Region,Departement,COM_ARRT_VILLE,COMMUNE,QUARTIER_VILLAGE_HAMEAU,CONCESSION,MENAGE,HOMMES,FEMMES,POPULATION
DAKAR,DAKAR,GOREE,GOREE,MBAMBARA,41,53,137,147,284
DAKAR,DAKAR,GOREE,GOREE,PONTY,57,95,340,361,701
DAKAR,DAKAR,GOREE,GOREE,TONGHOR,37,83,185,182,367
DAKAR,DAKAR,GOREE,GOREE,CASTEL,35,59,180,159,339
DAKAR,DAKAR,"VILLE DE DAKAR","DAKAR PLATEAU","CITE CAP VERDIENNE",56,180,408,371,779
DAKAR,DAKAR,"VILLE DE DAKAR","DAKAR PLATEAU","DAROU SALAM I",64,284,627,591,1218
DAKAR,DAKAR,"VILLE DE DAKAR","DAKAR PLATEAU",DIECKO,78,256,423,483,906
DAKAR,DAKAR,"VILLE DE DAKAR","DAKAR PLATEAU","DIECKO PLATEAU II",25,120,186,227,413
DAKAR,DAKAR,"VILLE DE DAKAR","DAKAR PLATEAU","GOUYE SALANE",50,173,315,323,638
DAKAR,DAKAR,"VILLE DE DAKAR","DAKAR PLATEAU","HOCK SANS FILS",230,894,2226,1801,4027
DAKAR,DAKAR,"VILLE DE DAKAR","DAKAR PLATEAU","KAYES FINDIW",101,383,999,1130,2129
DAKAR,DAKAR,"VILLE DE DAKAR","DAKAR PLATEAU",LAMBINASSE,115,320,465,506,971
DAKAR,DAKAR,"VILLE DE DAKAR","DAKAR PLATEAU",MBOTTE,26,78,213,227,440
DAKAR,DAKAR,"VILLE DE DAKAR","DAKAR PLATEAU","NIAYE THIOCKER",84,436,1110,1043,2153
DAKAR,DAKAR,"VILLE DE DAKAR","DAKAR PLATEAU","PARC FOURRAGE",23,235,474,476,950
DAKAR,DAKAR,"VILLE DE DAKAR","DAKAR PLATEAU",PETERSEN,52,185,834,512,1346
DAKAR,DAKAR,"VILLE DE DAKAR","DAKAR PLATEAU",REUBEUSS,432,1723,5669,4024,9693
DAKAR,DAKAR,"VILLE DE DAKAR","DAKAR PLATEAU","ROUKHOU DJINE",77,371,837,1052,1889
DAKAR,DAKAR,"VILLE DE DAKAR","DAKAR PLATEAU",SANDIAL,275,981,1624,1829,3453
DAKAR,DAKAR,"VILLE DE DAKAR","DAKAR PLATEAU",THIEDEME,67,211,468,485,953
DAKAR,DAKAR,"VILLE DE DAKAR","DAKAR PLATEAU","YAKHA DIEUF",142,649,1630,1363,2993
DAKAR,DAKAR,"VILLE DE DAKAR",MEDINA,"ABATTOIRS I",104,454,1216,985,2201
DAKAR,DAKAR,"VILLE DE DAKAR",MEDINA,"ABATTOIRS II",115,485,1186,1059,2245
DAKAR,DAKAR,"VILLE DE DAKAR",MEDINA,"ABATTOIRS III",56,238,502,515,1017
DAKAR,DAKAR,"VILLE DE DAKAR",MEDINA,"ABATTOIRS IV",65,299,757,580,1337
DAKAR,DAKAR,"VILLE DE DAKAR",MEDINA,"ABATTOIRS V",80,514,1076,930,2006
DAKAR,DAKAR,"VILLE DE DAKAR",MEDINA,"BOULEVARD GENERAL DE GAULLE",248,334,833,899,1732
DAKAR,DAKAR,"VILLE DE DAKAR",MEDINA,"DIECKO NORD I",113,678,1527,1261,2788
DAKAR,DAKAR,"VILLE DE DAKAR",MEDINA,"DIECKO NORD II",135,888,2171,1858,4029
DAKAR,DAKAR,"VILLE DE DAKAR",MEDINA,"DIECKO PINTH",223,869,2205,1905,4110
DAKAR,DAKAR,"VILLE DE DAKAR",MEDINA,"DIECKO SUD",135,607,1473,1089,2562
DAKAR,DAKAR,"VILLE DE DAKAR",MEDINA,"GIBRALTAR I",248,312,822,935,1757
DAKAR,DAKAR,"VILLE DE DAKAR",MEDINA,"GIBRALTAR II",181,454,1031,1244,2275
DAKAR,DAKAR,"VILLE DE DAKAR",MEDINA,"GOUYE MARIAMA LAYENE",90,433,1271,1157,2428
DAKAR,DAKAR,"VILLE DE DAKAR",MEDINA,"GOUYE MARIAMA PINTH",232,964,2554,2290,4844
DAKAR,DAKAR,"VILLE DE DAKAR",MEDINA,"GOUYE SALANE PINTH",300,1620,3868,3353,7221
DAKAR,DAKAR,"VILLE DE DAKAR",MEDINA,"GOUYE SALANE I",155,807,1887,1579,3466
DAKAR,DAKAR,"VILLE DE DAKAR",MEDINA,"GOUYE TANN",166,746,1773,1672,3445
DAKAR,DAKAR,"VILLE DE DAKAR",MEDINA,"KAYE OUSMANE DIENE",231,1212,2642,2411,5053
DAKAR,DAKAR,"VILLE DE DAKAR",MEDINA,M’BACKEUNEU,99,444,988,847,1835
DAKAR,DAKAR,"VILLE DE DAKAR",MEDINA,NGARAFF,61,311,810,668,1478
DAKAR,DAKAR,"VILLE DE DAKAR",MEDINA,"NGARAFF PINTH",158,723,1880,1556,3436
DAKAR,DAKAR,"VILLE DE DAKAR",MEDINA,"RASS MISSION",81,354,870,932,1802
DAKAR,DAKAR,"VILLE DE DAKAR",MEDINA,"SANTHIABA PINTH",122,460,1232,1061,2293
DAKAR,DAKAR,"VILLE DE DAKAR",MEDINA,"THIEURIGNE I",94,278,703,647,1350
DAKAR,DAKAR,"VILLE DE DAKAR",MEDINA,"THIEURIGNE II",130,535,1269,995,2264
DAKAR,DAKAR,"VILLE DE DAKAR",MEDINA,TILENE,75,563,1464,1122,2586
DAKAR,DAKAR,"VILLE DE DAKAR",MEDINA,"DIECKO NORD III",162,836,1894,1593,3487
DAKAR,DAKAR,"VILLE DE DAKAR",MEDINA,"GOUYE SALANE II",97,577,1304,1052,2356
DAKAR,DAKAR,"VILLE DE DAKAR",MEDINA,"GOUYE SALANE III",215,1240,2685,2456,5141
DAKAR,DAKAR,"VILLE DE DAKAR","GUEULE TAPEE FASS COLOBANE","COLOBANE BAYELAYE",165,746,1986,1592,3578
DAKAR,DAKAR,"VILLE DE DAKAR","GUEULE TAPEE FASS COLOBANE","COLOBANE HOCK",178,824,2711,1784,4495
DAKAR,DAKAR,"VILLE DE DAKAR","GUEULE TAPEE FASS COLOBANE","COLOBANE HOCK PINTH",220,1371,3142,2350,5492
DAKAR,DAKAR,"VILLE DE DAKAR","GUEULE TAPEE FASS COLOBANE","COLOBANE TSF",63,201,496,398,894
DAKAR,DAKAR,"VILLE DE DAKAR","GUEULE TAPEE FASS COLOBANE","FASS BATIMENT (FASS LOUVEAU)",298,1727,4083,3684,7767
DAKAR,DAKAR,"VILLE DE DAKAR","GUEULE TAPEE FASS COLOBANE","FASS CASIER",144,488,1243,1198,2441
DAKAR,DAKAR,"VILLE DE DAKAR","GUEULE TAPEE FASS COLOBANE","FASS DELORME",474,2876,6237,5800,12037
DAKAR,DAKAR,"VILLE DE DAKAR","GUEULE TAPEE FASS COLOBANE","FASS PAILLOTTE",66,695,959,923,1882
DAKAR,DAKAR,"VILLE DE DAKAR","GUEULE TAPEE FASS COLOBANE","GUEULE TAPEE I",144,450,1082,1044,2126
DAKAR,DAKAR,"VILLE DE DAKAR","GUEULE TAPEE FASS COLOBANE","GUEULE TAPEE II",97,333,1063,1032,2095
DAKAR,DAKAR,"VILLE DE DAKAR","GUEULE TAPEE FASS COLOBANE","GUEULE TAPEE III (NDOYENE)",314,1231,2843,2493,5336
DAKAR,DAKAR,"VILLE DE DAKAR","GUEULE TAPEE FASS COLOBANE","HLM FASS",295,632,2016,1937,3953
DAKAR,DAKAR,"VILLE DE DAKAR","GUEULE TAPEE FASS COLOBANE","HLM GUEULE TAPEE (GUEULE TAPEE IV)",521,1498,3701,3430,7131
DAKAR,DAKAR,"VILLE DE DAKAR","FANN POINT E AMITIE","AMITIE I",137,230,526,658,1184
DAKAR,DAKAR,"VILLE DE DAKAR","FANN POINT E AMITIE","AMITIE II",272,510,1108,1294,2402
DAKAR,DAKAR,"VILLE DE DAKAR","FANN POINT E AMITIE","FANN HOCK",355,1021,5168,3138,8306
DAKAR,DAKAR,"VILLE DE DAKAR","FANN POINT E AMITIE","FANN RESIDENCE",170,202,441,515,956
DAKAR,DAKAR,"VILLE DE DAKAR","FANN POINT E AMITIE","POINT E",513,814,1547,1862,3409
DAKAR,DAKAR,"VILLE DE DAKAR","FANN POINT E AMITIE","SICAP RUE X",199,353,978,923,1901
DAKAR,DAKAR,"VILLE DE DAKAR","FANN POINT E AMITIE","ZONE B  BALLON",137,251,653,633,1286
DAKAR,DAKAR,"VILLE DE DAKAR","FANN POINT E AMITIE","ZONE B  BATIMENT",88,120,335,336,671
DAKAR,DAKAR,"VILLE DE DAKAR","GRAND DAKAR","GRAND DAKAR I A (DARABIS)",72,154,367,335,702
DAKAR,DAKAR,"VILLE DE DAKAR","GRAND DAKAR","GRAND DAKAR I B",248,1185,2465,2315,4780
DAKAR,DAKAR,"VILLE DE DAKAR","GRAND DAKAR","GRAND DAKAR II A",277,1326,3178,2823,6001
DAKAR,DAKAR,"VILLE DE DAKAR","GRAND DAKAR","GRAND DAKAR II B",147,632,1532,1466,2998
DAKAR,DAKAR,"VILLE DE DAKAR","GRAND DAKAR","GRAND DAKAR IV A",186,1004,2047,2027,4074
DAKAR,DAKAR,"VILLE DE DAKAR","GRAND DAKAR","GRAND DAKAR IV B",132,829,1832,1750,3582
DAKAR,DAKAR,"VILLE DE DAKAR","GRAND DAKAR","GRAND DAKAR VI A",214,970,2236,2137,4373
DAKAR,DAKAR,"VILLE DE DAKAR","GRAND DAKAR","GRAND DAKAR VI B",135,693,1569,1392,2961
DAKAR,DAKAR,"VILLE DE DAKAR","GRAND DAKAR","GRAND DAKAR VII B (ZONE A)",190,483,1116,1243,2359
DAKAR,DAKAR,"VILLE DE DAKAR","GRAND DAKAR","GRAND DAKAR V A",193,1072,2540,2455,4995
DAKAR,DAKAR,"VILLE DE DAKAR","GRAND DAKAR","GRAND DAKAR III A",206,1046,2234,2069,4303
DAKAR,DAKAR,"VILLE DE DAKAR","GRAND DAKAR","GRAND DAKAR V B",199,827,1909,1814,3723
DAKAR,DAKAR,"VILLE DE DAKAR","GRAND DAKAR","SICAP AMITIE III ANNEXE",50,129,431,401,832
DAKAR,DAKAR,"VILLE DE DAKAR","GRAND DAKAR","GRAND DAKAR VII A TAÏBA",78,219,1032,619,1651
DAKAR,DAKAR,"VILLE DE DAKAR",BISCUITERIE,"BISCUITERIE IA",87,533,1201,976,2177
DAKAR,DAKAR,"VILLE DE DAKAR",BISCUITERIE,"BISCUITERIE IB",152,827,1732,1544,3276
DAKAR,DAKAR,"VILLE DE DAKAR",BISCUITERIE,"BISCUITERIE III",190,1333,2696,2283,4979
DAKAR,DAKAR,"VILLE DE DAKAR",BISCUITERIE,"BISCUITERIE KAYES",106,610,1452,1232,2684
DAKAR,DAKAR,"VILLE DE DAKAR",BISCUITERIE,"BISCUITERIE MADIAMA",91,664,1336,1328,2664
DAKAR,DAKAR,"VILLE DE DAKAR",BISCUITERIE,"BISCUITERIE TOUBA",215,894,2371,2171,4542
DAKAR,DAKAR,"VILLE DE DAKAR",BISCUITERIE,"BISCUITERIE V (POTOU)",269,1565,3625,3089,6714
DAKAR,DAKAR,"VILLE DE DAKAR",BISCUITERIE,"BISCUITERIE VI (USINE PARC)",131,596,1407,1162,2569
DAKAR,DAKAR,"VILLE DE DAKAR",BISCUITERIE,BOPP,254,659,1841,1719,3560
DAKAR,DAKAR,"VILLE DE DAKAR",BISCUITERIE,"CITE CHEIKH AHMADOU BAMBA",42,100,209,242,451
DAKAR,DAKAR,"VILLE DE DAKAR",BISCUITERIE,"CITE NDAR (OUAGOU NIAYES III)",211,454,1276,1444,2720
DAKAR,DAKAR,"VILLE DE DAKAR",BISCUITERIE,"DJIDDAH NGUELAW",104,522,1281,1054,2335
DAKAR,DAKAR,"VILLE DE DAKAR",BISCUITERIE,"GOUYE THIEURIGNE (CITE BISSAP)",242,1311,3119,3070,6189
DAKAR,DAKAR,"VILLE DE DAKAR",BISCUITERIE,"GRAND DAKAR X (NIARY TALLY)",308,1507,3414,2675,6089
DAKAR,DAKAR,"VILLE DE DAKAR",BISCUITERIE,"OUAGOU NIAYE I",342,1632,3416,2916,6332
DAKAR,DAKAR,"VILLE DE DAKAR",BISCUITERIE,"OUAGOU NIAYE II",301,949,2395,2339,4734
DAKAR,DAKAR,"VILLE DE DAKAR",BISCUITERIE,"USINE BEN TALLY (BISCUITERIE IV MISTRA)",220,1232,2771,2458,5229
DAKAR,DAKAR,"VILLE DE DAKAR",BISCUITERIE,"ZONE INDUSTRIELLE",77,317,812,848,1660
DAKAR,DAKAR,"VILLE DE DAKAR",BISCUITERIE,"BISCUITERIE II",77,401,985,780,1765
DAKAR,DAKAR,"VILLE DE DAKAR",BISCUITERIE,"GRAND DAKAR XI",129,833,1864,1492,3356
DAKAR,DAKAR,"VILLE DE DAKAR",HLM,"CITE DES EAUX",63,103,373,341,714
DAKAR,DAKAR,"VILLE DE DAKAR",HLM,"CITE DOUANES",122,302,811,923,1734
DAKAR,DAKAR,"VILLE DE DAKAR",HLM,"CITE PORT",135,283,878,765,1643
DAKAR,DAKAR,"VILLE DE DAKAR",HLM,"HLM ANGLE MOUSSE",164,341,842,863,1705
DAKAR,DAKAR,"VILLE DE DAKAR",HLM,"HLM I",471,688,2114,2113,4227
DAKAR,DAKAR,"VILLE DE DAKAR",HLM,"HLM II",344,568,1695,1782,3477
DAKAR,DAKAR,"VILLE DE DAKAR",HLM,"HLM III",238,426,1344,1292,2636
DAKAR,DAKAR,"VILLE DE DAKAR",HLM,"HLM IV A",339,489,1476,1649,3125
DAKAR,DAKAR,"VILLE DE DAKAR",HLM,"HLM IV B",121,151,407,439,846
DAKAR,DAKAR,"VILLE DE DAKAR",HLM,"HLM IV C",400,547,1705,1917,3622
DAKAR,DAKAR,"VILLE DE DAKAR",HLM,"HLM MONTAGNE (ZONE ARTISANALE N° IV)",294,1432,3057,3197,6254
DAKAR,DAKAR,"VILLE DE DAKAR",HLM,"HLM NIMZATT (HLM VI)",360,585,1636,1872,3508
DAKAR,DAKAR,"VILLE DE DAKAR",HLM,"HLM V A",385,725,2051,2189,4240
DAKAR,DAKAR,"VILLE DE DAKAR",HLM,"HLM V B",531,860,2519,2725,5244
DAKAR,DAKAR,"VILLE DE DAKAR","HANN BEL AIR","CITE BELLE VUE",71,147,279,294,573
DAKAR,DAKAR,"VILLE DE DAKAR","HANN BEL AIR","CITE ELISABETH DIOUF",127,174,372,479,851
DAKAR,DAKAR,"VILLE DE DAKAR","HANN BEL AIR","CITE ISRA",249,377,993,943,1936
DAKAR,DAKAR,"VILLE DE DAKAR","HANN BEL AIR","CITE KEUR YARAKH",49,55,105,145,250
DAKAR,DAKAR,"VILLE DE DAKAR","HANN BEL AIR","CITE MARINAS",131,217,415,505,920
DAKAR,DAKAR,"VILLE DE DAKAR","HANN BEL AIR","CITE SANDIAL",59,63,127,163,290
DAKAR,DAKAR,"VILLE DE DAKAR","HANN BEL AIR","CITE SCAT URBAM MARISTE I",1124,2526,5899,6787,12686
DAKAR,DAKAR,"VILLE DE DAKAR","HANN BEL AIR","CITE SCAT URBAM MARISTE II",1107,2680,5983,6691,12674
DAKAR,DAKAR,"VILLE DE DAKAR","HANN BEL AIR","CITE SOME",42,100,281,302,583
DAKAR,DAKAR,"VILLE DE DAKAR","HANN BEL AIR","FORD B",150,265,647,660,1307
DAKAR,DAKAR,"VILLE DE DAKAR","HANN BEL AIR","HANN EQUIPE",135,340,1060,1111,2171
DAKAR,DAKAR,"VILLE DE DAKAR","HANN BEL AIR","HANN GANGUI",110,348,1030,929,1959
DAKAR,DAKAR,"VILLE DE DAKAR","HANN BEL AIR","HANN III",216,417,1268,1169,2437
DAKAR,DAKAR,"VILLE DE DAKAR","HANN BEL AIR","HANN MARIGOT II",130,307,1145,1115,2260
DAKAR,DAKAR,"VILLE DE DAKAR","HANN BEL AIR","HANN MARISTE",410,816,1806,2116,3922
DAKAR,DAKAR,"VILLE DE DAKAR","HANN BEL AIR","HANN MONTAGNE VI",442,1335,4111,3568,7679
DAKAR,DAKAR,"VILLE DE DAKAR","HANN BEL AIR","HANN PARC I",26,52,147,140,287
DAKAR,DAKAR,"VILLE DE DAKAR","HANN BEL AIR","HANN PARC II",24,114,221,139,360
DAKAR,DAKAR,"VILLE DE DAKAR","HANN BEL AIR","HANN SANTHIE",396,2112,4291,3262,7553
DAKAR,DAKAR,"VILLE DE DAKAR","HANN BEL AIR","HANN YENE",174,367,1592,1560,3152
DAKAR,DAKAR,"VILLE DE DAKAR","HANN BEL AIR","HLM HANN MARISTE",324,499,1256,1358,2614
DAKAR,DAKAR,"VILLE DE DAKAR","HANN BEL AIR","WALOGUI (HANN PLAGE)",173,425,1771,1626,3397
DAKAR,DAKAR,"VILLE DE DAKAR","HANN BEL AIR","HANN MONTAGNE V A",292,853,2617,2431,5048
DAKAR,DAKAR,"VILLE DE DAKAR","HANN BEL AIR","HANN MONTAGNE V B",218,634,2011,1930,3941
DAKAR,DAKAR,"VILLE DE DAKAR","HANN BEL AIR","HANN PECHEURS I",212,477,2133,1917,4050
DAKAR,DAKAR,"VILLE DE DAKAR","HANN BEL AIR","HANN PECHEURS  II",90,266,822,708,1530
DAKAR,DAKAR,"VILLE DE DAKAR","HANN BEL AIR",PORT,65,296,1036,876,1912
DAKAR,DAKAR,"VILLE DE DAKAR","HANN BEL AIR",POTOU,45,83,358,208,566
DAKAR,DAKAR,"VILLE DE DAKAR","SICAP LIBERTE","CITE BARAQUE",42,247,772,769,1541
DAKAR,DAKAR,"VILLE DE DAKAR","SICAP LIBERTE","LIBERTE I",498,720,1745,1888,3633
DAKAR,DAKAR,"VILLE DE DAKAR","SICAP LIBERTE","LIBERTE II",428,621,1491,1732,3223
DAKAR,DAKAR,"VILLE DE DAKAR","SICAP LIBERTE","LIBERTE III",483,640,1739,1887,3626
DAKAR,DAKAR,"VILLE DE DAKAR","SICAP LIBERTE","LIBERTE IV",927,1331,3495,3729,7224
DAKAR,DAKAR,"VILLE DE DAKAR","SICAP LIBERTE","LIBERTE V",551,748,1970,2287,4257
DAKAR,DAKAR,"VILLE DE DAKAR","SICAP LIBERTE","LIBERTE VI",1185,1847,4334,4954,9288
DAKAR,DAKAR,"VILLE DE DAKAR","SICAP LIBERTE","LIBERTE VI EXTENSION",840,1958,3841,4446,8287
DAKAR,DAKAR,"VILLE DE DAKAR","DIEUPPEUL DERKLE","CASTOR (CITE ELEVAGE)",63,83,308,333,641
DAKAR,DAKAR,"VILLE DE DAKAR","DIEUPPEUL DERKLE","CASTOR (CITE MARINE)",200,400,1125,1295,2420
DAKAR,DAKAR,"VILLE DE DAKAR","DIEUPPEUL DERKLE","CASTOR I",183,495,1305,1428,2733
DAKAR,DAKAR,"VILLE DE DAKAR","DIEUPPEUL DERKLE","CASTOR II",98,307,811,932,1743
DAKAR,DAKAR,"VILLE DE DAKAR","DIEUPPEUL DERKLE","CITE CASTOR III (BOURGUIBA)",34,172,412,446,858
DAKAR,DAKAR,"VILLE DE DAKAR","DIEUPPEUL DERKLE","CITE ASECNA ET CITE SOTRAC",92,253,539,602,1141
DAKAR,DAKAR,"VILLE DE DAKAR","DIEUPPEUL DERKLE","CITE GEOGRAPHIE",56,181,602,473,1075
DAKAR,DAKAR,"VILLE DE DAKAR","DIEUPPEUL DERKLE","CITE GRANDE IMPRIMERIE AFRICAINE",58,197,491,507,998
DAKAR,DAKAR,"VILLE DE DAKAR","DIEUPPEUL DERKLE","CITE MINIERE",91,205,569,634,1203
DAKAR,DAKAR,"VILLE DE DAKAR","DIEUPPEUL DERKLE","CITE NOSOCO",31,99,279,270,549
DAKAR,DAKAR,"VILLE DE DAKAR","DIEUPPEUL DERKLE","CITE ORSTOM",22,91,247,267,514
DAKAR,DAKAR,"VILLE DE DAKAR","DIEUPPEUL DERKLE","CITE PTT",66,168,514,525,1039
DAKAR,DAKAR,"VILLE DE DAKAR","DIEUPPEUL DERKLE","DERKLE (CITE CREDIT FONCIER)",46,82,213,245,458
DAKAR,DAKAR,"VILLE DE DAKAR","DIEUPPEUL DERKLE","DERKLE (GAZELLE SOBOA)",27,90,227,210,437
DAKAR,DAKAR,"VILLE DE DAKAR","DIEUPPEUL DERKLE","DERKLE II (DAROU SALAM)",207,659,1521,1808,3329
DAKAR,DAKAR,"VILLE DE DAKAR","DIEUPPEUL DERKLE","DERKLE II (MAGARY)",104,177,474,577,1051
DAKAR,DAKAR,"VILLE DE DAKAR","DIEUPPEUL DERKLE","DERKLE II (NOTAIRE)",76,218,710,589,1299
DAKAR,DAKAR,"VILLE DE DAKAR","DIEUPPEUL DERKLE","DIEUPPEUL II (CITE PRESTATION FAMILIALE)",148,236,612,684,1296
DAKAR,DAKAR,"VILLE DE DAKAR","DIEUPPEUL DERKLE","SICAP DIEUPPEUL I",373,549,1377,1506,2883
DAKAR,DAKAR,"VILLE DE DAKAR","DIEUPPEUL DERKLE","SICAP DIEUPPEUL II",255,334,977,1019,1996
DAKAR,DAKAR,"VILLE DE DAKAR","DIEUPPEUL DERKLE","SICAP DIEUPPEUL III",360,938,1644,1810,3454
DAKAR,DAKAR,"VILLE DE DAKAR","DIEUPPEUL DERKLE","SICAP DIEUPPEUL IV",457,937,1564,1759,3323
DAKAR,DAKAR,"VILLE DE DAKAR","DIEUPPEUL DERKLE","SICAP LIBERTE V B",410,620,1599,1782,3381
DAKAR,DAKAR,"VILLE DE DAKAR","DIEUPPEUL DERKLE","SICAP LIBERTE V C",129,161,434,470,904
DAKAR,DAKAR,"VILLE DE DAKAR",OUAKAM,"ANCIENNE PISTE",151,465,857,937,1794
DAKAR,DAKAR,"VILLE DE DAKAR",OUAKAM,BALLON,139,302,836,827,1663
DAKAR,DAKAR,"VILLE DE DAKAR",OUAKAM,"BIRA OUAKAM (TOUBA OUAKAM)",1306,3631,9160,9053,18213
DAKAR,DAKAR,"VILLE DE DAKAR",OUAKAM,BOULGA,181,451,1337,1536,2873
DAKAR,DAKAR,"VILLE DE DAKAR",OUAKAM,"CITE ASECNA",323,583,1731,1910,3641
DAKAR,DAKAR,"VILLE DE DAKAR",OUAKAM,"CITE ASECNA III",42,63,145,204,349
DAKAR,DAKAR,"VILLE DE DAKAR",OUAKAM,"CITE ASSEMBLE NATIONALE",253,423,1069,1130,2199
DAKAR,DAKAR,"VILLE DE DAKAR",OUAKAM,"CITE COMICO",409,806,2070,2261,4331
DAKAR,DAKAR,"VILLE DE DAKAR",OUAKAM,"CITE COMMUNAUTE URBAINE",61,95,269,334,603
DAKAR,DAKAR,"VILLE DE DAKAR",OUAKAM,"CITE EL HADJI MALICK SY",749,1195,2604,3080,5684
DAKAR,DAKAR,"VILLE DE DAKAR",OUAKAM,"CITE ENSEIGNANT SUPERIEUR",114,166,361,390,751
DAKAR,DAKAR,"VILLE DE DAKAR",OUAKAM,"CITE URBANISME HABITAT",51,55,138,157,295
DAKAR,DAKAR,"VILLE DE DAKAR",OUAKAM,"GOUYE SOR",174,403,1156,1164,2320
DAKAR,DAKAR,"VILLE DE DAKAR",OUAKAM,LEONA,93,250,613,612,1225
DAKAR,DAKAR,"VILLE DE DAKAR",OUAKAM,"MAMELLES AVIATION",392,534,1195,1384,2579
DAKAR,DAKAR,"VILLE DE DAKAR",OUAKAM,MBOUL,273,680,1992,2102,4094
DAKAR,DAKAR,"VILLE DE DAKAR",OUAKAM,"MERINA (MERINA I)",99,279,920,934,1854
DAKAR,DAKAR,"VILLE DE DAKAR",OUAKAM,"MERINA (MERINA II)",160,349,1047,1084,2131
DAKAR,DAKAR,"VILLE DE DAKAR",OUAKAM,"MONTAGNE ROUGE",275,634,1463,1590,3053
DAKAR,DAKAR,"VILLE DE DAKAR",OUAKAM,"OUAKAM CORNICHE",94,133,360,311,671
DAKAR,DAKAR,"VILLE DE DAKAR",OUAKAM,RIP,47,147,491,416,907
DAKAR,DAKAR,"VILLE DE DAKAR",OUAKAM,"SACRE CŒUR III VDN",556,763,1553,1931,3484
DAKAR,DAKAR,"VILLE DE DAKAR",OUAKAM,SINTHIA,99,164,639,739,1378
DAKAR,DAKAR,"VILLE DE DAKAR",OUAKAM,"SUD AFRICA",85,132,1170,365,1535
DAKAR,DAKAR,"VILLE DE DAKAR",OUAKAM,TAGLOU,259,613,1696,1854,3550
DAKAR,DAKAR,"VILLE DE DAKAR",OUAKAM,"TOUBA ALMADIES",147,184,415,438,853
DAKAR,DAKAR,"VILLE DE DAKAR",OUAKAM,"TOUBA OUAKAM II (CITE AVION)",1491,4602,10238,10392,20630
DAKAR,DAKAR,"VILLE DE DAKAR",OUAKAM,"TOUBA RENAISSANCE",266,387,782,974,1756
DAKAR,DAKAR,"VILLE DE DAKAR",OUAKAM,"ZONE DE L'AEROPORT",447,709,1523,1832,3355
DAKAR,DAKAR,"VILLE DE DAKAR",OUAKAM,BATRAIN,338,613,1286,1484,2770
DAKAR,DAKAR,"VILLE DE DAKAR",NGOR,"ALMADIES EST",240,330,682,789,1471
DAKAR,DAKAR,"VILLE DE DAKAR",NGOR,"ALMADIES OUEST",230,303,721,792,1513
DAKAR,DAKAR,"VILLE DE DAKAR",NGOR,"GRAND NGOR",172,438,1551,1448,2999
DAKAR,DAKAR,"VILLE DE DAKAR",NGOR,"ILE DE NGOR",11,11,45,3,48
DAKAR,DAKAR,"VILLE DE DAKAR",NGOR,NDIONGORANE,257,733,2084,1981,4065
DAKAR,DAKAR,"VILLE DE DAKAR",NGOR,"NGOR VIRAGE",106,138,368,393,761
DAKAR,DAKAR,"VILLE DE DAKAR",NGOR,"PETIT NGOR",129,418,1307,1270,2577
DAKAR,DAKAR,"VILLE DE DAKAR",NGOR,"PETIT NGOR (RESIDENCE NORD)",13,14,42,27,69
DAKAR,DAKAR,"VILLE DE DAKAR",NGOR,"ZONE EXTENSION EST",118,236,456,474,930
DAKAR,DAKAR,"VILLE DE DAKAR",NGOR,"ZONE EXTENSION OUEST",209,368,715,757,1472
DAKAR,DAKAR,"VILLE DE DAKAR",NGOR,"ALMADIES (STATION SHELL)",305,397,956,845,1801
DAKAR,DAKAR,"VILLE DE DAKAR",YOFF,CDE,15,35,68,66,134
DAKAR,DAKAR,"VILLE DE DAKAR",YOFF,"CITE A. EL. MAS",213,318,745,926,1671
DAKAR,DAKAR,"VILLE DE DAKAR",YOFF,"CITE AIR AFRIQUE A",205,348,797,939,1736
DAKAR,DAKAR,"VILLE DE DAKAR",YOFF,"CITE AIR AFRIQUE B",91,129,268,331,599
DAKAR,DAKAR,"VILLE DE DAKAR",YOFF,"CITE AIR FRANCE",522,873,1951,2302,4253
DAKAR,DAKAR,"VILLE DE DAKAR",YOFF,"CITE AIR SENEGAL",7,8,23,42,65
DAKAR,DAKAR,"VILLE DE DAKAR",YOFF,"CITE ALIA DIENE",52,98,180,237,417
DAKAR,DAKAR,"VILLE DE DAKAR",YOFF,"CITE AMADOU DIOP",8,16,46,42,88
DAKAR,DAKAR,"VILLE DE DAKAR",YOFF,"CITE APECSY ECOLOGIQUE",115,223,510,631,1141
DAKAR,DAKAR,"VILLE DE DAKAR",YOFF,"CITE APECSY I",277,479,1167,1345,2512
DAKAR,DAKAR,"VILLE DE DAKAR",YOFF,"CITE APECSY II EST",299,426,1245,1480,2725
DAKAR,DAKAR,"VILLE DE DAKAR",YOFF,"CITE APECSY II OUEST",195,383,954,1030,1984
DAKAR,DAKAR,"VILLE DE DAKAR",YOFF,"CITE APECSY III",73,113,265,293,558
DAKAR,DAKAR,"VILLE DE DAKAR",YOFF,"CITE ASECNA",304,462,1550,1272,2822
DAKAR,DAKAR,"VILLE DE DAKAR",YOFF,"CITE ASECNA EXTENSION",132,184,401,536,937
DAKAR,DAKAR,"VILLE DE DAKAR",YOFF,"CITE AZUR I",162,250,520,712,1232
DAKAR,DAKAR,"VILLE DE DAKAR",YOFF,"CITE AZUR II",141,212,537,616,1153
DAKAR,DAKAR,"VILLE DE DAKAR",YOFF,"CITE AZUR III",95,128,331,413,744
DAKAR,DAKAR,"VILLE DE DAKAR",YOFF,"CITE BARA MBOUP",299,620,1405,1487,2892
DAKAR,DAKAR,"VILLE DE DAKAR",YOFF,"CITE BCEAO I",99,106,294,292,586
DAKAR,DAKAR,"VILLE DE DAKAR",YOFF,"CITE BCEAO II",82,105,243,298,541
DAKAR,DAKAR,"VILLE DE DAKAR",YOFF,"CITE BCEAO OCEAN",35,40,70,89,159
DAKAR,DAKAR,"VILLE DE DAKAR",YOFF,"CITE BIAGUI",104,120,198,300,498
DAKAR,DAKAR,"VILLE DE DAKAR",YOFF,"CITE DAKAR MARINE",175,282,877,922,1799
DAKAR,DAKAR,"VILLE DE DAKAR",YOFF,"CITE DIACKSAO",123,202,522,569,1091
DAKAR,DAKAR,"VILLE DE DAKAR",YOFF,"CITE DJILY MBAYE",180,271,708,856,1564
DAKAR,DAKAR,"VILLE DE DAKAR",YOFF,"CITE IBRAHIMA NIANG",50,59,176,206,382
DAKAR,DAKAR,"VILLE DE DAKAR",YOFF,"CITE LA POSTE (DIAMALAYE)",61,90,256,217,473
DAKAR,DAKAR,"VILLE DE DAKAR",YOFF,"CITE LOBATT FALL",26,30,52,70,122
DAKAR,DAKAR,"VILLE DE DAKAR",YOFF,"CITE LONASE",192,298,544,713,1257
DAKAR,DAKAR,"VILLE DE DAKAR",YOFF,"CITE PALENE",84,99,246,283,529
DAKAR,DAKAR,"VILLE DE DAKAR",YOFF,"CITE POSTE",25,33,71,87,158
DAKAR,DAKAR,"VILLE DE DAKAR",YOFF,"CITE SAGEF",63,94,194,251,445
DAKAR,DAKAR,"VILLE DE DAKAR",YOFF,"CITE SODALO",104,218,612,555,1167
DAKAR,DAKAR,"VILLE DE DAKAR",YOFF,"CITE SONATEL",114,213,512,601,1113
DAKAR,DAKAR,"VILLE DE DAKAR",YOFF,"CITE SONATEL III",1203,2541,5344,6037,11381
DAKAR,DAKAR,"VILLE DE DAKAR",YOFF,"CITE TOBAGO",339,485,1013,1408,2421
DAKAR,DAKAR,"VILLE DE DAKAR",YOFF,DAGOUDANE,162,363,1566,1374,2940
DAKAR,DAKAR,"VILLE DE DAKAR",YOFF,"DIAMALAYE EXTENSION",27,68,132,164,296
DAKAR,DAKAR,"VILLE DE DAKAR",YOFF,"DIAMALAYE I",116,138,347,364,711
DAKAR,DAKAR,"VILLE DE DAKAR",YOFF,"DIAMALAYE II",407,602,1501,1626,3127
DAKAR,DAKAR,"VILLE DE DAKAR",YOFF,"DIAMALAYE III",239,536,1517,1405,2922
DAKAR,DAKAR,"VILLE DE DAKAR",YOFF,LAYENE,384,704,2526,2810,5336
DAKAR,DAKAR,"VILLE DE DAKAR",YOFF,"MAME RHANE",112,267,615,681,1296
DAKAR,DAKAR,"VILLE DE DAKAR",YOFF,NDENATE,471,1181,4055,4021,8076
DAKAR,DAKAR,"VILLE DE DAKAR",YOFF,NDEUNGAGNE,418,992,3389,3623,7012
DAKAR,DAKAR,"VILLE DE DAKAR",YOFF,NGAPAROU,426,899,2983,3158,6141
DAKAR,DAKAR,"VILLE DE DAKAR",YOFF,"SICAP LAYENE",340,510,1696,1857,3553
DAKAR,DAKAR,"VILLE DE DAKAR",YOFF,"SIPRES IV",26,31,79,88,167
DAKAR,DAKAR,"VILLE DE DAKAR",YOFF,"TELECOM RESIDENCE",85,117,310,334,644
DAKAR,DAKAR,"VILLE DE DAKAR",YOFF,"TERME NORD TRAVAUX ET CADRES",206,436,1514,1487,3001
DAKAR,DAKAR,"VILLE DE DAKAR",YOFF,TONGHOR,756,1841,5727,5640,11367
DAKAR,DAKAR,"VILLE DE DAKAR",YOFF,"TOUNDEUP REYA",498,775,1590,1642,3232
DAKAR,DAKAR,"VILLE DE DAKAR",YOFF,"YOFF EXTENSION",110,201,505,621,1126
DAKAR,DAKAR,"VILLE DE DAKAR",YOFF,"YOFF MBENGUENE",305,658,2106,2220,4326
DAKAR,DAKAR,"VILLE DE DAKAR",YOFF,"YOFF RAND RAR",40,57,140,129,269
DAKAR,DAKAR,"VILLE DE DAKAR",YOFF,"CITE LONASE II",39,61,221,239,460
DAKAR,DAKAR,"VILLE DE DAKAR","MERMOZ SACRE COEUR","AMITIE III",307,480,1143,1398,2541
DAKAR,DAKAR,"VILLE DE DAKAR","MERMOZ SACRE COEUR",BAOBAB,890,1313,3011,3422,6433
DAKAR,DAKAR,"VILLE DE DAKAR","MERMOZ SACRE COEUR","CITE IBA NDIAYE DIADJI",52,80,143,193,336
DAKAR,DAKAR,"VILLE DE DAKAR","MERMOZ SACRE COEUR",KARACK,252,352,881,939,1820
DAKAR,DAKAR,"VILLE DE DAKAR","MERMOZ SACRE COEUR","MERMOZ 1ere PORTE",346,415,951,1090,2041
DAKAR,DAKAR,"VILLE DE DAKAR","MERMOZ SACRE COEUR","MERMOZ 2EME PORTE",262,412,808,1033,1841
DAKAR,DAKAR,"VILLE DE DAKAR","MERMOZ SACRE COEUR","MERMOZ PYROTECHNIQUE",682,986,2150,2599,4749
DAKAR,DAKAR,"VILLE DE DAKAR","MERMOZ SACRE COEUR","SACRE CŒUR I",272,474,1226,1210,2436
DAKAR,DAKAR,"VILLE DE DAKAR","MERMOZ SACRE COEUR","SACRE CŒUR II",386,576,1382,1345,2727
DAKAR,DAKAR,"VILLE DE DAKAR","MERMOZ SACRE COEUR","SACRE CŒUR III PYROTECHNIQUE",323,755,1506,1716,3222
DAKAR,DAKAR,"VILLE DE DAKAR","MERMOZ SACRE COEUR",TERANGA,89,141,326,357,683
DAKAR,DAKAR,"VILLE DE DAKAR","MERMOZ SACRE COEUR","FENETRE MERMOZ",134,432,1016,1235,2251
DAKAR,DAKAR,"VILLE DE DAKAR","MERMOZ SACRE COEUR","SACRE CŒUR III",1095,1659,3432,4086,7518
DAKAR,DAKAR,"VILLE DE DAKAR","GRAND YOFF",BAGDAD,221,564,1623,1632,3255
DAKAR,DAKAR,"VILLE DE DAKAR","GRAND YOFF","CAMP SEKOU MBALLO (LIBERTE VI EXTENSION)",589,961,2118,2447,4565
DAKAR,DAKAR,"VILLE DE DAKAR","GRAND YOFF","CICES EST",396,1265,2463,2775,5238
DAKAR,DAKAR,"VILLE DE DAKAR","GRAND YOFF","CITE BASTOS I",49,100,404,322,726
DAKAR,DAKAR,"VILLE DE DAKAR","GRAND YOFF","CITE BASTOS II",50,113,347,356,703
DAKAR,DAKAR,"VILLE DE DAKAR","GRAND YOFF","CITE CPI",251,359,974,903,1877
DAKAR,DAKAR,"VILLE DE DAKAR","GRAND YOFF","CITE FOIRE MAGISTRAT",175,362,728,929,1657
DAKAR,DAKAR,"VILLE DE DAKAR","GRAND YOFF","CITE KERETOU",288,744,1719,1910,3629
DAKAR,DAKAR,"VILLE DE DAKAR","GRAND YOFF","CITE MILLIONNAIRE",440,2045,4871,5024,9895
DAKAR,DAKAR,"VILLE DE DAKAR","GRAND YOFF","CITE SIPRES I",169,218,531,575,1106
DAKAR,DAKAR,"VILLE DE DAKAR","GRAND YOFF","CITE SIPRES II SICA",166,195,401,575,976
DAKAR,DAKAR,"VILLE DE DAKAR","GRAND YOFF","DAROU RAHMANE I",164,579,1543,1609,3152
DAKAR,DAKAR,"VILLE DE DAKAR","GRAND YOFF","DAROU RAHMANE II",135,402,1342,1076,2418
DAKAR,DAKAR,"VILLE DE DAKAR","GRAND YOFF","DAROU RAKHMANE III",103,261,884,805,1689
DAKAR,DAKAR,"VILLE DE DAKAR","GRAND YOFF","DAROU SALAM I",72,169,507,523,1030
DAKAR,DAKAR,"VILLE DE DAKAR","GRAND YOFF","DAROU SALAM II",224,764,2053,1949,4002
DAKAR,DAKAR,"VILLE DE DAKAR","GRAND YOFF","DAROU SALAM III",80,166,591,599,1190
DAKAR,DAKAR,"VILLE DE DAKAR","GRAND YOFF","DAROU SANTHIE",84,329,922,916,1838
DAKAR,DAKAR,"VILLE DE DAKAR","GRAND YOFF","GAZELLE I",106,340,870,829,1699
DAKAR,DAKAR,"VILLE DE DAKAR","GRAND YOFF","GRAND YOFF LEONA",444,1036,2949,2965,5914
DAKAR,DAKAR,"VILLE DE DAKAR","GRAND YOFF","HAMO GRAND YOFF",120,140,373,448,821
DAKAR,DAKAR,"VILLE DE DAKAR","GRAND YOFF","HLM GRAND YOFF",234,538,1368,1462,2830
DAKAR,DAKAR,"VILLE DE DAKAR","GRAND YOFF","HLM GRAND YOFF I",130,146,421,507,928
DAKAR,DAKAR,"VILLE DE DAKAR","GRAND YOFF","HLM GRAND YOFF II",135,233,660,781,1441
DAKAR,DAKAR,"VILLE DE DAKAR","GRAND YOFF","HLM GRAND YOFF II (CITE ASSANE DIOP)",171,402,1005,1118,2123
DAKAR,DAKAR,"VILLE DE DAKAR","GRAND YOFF","HLM GRAND YOFF III",370,685,1762,1975,3737
DAKAR,DAKAR,"VILLE DE DAKAR","GRAND YOFF","HLM PATTE D'OIE",351,496,1734,1849,3583
DAKAR,DAKAR,"VILLE DE DAKAR","GRAND YOFF","HLM SHELTER I",81,116,263,320,583
DAKAR,DAKAR,"VILLE DE DAKAR","GRAND YOFF","HLM SHELTER II",306,477,1287,1432,2719
DAKAR,DAKAR,"VILLE DE DAKAR","GRAND YOFF","KHAR YALLA (CITE TELE)",120,360,987,1022,2009
DAKAR,DAKAR,"VILLE DE DAKAR","GRAND YOFF","KHAR YALLA II",118,288,973,966,1939
DAKAR,DAKAR,"VILLE DE DAKAR","GRAND YOFF","MAKA I",110,416,1121,1171,2292
DAKAR,DAKAR,"VILLE DE DAKAR","GRAND YOFF","MAKA II",61,163,524,541,1065
DAKAR,DAKAR,"VILLE DE DAKAR","GRAND YOFF","MAKA III",103,301,871,921,1792
DAKAR,DAKAR,"VILLE DE DAKAR","GRAND YOFF",MISSIRAH,376,1103,3035,3031,6066
DAKAR,DAKAR,"VILLE DE DAKAR","GRAND YOFF",SANTHIABA,253,790,2103,2096,4199
DAKAR,DAKAR,"VILLE DE DAKAR","GRAND YOFF","SCAT URBAM (CITE CONACHAP)",529,1076,3356,3093,6449
DAKAR,DAKAR,"VILLE DE DAKAR","GRAND YOFF","SCAT URBAM (CITE FOUGEROLLE)",40,78,212,224,436
DAKAR,DAKAR,"VILLE DE DAKAR","GRAND YOFF","SCAT URBAM (CITE KEUR KHADIM I)",45,73,192,219,411
DAKAR,DAKAR,"VILLE DE DAKAR","GRAND YOFF","SCAT URBAM (CITE KEUR KHADIM II)",122,217,534,650,1184
DAKAR,DAKAR,"VILLE DE DAKAR","GRAND YOFF","SCAT URBAM (ILOT A)",92,192,476,591,1067
DAKAR,DAKAR,"VILLE DE DAKAR","GRAND YOFF","SCAT URBAM (ILOT B)",80,214,501,636,1137
DAKAR,DAKAR,"VILLE DE DAKAR","GRAND YOFF","SCAT URBAM (ILOT C)",57,143,362,470,832
DAKAR,DAKAR,"VILLE DE DAKAR","GRAND YOFF","SCAT URBAM (ILOT D)",64,249,492,580,1072
DAKAR,DAKAR,"VILLE DE DAKAR","GRAND YOFF","SCAT URBAM (ILOT E)",129,315,731,839,1570
DAKAR,DAKAR,"VILLE DE DAKAR","GRAND YOFF","SCAT URBAM (ILOT F)",90,157,375,425,800
DAKAR,DAKAR,"VILLE DE DAKAR","GRAND YOFF","SCAT URBAM (ILOT G)",96,264,588,629,1217
DAKAR,DAKAR,"VILLE DE DAKAR","GRAND YOFF","SCAT URBAM (ILOT H)",81,336,717,710,1427
DAKAR,DAKAR,"VILLE DE DAKAR","GRAND YOFF","SCAT URBAM (ILOT M)",44,99,315,272,587
DAKAR,DAKAR,"VILLE DE DAKAR","GRAND YOFF","SCAT URBAM (ILOT N)",102,322,855,836,1691
DAKAR,DAKAR,"VILLE DE DAKAR","GRAND YOFF","SCAT URBAM ARAFAT",201,997,1978,2089,4067
DAKAR,DAKAR,"VILLE DE DAKAR","GRAND YOFF","SHELTER (ZONE COMMERCIALE)",253,508,1345,1530,2875
DAKAR,DAKAR,"VILLE DE DAKAR","GRAND YOFF","SICAP FOIRE",182,237,612,777,1389
DAKAR,DAKAR,"VILLE DE DAKAR","GRAND YOFF","SUD FOIRE (CITE CSE)",202,263,805,954,1759
DAKAR,DAKAR,"VILLE DE DAKAR","GRAND YOFF","SUD FOIRE (CITE LIBASSE NIANG)",119,184,426,525,951
DAKAR,DAKAR,"VILLE DE DAKAR","GRAND YOFF","SUD FOIRE (CITE OUSMANE DIOP)",50,108,230,235,465
DAKAR,DAKAR,"VILLE DE DAKAR","GRAND YOFF","SUD FOIRE (CITE SONATEL I)",152,325,775,884,1659
DAKAR,DAKAR,"VILLE DE DAKAR","GRAND YOFF","SUD FOIRE (CITE SONATEL II)",73,101,272,380,652
DAKAR,DAKAR,"VILLE DE DAKAR","GRAND YOFF","SUD FOIRE (CITE SONATEL III)",75,124,342,397,739
DAKAR,DAKAR,"VILLE DE DAKAR","GRAND YOFF","TAIBA I",180,587,1832,1709,3541
DAKAR,DAKAR,"VILLE DE DAKAR","GRAND YOFF","TAIBA II",292,1233,3214,3169,6383
DAKAR,DAKAR,"VILLE DE DAKAR","GRAND YOFF","TAIBA III",92,287,872,886,1758
DAKAR,DAKAR,"VILLE DE DAKAR","GRAND YOFF","TAIBA IV",40,168,542,424,966
DAKAR,DAKAR,"VILLE DE DAKAR","GRAND YOFF","ZONE DE CAPTAGE",972,2728,6387,7309,13696
DAKAR,DAKAR,"VILLE DE DAKAR","GRAND YOFF","ARAFAT B BIS",75,382,973,825,1798
DAKAR,DAKAR,"VILLE DE DAKAR","GRAND YOFF","ARAFAT I A",183,783,1807,1882,3689
DAKAR,DAKAR,"VILLE DE DAKAR","GRAND YOFF","ARAFAT I B",111,382,1276,1192,2468
DAKAR,DAKAR,"VILLE DE DAKAR","GRAND YOFF","ARAFAT II",83,351,1051,1004,2055
DAKAR,DAKAR,"VILLE DE DAKAR","GRAND YOFF","ARAFAT III",77,219,750,678,1428
DAKAR,DAKAR,"VILLE DE DAKAR","GRAND YOFF","ARAFAT THIOSSANE",120,443,1279,1302,2581
DAKAR,DAKAR,"VILLE DE DAKAR","GRAND YOFF","ARAFAT V",165,811,1882,1812,3694
DAKAR,DAKAR,"VILLE DE DAKAR","GRAND YOFF","ARAFAT VI",76,237,881,661,1542
DAKAR,DAKAR,"VILLE DE DAKAR","GRAND YOFF","DJIEDDAH I",86,279,638,725,1363
DAKAR,DAKAR,"VILLE DE DAKAR","GRAND YOFF","DJIEDDAH II",187,460,1600,1515,3115
DAKAR,DAKAR,"VILLE DE DAKAR","GRAND YOFF","DJIEDDAH III",157,570,1572,1523,3095
DAKAR,DAKAR,"VILLE DE DAKAR","GRAND YOFF","KHAR YALLA I",174,486,1458,1364,2822
DAKAR,DAKAR,"VILLE DE DAKAR","GRAND YOFF","TOUBA ARAFAT",90,280,861,798,1659
DAKAR,DAKAR,"VILLE DE DAKAR","PATTE D'OIE","CITE BCEAO",44,103,259,298,557
DAKAR,DAKAR,"VILLE DE DAKAR","PATTE D'OIE","CITE EL AMAL",69,145,378,398,776
DAKAR,DAKAR,"VILLE DE DAKAR","PATTE D'OIE","CITE IMPOTS ET DOMAINES",435,1069,2923,3350,6273
DAKAR,DAKAR,"VILLE DE DAKAR","PATTE D'OIE","CITE KEUR DAMEL",211,374,960,1054,2014
DAKAR,DAKAR,"VILLE DE DAKAR","PATTE D'OIE","CITE LEOPOLD SEDAR SENGHOR",232,546,1230,1516,2746
DAKAR,DAKAR,"VILLE DE DAKAR","PATTE D'OIE","CITE MIXTA",129,172,319,390,709
DAKAR,DAKAR,"VILLE DE DAKAR","PATTE D'OIE","CITE SOPRIM",351,538,1325,1575,2900
DAKAR,DAKAR,"VILLE DE DAKAR","PATTE D'OIE","CITE SOPRIM EXTENSION",598,1766,4140,4600,8740
DAKAR,DAKAR,"VILLE DE DAKAR","PATTE D'OIE","PATTE D'OIE BUILDERS",695,1024,2915,3411,6326
DAKAR,DAKAR,"VILLE DE DAKAR","PATTE D'OIE","CITE ARTP",9,14,29,29,58
DAKAR,DAKAR,"VILLE DE DAKAR","PATTE D'OIE","CITE ATAYA",8,65,133,171,304
DAKAR,DAKAR,"VILLE DE DAKAR","PATTE D'OIE","CITE MAGISTRAT",62,86,211,224,435
DAKAR,DAKAR,"VILLE DE DAKAR","PATTE D'OIE","CITE SONATEL",59,64,136,162,298
DAKAR,DAKAR,"VILLE DE DAKAR","PATTE D'OIE","GRAND MEDINE 1",112,268,873,873,1746
DAKAR,DAKAR,"VILLE DE DAKAR","PATTE D'OIE","GRAND MEDINE 2",144,261,1049,933,1982
DAKAR,DAKAR,"VILLE DE DAKAR","PATTE D'OIE","GRAND MEDINE 3",144,298,1197,1106,2303
DAKAR,DAKAR,"VILLE DE DAKAR","PATTE D'OIE","GRAND MEDINE 4",170,456,1369,1333,2702
DAKAR,DAKAR,"VILLE DE DAKAR","PATTE D'OIE","GRAND MEDINE 5",175,331,1280,1264,2544
DAKAR,DAKAR,"VILLE DE DAKAR","PATTE D'OIE","GRAND MEDINE 6",103,169,769,672,1441
DAKAR,DAKAR,"VILLE DE DAKAR","PATTE D'OIE","GRAND MEDINE 7",138,231,1005,962,1967
DAKAR,DAKAR,"VILLE DE DAKAR","PARCELLES ASSAINIES","HLM GRAND MEDINE (UNITE 23)",1057,1626,4429,5184,9613
DAKAR,DAKAR,"VILLE DE DAKAR","PARCELLES ASSAINIES","UNITE 9",287,718,2244,2253,4497
DAKAR,DAKAR,"VILLE DE DAKAR","PARCELLES ASSAINIES","UNITE 7",564,1370,4289,4341,8630
DAKAR,DAKAR,"VILLE DE DAKAR","PARCELLES ASSAINIES","UNITE 8",605,1485,4531,4820,9351
DAKAR,DAKAR,"VILLE DE DAKAR","PARCELLES ASSAINIES","UNITE 10",473,1352,3852,3739,7591
DAKAR,DAKAR,"VILLE DE DAKAR","PARCELLES ASSAINIES","UNITE 11",720,1695,5348,5394,10742
DAKAR,DAKAR,"VILLE DE DAKAR","PARCELLES ASSAINIES","UNITE 12",539,1194,3747,3876,7623
DAKAR,DAKAR,"VILLE DE DAKAR","PARCELLES ASSAINIES","UNITE 13",541,1462,4474,4519,8993
DAKAR,DAKAR,"VILLE DE DAKAR","PARCELLES ASSAINIES","UNITE 14",397,1194,3359,3174,6533
DAKAR,DAKAR,"VILLE DE DAKAR","PARCELLES ASSAINIES","UNITE 19",560,1377,4294,4196,8490
DAKAR,DAKAR,"VILLE DE DAKAR","PARCELLES ASSAINIES","UNITE 15",224,595,1592,1868,3460
DAKAR,DAKAR,"VILLE DE DAKAR","PARCELLES ASSAINIES","UNITE 16",580,1522,4577,4904,9481
DAKAR,DAKAR,"VILLE DE DAKAR","PARCELLES ASSAINIES","UNITE 17",569,1232,3923,4112,8035
DAKAR,DAKAR,"VILLE DE DAKAR","PARCELLES ASSAINIES","UNITE 18",580,1388,4477,4299,8776
DAKAR,DAKAR,"VILLE DE DAKAR","PARCELLES ASSAINIES","UNITE 20",592,1676,5035,4679,9714
DAKAR,DAKAR,"VILLE DE DAKAR","PARCELLES ASSAINIES","UNITE 21",541,1292,4060,4157,8217
DAKAR,DAKAR,"VILLE DE DAKAR","PARCELLES ASSAINIES","UNITE 22",567,1610,4704,4416,9120
DAKAR,DAKAR,"VILLE DE DAKAR","PARCELLES ASSAINIES","UNITE 24",602,1461,4584,4817,9401
DAKAR,DAKAR,"VILLE DE DAKAR","PARCELLES ASSAINIES","UNITE 25",539,1409,4160,3885,8045
DAKAR,DAKAR,"VILLE DE DAKAR","PARCELLES ASSAINIES","UNITE 26",810,1898,5596,5763,11359
DAKAR,DAKAR,"VILLE DE DAKAR",CAMBERENE,"CAMBERENE II A",255,705,2126,2116,4242
DAKAR,DAKAR,"VILLE DE DAKAR",CAMBERENE,"CAMBERENE II B",365,818,2576,2233,4809
DAKAR,DAKAR,"VILLE DE DAKAR",CAMBERENE,"CAMBERENE II C",250,755,2098,1907,4005
DAKAR,DAKAR,"VILLE DE DAKAR",CAMBERENE,CAYOR,149,231,972,983,1955
DAKAR,DAKAR,"VILLE DE DAKAR",CAMBERENE,"CITE DES NATIONS UNIES",332,890,2180,2406,4586
DAKAR,DAKAR,"VILLE DE DAKAR",CAMBERENE,DEGGO,732,1697,5791,5312,11103
DAKAR,DAKAR,"VILLE DE DAKAR",CAMBERENE,DIAMAGUENE,543,1353,4388,4103,8491
DAKAR,DAKAR,"VILLE DE DAKAR",CAMBERENE,ISLAM,499,1532,4163,4015,8178
DAKAR,DAKAR,"VILLE DE DAKAR",CAMBERENE,"ISLAM EXTENSION",132,465,1245,1177,2422
DAKAR,DAKAR,"VILLE DE DAKAR",CAMBERENE,KAWSARA,368,788,2533,2478,5011
DAKAR,DAKAR,"VILLE DE DAKAR",CAMBERENE,"KEUR GOUMACK",174,301,1399,1543,2942
DAKAR,DAKAR,"VILLE DE DAKAR",CAMBERENE,MBANE,415,818,3001,2758,5759
DAKAR,DAKAR,"VILLE DE DAKAR",CAMBERENE,MEDINA,238,425,1889,2031,3920
DAKAR,DAKAR,"VILLE DE DAKAR",CAMBERENE,PEULGA,108,188,737,737,1474
DAKAR,DAKAR,"VILLE DE DAKAR",CAMBERENE,THIOKHOLANE,138,239,1240,1295,2535
DAKAR,PIKINE,"VILLE DE PIKINE","PIKINE OUEST","CITE ICOTAF (ZONE INDUSTRIELLE)",107,251,762,783,1545
DAKAR,PIKINE,"VILLE DE PIKINE","PIKINE OUEST","CITE LOBATT FALL",90,116,332,356,688
DAKAR,PIKINE,"VILLE DE PIKINE","PIKINE OUEST","CITE SOTIBA",108,264,843,840,1683
DAKAR,PIKINE,"VILLE DE PIKINE","PIKINE OUEST","COLOBANE NIANGHOR",128,271,954,921,1875
DAKAR,PIKINE,"VILLE DE PIKINE","PIKINE OUEST","CREDIT FONCIER",245,534,1711,1761,3472
DAKAR,PIKINE,"VILLE DE PIKINE","PIKINE OUEST","DAROU NIANGHOR",203,525,1593,1461,3054
DAKAR,PIKINE,"VILLE DE PIKINE","PIKINE OUEST","DAROU SALAM I",61,159,505,508,1013
DAKAR,PIKINE,"VILLE DE PIKINE","PIKINE OUEST","CITE TECHNOPOLE",390,850,2442,2413,4855
DAKAR,PIKINE,"VILLE DE PIKINE","PIKINE OUEST","DAROU SALAM III",169,477,1488,1285,2773
DAKAR,PIKINE,"VILLE DE PIKINE","PIKINE OUEST","DIAMAGUENE II",70,185,604,532,1136
DAKAR,PIKINE,"VILLE DE PIKINE","PIKINE OUEST","GAZELLE EST",175,513,1426,1543,2969
DAKAR,PIKINE,"VILLE DE PIKINE","PIKINE OUEST","GAZELLE OUEST",231,676,2133,2108,4241
DAKAR,PIKINE,"VILLE DE PIKINE","PIKINE OUEST","ICOTAF I",209,459,1417,1314,2731
DAKAR,PIKINE,"VILLE DE PIKINE","PIKINE OUEST","ICOTAF II",244,485,1695,1736,3431
DAKAR,PIKINE,"VILLE DE PIKINE","PIKINE OUEST","MAKA COLOBANE DIAMAGUENE",103,317,1032,922,1954
DAKAR,PIKINE,"VILLE DE PIKINE","PIKINE OUEST","MAKA COLOBANE II",80,198,573,568,1141
DAKAR,PIKINE,"VILLE DE PIKINE","PIKINE OUEST","MISSIRAH COLOBANE",185,484,1535,1366,2901
DAKAR,PIKINE,"VILLE DE PIKINE","PIKINE OUEST","MISSIRAH WAKHALDIAM",194,493,1536,1510,3046
DAKAR,PIKINE,"VILLE DE PIKINE","PIKINE OUEST","SOTIBA EXTENSION",195,362,1256,1362,2618
DAKAR,PIKINE,"VILLE DE PIKINE","PIKINE OUEST","DAROU SALAM II",196,606,1840,1771,3611
DAKAR,PIKINE,"VILLE DE PIKINE","PIKINE OUEST","LOTISSEMENT ABATTOIR",106,238,918,894,1812
DAKAR,PIKINE,"VILLE DE PIKINE","PIKINE OUEST","MAKA COLOBANE ABBATOIR",119,338,1146,1155,2301
DAKAR,PIKINE,"VILLE DE PIKINE","PIKINE OUEST","MAKA COLOBANE I",160,409,1283,1107,2390
DAKAR,PIKINE,"VILLE DE PIKINE","PIKINE EST","ALLEES COURSINS I",90,191,642,583,1225
DAKAR,PIKINE,"VILLE DE PIKINE","PIKINE EST","ALLEES COURSINS II",71,135,486,450,936
DAKAR,PIKINE,"VILLE DE PIKINE","PIKINE EST","CHAMPS DE COURSE I",241,591,1895,1770,3665
DAKAR,PIKINE,"VILLE DE PIKINE","PIKINE EST","CHAMPS DE COURSE II",168,419,1319,1026,2345
DAKAR,PIKINE,"VILLE DE PIKINE","PIKINE EST","CITE COCOTIERS",183,386,1224,1323,2547
DAKAR,PIKINE,"VILLE DE PIKINE","PIKINE EST","CITE PEPINIERE",183,393,1171,1039,2210
DAKAR,PIKINE,"VILLE DE PIKINE","PIKINE EST","ZONE ARTISANALE",45,154,438,314,752
DAKAR,PIKINE,"VILLE DE PIKINE","PIKINE EST","CITE SERIGNE MANSOUR SY",260,565,1791,1722,3513
DAKAR,PIKINE,"VILLE DE PIKINE","PIKINE EST","CITE STAGD I",86,184,623,575,1198
DAKAR,PIKINE,"VILLE DE PIKINE","PIKINE EST","FASS MARIGOT I",115,294,859,849,1708
DAKAR,PIKINE,"VILLE DE PIKINE","PIKINE EST","NIMZATT II",188,442,1295,1311,2606
DAKAR,PIKINE,"VILLE DE PIKINE","PIKINE EST","TOUBA DIACKSAO",209,497,1494,1398,2892
DAKAR,PIKINE,"VILLE DE PIKINE","PIKINE EST","WAKHINANE I",84,246,584,528,1112
DAKAR,PIKINE,"VILLE DE PIKINE","PIKINE EST","WAKHINANE II",131,330,1007,945,1952
DAKAR,PIKINE,"VILLE DE PIKINE","PIKINE EST","WAKHINANE III A",48,98,368,338,706
DAKAR,PIKINE,"VILLE DE PIKINE","PIKINE EST","WAKHINANE III B",159,315,1063,984,2047
DAKAR,PIKINE,"VILLE DE PIKINE","PIKINE EST","WAKHINANE III C",24,45,189,139,328
DAKAR,PIKINE,"VILLE DE PIKINE","PIKINE EST","CITE STAGD II",80,149,484,491,975
DAKAR,PIKINE,"VILLE DE PIKINE","PIKINE NORD","AINOUMANE I",131,377,1187,1160,2347
DAKAR,PIKINE,"VILLE DE PIKINE","PIKINE NORD","AINOUMANE II",91,287,926,838,1764
DAKAR,PIKINE,"VILLE DE PIKINE","PIKINE NORD","COLOBANE ARAFAT",174,390,1203,1139,2342
DAKAR,PIKINE,"VILLE DE PIKINE","PIKINE NORD","COLOBANE LANSAR",161,342,1132,1104,2236
DAKAR,PIKINE,"VILLE DE PIKINE","PIKINE NORD","COLOBANE ROBINET TILL",225,464,1555,1582,3137
DAKAR,PIKINE,"VILLE DE PIKINE","PIKINE NORD","DAROU KHOUDOSS",502,1208,3716,3696,7412
DAKAR,PIKINE,"VILLE DE PIKINE","PIKINE NORD","DIACKSAO FASS I",149,349,1069,1110,2179
DAKAR,PIKINE,"VILLE DE PIKINE","PIKINE NORD","DIACKSAO FASS II",133,350,1020,873,1893
DAKAR,PIKINE,"VILLE DE PIKINE","PIKINE NORD","FASS MARIGOT II",171,466,1387,1222,2609
DAKAR,PIKINE,"VILLE DE PIKINE","PIKINE NORD","GUEULE TAPEE",76,145,540,472,1012
DAKAR,PIKINE,"VILLE DE PIKINE","PIKINE NORD","MEDINA PIKINE",215,513,1652,1643,3295
DAKAR,PIKINE,"VILLE DE PIKINE","PIKINE NORD",NDIASSANE,225,517,1450,1321,2771
DAKAR,PIKINE,"VILLE DE PIKINE","PIKINE NORD","NIMZATT I",250,725,2271,2107,4378
DAKAR,PIKINE,"VILLE DE PIKINE","PIKINE NORD","NIMZATT II",177,475,1525,1547,3072
DAKAR,PIKINE,"VILLE DE PIKINE","PIKINE NORD","ROUTE DES NIAYES",118,279,787,840,1627
DAKAR,PIKINE,"VILLE DE PIKINE","PIKINE NORD","SAM COLOBANE",237,516,1660,1773,3433
DAKAR,PIKINE,"VILLE DE PIKINE","PIKINE NORD",SEUKEUBE,102,226,734,712,1446
DAKAR,PIKINE,"VILLE DE PIKINE","PIKINE NORD","WAKHINANE NORD",143,359,1224,911,2135
DAKAR,PIKINE,"VILLE DE PIKINE",DALIFORT,"CITE ASSURANCE",155,260,736,715,1451
DAKAR,PIKINE,"VILLE DE PIKINE",DALIFORT,"CITE  BELVEDERE",258,543,1567,1580,3147
DAKAR,PIKINE,"VILLE DE PIKINE",DALIFORT,"CITE CASTORS FORCES ARMÉES",155,363,1229,1138,2367
DAKAR,PIKINE,"VILLE DE PIKINE",DALIFORT,"CITE HILAL 2 HACIENDA",80,168,402,468,870
DAKAR,PIKINE,"VILLE DE PIKINE",DALIFORT,"CITE MARINE III",206,359,1083,1095,2178
DAKAR,PIKINE,"VILLE DE PIKINE",DALIFORT,"CITE MOR MATY SARR",300,886,2299,2262,4561
DAKAR,PIKINE,"VILLE DE PIKINE",DALIFORT,"CITE MUNICIPALITE (MAIRIE)",155,439,1273,1223,2496
DAKAR,PIKINE,"VILLE DE PIKINE",DALIFORT,"CITE SOLEIL",87,150,384,376,760
DAKAR,PIKINE,"VILLE DE PIKINE",DALIFORT,"DAROU SALAM",131,429,1066,921,1987
DAKAR,PIKINE,"VILLE DE PIKINE",DALIFORT,DEGGO,101,304,847,723,1570
DAKAR,PIKINE,"VILLE DE PIKINE",DALIFORT,"TOUBA SERAS",345,916,2261,2050,4311
DAKAR,PIKINE,"VILLE DE PIKINE",DALIFORT,"CITE MOMAR NDIAYE",33,61,269,232,501
DAKAR,PIKINE,"VILLE DE PIKINE",DALIFORT,"CITE SHELL",65,152,351,369,720
DAKAR,PIKINE,"VILLE DE PIKINE",DALIFORT,"DALIFORT I",102,319,820,803,1623
DAKAR,PIKINE,"VILLE DE PIKINE",DALIFORT,"DALIFORT I RUE 10",81,210,751,645,1396
DAKAR,PIKINE,"VILLE DE PIKINE",DALIFORT,"DALIFORT II",93,247,838,761,1599
DAKAR,PIKINE,"VILLE DE PIKINE",DALIFORT,"DALIFORT IV GENERALE FONCIERE",134,375,1149,1094,2243
DAKAR,PIKINE,"VILLE DE PIKINE",DALIFORT,"DALIFORT S/Q 1 MARCHÉ",97,257,830,739,1569
DAKAR,PIKINE,"VILLE DE PIKINE",DALIFORT,"DALIFORT S/Q 10",104,387,1032,960,1992
DAKAR,PIKINE,"VILLE DE PIKINE",DALIFORT,"DALIFORT S/Q 4",53,108,331,398,729
DAKAR,PIKINE,"VILLE DE PIKINE",DALIFORT,"DALIFORT S/Q 5 TALLY CARREAUX",60,145,533,493,1026
DAKAR,PIKINE,"VILLE DE PIKINE","DJIDAH THIAROYE KAO","AINOUMANE I",52,102,455,406,861
DAKAR,PIKINE,"VILLE DE PIKINE","DJIDAH THIAROYE KAO","AINOUMANE II",123,240,840,787,1627
DAKAR,PIKINE,"VILLE DE PIKINE","DJIDAH THIAROYE KAO","AINOUMANE III",337,785,3006,2756,5762
DAKAR,PIKINE,"VILLE DE PIKINE","DJIDAH THIAROYE KAO","BAGDAD ALWARE",45,56,339,335,674
DAKAR,PIKINE,"VILLE DE PIKINE","DJIDAH THIAROYE KAO","BAGDAD I",71,131,683,597,1280
DAKAR,PIKINE,"VILLE DE PIKINE","DJIDAH THIAROYE KAO","BAGDAD II",51,140,389,408,797
DAKAR,PIKINE,"VILLE DE PIKINE","DJIDAH THIAROYE KAO","BAGDAD III",56,92,420,382,802
DAKAR,PIKINE,"VILLE DE PIKINE","DJIDAH THIAROYE KAO","BAGDAD IV",40,57,303,280,583
DAKAR,PIKINE,"VILLE DE PIKINE","DJIDAH THIAROYE KAO",DAROULAYE,245,504,1954,1600,3554
DAKAR,PIKINE,"VILLE DE PIKINE","DJIDAH THIAROYE KAO","DAROU RAHMANE II",95,205,727,665,1392
DAKAR,PIKINE,"VILLE DE PIKINE","DJIDAH THIAROYE KAO","GOUYE SALAM I",152,232,1129,1063,2192
DAKAR,PIKINE,"VILLE DE PIKINE","DJIDAH THIAROYE KAO","GOUYE SALAM II B",145,354,1138,1095,2233
DAKAR,PIKINE,"VILLE DE PIKINE","DJIDAH THIAROYE KAO","GOUYE SALAM I B",150,312,1260,1130,2390
DAKAR,PIKINE,"VILLE DE PIKINE","DJIDAH THIAROYE KAO","HAMDALAYE II A",119,205,960,901,1861
DAKAR,PIKINE,"VILLE DE PIKINE","DJIDAH THIAROYE KAO","HAMDALAYE II B",182,367,1764,1474,3238
DAKAR,PIKINE,"VILLE DE PIKINE","DJIDAH THIAROYE KAO","HAMDALAYE II C",77,158,711,578,1289
DAKAR,PIKINE,"VILLE DE PIKINE","DJIDAH THIAROYE KAO","MINAM II B",101,206,776,710,1486
DAKAR,PIKINE,"VILLE DE PIKINE","DJIDAH THIAROYE KAO",LANSAR,348,715,2417,2504,4921
DAKAR,PIKINE,"VILLE DE PIKINE","DJIDAH THIAROYE KAO","LEONA I",131,243,1173,1090,2263
DAKAR,PIKINE,"VILLE DE PIKINE","DJIDAH THIAROYE KAO","LEONA II A ET II B",175,326,1425,1192,2617
DAKAR,PIKINE,"VILLE DE PIKINE","DJIDAH THIAROYE KAO","MEDINA IV",135,252,1020,924,1944
DAKAR,PIKINE,"VILLE DE PIKINE","DJIDAH THIAROYE KAO","MEDINATOUL MOUNAWARA",254,657,1990,1970,3960
DAKAR,PIKINE,"VILLE DE PIKINE","DJIDAH THIAROYE KAO",MESSERE,267,607,2009,1703,3712
DAKAR,PIKINE,"VILLE DE PIKINE","DJIDAH THIAROYE KAO","MOUSDALIFA I",141,393,1196,950,2146
DAKAR,PIKINE,"VILLE DE PIKINE","DJIDAH THIAROYE KAO","MOUSDALIFA II",94,226,722,614,1336
DAKAR,PIKINE,"VILLE DE PIKINE","DJIDAH THIAROYE KAO","MOUSDALIFA III",116,243,818,710,1528
DAKAR,PIKINE,"VILLE DE PIKINE","DJIDAH THIAROYE KAO","MOUSDALIFA IV",106,204,783,759,1542
DAKAR,PIKINE,"VILLE DE PIKINE","DJIDAH THIAROYE KAO","GRAND PIKINE (NIETTY MBAR)",34,54,198,186,384
DAKAR,PIKINE,"VILLE DE PIKINE","DJIDAH THIAROYE KAO","SAM SAM II  (CITE POLICE)",69,219,518,431,949
DAKAR,PIKINE,"VILLE DE PIKINE","DJIDAH THIAROYE KAO","SANTE YALLA",317,588,2463,2243,4706
DAKAR,PIKINE,"VILLE DE PIKINE","DJIDAH THIAROYE KAO",SEFFA,260,530,1858,1805,3663
DAKAR,PIKINE,"VILLE DE PIKINE","DJIDAH THIAROYE KAO","SEFFA EXTENSION",47,125,311,347,658
DAKAR,PIKINE,"VILLE DE PIKINE","DJIDAH THIAROYE KAO","SINAYE BABACAR SY",131,236,902,919,1821
DAKAR,PIKINE,"VILLE DE PIKINE","DJIDAH THIAROYE KAO","THIAROYE MINAME I",144,308,1187,1134,2321
DAKAR,PIKINE,"VILLE DE PIKINE","DJIDAH THIAROYE KAO","TOUBA PIKINE",290,638,2185,2065,4250
DAKAR,PIKINE,"VILLE DE PIKINE","DJIDAH THIAROYE KAO","TOUBA THIAROYE",137,294,997,963,1960
DAKAR,PIKINE,"VILLE DE PIKINE","DJIDAH THIAROYE KAO","AINOUMANE I A",95,157,770,740,1510
DAKAR,PIKINE,"VILLE DE PIKINE","DJIDAH THIAROYE KAO","AINOUMANE SANT YALLA II",97,202,660,664,1324
DAKAR,PIKINE,"VILLE DE PIKINE","DJIDAH THIAROYE KAO","AINOUMANE SANT YALLA III",59,95,471,474,945
DAKAR,PIKINE,"VILLE DE PIKINE","DJIDAH THIAROYE KAO","BAGDAD DIOFFIOR",122,167,887,855,1742
DAKAR,PIKINE,"VILLE DE PIKINE","DJIDAH THIAROYE KAO","BAGDAD II A",88,132,673,661,1334
DAKAR,PIKINE,"VILLE DE PIKINE","DJIDAH THIAROYE KAO","DJIDAH I ET II",231,501,1769,1569,3338
DAKAR,PIKINE,"VILLE DE PIKINE","DJIDAH THIAROYE KAO","FASS III",84,235,674,566,1240
DAKAR,PIKINE,"VILLE DE PIKINE","DJIDAH THIAROYE KAO","FASS IV",61,130,441,402,843
DAKAR,PIKINE,"VILLE DE PIKINE","DJIDAH THIAROYE KAO","HALWAR II",108,198,817,824,1641
DAKAR,PIKINE,"VILLE DE PIKINE","DJIDAH THIAROYE KAO","HALWAR III",78,133,599,551,1150
DAKAR,PIKINE,"VILLE DE PIKINE","DJIDAH THIAROYE KAO","LEONA III",81,188,670,546,1216
DAKAR,PIKINE,"VILLE DE PIKINE","DJIDAH THIAROYE KAO","MEDINA GOUNASS EXTENSION",44,84,314,312,626
DAKAR,PIKINE,"VILLE DE PIKINE","DJIDAH THIAROYE KAO","MINAM II A",141,288,1259,1153,2412
DAKAR,PIKINE,"VILLE DE PIKINE","DJIDAH THIAROYE KAO","TOUBA BAGDAD II",129,233,1074,1031,2105
DAKAR,PIKINE,"VILLE DE PIKINE","GUINAW RAIL NORD","DAROU RAHMATY",184,394,1462,1312,2774
DAKAR,PIKINE,"VILLE DE PIKINE","GUINAW RAIL NORD","DAROU SALAM I",79,180,619,602,1221
DAKAR,PIKINE,"VILLE DE PIKINE","GUINAW RAIL NORD","DAROU SALAM II",190,386,1283,1261,2544
DAKAR,PIKINE,"VILLE DE PIKINE","GUINAW RAIL NORD","DAROU SALAM II B",172,312,1319,1195,2514
DAKAR,PIKINE,"VILLE DE PIKINE","GUINAW RAIL NORD","GRAND THIAROYE I",202,422,1542,1391,2933
DAKAR,PIKINE,"VILLE DE PIKINE","GUINAW RAIL NORD","GRAND THIAROYE II BIS",317,642,2205,2158,4363
DAKAR,PIKINE,"VILLE DE PIKINE","GUINAW RAIL NORD","GRAND THIAROYE V",172,417,1327,1271,2598
DAKAR,PIKINE,"VILLE DE PIKINE","GUINAW RAIL NORD","MEDINATOUL MOUNAWARA I",144,321,969,861,1830
DAKAR,PIKINE,"VILLE DE PIKINE","GUINAW RAIL NORD","MEDINATOUL MOUNAWARA II",183,400,1352,1208,2560
DAKAR,PIKINE,"VILLE DE PIKINE","GUINAW RAIL NORD","SAM II BIS",153,346,1129,1060,2189
DAKAR,PIKINE,"VILLE DE PIKINE","GUINAW RAIL NORD",SANGOMAR,120,220,836,780,1616
DAKAR,PIKINE,"VILLE DE PIKINE","GUINAW RAIL NORD","GRAND THIAROYE II",223,442,1568,1593,3161
DAKAR,PIKINE,"VILLE DE PIKINE","GUINAW RAIL SUD","AINOUMANE IV A",188,448,1458,1285,2743
DAKAR,PIKINE,"VILLE DE PIKINE","GUINAW RAIL SUD","CITE EL HADJI MALICK SY",86,172,668,708,1376
DAKAR,PIKINE,"VILLE DE PIKINE","GUINAW RAIL SUD","DAROU KHOUDOSS",122,292,886,900,1786
DAKAR,PIKINE,"VILLE DE PIKINE","GUINAW RAIL SUD","DAROU MARNANE I",122,221,921,794,1715
DAKAR,PIKINE,"VILLE DE PIKINE","GUINAW RAIL SUD","DAROU MARNANE II",62,143,500,491,991
DAKAR,PIKINE,"VILLE DE PIKINE","GUINAW RAIL SUD","DAROU MARNANE III",79,138,622,622,1244
DAKAR,PIKINE,"VILLE DE PIKINE","GUINAW RAIL SUD","DAROU MARNANE IV",97,213,754,704,1458
DAKAR,PIKINE,"VILLE DE PIKINE","GUINAW RAIL SUD","DAROU MARNANE SANT YALLA I",102,162,795,780,1575
DAKAR,PIKINE,"VILLE DE PIKINE","GUINAW RAIL SUD","DAROU MARNANE SANT YALLA II",101,244,868,794,1662
DAKAR,PIKINE,"VILLE DE PIKINE","GUINAW RAIL SUD","DAROU MARNANE V",100,287,882,839,1721
DAKAR,PIKINE,"VILLE DE PIKINE","GUINAW RAIL SUD","DAROU NAHIM",206,613,1916,1632,3548
DAKAR,PIKINE,"VILLE DE PIKINE","GUINAW RAIL SUD","GRAND THIAROYE III",119,212,933,952,1885
DAKAR,PIKINE,"VILLE DE PIKINE","GUINAW RAIL SUD","GRAND THIAROYE IV",38,87,311,351,662
DAKAR,PIKINE,"VILLE DE PIKINE","GUINAW RAIL SUD","GRAND THIAROYE VII",106,230,856,787,1643
DAKAR,PIKINE,"VILLE DE PIKINE","GUINAW RAIL SUD","MOUSDALIFA I",191,478,1569,1444,3013
DAKAR,PIKINE,"VILLE DE PIKINE","GUINAW RAIL SUD","MOUSDALIFA II",86,229,759,634,1393
DAKAR,PIKINE,"VILLE DE PIKINE","GUINAW RAIL SUD","MOUSDALIFA III",49,160,504,478,982
DAKAR,PIKINE,"VILLE DE PIKINE","GUINAW RAIL SUD","MOUSDALIFA IV",65,137,497,448,945
DAKAR,PIKINE,"VILLE DE PIKINE","GUINAW RAIL SUD","SAM II",75,184,579,524,1103
DAKAR,PIKINE,"VILLE DE PIKINE","GUINAW RAIL SUD","TIVAOUANE II",51,102,376,376,752
DAKAR,PIKINE,"VILLE DE PIKINE","GUINAW RAIL SUD","YALLA YANA",126,277,1065,1001,2066
DAKAR,PIKINE,"VILLE DE PIKINE","GUINAW RAIL SUD","AÏNOUMANE VI B",160,380,1282,1116,2398
DAKAR,PIKINE,"VILLE DE PIKINE","GUINAW RAIL SUD","DAROU SALAM SOTRAC",57,111,416,429,845
DAKAR,PIKINE,"VILLE DE PIKINE","GUINAW RAIL SUD","SOTRAC I",68,163,561,517,1078
DAKAR,PIKINE,"VILLE DE PIKINE","GUINAW RAIL SUD","SOTRAC II",98,298,823,778,1601
DAKAR,PIKINE,"VILLE DE PIKINE","THIAROYE SUR MER","CHEIKH SOW",54,117,495,466,961
DAKAR,PIKINE,"VILLE DE PIKINE","THIAROYE SUR MER","MANDIAYE DIOP",204,624,1834,1627,3461
DAKAR,PIKINE,"VILLE DE PIKINE","THIAROYE SUR MER","CITE OUSMANE FALL",157,224,805,763,1568
DAKAR,PIKINE,"VILLE DE PIKINE","THIAROYE SUR MER","CITE SOCABEG ET ALIZE",363,694,1760,1852,3612
DAKAR,PIKINE,"VILLE DE PIKINE","THIAROYE SUR MER",FALLENE,45,106,628,602,1230
DAKAR,PIKINE,"VILLE DE PIKINE","THIAROYE SUR MER","IBRAHIMA NDAO",211,406,1487,1360,2847
DAKAR,PIKINE,"VILLE DE PIKINE","THIAROYE SUR MER","IBRAHIMA NGOM",137,215,1234,1145,2379
DAKAR,PIKINE,"VILLE DE PIKINE","THIAROYE SUR MER","LEYE DJITE",121,191,1065,1038,2103
DAKAR,PIKINE,"VILLE DE PIKINE","THIAROYE SUR MER","MACOUMBA SYLLA",161,313,1506,1408,2914
DAKAR,PIKINE,"VILLE DE PIKINE","THIAROYE SUR MER","ORYX 3 (MAME MATAR DIA)",107,222,790,722,1512
DAKAR,PIKINE,"VILLE DE PIKINE","THIAROYE SUR MER","MOR LAYE SENE (SENENE)",113,276,1092,991,2083
DAKAR,PIKINE,"VILLE DE PIKINE","THIAROYE SUR MER","NGAGNE DIAW",143,369,962,835,1797
DAKAR,PIKINE,"VILLE DE PIKINE","THIAROYE SUR MER",NIAGA,27,63,277,262,539
DAKAR,PIKINE,"VILLE DE PIKINE","THIAROYE SUR MER","ORYX 1 (MEDINA NIANG)",183,355,1209,1055,2264
DAKAR,PIKINE,"VILLE DE PIKINE","THIAROYE SUR MER","SAFCO 1",119,168,405,474,879
DAKAR,PIKINE,"VILLE DE PIKINE","THIAROYE SUR MER","SAFCO 2",87,113,286,338,624
DAKAR,PIKINE,"VILLE DE PIKINE","THIAROYE SUR MER",SANTHIABA,81,161,809,809,1618
DAKAR,PIKINE,"VILLE DE PIKINE","THIAROYE SUR MER",SAPI,126,182,496,569,1065
DAKAR,PIKINE,"VILLE DE PIKINE","THIAROYE SUR MER","THIAROYE BAGDAD",274,490,1514,1535,3049
DAKAR,PIKINE,"VILLE DE PIKINE","THIAROYE SUR MER","CITE DPV",49,65,174,207,381
DAKAR,PIKINE,"VILLE DE PIKINE","THIAROYE SUR MER","CITE NESTLE AZUR",67,116,342,376,718
DAKAR,PIKINE,"VILLE DE PIKINE","THIAROYE SUR MER","CITE PAPA GUEYE KHAR",135,260,836,840,1676
DAKAR,PIKINE,"VILLE DE PIKINE","THIAROYE SUR MER","CITE RST",341,574,1729,1808,3537
DAKAR,PIKINE,"VILLE DE PIKINE","THIAROYE SUR MER",FASS,64,129,450,489,939
DAKAR,PIKINE,"VILLE DE PIKINE","THIAROYE SUR MER","FASS 2",29,82,337,312,649
DAKAR,PIKINE,"VILLE DE PIKINE","THIAROYE SUR MER",MARENE,44,87,437,369,806
DAKAR,PIKINE,"VILLE DE PIKINE","THIAROYE SUR MER",MBATAL,145,298,973,948,1921
DAKAR,PIKINE,"VILLE DE PIKINE","THIAROYE SUR MER","MBATAL KEUR NGADIEL",43,67,237,268,505
DAKAR,PIKINE,"VILLE DE PIKINE","THIAROYE SUR MER","NDAKHTE NDIAYE",41,112,729,550,1279
DAKAR,PIKINE,"VILLE DE PIKINE","THIAROYE SUR MER","NDALOUM NIANG",102,198,836,765,1601
DAKAR,PIKINE,"VILLE DE PIKINE","THIAROYE SUR MER",NDIOBENE,14,63,334,297,631
DAKAR,PIKINE,"VILLE DE PIKINE","THIAROYE SUR MER",NGUEYENE,33,124,601,567,1168
DAKAR,PIKINE,"VILLE DE PIKINE","THIAROYE SUR MER","NIANGUE 1",29,62,366,352,718
DAKAR,PIKINE,"VILLE DE PIKINE","THIAROYE SUR MER","NIANGUE 2",50,236,641,624,1265
DAKAR,PIKINE,"VILLE DE PIKINE","THIAROYE SUR MER","ORYX 2 (MEDINA NIANG)",91,185,667,627,1294
DAKAR,PIKINE,"VILLE DE PIKINE","THIAROYE SUR MER","SEPCO I",123,143,378,429,807
DAKAR,PIKINE,"VILLE DE PIKINE","THIAROYE SUR MER","SEPCO II",102,137,364,395,759
DAKAR,PIKINE,"VILLE DE PIKINE","THIAROYE SUR MER","USINE (VIEUX THIANE)",138,409,1033,981,2014
DAKAR,PIKINE,"VILLE DE PIKINE","THIAROYE SUR MER","USINE COTONNIERE CAP VERT",133,296,895,816,1711
DAKAR,PIKINE,"VILLE DE PIKINE","THIAROYE SUR MER","ZONE INDUSTRIELLE",15,23,89,106,195
DAKAR,PIKINE,"VILLE DE PIKINE","TIVAOUANE DIACKSAO","CITE NALA",116,236,1041,944,1985
DAKAR,PIKINE,"VILLE DE PIKINE","TIVAOUANE DIACKSAO","DIACKSAO I",206,604,1836,1578,3414
DAKAR,PIKINE,"VILLE DE PIKINE","TIVAOUANE DIACKSAO","DIACKSAO II",191,423,1593,1456,3049
DAKAR,PIKINE,"VILLE DE PIKINE","TIVAOUANE DIACKSAO","DIACKSAO WALO",103,160,796,757,1553
DAKAR,PIKINE,"VILLE DE PIKINE","TIVAOUANE DIACKSAO","DIAMAGUENE II",113,242,867,871,1738
DAKAR,PIKINE,"VILLE DE PIKINE","TIVAOUANE DIACKSAO","LANSAR I",250,629,2220,1934,4154
DAKAR,PIKINE,"VILLE DE PIKINE","TIVAOUANE DIACKSAO","LANSAR III",219,485,1740,1563,3303
DAKAR,PIKINE,"VILLE DE PIKINE","TIVAOUANE DIACKSAO","MEDINA MARENE I",222,543,1717,1594,3311
DAKAR,PIKINE,"VILLE DE PIKINE","TIVAOUANE DIACKSAO","WAKHINANE I",300,707,2417,2428,4845
DAKAR,PIKINE,"VILLE DE PIKINE","TIVAOUANE DIACKSAO","WAKHINANE IV",84,160,649,555,1204
DAKAR,PIKINE,"VILLE DE PIKINE","TIVAOUANE DIACKSAO","DIAMAGUENE I",142,304,977,925,1902
DAKAR,PIKINE,"VILLE DE PIKINE","TIVAOUANE DIACKSAO","FASS DIACKSAO",183,434,1394,1241,2635
DAKAR,PIKINE,"VILLE DE PIKINE","TIVAOUANE DIACKSAO",TIVAOUANE,279,740,2476,2280,4756
DAKAR,PIKINE,"VILLE DE PIKINE","TIVAOUANE DIACKSAO","WAKHINANE II",200,517,1540,1503,3043
DAKAR,PIKINE,"VILLE DE PIKINE","DIAMAGUENE SICAP MBAO",AINOUMADY,343,599,2478,2467,4945
DAKAR,PIKINE,"VILLE DE PIKINE","DIAMAGUENE SICAP MBAO","HAMDALLAH IV",302,501,1984,1874,3858
DAKAR,PIKINE,"VILLE DE PIKINE","DIAMAGUENE SICAP MBAO","HAMDALLAH V",164,283,1190,1208,2398
DAKAR,PIKINE,"VILLE DE PIKINE","DIAMAGUENE SICAP MBAO",ARAFAT,49,159,362,314,676
DAKAR,PIKINE,"VILLE DE PIKINE","DIAMAGUENE SICAP MBAO","CITE MILLIONNAIRE",175,396,1070,994,2064
DAKAR,PIKINE,"VILLE DE PIKINE","DIAMAGUENE SICAP MBAO","CITE NELSON MANDELA",112,285,653,585,1238
DAKAR,PIKINE,"VILLE DE PIKINE","DIAMAGUENE SICAP MBAO","CITE PASTEUR",308,697,1942,1989,3931
DAKAR,PIKINE,"VILLE DE PIKINE","DIAMAGUENE SICAP MBAO","CITE SICA DE MBAO (CITE ALIOU SOW)",176,236,625,718,1343
DAKAR,PIKINE,"VILLE DE PIKINE","DIAMAGUENE SICAP MBAO","CITE SOBOA",54,140,445,348,793
DAKAR,PIKINE,"VILLE DE PIKINE","DIAMAGUENE SICAP MBAO","DAROU MINAM I (DAROU RAHMANE I A)",183,375,1389,1318,2707
DAKAR,PIKINE,"VILLE DE PIKINE","DIAMAGUENE SICAP MBAO","DAROU MINAM II",86,214,699,627,1326
DAKAR,PIKINE,"VILLE DE PIKINE","DIAMAGUENE SICAP MBAO","DAROU RAHMANE II B",304,588,2201,1983,4184
DAKAR,PIKINE,"VILLE DE PIKINE","DIAMAGUENE SICAP MBAO","DAROU RAHMANE III A",166,413,1431,1295,2726
DAKAR,PIKINE,"VILLE DE PIKINE","DIAMAGUENE SICAP MBAO","DIACKSAO II GOUYE SAPOUT",219,511,1863,1865,3728
DAKAR,PIKINE,"VILLE DE PIKINE","DIAMAGUENE SICAP MBAO","DIAMAGUENE MAREGE (SAMBA DRAME)",162,316,1213,1176,2389
DAKAR,PIKINE,"VILLE DE PIKINE","DIAMAGUENE SICAP MBAO","FASS MBAO I",110,181,663,675,1338
DAKAR,PIKINE,"VILLE DE PIKINE","DIAMAGUENE SICAP MBAO","FASS MBAO II",190,331,1218,1167,2385
DAKAR,PIKINE,"VILLE DE PIKINE","DIAMAGUENE SICAP MBAO","FASS MBAO III",155,364,1088,1041,2129
DAKAR,PIKINE,"VILLE DE PIKINE","DIAMAGUENE SICAP MBAO",FORA,82,143,522,521,1043
DAKAR,PIKINE,"VILLE DE PIKINE","DIAMAGUENE SICAP MBAO","LEONA DIAMAGUENE",100,248,906,815,1721
DAKAR,PIKINE,"VILLE DE PIKINE","DIAMAGUENE SICAP MBAO","MEDINA FASS MBAO",130,319,1212,1127,2339
DAKAR,PIKINE,"VILLE DE PIKINE","DIAMAGUENE SICAP MBAO","MEDINA MARENE II",189,444,1408,1357,2765
DAKAR,PIKINE,"VILLE DE PIKINE","DIAMAGUENE SICAP MBAO","MEDINATOUL MOUNAWARA",245,476,2053,1809,3862
DAKAR,PIKINE,"VILLE DE PIKINE","DIAMAGUENE SICAP MBAO","TOUBA MEDINATOUL RASSOUL (RTS)",187,346,961,908,1869
DAKAR,PIKINE,"VILLE DE PIKINE","DIAMAGUENE SICAP MBAO","MISSIRAH I",85,156,636,597,1233
DAKAR,PIKINE,"VILLE DE PIKINE","DIAMAGUENE SICAP MBAO","NASSOUROULAYE I",117,214,945,924,1869
DAKAR,PIKINE,"VILLE DE PIKINE","DIAMAGUENE SICAP MBAO","NASSOUROULAYE II",167,264,1033,1029,2062
DAKAR,PIKINE,"VILLE DE PIKINE","DIAMAGUENE SICAP MBAO","NASSOUROULAYE III A",153,245,1081,990,2071
DAKAR,PIKINE,"VILLE DE PIKINE","DIAMAGUENE SICAP MBAO","SAM SAM I A",102,191,765,752,1517
DAKAR,PIKINE,"VILLE DE PIKINE","DIAMAGUENE SICAP MBAO","SAM SAM I B",359,761,2817,2726,5543
DAKAR,PIKINE,"VILLE DE PIKINE","DIAMAGUENE SICAP MBAO","SAM SAM III",123,229,929,828,1757
DAKAR,PIKINE,"VILLE DE PIKINE","DIAMAGUENE SICAP MBAO","SAM SAM III C TAIF",82,169,578,515,1093
DAKAR,PIKINE,"VILLE DE PIKINE","DIAMAGUENE SICAP MBAO","SAM SAM III DAROU KHAFOR",75,158,629,451,1080
DAKAR,PIKINE,"VILLE DE PIKINE","DIAMAGUENE SICAP MBAO","SAM SAM NIMZATT",115,209,785,710,1495
DAKAR,PIKINE,"VILLE DE PIKINE","DIAMAGUENE SICAP MBAO","SICAP DAROUL IMANE",228,680,1982,1855,3837
DAKAR,PIKINE,"VILLE DE PIKINE","DIAMAGUENE SICAP MBAO","SICAP EXTENSION",220,576,1199,1322,2521
DAKAR,PIKINE,"VILLE DE PIKINE","DIAMAGUENE SICAP MBAO","SICAP MBAO (CITE OUVRIÈRE)",486,875,2800,2720,5520
DAKAR,PIKINE,"VILLE DE PIKINE","DIAMAGUENE SICAP MBAO","TAIF I",98,233,725,638,1363
DAKAR,PIKINE,"VILLE DE PIKINE","DIAMAGUENE SICAP MBAO","TAIF I SUD",80,158,565,487,1052
DAKAR,PIKINE,"VILLE DE PIKINE","DIAMAGUENE SICAP MBAO","TAIF III",72,143,477,502,979
DAKAR,PIKINE,"VILLE DE PIKINE","DIAMAGUENE SICAP MBAO","TOUBA DIAMAGUENE",88,160,717,614,1331
DAKAR,PIKINE,"VILLE DE PIKINE","DIAMAGUENE SICAP MBAO","TOUBA SAM SAM II",179,306,1625,1284,2909
DAKAR,PIKINE,"VILLE DE PIKINE","DIAMAGUENE SICAP MBAO","BABOU SALAM",109,274,919,793,1712
DAKAR,PIKINE,"VILLE DE PIKINE","DIAMAGUENE SICAP MBAO","CHEIKH ANTA",44,85,311,314,625
DAKAR,PIKINE,"VILLE DE PIKINE","DIAMAGUENE SICAP MBAO","CITE SABE",49,52,182,207,389
DAKAR,PIKINE,"VILLE DE PIKINE","DIAMAGUENE SICAP MBAO","CITE SOTRAC",195,493,1490,1391,2881
DAKAR,PIKINE,"VILLE DE PIKINE","DIAMAGUENE SICAP MBAO","DAROU RAHMANE A I",109,210,837,715,1552
DAKAR,PIKINE,"VILLE DE PIKINE","DIAMAGUENE SICAP MBAO","DAROU RAHMANE III B",112,287,1048,981,2029
DAKAR,PIKINE,"VILLE DE PIKINE","DIAMAGUENE SICAP MBAO","DAROU SALAM SAM SAM III",58,119,506,415,921
DAKAR,PIKINE,"VILLE DE PIKINE","DIAMAGUENE SICAP MBAO","DAROU SALAM SANT YALLA",322,694,2501,2310,4811
DAKAR,PIKINE,"VILLE DE PIKINE","DIAMAGUENE SICAP MBAO",DIMAT,99,165,771,742,1513
DAKAR,PIKINE,"VILLE DE PIKINE","DIAMAGUENE SICAP MBAO","KAOUSSARA MEDINA FASS MBAO",65,189,614,473,1087
DAKAR,PIKINE,"VILLE DE PIKINE","DIAMAGUENE SICAP MBAO","MAKATAL MOUKARAMA",194,438,1462,1451,2913
DAKAR,PIKINE,"VILLE DE PIKINE","DIAMAGUENE SICAP MBAO","MEDINA DIAMAGUENE",97,188,769,617,1386
DAKAR,PIKINE,"VILLE DE PIKINE","DIAMAGUENE SICAP MBAO","MEDINA KILOMETRES 16",181,377,1333,1189,2522
DAKAR,PIKINE,"VILLE DE PIKINE","DIAMAGUENE SICAP MBAO","MEDINA SAM SAM II",80,140,625,585,1210
DAKAR,PIKINE,"VILLE DE PIKINE","DIAMAGUENE SICAP MBAO","MEDINA SAM SAM III",80,158,609,572,1181
DAKAR,PIKINE,"VILLE DE PIKINE","DIAMAGUENE SICAP MBAO","MEDINA SAM SAM III C",191,291,1232,1148,2380
DAKAR,PIKINE,"VILLE DE PIKINE","DIAMAGUENE SICAP MBAO","MEDINATOUL SAM SAM III",84,157,576,497,1073
DAKAR,PIKINE,"VILLE DE PIKINE","DIAMAGUENE SICAP MBAO","MISSIRAH II TALLY MAME DIARRA",104,192,724,699,1423
DAKAR,PIKINE,"VILLE DE PIKINE","DIAMAGUENE SICAP MBAO","MOUSDALIFA MEDINA FASS MBAO",119,275,1008,950,1958
DAKAR,PIKINE,"VILLE DE PIKINE","DIAMAGUENE SICAP MBAO","NASSOUROULAYE III B",51,92,247,233,480
DAKAR,PIKINE,"VILLE DE PIKINE","DIAMAGUENE SICAP MBAO","SAM SAM II",236,459,1794,1735,3529
DAKAR,PIKINE,"VILLE DE PIKINE","DIAMAGUENE SICAP MBAO","SAM SAM III TOUBA KHAIRA",222,435,1722,1557,3279
DAKAR,PIKINE,"VILLE DE PIKINE","DIAMAGUENE SICAP MBAO","SAM SAM III ZONE 8",101,215,779,754,1533
DAKAR,PIKINE,"VILLE DE PIKINE","THIAROYE GARE","LA ROCHETTE A",288,679,2130,2062,4192
DAKAR,PIKINE,"VILLE DE PIKINE","THIAROYE GARE","KHEWEUL LA ROCHETTE B",128,413,1221,1086,2307
DAKAR,PIKINE,"VILLE DE PIKINE","THIAROYE GARE","DAROU SALAM I",86,223,679,655,1334
DAKAR,PIKINE,"VILLE DE PIKINE","THIAROYE GARE","FASS I",108,204,851,758,1609
DAKAR,PIKINE,"VILLE DE PIKINE","THIAROYE GARE","FASS II",67,146,520,520,1040
DAKAR,PIKINE,"VILLE DE PIKINE","THIAROYE GARE","HAMDALAHI III",228,504,1868,1760,3628
DAKAR,PIKINE,"VILLE DE PIKINE","THIAROYE GARE","HAMDALAHI III C",173,357,1171,1180,2351
DAKAR,PIKINE,"VILLE DE PIKINE","THIAROYE GARE","HAMDALAHI I",363,847,2845,2675,5520
DAKAR,PIKINE,"VILLE DE PIKINE","THIAROYE GARE",LAYENE,40,81,291,273,564
DAKAR,PIKINE,"VILLE DE PIKINE","THIAROYE GARE","PIKINI BOUGOU",156,369,1245,1247,2492
DAKAR,PIKINE,"VILLE DE PIKINE",MBAO,"AB GOKH (GRAND MBAO)",183,268,968,1010,1978
DAKAR,PIKINE,"VILLE DE PIKINE",MBAO,"ALDIANA (KEUR MBAYE FALL)",215,596,1476,1296,2772
DAKAR,PIKINE,"VILLE DE PIKINE",MBAO,BAOBAB,249,359,944,1051,1995
DAKAR,PIKINE,"VILLE DE PIKINE",MBAO,"BEAU SEJOUR",222,399,1260,1157,2417
DAKAR,PIKINE,"VILLE DE PIKINE",MBAO,"BENOU SANT YALLA",289,467,1601,1565,3166
DAKAR,PIKINE,"VILLE DE PIKINE",MBAO,"CITE ADJA MAREME DIOP MAKHTAR (PETIT MBAO)",146,203,600,660,1260
DAKAR,PIKINE,"VILLE DE PIKINE",MBAO,"CITE ALMAMY",45,73,172,221,393
DAKAR,PIKINE,"VILLE DE PIKINE",MBAO,"CITE ASECNA",218,303,847,923,1770
DAKAR,PIKINE,"VILLE DE PIKINE",MBAO,"CITE ASSURANCE ZAC MBAO",195,247,763,741,1504
DAKAR,PIKINE,"VILLE DE PIKINE",MBAO,"CITE BALICO",38,51,116,146,262
DAKAR,PIKINE,"VILLE DE PIKINE",MBAO,"CITE BOUGOUMA SECK",192,294,883,895,1778
DAKAR,PIKINE,"VILLE DE PIKINE",MBAO,"CITE ENVIRONNEMENT",84,135,380,400,780
DAKAR,PIKINE,"VILLE DE PIKINE",MBAO,"CITE FINANCE",58,73,234,272,506
DAKAR,PIKINE,"VILLE DE PIKINE",MBAO,"CITE FLAMBOYANT",236,362,1059,1150,2209
DAKAR,PIKINE,"VILLE DE PIKINE",MBAO,"CITE GABONAISE (COTOA,SPIS,FRIPERIE)",121,157,489,504,993
DAKAR,PIKINE,"VILLE DE PIKINE",MBAO,"CITE MANTOR DIOUF",92,108,300,347,647
DAKAR,PIKINE,"VILLE DE PIKINE",MBAO,"CITE NDEYE MARIE",307,388,1104,1319,2423
DAKAR,PIKINE,"VILLE DE PIKINE",MBAO,"CITE PENITENCE (IDEN, ETRANGERE, KHALIFA HOLDING MBAO)",107,141,362,464,826
DAKAR,PIKINE,"VILLE DE PIKINE",MBAO,"CITE PERSONNEL FORCE FRANCAISE DU CAP VERT",83,113,334,412,746
DAKAR,PIKINE,"VILLE DE PIKINE",MBAO,"CITE POLICE",130,229,650,680,1330
DAKAR,PIKINE,"VILLE DE PIKINE",MBAO,"CITE PORT (SATS)",78,115,330,310,640
DAKAR,PIKINE,"VILLE DE PIKINE",MBAO,"CITE POSTE (KEUR MBAYE FALL)",154,249,862,843,1705
DAKAR,PIKINE,"VILLE DE PIKINE",MBAO,"CITE PROMOCAP",274,410,1068,1174,2242
DAKAR,PIKINE,"VILLE DE PIKINE",MBAO,"CITE RTS",62,105,289,336,625
DAKAR,PIKINE,"VILLE DE PIKINE",MBAO,"CITE SABA",162,201,760,772,1532
DAKAR,PIKINE,"VILLE DE PIKINE",MBAO,"CITE SAFCO",139,172,471,545,1016
DAKAR,PIKINE,"VILLE DE PIKINE",MBAO,"CITE SATAR ZAC MBAO",70,74,201,268,469
DAKAR,PIKINE,"VILLE DE PIKINE",MBAO,"CITE SENELEC",24,57,133,153,286
DAKAR,PIKINE,"VILLE DE PIKINE",MBAO,"CITE SERIGNE MANSOUR SY",288,458,1214,1400,2614
DAKAR,PIKINE,"VILLE DE PIKINE",MBAO,"CITE SHELL",42,55,176,200,376
DAKAR,PIKINE,"VILLE DE PIKINE",MBAO,"CITE SIPRES V",290,302,754,930,1684
DAKAR,PIKINE,"VILLE DE PIKINE",MBAO,"CITE SODEVA",27,33,105,132,237
DAKAR,PIKINE,"VILLE DE PIKINE",MBAO,"CITE SONES",23,24,70,72,142
DAKAR,PIKINE,"VILLE DE PIKINE",MBAO,"CITE SUDES (IBA NDIAYE DIADJ AK LIKEUWEUR)",149,192,568,620,1188
DAKAR,PIKINE,"VILLE DE PIKINE",MBAO,"CITE ICS TAIBA",65,87,284,304,588
DAKAR,PIKINE,"VILLE DE PIKINE",MBAO,"DABAKH MALICK",666,1098,3014,3217,6231
DAKAR,PIKINE,"VILLE DE PIKINE",MBAO,"DAL DIAM",141,228,771,839,1610
DAKAR,PIKINE,"VILLE DE PIKINE",MBAO,"DAROU SALAM (KEUR MBAYE FALL)",133,274,807,732,1539
DAKAR,PIKINE,"VILLE DE PIKINE",MBAO,"DAROU SALAM I (KEUR MBAYE FALL)",272,602,1953,1690,3643
DAKAR,PIKINE,"VILLE DE PIKINE",MBAO,"DAROU SALAM II (KEUR MBAYE FALL)",168,320,1018,1006,2024
DAKAR,PIKINE,"VILLE DE PIKINE",MBAO,"DAROU SALAM RUE X",381,648,2193,2068,4261
DAKAR,PIKINE,"VILLE DE PIKINE",MBAO,"DIAMAGUENE (KEUR MBAYE FALL)",111,260,756,715,1471
DAKAR,PIKINE,"VILLE DE PIKINE",MBAO,"DIAMAGUENE APRES PEAGE",177,248,761,704,1465
DAKAR,PIKINE,"VILLE DE PIKINE",MBAO,"DJANATOU FIRDAWSI (KEUR MBAYE FALL)",153,423,1079,1093,2172
DAKAR,PIKINE,"VILLE DE PIKINE",MBAO,"EX SONES",84,136,373,370,743
DAKAR,PIKINE,"VILLE DE PIKINE",MBAO,"KEUR MBAYE FALL EXTENSION SUD (KEUR MBAYE FALL)",286,525,1960,1762,3722
DAKAR,PIKINE,"VILLE DE PIKINE",MBAO,"FASS (GRAND MBAO)",97,168,654,709,1363
DAKAR,PIKINE,"VILLE DE PIKINE",MBAO,"GRAND MBAO EXTENSION B (GRAND MBAO)",236,332,1132,1144,2276
DAKAR,PIKINE,"VILLE DE PIKINE",MBAO,"KAMB GARAGE",24,31,175,178,353
DAKAR,PIKINE,"VILLE DE PIKINE",MBAO,"KAMB MOSQUEE",31,50,253,233,486
DAKAR,PIKINE,"VILLE DE PIKINE",MBAO,"KAMB NORD (KAMB FALL)",62,109,461,439,900
DAKAR,PIKINE,"VILLE DE PIKINE",MBAO,"KAMB OUEST",37,65,279,255,534
DAKAR,PIKINE,"VILLE DE PIKINE",MBAO,"KAMB PEULH",53,94,444,377,821
DAKAR,PIKINE,"VILLE DE PIKINE",MBAO,"KAOSSARA MBAO GARE RUE X",469,676,2631,2527,5158
DAKAR,PIKINE,"VILLE DE PIKINE",MBAO,"KEUR MBAYE FALL I",93,130,617,621,1238
DAKAR,PIKINE,"VILLE DE PIKINE",MBAO,KHEWEUL,173,313,809,936,1745
DAKAR,PIKINE,"VILLE DE PIKINE",MBAO,"LAMSAR (GRAND MBAO)",55,75,302,308,610
DAKAR,PIKINE,"VILLE DE PIKINE",MBAO,"LOTISSEMENT BAOBAB",391,601,1400,1706,3106
DAKAR,PIKINE,"VILLE DE PIKINE",MBAO,"MEDINA MBAO CONCORDE (KEUR MBAYE FALL)",167,251,795,744,1539
DAKAR,PIKINE,"VILLE DE PIKINE",MBAO,"PETIT MBAO PEULH (PETIT MBAO)",65,124,366,366,732
DAKAR,PIKINE,"VILLE DE PIKINE",MBAO,"MBAO VILLENEUVE",422,489,1267,1335,2602
DAKAR,PIKINE,"VILLE DE PIKINE",MBAO,"MEDINA MBAO GARE (KEUR MBAYE FALL)",454,564,2218,2256,4474
DAKAR,PIKINE,"VILLE DE PIKINE",MBAO,"MEDINE (GRAND MBAO)",98,185,716,756,1472
DAKAR,PIKINE,"VILLE DE PIKINE",MBAO,"NDIOBENE (GRAND MBAO)",116,175,830,769,1599
DAKAR,PIKINE,"VILLE DE PIKINE",MBAO,"NDOYENE KAW",81,112,470,463,933
DAKAR,PIKINE,"VILLE DE PIKINE",MBAO,"NDOYENE SOUF (GRAND MBAO)",40,85,451,514,965
DAKAR,PIKINE,"VILLE DE PIKINE",MBAO,"PETIT MBAO EXTENTION",336,529,1505,1662,3167
DAKAR,PIKINE,"VILLE DE PIKINE",MBAO,"SANT YALLA (KEUR MBAYE FALL)",171,261,934,934,1868
DAKAR,PIKINE,"VILLE DE PIKINE",MBAO,"SDV (MIXTE)",181,247,807,827,1634
DAKAR,PIKINE,"VILLE DE PIKINE",MBAO,"SERIGNE MANSOUR SY",129,221,830,788,1618
DAKAR,PIKINE,"VILLE DE PIKINE",MBAO,"SEYDOU NOUROU TALL (KEUR MBAYE FALL)",157,302,1025,992,2017
DAKAR,PIKINE,"VILLE DE PIKINE",MBAO,"THIEKENE (GRAND MBAO)",21,43,204,181,385
DAKAR,PIKINE,"VILLE DE PIKINE",MBAO,"TOUBA GUEDE (KEUR MBAYE FALL)",112,212,814,777,1591
DAKAR,PIKINE,"VILLE DE PIKINE",MBAO,"TOUBA TAIF (KEUR MBAYE FALL)",277,663,1941,1882,3823
DAKAR,PIKINE,"VILLE DE PIKINE",MBAO,"ZONE INDUSTRIELLE (FORET CLASSEE DE MBAO)",10,10,29,48,77
DAKAR,PIKINE,"VILLE DE PIKINE",MBAO,"AB GOKH EXTENSION (GRAND MBAO)",157,243,755,815,1570
DAKAR,PIKINE,"VILLE DE PIKINE",MBAO,"BAYAL EXTENSION (PETIT MBAO)",23,49,198,213,411
DAKAR,PIKINE,"VILLE DE PIKINE",MBAO,"BRAS DE MER",98,155,569,575,1144
DAKAR,PIKINE,"VILLE DE PIKINE",MBAO,"CITE BAYE NIASS",65,179,253,313,566
DAKAR,PIKINE,"VILLE DE PIKINE",MBAO,"CITE CORA FALL",19,27,74,84,158
DAKAR,PIKINE,"VILLE DE PIKINE",MBAO,"CITE LA CLEMENCE",121,144,425,504,929
DAKAR,PIKINE,"VILLE DE PIKINE",MBAO,"CITE SAFCO (CITE YAYE SOKHNA)",69,80,197,248,445
DAKAR,PIKINE,"VILLE DE PIKINE",MBAO,"CITE SICAP",33,54,124,172,296
DAKAR,PIKINE,"VILLE DE PIKINE",MBAO,"CITE SIDAK",120,157,472,588,1060
DAKAR,PIKINE,"VILLE DE PIKINE",MBAO,"CITE TAWFEKH",44,50,166,199,365
DAKAR,PIKINE,"VILLE DE PIKINE",MBAO,"EXTENSION C (KEUR MBAYE FALL)",249,457,1463,1521,2984
DAKAR,PIKINE,"VILLE DE PIKINE",MBAO,"FASS (PETIT MBAO)",32,50,184,197,381
DAKAR,PIKINE,"VILLE DE PIKINE",MBAO,"FASS EXTENSION",41,86,358,261,619
DAKAR,PIKINE,"VILLE DE PIKINE",MBAO,"GRAND MBAO EXTENSION EST (GRAND MBAO)",328,504,1563,1724,3287
DAKAR,PIKINE,"VILLE DE PIKINE",MBAO,"KAMB EXTENSION",229,391,1237,1272,2509
DAKAR,PIKINE,"VILLE DE PIKINE",MBAO,"MBAO PEULH",34,46,173,151,324
DAKAR,PIKINE,"VILLE DE PIKINE",MBAO,"MBAO PEULH EXTENSION (PETIT MBAO)",35,68,209,205,414
DAKAR,PIKINE,"VILLE DE PIKINE",MBAO,"MEDINATOUL MOUNAWARA",209,327,1156,1267,2423
DAKAR,PIKINE,"VILLE DE PIKINE",MBAO,"MISSION FRANCAISE DE COOPERATION",76,129,403,391,794
DAKAR,PIKINE,"VILLE DE PIKINE",MBAO,"MOSQUEE II",38,55,243,253,496
DAKAR,PIKINE,"VILLE DE PIKINE",MBAO,"NIARY GOUYE (GRAND MBAO)",50,86,409,400,809
DAKAR,PIKINE,"VILLE DE PIKINE",MBAO,"QUARTIER MOUSTAPHA SALL (KEUR MBAYE EXTENSION)",248,392,1363,1339,2702
DAKAR,PIKINE,"VILLE DE PIKINE",MBAO,"SERIGNE MANSOUR SY BIS (GRAND MBAO)",89,125,407,465,872
DAKAR,PIKINE,"VILLE DE PIKINE",MBAO,"THIEKENE (PETIT MBAO)",22,36,138,156,294
DAKAR,PIKINE,"VILLE DE PIKINE",MBAO,TONGHOR,18,28,122,145,267
DAKAR,PIKINE,"VILLE DE PIKINE",MBAO,"TOURNAL (PETIT MBAO)",17,26,129,142,271
DAKAR,RUFISQUE,BARGNY,BARGNY,"CITE CASTOR 3 EXTENTION",82,129,668,647,1315
DAKAR,RUFISQUE,BARGNY,BARGNY,"CITE CASTOR EXTENTION",321,417,1370,1336,2706
DAKAR,RUFISQUE,BARGNY,BARGNY,"CITE CASTOR II",123,162,653,658,1311
DAKAR,RUFISQUE,BARGNY,BARGNY,"CITE I",432,518,2276,1816,4092
DAKAR,RUFISQUE,BARGNY,BARGNY,"CITE II",143,241,1001,1024,2025
DAKAR,RUFISQUE,BARGNY,BARGNY,"CITE SERIGNE BABACAR SY",101,122,665,399,1064
DAKAR,RUFISQUE,BARGNY,BARGNY,"DAROU I",142,254,1010,1064,2074
DAKAR,RUFISQUE,BARGNY,BARGNY,"DAROU II",76,109,455,471,926
DAKAR,RUFISQUE,BARGNY,BARGNY,DIAMALAYE,223,277,1235,1261,2496
DAKAR,RUFISQUE,BARGNY,BARGNY,"DIAMALAYE (WAKHANDE)",225,250,981,884,1865
DAKAR,RUFISQUE,BARGNY,BARGNY,"GOUYE DAGA",76,196,902,890,1792
DAKAR,RUFISQUE,BARGNY,BARGNY,"GOUYE DIOULANCAR",81,234,1317,1344,2661
DAKAR,RUFISQUE,BARGNY,BARGNY,"GOUYE NDIANDIA",60,91,383,408,791
DAKAR,RUFISQUE,BARGNY,BARGNY,"KIP CARRIERE",324,547,2044,1955,3999
DAKAR,RUFISQUE,BARGNY,BARGNY,"KIP FINCONE",840,1431,4213,4176,8389
DAKAR,RUFISQUE,BARGNY,BARGNY,LAYENE,75,144,696,658,1354
DAKAR,RUFISQUE,BARGNY,BARGNY,MARNANE,41,78,242,255,497
DAKAR,RUFISQUE,BARGNY,BARGNY,"MBOTH KAW",99,159,747,798,1545
DAKAR,RUFISQUE,BARGNY,BARGNY,"MBOTH WAGUE",146,216,946,878,1824
DAKAR,RUFISQUE,BARGNY,BARGNY,"MEDINATOUL MOUNAWARA",382,510,2043,2085,4128
DAKAR,RUFISQUE,BARGNY,BARGNY,MINAME,56,103,590,465,1055
DAKAR,RUFISQUE,BARGNY,BARGNY,MISSIRAH,146,226,1010,1029,2039
DAKAR,RUFISQUE,BARGNY,BARGNY,NDALDALY,86,168,796,839,1635
DAKAR,RUFISQUE,BARGNY,BARGNY,"NDIAGA SAMB",83,153,1033,933,1966
DAKAR,RUFISQUE,BARGNY,BARGNY,"NDIANDIA I",90,228,1294,1207,2501
DAKAR,RUFISQUE,BARGNY,BARGNY,"NDIANDIA II",14,55,251,266,517
DAKAR,RUFISQUE,BARGNY,BARGNY,"NDIAYENE GUEDJI",15,47,270,292,562
DAKAR,RUFISQUE,BARGNY,BARGNY,NDIOLMANE,85,252,1111,1116,2227
DAKAR,RUFISQUE,BARGNY,BARGNY,"NGOUDA NDIAYENE",55,129,648,666,1314
DAKAR,RUFISQUE,BARGNY,BARGNY,"NGOUDE BAYE",86,193,933,894,1827
DAKAR,RUFISQUE,BARGNY,BARGNY,NGOUNOU,12,21,141,106,247
DAKAR,RUFISQUE,BARGNY,BARGNY,NGUENE,53,129,538,546,1084
DAKAR,RUFISQUE,BARGNY,BARGNY,NIANGUENE,89,198,976,973,1949
DAKAR,RUFISQUE,BARGNY,BARGNY,"SANTHIOUB GUEDJI",113,257,1217,1282,2499
DAKAR,RUFISQUE,BARGNY,BARGNY,"BARGNY VILLE VERTE  I",128,136,534,432,966
DAKAR,RUFISQUE,SENDOU,SENDOU,"SENDOU PEULGHA (PANTHIOUR)",56,61,190,178,368
DAKAR,RUFISQUE,SENDOU,SENDOU,"SENDOU EST EXTENSION",201,243,1410,1247,2657
DAKAR,RUFISQUE,SENDOU,SENDOU,"SENDOU OUEST EXTENSION",15,45,230,239,469
DAKAR,RUFISQUE,SENDOU,SENDOU,"SENDOU THIOSSANE",70,97,294,257,551
DAKAR,RUFISQUE,SANGALKAM,BAMBILOR,BAMBILOR,2771,3193,11858,11486,23344
DAKAR,RUFISQUE,SANGALKAM,BAMBILOR,"DENY BIRAME NDAO NORD",259,359,2284,2008,4292
DAKAR,RUFISQUE,SANGALKAM,BAMBILOR,"DENY BIRAME NDAO SUD",203,286,1514,1406,2920
DAKAR,RUFISQUE,SANGALKAM,BAMBILOR,"DENY GUEDJI SUD",213,245,800,817,1617
DAKAR,RUFISQUE,SANGALKAM,BAMBILOR,"H1 KOURKA PENE",178,183,534,515,1049
DAKAR,RUFISQUE,SANGALKAM,BAMBILOR,"GOROM I",441,534,2510,2385,4895
DAKAR,RUFISQUE,SANGALKAM,BAMBILOR,"GOROM II",639,781,2917,2959,5876
DAKAR,RUFISQUE,SANGALKAM,BAMBILOR,"GOROM III",81,88,397,353,750
DAKAR,RUFISQUE,SANGALKAM,BAMBILOR,"KANIACK NDIAWDOUNE",120,160,736,654,1390
DAKAR,RUFISQUE,SANGALKAM,BAMBILOR,MBEUTHE,174,201,1029,883,1912
DAKAR,RUFISQUE,SANGALKAM,BAMBILOR,"NDIAKHIRATE PEULH",238,293,1043,1006,2049
DAKAR,RUFISQUE,SANGALKAM,BAMBILOR,"NDIOUGOUYE DIACKSAO",179,195,712,614,1326
DAKAR,RUFISQUE,SANGALKAM,BAMBILOR,NGUENDOUF,57,57,211,161,372
DAKAR,RUFISQUE,SANGALKAM,BAMBILOR,WAYABAME,159,189,658,594,1252
DAKAR,RUFISQUE,SANGALKAM,BAMBILOR,"H1 MBEYE",161,190,779,641,1420
DAKAR,RUFISQUE,SANGALKAM,BAMBILOR,"H2 KHOSS KHAR YALLA",48,49,147,76,223
DAKAR,RUFISQUE,SANGALKAM,BAMBILOR,"COMICO V BAMBILOR",1040,1090,3105,3308,6413
DAKAR,RUFISQUE,SANGALKAM,SANGALKAM,"BAKARY DIOP",59,77,390,453,843
DAKAR,RUFISQUE,SANGALKAM,SANGALKAM,BAYAAL,217,244,1048,951,1999
DAKAR,RUFISQUE,SANGALKAM,SANGALKAM,"CITE EL HADJI DOUDOU BASSE II",77,82,242,263,505
DAKAR,RUFISQUE,SANGALKAM,SANGALKAM,"DAROU RAHMANE",334,362,1379,1350,2729
DAKAR,RUFISQUE,SANGALKAM,SANGALKAM,"DAROU SALAM I",159,180,625,709,1334
DAKAR,RUFISQUE,SANGALKAM,SANGALKAM,"DAROU SALAM II",416,449,1760,1610,3370
DAKAR,RUFISQUE,SANGALKAM,SANGALKAM,DIAMAGUENE,72,91,315,307,622
DAKAR,RUFISQUE,SANGALKAM,SANGALKAM,ESCALE,78,106,461,357,818
DAKAR,RUFISQUE,SANGALKAM,SANGALKAM,"NDIAKHIRATE DIGUE",630,863,3570,3117,6687
DAKAR,RUFISQUE,SANGALKAM,SANGALKAM,"NDIAKHIRATE NDIAYENE",464,523,1995,1919,3914
DAKAR,RUFISQUE,SANGALKAM,SANGALKAM,SERERE,33,35,192,194,386
DAKAR,RUFISQUE,SANGALKAM,SANGALKAM,"CITE DABAKH",117,130,406,445,851
DAKAR,RUFISQUE,SANGALKAM,SANGALKAM,"CITE EL HADJ DOUDOU BASSE I",250,266,579,745,1324
DAKAR,RUFISQUE,SANGALKAM,SANGALKAM,"CITE NOUVEL HORIZON",518,562,1594,1745,3339
DAKAR,RUFISQUE,SANGALKAM,SANGALKAM,"CITE SERIGNE BARA",183,202,530,582,1112
DAKAR,RUFISQUE,SANGALKAM,SANGALKAM,"CITE SOCOCIM",105,105,372,359,731
DAKAR,RUFISQUE,SANGALKAM,SANGALKAM,"CITE YACINE IMMO",185,243,676,757,1433
DAKAR,RUFISQUE,SANGALKAM,SANGALKAM,"KEUR DAOUDA SARR",402,480,1785,1942,3727
DAKAR,RUFISQUE,SANGALKAM,SANGALKAM,"KEUR NDIAYE LO",757,982,4285,3976,8261
DAKAR,RUFISQUE,SANGALKAM,SANGALKAM,KOUNOUNE,2288,2557,9300,9641,18941
DAKAR,RUFISQUE,SANGALKAM,SANGALKAM,"KOUNOUNE (CITE KOCHAPEC)",415,446,1432,1447,2879
DAKAR,RUFISQUE,SANGALKAM,SANGALKAM,"KOUNOUNE EXTENSION (CITE AIR FRANCE)",385,421,1169,1199,2368
DAKAR,RUFISQUE,SANGALKAM,SANGALKAM,"KOUNOUNE EXTENSION (SAGEF)",81,94,271,291,562
DAKAR,RUFISQUE,SANGALKAM,SANGALKAM,"KOUNOUNE NGALLAPE",484,527,1872,1879,3751
DAKAR,RUFISQUE,SANGALKAM,SANGALKAM,"LEBOUGUI 2000",438,551,1790,1860,3650
DAKAR,RUFISQUE,SANGALKAM,SANGALKAM,MEDINE,199,231,847,913,1760
DAKAR,RUFISQUE,SANGALKAM,SANGALKAM,"MERE THERESA",74,75,208,209,417
DAKAR,RUFISQUE,SANGALKAM,SANGALKAM,"SYR YAYE DIOR",403,457,1295,1397,2692
DAKAR,RUFISQUE,SANGALKAM,SANGALKAM,"CITE KAWSARE",273,308,1371,1258,2629
DAKAR,RUFISQUE,SANGALKAM,SANGALKAM,"CITE KHALIFA ABABACAR SY EXTENSION",48,51,159,146,305
DAKAR,RUFISQUE,SANGALKAM,SANGALKAM,"CITE MBABA GUISSE",176,187,546,576,1122
DAKAR,RUFISQUE,SANGALKAM,SANGALKAM,"CITE NDIOLA",117,147,506,539,1045
DAKAR,RUFISQUE,SANGALKAM,SANGALKAM,"CITE SOLAIRE",124,131,451,449,900
DAKAR,RUFISQUE,SANGALKAM,SANGALKAM,"DIAMAGUENE CITE VERTE",10,10,30,33,63
DAKAR,RUFISQUE,SANGALKAM,SANGALKAM,"DIANATOU MAHWA",178,190,722,525,1247
DAKAR,RUFISQUE,SANGALKAM,SANGALKAM,"GRANDE MOSQUEE",36,45,190,195,385
DAKAR,RUFISQUE,SANGALKAM,SANGALKAM,"KEUR NDIAYE LO EXTENSION",88,90,308,281,589
DAKAR,RUFISQUE,SANGALKAM,SANGALKAM,"KOUNOUNE ALMADIES II",357,461,1191,1465,2656
DAKAR,RUFISQUE,SANGALKAM,SANGALKAM,"KOUNOUNE EXTENSION (CITE AIR FRANCE KOUNOUNE II)",302,314,993,1086,2079
DAKAR,RUFISQUE,SANGALKAM,SANGALKAM,"KOUNOUNE EXTENSION (SICAP)",160,166,448,429,877
DAKAR,RUFISQUE,SANGALKAM,SANGALKAM,"MEDINA THIOUB",1487,1760,7268,6815,14083
DAKAR,RUFISQUE,SANGALKAM,SANGALKAM,"MEDINATOUL MOUNAWARA",155,183,523,521,1044
DAKAR,RUFISQUE,SANGALKAM,SANGALKAM,"SANGALKAM (DAROU SALAM II)",45,52,230,240,470
DAKAR,RUFISQUE,SANGALKAM,SANGALKAM,TAWFEKH,37,55,216,243,459
DAKAR,RUFISQUE,SANGALKAM,"TIVAOUANE PEULH NIAGHA",BENEUBA,214,238,921,873,1794
DAKAR,RUFISQUE,SANGALKAM,"TIVAOUANE PEULH NIAGHA","H2 KEUR BALLA",657,696,2789,2663,5452
DAKAR,RUFISQUE,SANGALKAM,"TIVAOUANE PEULH NIAGHA","CITE SAFCO III",377,491,1702,1521,3223
DAKAR,RUFISQUE,SANGALKAM,"TIVAOUANE PEULH NIAGHA","DAROU SALAM 2",140,174,466,530,996
DAKAR,RUFISQUE,SANGALKAM,"TIVAOUANE PEULH NIAGHA","DENY GUEDJ NORD",110,127,416,416,832
DAKAR,RUFISQUE,SANGALKAM,"TIVAOUANE PEULH NIAGHA","NIACOUL RAB EXTENSION",50,64,192,179,371
DAKAR,RUFISQUE,SANGALKAM,"TIVAOUANE PEULH NIAGHA","NIAGHA OUOLOF",401,450,1787,1605,3392
DAKAR,RUFISQUE,SANGALKAM,"TIVAOUANE PEULH NIAGHA","NIAGHA PEULH",299,317,1315,1112,2427
DAKAR,RUFISQUE,SANGALKAM,"TIVAOUANE PEULH NIAGHA","TIVAOUANE PEULH",147,196,751,728,1479
DAKAR,RUFISQUE,SANGALKAM,"TIVAOUANE PEULH NIAGHA","CITE APIX",763,975,3459,3742,7201
DAKAR,RUFISQUE,SANGALKAM,"TIVAOUANE PEULH NIAGHA","GROUPE NABY (SOPE NABY)",351,466,1742,1753,3495
DAKAR,RUFISQUE,SANGALKAM,"TIVAOUANE PEULH NIAGHA","KEUR MAREME MBENGUE",344,357,1219,1189,2408
DAKAR,RUFISQUE,SANGALKAM,"TIVAOUANE PEULH NIAGHA",NAMORA,365,383,1571,1525,3096
DAKAR,RUFISQUE,SANGALKAM,"TIVAOUANE PEULH NIAGHA","NIACOUL RAB",2093,2552,9736,9361,19097
DAKAR,RUFISQUE,SANGALKAM,"TIVAOUANE PEULH NIAGHA",SOCABEG,19,22,58,66,124
DAKAR,RUFISQUE,SANGALKAM,"TIVAOUANE PEULH NIAGHA","TAWFEKH SOCABEG",91,92,433,428,861
DAKAR,RUFISQUE,SANGALKAM,"TIVAOUANE PEULH NIAGHA","DAROU SALAM",220,257,1014,1022,2036
DAKAR,RUFISQUE,SANGALKAM,"TIVAOUANE PEULH NIAGHA","ALMADIES 3",285,294,1071,960,2031
DAKAR,RUFISQUE,SANGALKAM,"TIVAOUANE PEULH NIAGHA","ALPHA THIOMBANE",69,70,299,248,547
DAKAR,RUFISQUE,SANGALKAM,"TIVAOUANE PEULH NIAGHA",ARAFAT,66,76,252,258,510
DAKAR,RUFISQUE,SANGALKAM,"TIVAOUANE PEULH NIAGHA",ARAFATE,63,78,339,290,629
DAKAR,RUFISQUE,SANGALKAM,"TIVAOUANE PEULH NIAGHA","CITE AGNES",99,100,308,360,668
DAKAR,RUFISQUE,SANGALKAM,"TIVAOUANE PEULH NIAGHA","CITE COFIA",34,35,94,96,190
DAKAR,RUFISQUE,SANGALKAM,"TIVAOUANE PEULH NIAGHA","CITE DES ENSEIGNANTS",38,41,128,155,283
DAKAR,RUFISQUE,SANGALKAM,"TIVAOUANE PEULH NIAGHA","CITE DES ENSEIGNANTS EXTENTION",151,165,535,617,1152
DAKAR,RUFISQUE,SANGALKAM,"TIVAOUANE PEULH NIAGHA","CITE IPRESS",5,5,14,12,26
DAKAR,RUFISQUE,SANGALKAM,"TIVAOUANE PEULH NIAGHA","CITE ISRA",5,5,15,19,34
DAKAR,RUFISQUE,SANGALKAM,"TIVAOUANE PEULH NIAGHA","CITE NAMORA",277,288,891,926,1817
DAKAR,RUFISQUE,SANGALKAM,"TIVAOUANE PEULH NIAGHA","CITE POLICE",178,180,638,604,1242
DAKAR,RUFISQUE,SANGALKAM,"TIVAOUANE PEULH NIAGHA","CITE SIPRES TIVAOUNE PEULH",104,110,398,440,838
DAKAR,RUFISQUE,SANGALKAM,"TIVAOUANE PEULH NIAGHA","CITE SOCABEG UNITE 2 SANTE YALLA",325,364,1430,1417,2847
DAKAR,RUFISQUE,SANGALKAM,"TIVAOUANE PEULH NIAGHA","CITE TAWFEKH 3",7,7,29,23,52
DAKAR,RUFISQUE,SANGALKAM,"TIVAOUANE PEULH NIAGHA","CITE UCAD 3",92,117,407,359,766
DAKAR,RUFISQUE,SANGALKAM,"TIVAOUANE PEULH NIAGHA","DALAL DIAME",52,59,210,243,453
DAKAR,RUFISQUE,SANGALKAM,"TIVAOUANE PEULH NIAGHA","DARES SALAM",95,119,390,430,820
DAKAR,RUFISQUE,SANGALKAM,"TIVAOUANE PEULH NIAGHA","DAROU KHALIL",70,80,337,326,663
DAKAR,RUFISQUE,SANGALKAM,"TIVAOUANE PEULH NIAGHA","DAROU KHAYRI",145,163,635,596,1231
DAKAR,RUFISQUE,SANGALKAM,"TIVAOUANE PEULH NIAGHA","DAROU KHOUDOUSS",82,94,323,347,670
DAKAR,RUFISQUE,SANGALKAM,"TIVAOUANE PEULH NIAGHA","DAROU RAHMANE 1",148,173,684,642,1326
DAKAR,RUFISQUE,SANGALKAM,"TIVAOUANE PEULH NIAGHA","DAROU RAHMANE 3",225,314,1047,1076,2123
DAKAR,RUFISQUE,SANGALKAM,"TIVAOUANE PEULH NIAGHA","DAROU RAKHEMANE 2",257,282,1082,991,2073
DAKAR,RUFISQUE,SANGALKAM,"TIVAOUANE PEULH NIAGHA","DAROU SALAM 3",107,128,468,475,943
DAKAR,RUFISQUE,SANGALKAM,"TIVAOUANE PEULH NIAGHA","DAROU SALAM BEIGNE BI",112,114,441,385,826
DAKAR,RUFISQUE,SANGALKAM,"TIVAOUANE PEULH NIAGHA","DAROU SALAM NAMORA",92,97,404,326,730
DAKAR,RUFISQUE,SANGALKAM,"TIVAOUANE PEULH NIAGHA","DAROU SALAM TAWFEKHE",46,46,265,262,527
DAKAR,RUFISQUE,SANGALKAM,"TIVAOUANE PEULH NIAGHA",DEGGO,41,81,251,225,476
DAKAR,RUFISQUE,SANGALKAM,"TIVAOUANE PEULH NIAGHA","DIAMAGUENE QUARTIER SIRE CAMARA",100,113,510,451,961
DAKAR,RUFISQUE,SANGALKAM,"TIVAOUANE PEULH NIAGHA","DIAMAGUENE TIVAOUNE PEULH",113,168,584,539,1123
DAKAR,RUFISQUE,SANGALKAM,"TIVAOUANE PEULH NIAGHA",DIAMALAYE,208,241,845,794,1639
DAKAR,RUFISQUE,SANGALKAM,"TIVAOUANE PEULH NIAGHA","DIAME BOUGOUME",159,191,670,623,1293
DAKAR,RUFISQUE,SANGALKAM,"TIVAOUANE PEULH NIAGHA",FALLENE,80,103,361,383,744
DAKAR,RUFISQUE,SANGALKAM,"TIVAOUANE PEULH NIAGHA",FOUTA,64,76,454,422,876
DAKAR,RUFISQUE,SANGALKAM,"TIVAOUANE PEULH NIAGHA",GANDIOL,38,55,305,335,640
DAKAR,RUFISQUE,SANGALKAM,"TIVAOUANE PEULH NIAGHA","HLM 1",148,184,823,734,1557
DAKAR,RUFISQUE,SANGALKAM,"TIVAOUANE PEULH NIAGHA","HLM 2",63,93,360,376,736
DAKAR,RUFISQUE,SANGALKAM,"TIVAOUANE PEULH NIAGHA","HLM 3",91,113,523,505,1028
DAKAR,RUFISQUE,SANGALKAM,"TIVAOUANE PEULH NIAGHA","HLM SAM SAM",82,97,354,326,680
DAKAR,RUFISQUE,SANGALKAM,"TIVAOUANE PEULH NIAGHA","KEUR SALAM",68,72,190,245,435
DAKAR,RUFISQUE,SANGALKAM,"TIVAOUANE PEULH NIAGHA","M’BACKE KADIOR",36,37,132,145,277
DAKAR,RUFISQUE,SANGALKAM,"TIVAOUANE PEULH NIAGHA","MEDINATOUL SALAM NIACOUL RAB",22,25,120,112,232
DAKAR,RUFISQUE,SANGALKAM,"TIVAOUANE PEULH NIAGHA",MISSIRAH,134,148,571,517,1088
DAKAR,RUFISQUE,SANGALKAM,"TIVAOUANE PEULH NIAGHA","MOULAYE DABAKH",119,141,510,504,1014
DAKAR,RUFISQUE,SANGALKAM,"TIVAOUANE PEULH NIAGHA",MOUREL,53,66,251,289,540
DAKAR,RUFISQUE,SANGALKAM,"TIVAOUANE PEULH NIAGHA","MOUREL II",92,111,424,428,852
DAKAR,RUFISQUE,SANGALKAM,"TIVAOUANE PEULH NIAGHA","MOUSDALIFA NGUELMAK",275,304,1091,1066,2157
DAKAR,RUFISQUE,SANGALKAM,"TIVAOUANE PEULH NIAGHA","NAMORA MEDINATOUL MOUNA WA RA",168,183,572,609,1181
DAKAR,RUFISQUE,SANGALKAM,"TIVAOUANE PEULH NIAGHA","NDIAWRIGNE TIVAOUNE PEULH",64,77,355,367,722
DAKAR,RUFISQUE,SANGALKAM,"TIVAOUANE PEULH NIAGHA",NDIAYENE,17,26,114,121,235
DAKAR,RUFISQUE,SANGALKAM,"TIVAOUANE PEULH NIAGHA","NDIBENE TAWFEKHE",201,212,838,810,1648
DAKAR,RUFISQUE,SANGALKAM,"TIVAOUANE PEULH NIAGHA",NDIENENE,68,105,642,637,1279
DAKAR,RUFISQUE,SANGALKAM,"TIVAOUANE PEULH NIAGHA",NDIENGUENE,20,22,116,122,238
DAKAR,RUFISQUE,SANGALKAM,"TIVAOUANE PEULH NIAGHA",NGAYENNE,46,54,299,315,614
DAKAR,RUFISQUE,SANGALKAM,"TIVAOUANE PEULH NIAGHA","NIAGHA FRONTIERE",19,19,78,91,169
DAKAR,RUFISQUE,SANGALKAM,"TIVAOUANE PEULH NIAGHA","NIAGHA NIASSENE",39,43,218,214,432
DAKAR,RUFISQUE,SANGALKAM,"TIVAOUANE PEULH NIAGHA","NIAGHA OULOF CITE LAC ROSE",112,113,223,224,447
DAKAR,RUFISQUE,SANGALKAM,"TIVAOUANE PEULH NIAGHA","NIAGUE DAROU RAHMANE",36,37,136,108,244
DAKAR,RUFISQUE,SANGALKAM,"TIVAOUANE PEULH NIAGHA","NIMZATH ALMADIES",526,576,2050,1995,4045
DAKAR,RUFISQUE,SANGALKAM,"TIVAOUANE PEULH NIAGHA","NIMZATH SALIHINA 1",212,243,717,754,1471
DAKAR,RUFISQUE,SANGALKAM,"TIVAOUANE PEULH NIAGHA",PIKINE,71,98,405,438,843
DAKAR,RUFISQUE,SANGALKAM,"TIVAOUANE PEULH NIAGHA","PIKINE II",77,104,453,435,888
DAKAR,RUFISQUE,SANGALKAM,"TIVAOUANE PEULH NIAGHA","QUARTIER BAYAL BA",67,109,448,447,895
DAKAR,RUFISQUE,SANGALKAM,"TIVAOUANE PEULH NIAGHA","QUARTIER BAYE FALL NIANG",83,87,365,386,751
DAKAR,RUFISQUE,SANGALKAM,"TIVAOUANE PEULH NIAGHA","QUARTIER CHEIKH TIDIANE HANN",124,134,472,411,883
DAKAR,RUFISQUE,SANGALKAM,"TIVAOUANE PEULH NIAGHA","SANTA YALLA KHABANE",176,197,752,725,1477
DAKAR,RUFISQUE,SANGALKAM,"TIVAOUANE PEULH NIAGHA","SERIGNE MANSOUR SY",145,169,600,615,1215
DAKAR,RUFISQUE,SANGALKAM,"TIVAOUANE PEULH NIAGHA","TAWFEKH CFI INVEST",301,320,1065,1165,2230
DAKAR,RUFISQUE,SANGALKAM,"TIVAOUANE PEULH NIAGHA","TAWFEKH TP",129,171,673,596,1269
DAKAR,RUFISQUE,SANGALKAM,"TIVAOUANE PEULH NIAGHA","TAWFEKH YAKAR",133,147,671,677,1348
DAKAR,RUFISQUE,SANGALKAM,"TIVAOUANE PEULH NIAGHA",TAWFEKHE,86,142,545,537,1082
DAKAR,RUFISQUE,SANGALKAM,"TIVAOUANE PEULH NIAGHA","TAWFEKHE CSTP",148,151,599,616,1215
DAKAR,RUFISQUE,SANGALKAM,"TIVAOUANE PEULH NIAGHA","TAWFEKHE LA LINGUERE",363,413,1608,1573,3181
DAKAR,RUFISQUE,SANGALKAM,"TIVAOUANE PEULH NIAGHA","TAWFEKHE YAKAR DM S",84,86,315,373,688
DAKAR,RUFISQUE,SANGALKAM,"TIVAOUANE PEULH NIAGHA","TIVAOUANE PEULH DAROU RAHMANE",190,218,851,785,1636
DAKAR,RUFISQUE,SANGALKAM,"TIVAOUANE PEULH NIAGHA","TIVAOUANE PEULH DIAWRIGNE",79,96,386,388,774
DAKAR,RUFISQUE,SANGALKAM,"TIVAOUANE PEULH NIAGHA","TIVAOUANE PEULH MEDINA",252,285,1205,1071,2276
DAKAR,RUFISQUE,SANGALKAM,"TIVAOUANE PEULH NIAGHA","TIVAOUANE PEULH DADAL KA",125,159,562,593,1155
DAKAR,RUFISQUE,SANGALKAM,"TIVAOUANE PEULH NIAGHA","TIVAOUANE PEULH SAM SAM",138,159,682,657,1339
DAKAR,RUFISQUE,SANGALKAM,"TIVAOUANE PEULH NIAGHA","TIVAOUANE PEULH SANTA YALLAA",219,317,950,971,1921
DAKAR,RUFISQUE,SANGALKAM,"TIVAOUANE PEULH NIAGHA","TIVAOUNE PEULH BAOL",323,380,1487,1510,2997
DAKAR,RUFISQUE,SANGALKAM,"TIVAOUANE PEULH NIAGHA","TIVAOUNE PEULH DIANATOU",212,249,940,1009,1949
DAKAR,RUFISQUE,SANGALKAM,"TIVAOUANE PEULH NIAGHA","TIVAOUNE PEULH KHAR YALLA",70,84,369,313,682
DAKAR,RUFISQUE,SANGALKAM,"TIVAOUANE PEULH NIAGHA","TIVAOUNE PEULH ALPHA THIOMBANE",245,280,1021,1064,2085
DAKAR,RUFISQUE,SANGALKAM,"TIVAOUANE PEULH NIAGHA","TIVAOUNE PEULH DIAWARA",152,159,567,610,1177
DAKAR,RUFISQUE,SANGALKAM,"TIVAOUANE PEULH NIAGHA","TIVAOUNE PEULH SINGANE FALL",57,64,235,240,475
DAKAR,RUFISQUE,SANGALKAM,"TIVAOUANE PEULH NIAGHA","UNITE 5 SOCABEG",2,2,7,8,15
DAKAR,RUFISQUE,SANGALKAM,"TIVAOUANE PEULH NIAGHA","WAKHALDIAME TP",23,30,100,123,223
DAKAR,RUFISQUE,DIAMNIADIO,YENE,KELLE,269,311,1374,1363,2737
DAKAR,RUFISQUE,DIAMNIADIO,YENE,NDITAKH,263,322,1701,1518,3219
DAKAR,RUFISQUE,DIAMNIADIO,YENE,"NDOUKHOURA OUOLOF",98,107,416,279,695
DAKAR,RUFISQUE,DIAMNIADIO,YENE,NIANGHAL,566,774,4496,4316,8812
DAKAR,RUFISQUE,DIAMNIADIO,YENE,"NIAYES KHAYES",51,61,249,198,447
DAKAR,RUFISQUE,DIAMNIADIO,YENE,"TOUBAB DIALAW",519,612,2167,2004,4171
DAKAR,RUFISQUE,DIAMNIADIO,YENE,"YENE GUEDJI",541,723,3847,3630,7477
DAKAR,RUFISQUE,DIAMNIADIO,YENE,"YENE KAW",361,458,2771,2626,5397
DAKAR,RUFISQUE,DIAMNIADIO,YENE,"YENE TODD",156,239,984,953,1937
DAKAR,RUFISQUE,DIAMNIADIO,SEBIKOTANE,"DAROU SALAM",206,320,1328,1487,2815
DAKAR,RUFISQUE,DIAMNIADIO,SEBIKOTANE,"KEURI KAW",98,143,731,730,1461
DAKAR,RUFISQUE,DIAMNIADIO,SEBIKOTANE,"KHOUTANE SERERE",293,395,1470,1524,2994
DAKAR,RUFISQUE,DIAMNIADIO,SEBIKOTANE,NDIOLA,192,236,1122,1158,2280
DAKAR,RUFISQUE,DIAMNIADIO,SEBIKOTANE,NDOYENE,150,190,900,785,1685
DAKAR,RUFISQUE,DIAMNIADIO,SEBIKOTANE,"SEBI ESCALE",101,178,849,845,1694
DAKAR,RUFISQUE,DIAMNIADIO,SEBIKOTANE,"SEBI FASS",342,500,1906,1755,3661
DAKAR,RUFISQUE,DIAMNIADIO,SEBIKOTANE,"SEBI GARAGE",76,112,604,622,1226
DAKAR,RUFISQUE,DIAMNIADIO,SEBIKOTANE,"SEBI GARE",393,486,1943,1770,3713
DAKAR,RUFISQUE,DIAMNIADIO,SEBIKOTANE,"SEBI KIP KIP",302,401,1478,1475,2953
DAKAR,RUFISQUE,DIAMNIADIO,SEBIKOTANE,"SEBI TANGOR",886,1079,4016,3596,7612
DAKAR,RUFISQUE,DIAMNIADIO,SEBIKOTANE,"SEBI THIOKHO",361,642,2224,2203,4427
DAKAR,RUFISQUE,DIAMNIADIO,SEBIKOTANE,YEBA,213,272,1015,1048,2063
DAKAR,RUFISQUE,DIAMNIADIO,SEBIKOTANE,GUENE,125,185,629,621,1250
DAKAR,RUFISQUE,DIAMNIADIO,SEBIKOTANE,SOROKH,124,135,610,596,1206
DAKAR,RUFISQUE,DIAMNIADIO,SEBIKOTANE,"YEBA 2",77,132,646,609,1255
DAKAR,RUFISQUE,DIAMNIADIO,SEBIKOTANE,"YEBA INDA",30,56,291,253,544
DAKAR,RUFISQUE,DIAMNIADIO,DIAMNIADIO,"BOUNKA BAMBARA",55,59,269,250,519
DAKAR,RUFISQUE,DIAMNIADIO,DIAMNIADIO,"DENY BABACAR DIOP",134,153,608,648,1256
DAKAR,RUFISQUE,DIAMNIADIO,DIAMNIADIO,"DENY DEMBA CODOU",170,211,842,632,1474
DAKAR,RUFISQUE,DIAMNIADIO,DIAMNIADIO,"DENY MALICK GUEYE",158,200,914,920,1834
DAKAR,RUFISQUE,DIAMNIADIO,DIAMNIADIO,"DENY NDIAKHIRATE",486,708,2358,1970,4328
DAKAR,RUFISQUE,DIAMNIADIO,DIAMNIADIO,"DENY YOUSSOU",127,153,695,603,1298
DAKAR,RUFISQUE,DIAMNIADIO,DIAMNIADIO,"DOUGAR AITHIA",76,92,357,359,716
DAKAR,RUFISQUE,DIAMNIADIO,DIAMNIADIO,"DOUGAR I (LOSSA GOLA)",179,218,879,912,1791
DAKAR,RUFISQUE,DIAMNIADIO,DIAMNIADIO,"DOUGAR KANOUNE",99,144,561,486,1047
DAKAR,RUFISQUE,DIAMNIADIO,DIAMNIADIO,"DOUGAR OUEST (BOUNKA SERERE)",150,206,702,662,1364
DAKAR,RUFISQUE,DIAMNIADIO,DIAMNIADIO,"DOUGAR PEULH",187,234,1019,877,1896
DAKAR,RUFISQUE,DIAMNIADIO,DIAMNIADIO,"NDOUKHOURA PEULH I",175,202,932,803,1735
DAKAR,RUFISQUE,DIAMNIADIO,DIAMNIADIO,NDOYENE,136,182,912,724,1636
DAKAR,RUFISQUE,DIAMNIADIO,DIAMNIADIO,"DOUGAR POTOU TANGOR",91,125,592,544,1136
DAKAR,RUFISQUE,DIAMNIADIO,DIAMNIADIO,SANTHIE,31,35,154,118,272
DAKAR,RUFISQUE,DIAMNIADIO,DIAMNIADIO,"SEBY PONTY",301,363,2336,1582,3918
DAKAR,RUFISQUE,DIAMNIADIO,DIAMNIADIO,"DOUGAR YAM",34,70,359,365,724
DAKAR,RUFISQUE,DIAMNIADIO,DIAMNIADIO,"CITE DES FONCTIONNAIRES",170,192,418,468,886
DAKAR,RUFISQUE,DIAMNIADIO,DIAMNIADIO,"CITE PORT",253,276,611,627,1238
DAKAR,RUFISQUE,DIAMNIADIO,DIAMNIADIO,"DIAMNIADIO NORD",247,358,1343,1263,2606
DAKAR,RUFISQUE,DIAMNIADIO,DIAMNIADIO,"DIAMNIADIO SUD I",910,1146,4107,3514,7621
DAKAR,RUFISQUE,DIAMNIADIO,DIAMNIADIO,"DIAMNIADIO SUD II",611,919,3626,3245,6871
DAKAR,RUFISQUE,DIAMNIADIO,DIAMNIADIO,BELVEDERE,25,27,153,117,270
DAKAR,RUFISQUE,DIAMNIADIO,DIAMNIADIO,"NDOUKHOURA PEULH II",130,167,769,554,1323
DAKAR,RUFISQUE,"VILLE DE RUFISQUE","RUFISQUE EST","ARAFAT I",136,214,1155,1143,2298
DAKAR,RUFISQUE,"VILLE DE RUFISQUE","RUFISQUE EST","ARAFAT II",408,567,2168,2074,4242
DAKAR,RUFISQUE,"VILLE DE RUFISQUE","RUFISQUE EST","ARAFAT III",260,370,1389,1372,2761
DAKAR,RUFISQUE,"VILLE DE RUFISQUE","RUFISQUE EST","CHAMPS DE COURSE",220,334,1337,1277,2614
DAKAR,RUFISQUE,"VILLE DE RUFISQUE","RUFISQUE EST",CHEIKH,180,282,1229,1215,2444
DAKAR,RUFISQUE,"VILLE DE RUFISQUE","RUFISQUE EST","CITE CASTOR",206,353,1499,1468,2967
DAKAR,RUFISQUE,"VILLE DE RUFISQUE","RUFISQUE EST","COLOBANE I BIS",145,258,1048,1072,2120
DAKAR,RUFISQUE,"VILLE DE RUFISQUE","RUFISQUE EST","COLOBANE I NORD",163,246,1133,1129,2262
DAKAR,RUFISQUE,"VILLE DE RUFISQUE","RUFISQUE EST","COLOBANE II NORD",186,319,1382,1400,2782
DAKAR,RUFISQUE,"VILLE DE RUFISQUE","RUFISQUE EST","COLOBANE II SUD",144,231,851,938,1789
DAKAR,RUFISQUE,"VILLE DE RUFISQUE","RUFISQUE EST","DAROU KARIM",284,455,2006,1758,3764
DAKAR,RUFISQUE,"VILLE DE RUFISQUE","RUFISQUE EST","DAROU NAHIM",510,699,2749,2368,5117
DAKAR,RUFISQUE,"VILLE DE RUFISQUE","RUFISQUE EST",DIATTA,379,558,2649,2546,5195
DAKAR,RUFISQUE,"VILLE DE RUFISQUE","RUFISQUE EST","KEURY KAW",142,204,917,680,1597
DAKAR,RUFISQUE,"VILLE DE RUFISQUE","RUFISQUE EST","KEURY SOUF",160,228,562,605,1167
DAKAR,RUFISQUE,"VILLE DE RUFISQUE","RUFISQUE EST","KEURY SOUF GARE",29,47,148,151,299
DAKAR,RUFISQUE,"VILLE DE RUFISQUE","RUFISQUE EST","MERINA I",82,159,611,627,1238
DAKAR,RUFISQUE,"VILLE DE RUFISQUE","RUFISQUE EST","MERINA II",68,146,520,477,997
DAKAR,RUFISQUE,"VILLE DE RUFISQUE","RUFISQUE EST","THIAWLENE BOUTE",51,151,731,762,1493
DAKAR,RUFISQUE,"VILLE DE RUFISQUE","RUFISQUE EST","THIAWLENE DIGUE",33,113,508,544,1052
DAKAR,RUFISQUE,"VILLE DE RUFISQUE","RUFISQUE EST","THIAWLENE POUYENE",109,283,1240,1232,2472
DAKAR,RUFISQUE,"VILLE DE RUFISQUE","RUFISQUE EST","YOUSSOU MBARGANE DIOP",402,554,1636,1801,3437
DAKAR,RUFISQUE,"VILLE DE RUFISQUE","RUFISQUE EST","ALMADINAH CITY",70,73,212,209,421
DAKAR,RUFISQUE,"VILLE DE RUFISQUE","RUFISQUE EST","ALWAR GOUYE MOURIDE",89,121,621,567,1188
DAKAR,RUFISQUE,"VILLE DE RUFISQUE","RUFISQUE EST","ARAFAT I OUEST",182,288,1255,1210,2465
DAKAR,RUFISQUE,"VILLE DE RUFISQUE","RUFISQUE EST","ARAFAT II EST",78,132,423,433,856
DAKAR,RUFISQUE,"VILLE DE RUFISQUE","RUFISQUE EST","ARAFAT II OUEST",364,622,2298,2513,4811
DAKAR,RUFISQUE,"VILLE DE RUFISQUE","RUFISQUE EST","ARAFAT III KIPP",250,342,1173,1204,2377
DAKAR,RUFISQUE,"VILLE DE RUFISQUE","RUFISQUE EST","ARAFAT IV CAMP MARCHAND",151,210,774,814,1588
DAKAR,RUFISQUE,"VILLE DE RUFISQUE","RUFISQUE EST","ARAFAT IV CASTORS BATA",254,421,1477,1537,3014
DAKAR,RUFISQUE,"VILLE DE RUFISQUE","RUFISQUE EST","CHEIKH SUD",142,191,890,851,1741
DAKAR,RUFISQUE,"VILLE DE RUFISQUE","RUFISQUE EST","CITE SOCOCIM",50,92,419,437,856
DAKAR,RUFISQUE,"VILLE DE RUFISQUE","RUFISQUE EST","COLOBANE GOUYE MOURIDE",151,204,1078,1084,2162
DAKAR,RUFISQUE,"VILLE DE RUFISQUE","RUFISQUE EST","COLOBANE I",146,281,1155,1208,2363
DAKAR,RUFISQUE,"VILLE DE RUFISQUE","RUFISQUE EST","COLOBANE SOCOCIM",68,117,559,590,1149
DAKAR,RUFISQUE,"VILLE DE RUFISQUE","RUFISQUE EST","COLOBANE VOIE FERREE",12,27,106,106,212
DAKAR,RUFISQUE,"VILLE DE RUFISQUE","RUFISQUE EST","KEURY KAW GARE",71,88,382,376,758
DAKAR,RUFISQUE,"VILLE DE RUFISQUE","RUFISQUE EST","LEONA CHAMPS DE COURSE",28,38,146,151,297
DAKAR,RUFISQUE,"VILLE DE RUFISQUE","RUFISQUE EST","TOUBA  ALWAR",363,564,2302,2087,4389
DAKAR,RUFISQUE,"VILLE DE RUFISQUE","RUFISQUE NORD","AYNOUMANE FASS",96,133,609,603,1212
DAKAR,RUFISQUE,"VILLE DE RUFISQUE","RUFISQUE NORD","CITE DABAKH",752,955,3258,3103,6361
DAKAR,RUFISQUE,"VILLE DE RUFISQUE","RUFISQUE NORD","CITE ENSEIGNANTS",199,240,777,862,1639
DAKAR,RUFISQUE,"VILLE DE RUFISQUE","RUFISQUE NORD","CITE SENELEC",147,192,597,649,1246
DAKAR,RUFISQUE,"VILLE DE RUFISQUE","RUFISQUE NORD","CITE TACKO",826,1069,3255,3519,6774
DAKAR,RUFISQUE,"VILLE DE RUFISQUE","RUFISQUE NORD","DANGOU MINAME I",99,151,750,629,1379
DAKAR,RUFISQUE,"VILLE DE RUFISQUE","RUFISQUE NORD","DANGOU MINAME II",71,116,450,409,859
DAKAR,RUFISQUE,"VILLE DE RUFISQUE","RUFISQUE NORD","DANGOU MISSIRAH",117,178,808,791,1599
DAKAR,RUFISQUE,"VILLE DE RUFISQUE","RUFISQUE NORD","DANGOU NORD",402,656,2819,2888,5707
DAKAR,RUFISQUE,"VILLE DE RUFISQUE","RUFISQUE NORD","DANGOU NORD RESIDENCE",161,206,774,777,1551
DAKAR,RUFISQUE,"VILLE DE RUFISQUE","RUFISQUE NORD","DANGOU SUD",82,152,594,577,1171
DAKAR,RUFISQUE,"VILLE DE RUFISQUE","RUFISQUE NORD","DAROU RAKHMANE CENTRE",955,1357,5268,5000,10268
DAKAR,RUFISQUE,"VILLE DE RUFISQUE","RUFISQUE NORD","DAROU RAHMANE II (CITE JARAFF)",523,691,2410,2214,4624
DAKAR,RUFISQUE,"VILLE DE RUFISQUE","RUFISQUE NORD","DAROU RAKHMANE NORD EST",1039,1316,5151,4996,10147
DAKAR,RUFISQUE,"VILLE DE RUFISQUE","RUFISQUE NORD","DAROU RAKHMANE NORD OUEST",927,1298,4906,4374,9280
DAKAR,RUFISQUE,"VILLE DE RUFISQUE","RUFISQUE NORD","DAROU SALAM",164,264,1076,987,2063
DAKAR,RUFISQUE,"VILLE DE RUFISQUE","RUFISQUE NORD",DIAMAGUEUNE,58,105,373,407,780
DAKAR,RUFISQUE,"VILLE DE RUFISQUE","RUFISQUE NORD","DIORGUA CHERIF",555,797,3530,3466,6996
DAKAR,RUFISQUE,"VILLE DE RUFISQUE","RUFISQUE NORD","FASS I",83,174,660,626,1286
DAKAR,RUFISQUE,"VILLE DE RUFISQUE","RUFISQUE NORD","FASS II",345,484,1912,1884,3796
DAKAR,RUFISQUE,"VILLE DE RUFISQUE","RUFISQUE NORD","FASS NOFLAYE I",284,392,1637,1585,3222
DAKAR,RUFISQUE,"VILLE DE RUFISQUE","RUFISQUE NORD","FASS NOFLAYE II (FASS MANKHATANE)",201,337,1406,1292,2698
DAKAR,RUFISQUE,"VILLE DE RUFISQUE","RUFISQUE NORD","GOUYE ALDIANA",487,721,2874,2595,5469
DAKAR,RUFISQUE,"VILLE DE RUFISQUE","RUFISQUE NORD","GUENDEL II",135,252,988,1016,2004
DAKAR,RUFISQUE,"VILLE DE RUFISQUE","RUFISQUE NORD","GUENDEL III",80,147,575,499,1074
DAKAR,RUFISQUE,"VILLE DE RUFISQUE","RUFISQUE NORD","GUENDEL IV",105,222,770,761,1531
DAKAR,RUFISQUE,"VILLE DE RUFISQUE","RUFISQUE NORD","LEONA CHERIF",262,410,1268,1290,2558
DAKAR,RUFISQUE,"VILLE DE RUFISQUE","RUFISQUE NORD","NDAR GOU NDAW",209,346,1556,1351,2907
DAKAR,RUFISQUE,"VILLE DE RUFISQUE","RUFISQUE NORD","NIMZATT I",107,164,639,669,1308
DAKAR,RUFISQUE,"VILLE DE RUFISQUE","RUFISQUE NORD","NIMZATT II",89,138,562,628,1190
DAKAR,RUFISQUE,"VILLE DE RUFISQUE","RUFISQUE NORD","SANTA YALLA RESIDENCE",118,150,584,546,1130
DAKAR,RUFISQUE,"VILLE DE RUFISQUE","RUFISQUE NORD","SANTA YALLA I",324,466,1790,1844,3634
DAKAR,RUFISQUE,"VILLE DE RUFISQUE","RUFISQUE NORD","SANTA YALLA II",1062,1628,5514,5432,10946
DAKAR,RUFISQUE,"VILLE DE RUFISQUE","RUFISQUE NORD","SANTHIABA NDIOBENE",181,407,1433,1381,2814
DAKAR,RUFISQUE,"VILLE DE RUFISQUE","RUFISQUE NORD","SANTHIABA THIARENE",127,212,937,898,1835
DAKAR,RUFISQUE,"VILLE DE RUFISQUE","RUFISQUE NORD","SANTHIABA WAGUE",153,280,1026,841,1867
DAKAR,RUFISQUE,"VILLE DE RUFISQUE","RUFISQUE NORD","THIOKHO RESIDENCE",30,43,139,149,288
DAKAR,RUFISQUE,"VILLE DE RUFISQUE","RUFISQUE NORD","CITE SALAMA (CITE MBAYE JACQUES DIOP)",128,156,496,544,1040
DAKAR,RUFISQUE,"VILLE DE RUFISQUE","RUFISQUE OUEST","CITE ADE",215,292,761,862,1623
DAKAR,RUFISQUE,"VILLE DE RUFISQUE","RUFISQUE OUEST","CITE AGETIP",28,50,124,143,267
DAKAR,RUFISQUE,"VILLE DE RUFISQUE","RUFISQUE OUEST","CITE ASECNA",56,68,225,234,459
DAKAR,RUFISQUE,"VILLE DE RUFISQUE","RUFISQUE OUEST","CITE BATA-ZONE CAP DES BICHES-CITE SENELEC",204,269,832,937,1769
DAKAR,RUFISQUE,"VILLE DE RUFISQUE","RUFISQUE OUEST","CITE CAISSE DE SECURITE SOCIALE",53,61,175,203,378
DAKAR,RUFISQUE,"VILLE DE RUFISQUE","RUFISQUE OUEST","CITE CAPEC",200,225,748,719,1467
DAKAR,RUFISQUE,"VILLE DE RUFISQUE","RUFISQUE OUEST","CITE COLOBANE",49,78,209,233,442
DAKAR,RUFISQUE,"VILLE DE RUFISQUE","RUFISQUE OUEST","CITE CORA FALL",139,233,621,637,1258
DAKAR,RUFISQUE,"VILLE DE RUFISQUE","RUFISQUE OUEST","CITE DIOKOUL GABON",310,488,1764,1879,3643
DAKAR,RUFISQUE,"VILLE DE RUFISQUE","RUFISQUE OUEST","CITE ENSUT",16,39,105,102,207
DAKAR,RUFISQUE,"VILLE DE RUFISQUE","RUFISQUE OUEST","CITE FILAO",115,194,740,756,1496
DAKAR,RUFISQUE,"VILLE DE RUFISQUE","RUFISQUE OUEST","CITE IMPRIMERIE",185,272,803,822,1625
DAKAR,RUFISQUE,"VILLE DE RUFISQUE","RUFISQUE OUEST","CITE IRD (ORSTOM)",158,195,521,635,1156
DAKAR,RUFISQUE,"VILLE DE RUFISQUE","RUFISQUE OUEST","CITE KEUR SERIGNE KOKY-ANDRE KENNY",100,148,370,402,772
DAKAR,RUFISQUE,"VILLE DE RUFISQUE","RUFISQUE OUEST","CITE KHALIFA ABABACAR SY",243,340,846,962,1808
DAKAR,RUFISQUE,"VILLE DE RUFISQUE","RUFISQUE OUEST","CITE MAME SIGA I",74,99,275,267,542
DAKAR,RUFISQUE,"VILLE DE RUFISQUE","RUFISQUE OUEST","CITE MBAO HORIZON",68,91,220,324,544
DAKAR,RUFISQUE,"VILLE DE RUFISQUE","RUFISQUE OUEST","CITE MECS (MUTUELLE DES ENSEIGNANTS CATHOLIQUES DU SENEGAL)",147,196,472,506,978
DAKAR,RUFISQUE,"VILLE DE RUFISQUE","RUFISQUE OUEST","CITE MILLIONNAIRE",306,416,1221,1380,2601
DAKAR,RUFISQUE,"VILLE DE RUFISQUE","RUFISQUE OUEST","CITE MTOA",118,164,563,587,1150
DAKAR,RUFISQUE,"VILLE DE RUFISQUE","RUFISQUE OUEST","CITE PAMECAS",62,87,244,280,524
DAKAR,RUFISQUE,"VILLE DE RUFISQUE","RUFISQUE OUEST","CITE PARAGES",31,43,128,135,263
DAKAR,RUFISQUE,"VILLE DE RUFISQUE","RUFISQUE OUEST","CITE POSTE",113,137,392,492,884
DAKAR,RUFISQUE,"VILLE DE RUFISQUE","RUFISQUE OUEST","CITE RADIO",75,109,370,418,788
DAKAR,RUFISQUE,"VILLE DE RUFISQUE","RUFISQUE OUEST","CITE SAGAM",20,23,112,91,203
DAKAR,RUFISQUE,"VILLE DE RUFISQUE","RUFISQUE OUEST","CITE SAGEF I",80,96,258,284,542
DAKAR,RUFISQUE,"VILLE DE RUFISQUE","RUFISQUE OUEST","CITE SAGEF II",63,69,222,199,421
DAKAR,RUFISQUE,"VILLE DE RUFISQUE","RUFISQUE OUEST","CITE SANTE/ENSEIGNEMENT/FORCES ARMÉES",184,222,437,482,919
DAKAR,RUFISQUE,"VILLE DE RUFISQUE","RUFISQUE OUEST","CITE SAPEURS POMPIERS",195,257,681,921,1602
DAKAR,RUFISQUE,"VILLE DE RUFISQUE","RUFISQUE OUEST","CITE SAR",116,165,454,515,969
DAKAR,RUFISQUE,"VILLE DE RUFISQUE","RUFISQUE OUEST","CITE SENELEC",45,55,159,159,318
DAKAR,RUFISQUE,"VILLE DE RUFISQUE","RUFISQUE OUEST","CITE SERIGNE MANSOUR SY",148,166,503,558,1061
DAKAR,RUFISQUE,"VILLE DE RUFISQUE","RUFISQUE OUEST","CITE SHS",67,93,217,263,480
DAKAR,RUFISQUE,"VILLE DE RUFISQUE","RUFISQUE OUEST","CITE SIPRES",207,220,479,603,1082
DAKAR,RUFISQUE,"VILLE DE RUFISQUE","RUFISQUE OUEST","CITE SOBOA",106,151,418,502,920
DAKAR,RUFISQUE,"VILLE DE RUFISQUE","RUFISQUE OUEST","CITE IRD SOCABEG",84,95,340,295,635
DAKAR,RUFISQUE,"VILLE DE RUFISQUE","RUFISQUE OUEST","CITE SONACOS",216,321,934,1019,1953
DAKAR,RUFISQUE,"VILLE DE RUFISQUE","RUFISQUE OUEST","CITE SONATEL",58,73,264,327,591
DAKAR,RUFISQUE,"VILLE DE RUFISQUE","RUFISQUE OUEST","CITE SONATEL-ZAC MBAO",283,344,847,1024,1871
DAKAR,RUFISQUE,"VILLE DE RUFISQUE","RUFISQUE OUEST","CITE TECHNICIENS DES EAUX (SDE)",223,258,804,931,1735
DAKAR,RUFISQUE,"VILLE DE RUFISQUE","RUFISQUE OUEST","DAROU SALAM AZUR",211,339,1152,1059,2211
DAKAR,RUFISQUE,"VILLE DE RUFISQUE","RUFISQUE OUEST","DIOKOUL KAW",185,357,1487,1432,2919
DAKAR,RUFISQUE,"VILLE DE RUFISQUE","RUFISQUE OUEST","DIOKOUL KHER I",169,359,1300,1434,2734
DAKAR,RUFISQUE,"VILLE DE RUFISQUE","RUFISQUE OUEST","DIOKOUL LANSAR",133,234,1080,955,2035
DAKAR,RUFISQUE,"VILLE DE RUFISQUE","RUFISQUE OUEST","DIOKOUL NDIAYENE",110,209,929,921,1850
DAKAR,RUFISQUE,"VILLE DE RUFISQUE","RUFISQUE OUEST","DIOKOUL NDIOURENE",88,187,769,711,1480
DAKAR,RUFISQUE,"VILLE DE RUFISQUE","RUFISQUE OUEST","DIOKOUL WAGUE",107,223,893,909,1802
DAKAR,RUFISQUE,"VILLE DE RUFISQUE","RUFISQUE OUEST","GUENDEL I",62,100,321,355,676
DAKAR,RUFISQUE,"VILLE DE RUFISQUE","RUFISQUE OUEST","HLM I NDEFANN",158,190,717,788,1505
DAKAR,RUFISQUE,"VILLE DE RUFISQUE","RUFISQUE OUEST","HLM II",68,83,326,305,631
DAKAR,RUFISQUE,"VILLE DE RUFISQUE","RUFISQUE OUEST","HLM III",109,131,495,571,1066
DAKAR,RUFISQUE,"VILLE DE RUFISQUE","RUFISQUE OUEST","LEONA VALDA",108,279,1089,961,2050
DAKAR,RUFISQUE,"VILLE DE RUFISQUE","RUFISQUE OUEST","MEDINA ZAC MBAO",179,262,769,907,1676
DAKAR,RUFISQUE,"VILLE DE RUFISQUE","RUFISQUE OUEST",MEDINE,205,293,1208,1243,2451
DAKAR,RUFISQUE,"VILLE DE RUFISQUE","RUFISQUE OUEST","MOUSDALIFA SOCABEG",67,83,247,279,526
DAKAR,RUFISQUE,"VILLE DE RUFISQUE","RUFISQUE OUEST",NDEUCKOU,161,312,1283,1285,2568
DAKAR,RUFISQUE,"VILLE DE RUFISQUE","RUFISQUE OUEST",NGUESSOU,46,115,360,358,718
DAKAR,RUFISQUE,"VILLE DE RUFISQUE","RUFISQUE OUEST",THIOKHO,123,210,863,859,1722
DAKAR,RUFISQUE,"VILLE DE RUFISQUE","RUFISQUE OUEST","BABOU SALAM",291,384,1089,1276,2365
DAKAR,RUFISQUE,"VILLE DE RUFISQUE","RUFISQUE OUEST","BABOU SALAM 2",302,434,1288,1389,2677
DAKAR,RUFISQUE,"VILLE DE RUFISQUE","RUFISQUE OUEST","BINAL-MBAO HORIZON-SAFETOUR",200,280,736,807,1543
DAKAR,RUFISQUE,"VILLE DE RUFISQUE","RUFISQUE OUEST","CITE MAME SIGA II",19,21,60,54,114
DAKAR,RUFISQUE,"VILLE DE RUFISQUE","RUFISQUE OUEST","DIOKOUL ASMARA TIVAOUANE",133,190,656,675,1331
DAKAR,RUFISQUE,"VILLE DE RUFISQUE","RUFISQUE OUEST","MBEER TAW FEKH COLGATE",410,524,1462,1671,3133
DAKAR,RUFISQUE,"VILLE DE RUFISQUE","RUFISQUE OUEST","MEDINA SALAM ZAC MBAO",72,125,325,398,723
DAKAR,GUEDIAWAYE,"VILLE DE GUEDIAWAYE","GOLF SUD","CITE DU GOLF DE CAMBERENE (CITE ALIOUNE SOW)",861,1216,3251,4034,7285
DAKAR,GUEDIAWAYE,"VILLE DE GUEDIAWAYE","GOLF SUD","CITE ATEPA",40,106,257,304,561
DAKAR,GUEDIAWAYE,"VILLE DE GUEDIAWAYE","GOLF SUD","CITE DES ENSEIGNANTS",239,308,975,1125,2100
DAKAR,GUEDIAWAYE,"VILLE DE GUEDIAWAYE","GOLF SUD","CITE DOUANES",173,314,908,964,1872
DAKAR,GUEDIAWAYE,"VILLE DE GUEDIAWAYE","GOLF SUD","CITE FADIA",345,902,2468,2630,5098
DAKAR,GUEDIAWAYE,"VILLE DE GUEDIAWAYE","GOLF SUD","CITE FAYECAL",47,49,128,155,283
DAKAR,GUEDIAWAYE,"VILLE DE GUEDIAWAYE","GOLF SUD","CITE IBRAHIMA DIOP",91,121,403,452,855
DAKAR,GUEDIAWAYE,"VILLE DE GUEDIAWAYE","GOLF SUD","CITE SHS",289,405,1248,1385,2633
DAKAR,GUEDIAWAYE,"VILLE DE GUEDIAWAYE","GOLF SUD","FITH MITH",603,1573,4519,4674,9193
DAKAR,GUEDIAWAYE,"VILLE DE GUEDIAWAYE","GOLF SUD","GUENTABA I",247,768,2052,2170,4222
DAKAR,GUEDIAWAYE,"VILLE DE GUEDIAWAYE","GOLF SUD","GUENTABA II",200,684,1569,1701,3270
DAKAR,GUEDIAWAYE,"VILLE DE GUEDIAWAYE","GOLF SUD","GUENTABA III",483,1361,3554,3958,7512
DAKAR,GUEDIAWAYE,"VILLE DE GUEDIAWAYE","GOLF SUD","HAMO I",170,293,907,1024,1931
DAKAR,GUEDIAWAYE,"VILLE DE GUEDIAWAYE","GOLF SUD","HAMO II",212,423,1131,1231,2362
DAKAR,GUEDIAWAYE,"VILLE DE GUEDIAWAYE","GOLF SUD","HAMO III",171,247,685,811,1496
DAKAR,GUEDIAWAYE,"VILLE DE GUEDIAWAYE","GOLF SUD","HLM LAS PALMAS BLOC I",94,121,403,484,887
DAKAR,GUEDIAWAYE,"VILLE DE GUEDIAWAYE","GOLF SUD","HLM LAS PALMAS BLOC II",113,134,511,534,1045
DAKAR,GUEDIAWAYE,"VILLE DE GUEDIAWAYE","GOLF SUD","HLM LAS PALMAS BLOC III",356,449,1554,1740,3294
DAKAR,GUEDIAWAYE,"VILLE DE GUEDIAWAYE","GOLF SUD","PARCELLES ASSAINIES UNITE I",389,1005,3240,3017,6257
DAKAR,GUEDIAWAYE,"VILLE DE GUEDIAWAYE","GOLF SUD","PARCELLES ASSAINIES UNITE II",349,893,2550,2451,5001
DAKAR,GUEDIAWAYE,"VILLE DE GUEDIAWAYE","GOLF SUD","PARCELLES ASSAINIES UNITE III",295,784,2459,2380,4839
DAKAR,GUEDIAWAYE,"VILLE DE GUEDIAWAYE","GOLF SUD","PARCELLES ASSAINIES UNITE IV",374,976,2903,3045,5948
DAKAR,GUEDIAWAYE,"VILLE DE GUEDIAWAYE","GOLF SUD","PARCELLES ASSAINIES UNITE V",435,1318,4180,3797,7977
DAKAR,GUEDIAWAYE,"VILLE DE GUEDIAWAYE","GOLF SUD","PARCELLES ASSAINIES UNITE VI",491,1582,4463,4314,8777
DAKAR,GUEDIAWAYE,"VILLE DE GUEDIAWAYE","GOLF SUD","RASS MISSION",374,927,2903,2814,5717
DAKAR,GUEDIAWAYE,"VILLE DE GUEDIAWAYE","GOLF SUD","STATION X",311,671,1733,1990,3723
DAKAR,GUEDIAWAYE,"VILLE DE GUEDIAWAYE","GOLF SUD",TAIBA,184,438,1306,1372,2678
DAKAR,GUEDIAWAYE,"VILLE DE GUEDIAWAYE","GOLF SUD","TECHNOPOLE NIAYES",49,79,194,163,357
DAKAR,GUEDIAWAYE,"VILLE DE GUEDIAWAYE","GOLF SUD","CHAMPS DE COURSE B",155,394,1226,1293,2519
DAKAR,GUEDIAWAYE,"VILLE DE GUEDIAWAYE","GOLF SUD","CHAMPS DE COURSE D",138,404,1033,1088,2121
DAKAR,GUEDIAWAYE,"VILLE DE GUEDIAWAYE","GOLF SUD","CITE DALAL JAMM",86,167,350,449,799
DAKAR,GUEDIAWAYE,"VILLE DE GUEDIAWAYE","GOLF SUD","CITE LITTORAL",130,299,661,796,1457
DAKAR,GUEDIAWAYE,"VILLE DE GUEDIAWAYE","SAM NOTAIRE","CITE ADAMA DIOP",85,122,357,431,788
DAKAR,GUEDIAWAYE,"VILLE DE GUEDIAWAYE","SAM NOTAIRE","CITE BARRY ET LY",167,287,991,1003,1994
DAKAR,GUEDIAWAYE,"VILLE DE GUEDIAWAYE","SAM NOTAIRE","CITE HAMO TEFESS",55,83,264,318,582
DAKAR,GUEDIAWAYE,"VILLE DE GUEDIAWAYE","SAM NOTAIRE","CITE URBANISME",87,144,477,410,887
DAKAR,GUEDIAWAYE,"VILLE DE GUEDIAWAYE","SAM NOTAIRE","DAROU MINAM",207,373,1474,1453,2927
DAKAR,GUEDIAWAYE,"VILLE DE GUEDIAWAYE","SAM NOTAIRE","DAROU SALAM I",353,730,2586,2701,5287
DAKAR,GUEDIAWAYE,"VILLE DE GUEDIAWAYE","SAM NOTAIRE","DAROU SALAM II",225,518,1607,1637,3244
DAKAR,GUEDIAWAYE,"VILLE DE GUEDIAWAYE","SAM NOTAIRE",DIAMAGUENE,105,213,832,807,1639
DAKAR,GUEDIAWAYE,"VILLE DE GUEDIAWAYE","SAM NOTAIRE","GIBRALTAR I",361,717,2593,2715,5308
DAKAR,GUEDIAWAYE,"VILLE DE GUEDIAWAYE","SAM NOTAIRE","GIBRALTAR II",150,281,1010,1063,2073
DAKAR,GUEDIAWAYE,"VILLE DE GUEDIAWAYE","SAM NOTAIRE","GOLF NORD EST",145,331,1121,1051,2172
DAKAR,GUEDIAWAYE,"VILLE DE GUEDIAWAYE","SAM NOTAIRE","GOLF NORD I",203,471,1566,1689,3255
DAKAR,GUEDIAWAYE,"VILLE DE GUEDIAWAYE","SAM NOTAIRE","GOLF NORD I BIS",103,498,1021,950,1971
DAKAR,GUEDIAWAYE,"VILLE DE GUEDIAWAYE","SAM NOTAIRE","GOLF NORD II",161,344,1195,1117,2312
DAKAR,GUEDIAWAYE,"VILLE DE GUEDIAWAYE","SAM NOTAIRE","GOLF NORD II VDN",44,69,243,239,482
DAKAR,GUEDIAWAYE,"VILLE DE GUEDIAWAYE","SAM NOTAIRE","GUEULE TAPEE II",160,274,1168,1093,2261
DAKAR,GUEDIAWAYE,"VILLE DE GUEDIAWAYE","SAM NOTAIRE","HLM PARIS",189,341,1119,1209,2328
DAKAR,GUEDIAWAYE,"VILLE DE GUEDIAWAYE","SAM NOTAIRE","MBODE I",174,411,1466,1545,3011
DAKAR,GUEDIAWAYE,"VILLE DE GUEDIAWAYE","SAM NOTAIRE","MBODE II",216,410,1450,1567,3017
DAKAR,GUEDIAWAYE,"VILLE DE GUEDIAWAYE","SAM NOTAIRE","MBODE III",216,392,1625,1465,3090
DAKAR,GUEDIAWAYE,"VILLE DE GUEDIAWAYE","SAM NOTAIRE","MBODE IV",216,438,1766,1737,3503
DAKAR,GUEDIAWAYE,"VILLE DE GUEDIAWAYE","SAM NOTAIRE","MBODE V",202,448,1583,1533,3116
DAKAR,GUEDIAWAYE,"VILLE DE GUEDIAWAYE","SAM NOTAIRE","MBODE VI A",89,188,633,640,1273
DAKAR,GUEDIAWAYE,"VILLE DE GUEDIAWAYE","SAM NOTAIRE","MBODE VI A BIS",199,391,1370,1437,2807
DAKAR,GUEDIAWAYE,"VILLE DE GUEDIAWAYE","SAM NOTAIRE","MBODE VI B",286,554,2273,2220,4493
DAKAR,GUEDIAWAYE,"VILLE DE GUEDIAWAYE","SAM NOTAIRE","NOTAIRE EST",103,201,746,685,1431
DAKAR,GUEDIAWAYE,"VILLE DE GUEDIAWAYE","SAM NOTAIRE","NOTAIRE NORD",165,317,1056,1163,2219
DAKAR,GUEDIAWAYE,"VILLE DE GUEDIAWAYE","SAM NOTAIRE","NOTAIRE OUEST",154,269,1053,1083,2136
DAKAR,GUEDIAWAYE,"VILLE DE GUEDIAWAYE","SAM NOTAIRE","NOTAIRE SUD",139,254,916,1029,1945
DAKAR,GUEDIAWAYE,"VILLE DE GUEDIAWAYE","SAM NOTAIRE",PYROTECHNIQUE,116,318,943,974,1917
DAKAR,GUEDIAWAYE,"VILLE DE GUEDIAWAYE","SAM NOTAIRE","SAM GUEDIAWAYE",83,168,553,556,1109
DAKAR,GUEDIAWAYE,"VILLE DE GUEDIAWAYE","SAM NOTAIRE","GOLF NORD II B",118,247,903,918,1821
DAKAR,GUEDIAWAYE,"VILLE DE GUEDIAWAYE","SAM NOTAIRE","GOLF NORD TERANGA",90,224,743,749,1492
DAKAR,GUEDIAWAYE,"VILLE DE GUEDIAWAYE","SAM NOTAIRE","GUEULE TAPEE II A",193,356,1305,1371,2676
DAKAR,GUEDIAWAYE,"VILLE DE GUEDIAWAYE","MEDINA GOUNASS","BAGDAD I",132,208,1015,813,1828
DAKAR,GUEDIAWAYE,"VILLE DE GUEDIAWAYE","MEDINA GOUNASS","BAGDAD II",63,93,453,428,881
DAKAR,GUEDIAWAYE,"VILLE DE GUEDIAWAYE","MEDINA GOUNASS","CHAMPS DE COURSES",146,283,983,1033,2016
DAKAR,GUEDIAWAYE,"VILLE DE GUEDIAWAYE","MEDINA GOUNASS","DAROU RAHMANE IV A",116,237,941,909,1850
DAKAR,GUEDIAWAYE,"VILLE DE GUEDIAWAYE","MEDINA GOUNASS","DEMBA SOW (PARC)",272,533,1898,1855,3753
DAKAR,GUEDIAWAYE,"VILLE DE GUEDIAWAYE","MEDINA GOUNASS","LANSAR II C",105,253,1020,792,1812
DAKAR,GUEDIAWAYE,"VILLE DE GUEDIAWAYE","MEDINA GOUNASS","MEDINA GOUNASS AB BIS",74,148,513,483,996
DAKAR,GUEDIAWAYE,"VILLE DE GUEDIAWAYE","MEDINA GOUNASS","MEDINA GOUNASS I A",69,170,534,512,1046
DAKAR,GUEDIAWAYE,"VILLE DE GUEDIAWAYE","MEDINA GOUNASS","MEDINA GOUNASS I B V",56,131,412,353,765
DAKAR,GUEDIAWAYE,"VILLE DE GUEDIAWAYE","MEDINA GOUNASS","MEDINA GOUNASS I C",239,409,1692,1670,3362
DAKAR,GUEDIAWAYE,"VILLE DE GUEDIAWAYE","MEDINA GOUNASS","MEDINA GOUNASS II",109,220,788,705,1493
DAKAR,GUEDIAWAYE,"VILLE DE GUEDIAWAYE","MEDINA GOUNASS","MEDINA GOUNASS II B",96,173,852,706,1558
DAKAR,GUEDIAWAYE,"VILLE DE GUEDIAWAYE","MEDINA GOUNASS","MEDINA GOUNASS II BIS",192,310,1487,1366,2853
DAKAR,GUEDIAWAYE,"VILLE DE GUEDIAWAYE","MEDINA GOUNASS","MEDINA GOUNASS III",139,239,1047,968,2015
DAKAR,GUEDIAWAYE,"VILLE DE GUEDIAWAYE","MEDINA GOUNASS","MEDINA GOUNASS III B",112,188,743,630,1373
DAKAR,GUEDIAWAYE,"VILLE DE GUEDIAWAYE","MEDINA GOUNASS","MEDINA GOUNASS IV A",161,246,1016,1008,2024
DAKAR,GUEDIAWAYE,"VILLE DE GUEDIAWAYE","MEDINA GOUNASS","SANT YALLA II",96,159,654,626,1280
DAKAR,GUEDIAWAYE,"VILLE DE GUEDIAWAYE","MEDINA GOUNASS","SANT YALLA II BIS",84,129,517,452,969
DAKAR,GUEDIAWAYE,"VILLE DE GUEDIAWAYE","MEDINA GOUNASS","MEDINA GOUNASS II C",98,127,612,619,1231
DAKAR,GUEDIAWAYE,"VILLE DE GUEDIAWAYE","MEDINA GOUNASS","MEDINA GOUNASS II C BIS",104,262,975,879,1854
DAKAR,GUEDIAWAYE,"VILLE DE GUEDIAWAYE","MEDINA GOUNASS","MEDINA GOUNASS II I BIS",59,106,367,355,722
DAKAR,GUEDIAWAYE,"VILLE DE GUEDIAWAYE","MEDINA GOUNASS","MEDINA GOUNASS IV",64,126,507,400,907
DAKAR,GUEDIAWAYE,"VILLE DE GUEDIAWAYE","NDIAREME LIMAMOULAYE","ANGLE MOUSSE DAROU NAHIM",138,305,1048,1078,2126
DAKAR,GUEDIAWAYE,"VILLE DE GUEDIAWAYE","NDIAREME LIMAMOULAYE","ANGLE MOUSSE II",221,497,1581,1660,3241
DAKAR,GUEDIAWAYE,"VILLE DE GUEDIAWAYE","NDIAREME LIMAMOULAYE","ANGLE MOUSSE III",97,282,777,757,1534
DAKAR,GUEDIAWAYE,"VILLE DE GUEDIAWAYE","NDIAREME LIMAMOULAYE","HAMO IV",363,478,1562,1812,3374
DAKAR,GUEDIAWAYE,"VILLE DE GUEDIAWAYE","NDIAREME LIMAMOULAYE","HAMO V",207,286,932,1010,1942
DAKAR,GUEDIAWAYE,"VILLE DE GUEDIAWAYE","NDIAREME LIMAMOULAYE","HAMO VI",328,472,1464,1707,3171
DAKAR,GUEDIAWAYE,"VILLE DE GUEDIAWAYE","NDIAREME LIMAMOULAYE","NDIAREME I",52,112,436,380,816
DAKAR,GUEDIAWAYE,"VILLE DE GUEDIAWAYE","NDIAREME LIMAMOULAYE","NIMZAT II SANTE YALLA",131,270,920,920,1840
DAKAR,GUEDIAWAYE,"VILLE DE GUEDIAWAYE","NDIAREME LIMAMOULAYE","NIMZAT III",149,321,1181,1194,2375
DAKAR,GUEDIAWAYE,"VILLE DE GUEDIAWAYE","NDIAREME LIMAMOULAYE","NIMZAT NDIOLOFENE",289,521,1956,2031,3987
DAKAR,GUEDIAWAYE,"VILLE DE GUEDIAWAYE","NDIAREME LIMAMOULAYE","NIMZAT TAPITO",226,416,1616,1573,3189
DAKAR,GUEDIAWAYE,"VILLE DE GUEDIAWAYE","NDIAREME LIMAMOULAYE","NIMZAT V",66,125,526,511,1037
DAKAR,GUEDIAWAYE,"VILLE DE GUEDIAWAYE","NDIAREME LIMAMOULAYE",ADK,64,97,339,318,657
DAKAR,GUEDIAWAYE,"VILLE DE GUEDIAWAYE","NDIAREME LIMAMOULAYE","ANGLE MOUSSE I",82,182,675,655,1330
DAKAR,GUEDIAWAYE,"VILLE DE GUEDIAWAYE","NDIAREME LIMAMOULAYE","CITE BARACK",28,34,237,175,412
DAKAR,GUEDIAWAYE,"VILLE DE GUEDIAWAYE","NDIAREME LIMAMOULAYE",NDIAREME,35,78,297,302,599
DAKAR,GUEDIAWAYE,"VILLE DE GUEDIAWAYE","NDIAREME LIMAMOULAYE","NDIAREME II",98,168,730,776,1506
DAKAR,GUEDIAWAYE,"VILLE DE GUEDIAWAYE","NDIAREME LIMAMOULAYE","NIMZAT II",49,96,359,337,696
DAKAR,GUEDIAWAYE,"VILLE DE GUEDIAWAYE","NDIAREME LIMAMOULAYE","NIMZAT II SANTE YALLA II",75,137,510,530,1040
DAKAR,GUEDIAWAYE,"VILLE DE GUEDIAWAYE","NDIAREME LIMAMOULAYE","NIMZAT II YAKAAR",48,85,352,373,725
DAKAR,GUEDIAWAYE,"VILLE DE GUEDIAWAYE","NDIAREME LIMAMOULAYE","NIMZAT V BIS",28,52,224,203,427
DAKAR,GUEDIAWAYE,"VILLE DE GUEDIAWAYE","WAKHINANE NIMZATT",ALMINKO,85,208,697,664,1361
DAKAR,GUEDIAWAYE,"VILLE DE GUEDIAWAYE","WAKHINANE NIMZATT","ANGLE MOUSS II",273,525,1821,1852,3673
DAKAR,GUEDIAWAYE,"VILLE DE GUEDIAWAYE","WAKHINANE NIMZATT","BAYE LAYE",326,742,2558,2430,4988
DAKAR,GUEDIAWAYE,"VILLE DE GUEDIAWAYE","WAKHINANE NIMZATT","CITE AIR AFRIQUE",90,162,577,561,1138
DAKAR,GUEDIAWAYE,"VILLE DE GUEDIAWAYE","WAKHINANE NIMZATT","CITE BIAGUI",76,106,283,287,570
DAKAR,GUEDIAWAYE,"VILLE DE GUEDIAWAYE","WAKHINANE NIMZATT","CITE CAISSE DE SECURITE SOCIALE",56,72,198,221,419
DAKAR,GUEDIAWAYE,"VILLE DE GUEDIAWAYE","WAKHINANE NIMZATT","CITE COMICO II",220,423,1363,1400,2763
DAKAR,GUEDIAWAYE,"VILLE DE GUEDIAWAYE","WAKHINANE NIMZATT","CITE COUR SUPREME",52,111,312,345,657
DAKAR,GUEDIAWAYE,"VILLE DE GUEDIAWAYE","WAKHINANE NIMZATT","CITE DARE SALAM",72,136,396,494,890
DAKAR,GUEDIAWAYE,"VILLE DE GUEDIAWAYE","WAKHINANE NIMZATT","CITE GADAYE",255,360,1287,1342,2629
DAKAR,GUEDIAWAYE,"VILLE DE GUEDIAWAYE","WAKHINANE NIMZATT","CITE JUSTICE",52,61,234,288,522
DAKAR,GUEDIAWAYE,"VILLE DE GUEDIAWAYE","WAKHINANE NIMZATT","CITE MADIENG KHARY DIENG",42,64,313,263,576
DAKAR,GUEDIAWAYE,"VILLE DE GUEDIAWAYE","WAKHINANE NIMZATT","CITE MARCEL MAHE",13,15,66,84,150
DAKAR,GUEDIAWAYE,"VILLE DE GUEDIAWAYE","WAKHINANE NIMZATT","CITE MINISTERE COOPERATIVE ET PLAN",30,57,155,182,337
DAKAR,GUEDIAWAYE,"VILLE DE GUEDIAWAYE","WAKHINANE NIMZATT","CITE CHERIF MACKY SALL EX MUNUCIPALITE",207,346,1076,1064,2140
DAKAR,GUEDIAWAYE,"VILLE DE GUEDIAWAYE","WAKHINANE NIMZATT","CITE RONDON",28,55,192,191,383
DAKAR,GUEDIAWAYE,"VILLE DE GUEDIAWAYE","WAKHINANE NIMZATT","CITE SANTE",80,150,492,510,1002
DAKAR,GUEDIAWAYE,"VILLE DE GUEDIAWAYE","WAKHINANE NIMZATT","CITE SAR",91,249,752,728,1480
DAKAR,GUEDIAWAYE,"VILLE DE GUEDIAWAYE","WAKHINANE NIMZATT","CITE SONES",97,132,524,543,1067
DAKAR,GUEDIAWAYE,"VILLE DE GUEDIAWAYE","WAKHINANE NIMZATT","CITE SENELEC",78,154,521,556,1077
DAKAR,GUEDIAWAYE,"VILLE DE GUEDIAWAYE","WAKHINANE NIMZATT","CITE SENTENAC",115,150,494,551,1045
DAKAR,GUEDIAWAYE,"VILLE DE GUEDIAWAYE","WAKHINANE NIMZATT","CITE SOFRACO",95,117,339,397,736
DAKAR,GUEDIAWAYE,"VILLE DE GUEDIAWAYE","WAKHINANE NIMZATT","CITE SORES",86,239,794,738,1532
DAKAR,GUEDIAWAYE,"VILLE DE GUEDIAWAYE","WAKHINANE NIMZATT","CITE TRESOR",96,189,633,660,1293
DAKAR,GUEDIAWAYE,"VILLE DE GUEDIAWAYE","WAKHINANE NIMZATT","DAROU KHOUDOSS",134,281,1104,1029,2133
DAKAR,GUEDIAWAYE,"VILLE DE GUEDIAWAYE","WAKHINANE NIMZATT","DAROU RAHMANE II",174,323,1339,1186,2525
DAKAR,GUEDIAWAYE,"VILLE DE GUEDIAWAYE","WAKHINANE NIMZATT","DAROU RAHMANE IV",239,414,1753,1593,3346
DAKAR,GUEDIAWAYE,"VILLE DE GUEDIAWAYE","WAKHINANE NIMZATT","DAROU RAHMANE VI",39,44,228,233,461
DAKAR,GUEDIAWAYE,"VILLE DE GUEDIAWAYE","WAKHINANE NIMZATT","DAROU RAHMANE VII",96,144,610,648,1258
DAKAR,GUEDIAWAYE,"VILLE DE GUEDIAWAYE","WAKHINANE NIMZATT","DAROU RAHMANE VIII",88,131,680,607,1287
DAKAR,GUEDIAWAYE,"VILLE DE GUEDIAWAYE","WAKHINANE NIMZATT","DAROU SALAM",284,570,2048,1925,3973
DAKAR,GUEDIAWAYE,"VILLE DE GUEDIAWAYE","WAKHINANE NIMZATT","DAROUKHANE I",116,258,920,912,1832
DAKAR,GUEDIAWAYE,"VILLE DE GUEDIAWAYE","WAKHINANE NIMZATT","DAROUKHANE II",244,461,1728,1675,3403
DAKAR,GUEDIAWAYE,"VILLE DE GUEDIAWAYE","WAKHINANE NIMZATT",KAWSARA,226,468,1749,1680,3429
DAKAR,GUEDIAWAYE,"VILLE DE GUEDIAWAYE","WAKHINANE NIMZATT","KIP KM I",135,258,1043,1076,2119
DAKAR,GUEDIAWAYE,"VILLE DE GUEDIAWAYE","WAKHINANE NIMZATT","KIP KM II",130,277,973,955,1928
DAKAR,GUEDIAWAYE,"VILLE DE GUEDIAWAYE","WAKHINANE NIMZATT","KIP KOKO",169,393,1203,1319,2522
DAKAR,GUEDIAWAYE,"VILLE DE GUEDIAWAYE","WAKHINANE NIMZATT","CITE NDIOBENE VIVIANE",143,283,948,990,1938
DAKAR,GUEDIAWAYE,"VILLE DE GUEDIAWAYE","WAKHINANE NIMZATT","NIMZATT I",345,791,2949,2703,5652
DAKAR,GUEDIAWAYE,"VILLE DE GUEDIAWAYE","WAKHINANE NIMZATT","NIMZATT CARREFOUR",76,175,596,513,1109
DAKAR,GUEDIAWAYE,"VILLE DE GUEDIAWAYE","WAKHINANE NIMZATT","TIVAOUANE I",125,250,1066,1055,2121
DAKAR,GUEDIAWAYE,"VILLE DE GUEDIAWAYE","WAKHINANE NIMZATT","TOUBA GUEDIAWAYE",117,235,1003,1048,2051
DAKAR,GUEDIAWAYE,"VILLE DE GUEDIAWAYE","WAKHINANE NIMZATT",WAKHINANE,152,273,1016,1084,2100
DAKAR,GUEDIAWAYE,"VILLE DE GUEDIAWAYE","WAKHINANE NIMZATT","WAKHINANE IV",184,403,1578,1608,3186
DAKAR,GUEDIAWAYE,"VILLE DE GUEDIAWAYE","WAKHINANE NIMZATT","CITE VIVIANE WADE I",216,427,1803,1636,3439
DAKAR,GUEDIAWAYE,"VILLE DE GUEDIAWAYE","WAKHINANE NIMZATT","ANGLE MOUSSE CENTRAL",216,385,1586,1484,3070
DAKAR,GUEDIAWAYE,"VILLE DE GUEDIAWAYE","WAKHINANE NIMZATT","ANGLE MOUSSE KAWSARA",83,208,714,699,1413
DAKAR,GUEDIAWAYE,"VILLE DE GUEDIAWAYE","WAKHINANE NIMZATT","CITE ABDOU DIOUF",205,431,1530,1526,3056
DAKAR,GUEDIAWAYE,"VILLE DE GUEDIAWAYE","WAKHINANE NIMZATT","DAROU RAHMANE I",31,46,215,219,434
DAKAR,GUEDIAWAYE,"VILLE DE GUEDIAWAYE","WAKHINANE NIMZATT","DAROU RAHMANE I BIS",45,64,327,279,606
DAKAR,GUEDIAWAYE,"VILLE DE GUEDIAWAYE","WAKHINANE NIMZATT","GADAYE OCEAN",73,111,367,434,801
DAKAR,GUEDIAWAYE,"VILLE DE GUEDIAWAYE","WAKHINANE NIMZATT","KIP KOKO II",68,117,436,467,903
DAKAR,GUEDIAWAYE,"VILLE DE GUEDIAWAYE","WAKHINANE NIMZATT","MADIENG KHARY DIENG II",25,36,158,155,313
DAKAR,GUEDIAWAYE,"VILLE DE GUEDIAWAYE","WAKHINANE NIMZATT","WAKHINANE CENTRE",126,246,925,902,1827
DAKAR,GUEDIAWAYE,"VILLE DE GUEDIAWAYE","WAKHINANE NIMZATT","WAKHINANE EST",120,238,870,876,1746
DAKAR,GUEDIAWAYE,"VILLE DE GUEDIAWAYE","WAKHINANE NIMZATT","WAKHINANE I",166,343,1194,1218,2412
DAKAR,GUEDIAWAYE,"VILLE DE GUEDIAWAYE","WAKHINANE NIMZATT","WAKHINANE II",152,389,1392,1250,2642
DAKAR,GUEDIAWAYE,"VILLE DE GUEDIAWAYE","WAKHINANE NIMZATT","WAKHINANE IV C",98,197,819,877,1696
DAKAR,GUEDIAWAYE,"VILLE DE GUEDIAWAYE","WAKHINANE NIMZATT","WAKHINANE NIMZATT",17,39,164,138,302
DAKAR,"KEUR MASSAR",YEUMBEUL,"YEUMBEUL NORD","AFIA III A",299,632,2283,2099,4382
DAKAR,"KEUR MASSAR",YEUMBEUL,"YEUMBEUL NORD","AFIA III B",242,577,1827,1687,3514
DAKAR,"KEUR MASSAR",YEUMBEUL,"YEUMBEUL NORD","AFIA VI",282,605,2015,2049,4064
DAKAR,"KEUR MASSAR",YEUMBEUL,"YEUMBEUL NORD","AINOUMADY III",384,612,2613,2387,5000
DAKAR,"KEUR MASSAR",YEUMBEUL,"YEUMBEUL NORD","AINOUMADY IV",254,530,1775,1684,3459
DAKAR,"KEUR MASSAR",YEUMBEUL,"YEUMBEUL NORD","AINOUMADY I SOTRAC",200,405,1543,1463,3006
DAKAR,"KEUR MASSAR",YEUMBEUL,"YEUMBEUL NORD","ALPOULAR I A",127,220,946,868,1814
DAKAR,"KEUR MASSAR",YEUMBEUL,"YEUMBEUL NORD","ALPOULAR II",2,1,337,351,688
DAKAR,"KEUR MASSAR",YEUMBEUL,"YEUMBEUL NORD","BENE BARAQUE",162,315,1248,1296,2544
DAKAR,"KEUR MASSAR",YEUMBEUL,"YEUMBEUL NORD","BENE BARAQUE III",87,229,504,509,1013
DAKAR,"KEUR MASSAR",YEUMBEUL,"YEUMBEUL NORD","BENE BARAQUE IV",189,301,1280,1178,2458
DAKAR,"KEUR MASSAR",YEUMBEUL,"YEUMBEUL NORD","BENE BARAQUE V",119,210,893,826,1719
DAKAR,"KEUR MASSAR",YEUMBEUL,"YEUMBEUL NORD","BENE BARAQUE VI",249,378,1616,1587,3203
DAKAR,"KEUR MASSAR",YEUMBEUL,"YEUMBEUL NORD","CITE COMICO I",587,847,2682,2524,5206
DAKAR,"KEUR MASSAR",YEUMBEUL,"YEUMBEUL NORD","CITE COMICO II",410,555,1957,1842,3799
DAKAR,"KEUR MASSAR",YEUMBEUL,"YEUMBEUL NORD","CITE COMICO III",573,802,2513,2549,5062
DAKAR,"KEUR MASSAR",YEUMBEUL,"YEUMBEUL NORD","CITE COMICO IV",143,187,687,725,1412
DAKAR,"KEUR MASSAR",YEUMBEUL,"YEUMBEUL NORD","DAROU RAHMANE II",86,187,590,593,1183
DAKAR,"KEUR MASSAR",YEUMBEUL,"YEUMBEUL NORD","DAROU RAHMANE II B",245,482,1545,1464,3009
DAKAR,"KEUR MASSAR",YEUMBEUL,"YEUMBEUL NORD","DAROU RAHMANE III",96,152,677,680,1357
DAKAR,"KEUR MASSAR",YEUMBEUL,"YEUMBEUL NORD","DAROU SALAM",342,627,2421,2304,4725
DAKAR,"KEUR MASSAR",YEUMBEUL,"YEUMBEUL NORD","DAROU SALAM GAROU",164,268,1073,949,2022
DAKAR,"KEUR MASSAR",YEUMBEUL,"YEUMBEUL NORD","DAROU SALAM I",201,366,1468,1463,2931
DAKAR,"KEUR MASSAR",YEUMBEUL,"YEUMBEUL NORD","DAROU SALAM III",123,252,899,869,1768
DAKAR,"KEUR MASSAR",YEUMBEUL,"YEUMBEUL NORD","DAROU SALAM IV",70,110,494,379,873
DAKAR,"KEUR MASSAR",YEUMBEUL,"YEUMBEUL NORD","DAROU SALAM IV B",112,202,814,739,1553
DAKAR,"KEUR MASSAR",YEUMBEUL,"YEUMBEUL NORD","DAROU SALAM IV C",285,521,2045,1987,4032
DAKAR,"KEUR MASSAR",YEUMBEUL,"YEUMBEUL NORD","DAROU SALAM IX",286,556,2022,1998,4020
DAKAR,"KEUR MASSAR",YEUMBEUL,"YEUMBEUL NORD","DAROU SALAM TER",230,396,1481,1444,2925
DAKAR,"KEUR MASSAR",YEUMBEUL,"YEUMBEUL NORD","DAROU SALAM V",140,344,1052,1035,2087
DAKAR,"KEUR MASSAR",YEUMBEUL,"YEUMBEUL NORD","DAROU SALAM V A",133,294,1048,980,2028
DAKAR,"KEUR MASSAR",YEUMBEUL,"YEUMBEUL NORD","DAROU SALAM V A BIS",125,285,986,858,1844
DAKAR,"KEUR MASSAR",YEUMBEUL,"YEUMBEUL NORD","DAROU SALAM V B",121,246,856,875,1731
DAKAR,"KEUR MASSAR",YEUMBEUL,"YEUMBEUL NORD","DAROU SALAM V C",249,462,1801,1691,3492
DAKAR,"KEUR MASSAR",YEUMBEUL,"YEUMBEUL NORD","DAROU SALAM VI D",495,918,3430,3310,6740
DAKAR,"KEUR MASSAR",YEUMBEUL,"YEUMBEUL NORD","DAROU SALAM VI DIAMALAYE",317,552,2118,1994,4112
DAKAR,"KEUR MASSAR",YEUMBEUL,"YEUMBEUL NORD","DAROU SALAM VI E",496,805,3263,3158,6421
DAKAR,"KEUR MASSAR",YEUMBEUL,"YEUMBEUL NORD","DAROU SALAM VIII",522,895,3494,3262,6756
DAKAR,"KEUR MASSAR",YEUMBEUL,"YEUMBEUL NORD",DIAMALAYE,268,432,1578,1607,3185
DAKAR,"KEUR MASSAR",YEUMBEUL,"YEUMBEUL NORD","DJIDAH MARINE",66,100,352,339,691
DAKAR,"KEUR MASSAR",YEUMBEUL,"YEUMBEUL NORD","FASS I",143,297,1160,1121,2281
DAKAR,"KEUR MASSAR",YEUMBEUL,"YEUMBEUL NORD","FASS II",73,122,485,472,957
DAKAR,"KEUR MASSAR",YEUMBEUL,"YEUMBEUL NORD",HOUDALAYE,76,123,572,510,1082
DAKAR,"KEUR MASSAR",YEUMBEUL,"YEUMBEUL NORD",KHAIRA,295,666,2478,2291,4769
DAKAR,"KEUR MASSAR",YEUMBEUL,"YEUMBEUL NORD","LEONA YEUMBEUL",175,464,1456,1338,2794
DAKAR,"KEUR MASSAR",YEUMBEUL,"YEUMBEUL NORD","MEDINA ASECNA I",226,396,1690,1639,3329
DAKAR,"KEUR MASSAR",YEUMBEUL,"YEUMBEUL NORD",NDIOLOFENE,374,637,2623,2315,4938
DAKAR,"KEUR MASSAR",YEUMBEUL,"YEUMBEUL NORD",NEMA,114,213,1016,920,1936
DAKAR,"KEUR MASSAR",YEUMBEUL,"YEUMBEUL NORD","OUEST III B",55,91,405,402,807
DAKAR,"KEUR MASSAR",YEUMBEUL,"YEUMBEUL NORD","YEUMBEUL NDIAYENE",160,317,1166,1246,2412
DAKAR,"KEUR MASSAR",YEUMBEUL,"YEUMBEUL NORD","YEUMBEUL MALIKA SUD",290,469,2182,2110,4292
DAKAR,"KEUR MASSAR",YEUMBEUL,"YEUMBEUL NORD","YEUMBEUL NORD I",73,115,493,458,951
DAKAR,"KEUR MASSAR",YEUMBEUL,"YEUMBEUL NORD","YEUMBEUL NORD II B",93,152,638,586,1224
DAKAR,"KEUR MASSAR",YEUMBEUL,"YEUMBEUL NORD","YEUMBEUL NORD II C",254,440,1920,1720,3640
DAKAR,"KEUR MASSAR",YEUMBEUL,"YEUMBEUL NORD","AINOUMADY V",365,591,2067,1996,4063
DAKAR,"KEUR MASSAR",YEUMBEUL,"YEUMBEUL NORD","AINOUMADY II",304,538,2092,2103,4195
DAKAR,"KEUR MASSAR",YEUMBEUL,"YEUMBEUL NORD","AINOUMADY III 6",259,409,1659,1587,3246
DAKAR,"KEUR MASSAR",YEUMBEUL,"YEUMBEUL NORD","AINOUMADY VII",71,147,465,522,987
DAKAR,"KEUR MASSAR",YEUMBEUL,"YEUMBEUL NORD","AL WAR",21,29,144,147,291
DAKAR,"KEUR MASSAR",YEUMBEUL,"YEUMBEUL NORD","ASECNA B",235,509,1608,1623,3231
DAKAR,"KEUR MASSAR",YEUMBEUL,"YEUMBEUL NORD","ASECNA C",275,632,1932,2009,3941
DAKAR,"KEUR MASSAR",YEUMBEUL,"YEUMBEUL NORD","ASECNA D",153,349,999,1080,2079
DAKAR,"KEUR MASSAR",YEUMBEUL,"YEUMBEUL NORD","ASECNC A",310,645,2232,2291,4523
DAKAR,"KEUR MASSAR",YEUMBEUL,"YEUMBEUL NORD","BENE BARAQUE I B",184,335,1321,1177,2498
DAKAR,"KEUR MASSAR",YEUMBEUL,"YEUMBEUL NORD","BENE BARAQUE II A",127,225,956,830,1786
DAKAR,"KEUR MASSAR",YEUMBEUL,"YEUMBEUL NORD","CITE TAWFEKH",46,61,199,214,413
DAKAR,"KEUR MASSAR",YEUMBEUL,"YEUMBEUL NORD","COMICO IV EXTENSION",176,284,949,995,1944
DAKAR,"KEUR MASSAR",YEUMBEUL,"YEUMBEUL NORD","DAROU SALAM V D",80,151,593,562,1155
DAKAR,"KEUR MASSAR",YEUMBEUL,"YEUMBEUL NORD","DAROU SALAM V EXTENSION",106,180,743,676,1419
DAKAR,"KEUR MASSAR",YEUMBEUL,"YEUMBEUL NORD","GADAYE EXTENSION",150,230,773,871,1644
DAKAR,"KEUR MASSAR",YEUMBEUL,"YEUMBEUL NORD",GANDIOL,97,126,644,637,1281
DAKAR,"KEUR MASSAR",YEUMBEUL,"YEUMBEUL NORD",MEDINE,230,379,1608,1495,3103
DAKAR,"KEUR MASSAR",YEUMBEUL,"YEUMBEUL NORD","OUEST III A",61,100,499,390,889
DAKAR,"KEUR MASSAR",YEUMBEUL,"YEUMBEUL NORD","WAROUWAYE KAO",239,349,1270,1131,2401
DAKAR,"KEUR MASSAR",YEUMBEUL,"YEUMBEUL NORD","YEUMBEUL NORD II A",144,273,1024,1022,2046
DAKAR,"KEUR MASSAR",YEUMBEUL,"YEUMBEUL SUD","ABOU BASS",71,130,390,391,781
DAKAR,"KEUR MASSAR",YEUMBEUL,"YEUMBEUL SUD","AFFIA I",182,373,1373,1285,2658
DAKAR,"KEUR MASSAR",YEUMBEUL,"YEUMBEUL SUD","AFFIA II",251,515,1988,1773,3761
DAKAR,"KEUR MASSAR",YEUMBEUL,"YEUMBEUL SUD","AFFIA II B",188,478,1465,1393,2858
DAKAR,"KEUR MASSAR",YEUMBEUL,"YEUMBEUL SUD","AFFIA IV A",151,311,1142,1037,2179
DAKAR,"KEUR MASSAR",YEUMBEUL,"YEUMBEUL SUD","AFFIA IV B",127,324,1136,965,2101
DAKAR,"KEUR MASSAR",YEUMBEUL,"YEUMBEUL SUD","AFFIA NIMZATT",275,778,2299,2148,4447
DAKAR,"KEUR MASSAR",YEUMBEUL,"YEUMBEUL SUD",AKHLOULAYE,215,415,1723,1478,3201
DAKAR,"KEUR MASSAR",YEUMBEUL,"YEUMBEUL SUD","ALWAR I B",145,295,1175,1133,2308
DAKAR,"KEUR MASSAR",YEUMBEUL,"YEUMBEUL SUD","DAROU SALAM II",246,480,1910,1961,3871
DAKAR,"KEUR MASSAR",YEUMBEUL,"YEUMBEUL SUD",LAYENE,254,442,2007,2054,4061
DAKAR,"KEUR MASSAR",YEUMBEUL,"YEUMBEUL SUD","MBAWORE THIEURIGNE",50,138,505,438,943
DAKAR,"KEUR MASSAR",YEUMBEUL,"YEUMBEUL SUD","MEDINA SALAM",38,112,273,249,522
DAKAR,"KEUR MASSAR",YEUMBEUL,"YEUMBEUL SUD","MEDINA THIAROYE KAO I",256,454,1697,1719,3416
DAKAR,"KEUR MASSAR",YEUMBEUL,"YEUMBEUL SUD","MEDINA THIAROYE KAO II",296,536,2359,2246,4605
DAKAR,"KEUR MASSAR",YEUMBEUL,"YEUMBEUL SUD","MEDINA YEUMBEUL (NDAWENE)",200,361,1556,1661,3217
DAKAR,"KEUR MASSAR",YEUMBEUL,"YEUMBEUL SUD","MEDINA YEUMBEUL II",79,219,645,555,1200
DAKAR,"KEUR MASSAR",YEUMBEUL,"YEUMBEUL SUD","MEDINA YEUMBEUL II A",86,142,648,524,1172
DAKAR,"KEUR MASSAR",YEUMBEUL,"YEUMBEUL SUD","MEDINATOUL MOUNAWARA",366,804,2639,2423,5062
DAKAR,"KEUR MASSAR",YEUMBEUL,"YEUMBEUL SUD","NDIOBENE YEUMBEUL",52,144,647,581,1228
DAKAR,"KEUR MASSAR",YEUMBEUL,"YEUMBEUL SUD",SANTHIABA,110,181,705,746,1451
DAKAR,"KEUR MASSAR",YEUMBEUL,"YEUMBEUL SUD","SEYDOU NOUROU I",137,284,1096,965,2061
DAKAR,"KEUR MASSAR",YEUMBEUL,"YEUMBEUL SUD","SEYDOU NOUROU II",50,99,437,363,800
DAKAR,"KEUR MASSAR",YEUMBEUL,"YEUMBEUL SUD","THIAROYE KAO I (ALIOU DIA)",95,160,824,739,1563
DAKAR,"KEUR MASSAR",YEUMBEUL,"YEUMBEUL SUD","THIAROYE KAO II",159,330,1415,1413,2828
DAKAR,"KEUR MASSAR",YEUMBEUL,"YEUMBEUL SUD","THIAROYE KAO  III",118,195,855,833,1688
DAKAR,"KEUR MASSAR",YEUMBEUL,"YEUMBEUL SUD","THIAROYE KAO III A",108,232,959,899,1858
DAKAR,"KEUR MASSAR",YEUMBEUL,"YEUMBEUL SUD","THIAROYE KAO III D",299,653,2434,2286,4720
DAKAR,"KEUR MASSAR",YEUMBEUL,"YEUMBEUL SUD","THIAROYE KAO V (OUMAR FOUTIYOU)",270,525,2196,2095,4291
DAKAR,"KEUR MASSAR",YEUMBEUL,"YEUMBEUL SUD",THIEURIGNE,38,66,291,290,581
DAKAR,"KEUR MASSAR",YEUMBEUL,"YEUMBEUL SUD","TOUBA YEUMBEUL",238,485,1880,1807,3687
DAKAR,"KEUR MASSAR",YEUMBEUL,"YEUMBEUL SUD","YEUMBEUL NORD",24,58,315,317,632
DAKAR,"KEUR MASSAR",YEUMBEUL,"YEUMBEUL SUD","AFFIA II A",139,246,1070,1025,2095
DAKAR,"KEUR MASSAR",YEUMBEUL,"YEUMBEUL SUD","AFFIA V",105,273,917,885,1802
DAKAR,"KEUR MASSAR",YEUMBEUL,"YEUMBEUL SUD","CAYOR YEUMBEUL",125,232,973,1011,1984
DAKAR,"KEUR MASSAR",YEUMBEUL,"YEUMBEUL SUD","DJIDAH I (AFIA)",127,282,857,896,1753
DAKAR,"KEUR MASSAR",YEUMBEUL,"YEUMBEUL SUD","MEDINA THIAROYE KAO IV",255,512,2031,1884,3915
DAKAR,"KEUR MASSAR",YEUMBEUL,"YEUMBEUL SUD","MEDINA THIAROYE KAO V A",79,189,625,562,1187
DAKAR,"KEUR MASSAR",YEUMBEUL,"YEUMBEUL SUD","MEDINA THIAROYE KAO V B",67,139,568,486,1054
DAKAR,"KEUR MASSAR",YEUMBEUL,"YEUMBEUL SUD","MEDINA THIAROYE KAO III",166,352,1266,1207,2473
DAKAR,"KEUR MASSAR",YEUMBEUL,"YEUMBEUL SUD","THIAROYE KAO  III (ABABACAR SY)",43,58,297,324,621
DAKAR,"KEUR MASSAR",YEUMBEUL,"YEUMBEUL SUD","THIAROYE MINAME I",295,536,2462,2174,4636
DAKAR,"KEUR MASSAR",YEUMBEUL,"YEUMBEUL SUD","THIEURIGNE  II",216,418,1572,1536,3108
DAKAR,"KEUR MASSAR",YEUMBEUL,"YEUMBEUL SUD","TOUBA MINAME II",206,372,1432,1288,2720
DAKAR,"KEUR MASSAR",YEUMBEUL,"YEUMBEUL SUD","TOUBA THIAROYE",67,160,509,461,970
DAKAR,"KEUR MASSAR",MALIKA,"KEUR MASSAR NORD",ALHAMDOULILAHI,141,230,618,718,1336
DAKAR,"KEUR MASSAR",MALIKA,"KEUR MASSAR NORD","ARAFAT I",199,316,1227,1083,2310
DAKAR,"KEUR MASSAR",MALIKA,"KEUR MASSAR NORD","ARAFAT II",343,571,2055,2068,4123
DAKAR,"KEUR MASSAR",MALIKA,"KEUR MASSAR NORD","BOUNE III",151,310,1066,1063,2129
DAKAR,"KEUR MASSAR",MALIKA,"KEUR MASSAR NORD","BOUNE I",460,951,3220,3176,6396
DAKAR,"KEUR MASSAR",MALIKA,"KEUR MASSAR NORD","CASTOR SOTRAC OUEST",293,487,1742,1642,3384
DAKAR,"KEUR MASSAR",MALIKA,"KEUR MASSAR NORD","CITE GENDARMERIE II",227,251,893,806,1699
DAKAR,"KEUR MASSAR",MALIKA,"KEUR MASSAR NORD","CITE NIMRAN-CITE WARDINI",285,356,1268,1190,2458
DAKAR,"KEUR MASSAR",MALIKA,"KEUR MASSAR NORD","DAROU SALAM EXTENSION",462,641,2377,2430,4807
DAKAR,"KEUR MASSAR",MALIKA,"KEUR MASSAR NORD","DAARAY KAMIL",593,920,4177,3816,7993
DAKAR,"KEUR MASSAR",MALIKA,"KEUR MASSAR NORD","DAROU MISSETTE (KANEL)",71,144,380,362,742
DAKAR,"KEUR MASSAR",MALIKA,"KEUR MASSAR NORD","DAROU MISSETTE CENTRE I",129,240,890,823,1713
DAKAR,"KEUR MASSAR",MALIKA,"KEUR MASSAR NORD","DAROU MISSETTE CENTRE II",64,111,440,387,827
DAKAR,"KEUR MASSAR",MALIKA,"KEUR MASSAR NORD","DAROU MISSETTE EST I",140,270,860,851,1711
DAKAR,"KEUR MASSAR",MALIKA,"KEUR MASSAR NORD","DAROU MISSETTE EST II",133,229,810,680,1490
DAKAR,"KEUR MASSAR",MALIKA,"KEUR MASSAR NORD","DAROU MISSETTE EST III",177,314,1186,1141,2327
DAKAR,"KEUR MASSAR",MALIKA,"KEUR MASSAR NORD","DAROU MISSETTE NORD",171,251,1071,937,2008
DAKAR,"KEUR MASSAR",MALIKA,"KEUR MASSAR NORD","DAROU MISSETTE OUEST ALWAR",161,264,1039,1041,2080
DAKAR,"KEUR MASSAR",MALIKA,"KEUR MASSAR NORD","DAROU MISSETTE SUD",136,207,812,744,1556
DAKAR,"KEUR MASSAR",MALIKA,"KEUR MASSAR NORD","DAROU RAHMANE II",154,219,945,875,1820
DAKAR,"KEUR MASSAR",MALIKA,"KEUR MASSAR NORD","DAROU SALAM",45,69,278,318,596
DAKAR,"KEUR MASSAR",MALIKA,"KEUR MASSAR NORD","DAROU SALAM I BIS",347,565,2246,2219,4465
DAKAR,"KEUR MASSAR",MALIKA,"KEUR MASSAR NORD","DAROU SALAM II (BOUNE)",114,209,2337,1401,3738
DAKAR,"KEUR MASSAR",MALIKA,"KEUR MASSAR NORD","DIACKSAO I",211,352,1203,1266,2469
DAKAR,"KEUR MASSAR",MALIKA,"KEUR MASSAR NORD","DIACKSAO II (DEKH GOUMACK)",226,354,1314,1299,2613
DAKAR,"KEUR MASSAR",MALIKA,"KEUR MASSAR NORD",DINGUIRAYE,193,271,985,1009,1994
DAKAR,"KEUR MASSAR",MALIKA,"KEUR MASSAR NORD",FASS,316,489,1907,1986,3893
DAKAR,"KEUR MASSAR",MALIKA,"KEUR MASSAR NORD",HAMDALAYE,333,528,2326,2085,4411
DAKAR,"KEUR MASSAR",MALIKA,"KEUR MASSAR NORD",HOUSNA,126,213,808,840,1648
DAKAR,"KEUR MASSAR",MALIKA,"KEUR MASSAR NORD",JARDIN,110,166,651,678,1329
DAKAR,"KEUR MASSAR",MALIKA,"KEUR MASSAR NORD",KAWSARA,124,168,662,509,1171
DAKAR,"KEUR MASSAR",MALIKA,"KEUR MASSAR NORD","KEUR MASSAR CENTRE",76,129,522,573,1095
DAKAR,"KEUR MASSAR",MALIKA,"KEUR MASSAR NORD","KHAR YALLA",209,302,1140,1033,2173
DAKAR,"KEUR MASSAR",MALIKA,"KEUR MASSAR NORD","KHEUREUP KEUR",22,26,106,99,205
DAKAR,"KEUR MASSAR",MALIKA,"KEUR MASSAR NORD","MEDINA (GANA SARR)",328,488,1596,1691,3287
DAKAR,"KEUR MASSAR",MALIKA,"KEUR MASSAR NORD","MEDINATOUL MOUNAWARA",642,1307,4590,4453,9043
DAKAR,"KEUR MASSAR",MALIKA,"KEUR MASSAR NORD","MEDINATOUL RASSOUL",213,386,1481,1397,2878
DAKAR,"KEUR MASSAR",MALIKA,"KEUR MASSAR NORD","MEDINATOUL SALAM",342,497,2293,2021,4314
DAKAR,"KEUR MASSAR",MALIKA,"KEUR MASSAR NORD","MEDINATOUL SALAM I",231,350,1393,1361,2754
DAKAR,"KEUR MASSAR",MALIKA,"KEUR MASSAR NORD","MEDINATOUL SALAM II",170,235,1161,1121,2282
DAKAR,"KEUR MASSAR",MALIKA,"KEUR MASSAR NORD","MINAME KEUR MASSAR",93,149,652,530,1182
DAKAR,"KEUR MASSAR",MALIKA,"KEUR MASSAR NORD",MONTAGNE,74,136,496,459,955
DAKAR,"KEUR MASSAR",MALIKA,"KEUR MASSAR NORD","MONTAGNE I (DARADJI)",150,255,1024,954,1978
DAKAR,"KEUR MASSAR",MALIKA,"KEUR MASSAR NORD","MONTAGNE II",127,144,605,527,1132
DAKAR,"KEUR MASSAR",MALIKA,"KEUR MASSAR NORD",NDIAYENE,29,66,297,313,610
DAKAR,"KEUR MASSAR",MALIKA,"KEUR MASSAR NORD","NIAYES NDIORANE",437,677,2220,2101,4321
DAKAR,"KEUR MASSAR",MALIKA,"KEUR MASSAR NORD","NIMZAT SANT YALLA",248,325,994,998,1992
DAKAR,"KEUR MASSAR",MALIKA,"KEUR MASSAR NORD","OUMAR DIALLO",112,200,574,671,1245
DAKAR,"KEUR MASSAR",MALIKA,"KEUR MASSAR NORD","PARCELLES ASSAINIES UNITE 1",94,208,528,678,1206
DAKAR,"KEUR MASSAR",MALIKA,"KEUR MASSAR NORD","PARCELLES ASSAINIES UNITE 9",296,480,1514,1615,3129
DAKAR,"KEUR MASSAR",MALIKA,"KEUR MASSAR NORD","PARCELLES ASSAINIES UNITE 10",246,378,1193,1215,2408
DAKAR,"KEUR MASSAR",MALIKA,"KEUR MASSAR NORD","PARCELLES ASSAINIES UNITE 11",492,922,3107,3038,6145
DAKAR,"KEUR MASSAR",MALIKA,"KEUR MASSAR NORD","PARCELLES ASSAINIES UNITE 12",312,639,1990,1945,3935
DAKAR,"KEUR MASSAR",MALIKA,"KEUR MASSAR NORD","PARCELLES ASSAINIES UNITE 13",258,523,1549,1728,3277
DAKAR,"KEUR MASSAR",MALIKA,"KEUR MASSAR NORD","PARCELLES ASSAINIES UNITE 14",329,600,1938,1941,3879
DAKAR,"KEUR MASSAR",MALIKA,"KEUR MASSAR NORD","PARCELLES ASSAINIES UNITE 15",394,778,2551,2376,4927
DAKAR,"KEUR MASSAR",MALIKA,"KEUR MASSAR NORD","PARCELLES ASSAINIES UNITE 16",326,578,1826,1822,3648
DAKAR,"KEUR MASSAR",MALIKA,"KEUR MASSAR NORD","PARCELLES ASSAINIES UNITE 17",115,267,859,886,1745
DAKAR,"KEUR MASSAR",MALIKA,"KEUR MASSAR NORD",PEULGHA,76,132,523,531,1054
DAKAR,"KEUR MASSAR",MALIKA,"KEUR MASSAR NORD","SAM SAM I (ZONE RECASEMENT I)",261,413,1554,1630,3184
DAKAR,"KEUR MASSAR",MALIKA,"KEUR MASSAR NORD","SAM SAM III (ZONE RECASEMENT III)",217,323,1364,1321,2685
DAKAR,"KEUR MASSAR",MALIKA,"KEUR MASSAR NORD","SANT YALLA BOUNE",394,607,2580,2493,5073
DAKAR,"KEUR MASSAR",MALIKA,"KEUR MASSAR NORD","SANT YALLA I",184,286,1081,984,2065
DAKAR,"KEUR MASSAR",MALIKA,"KEUR MASSAR NORD",SANTHIABA,77,158,599,567,1166
DAKAR,"KEUR MASSAR",MALIKA,"KEUR MASSAR NORD","TAIBA KEUR MASSAR",151,233,794,898,1692
DAKAR,"KEUR MASSAR",MALIKA,"KEUR MASSAR NORD",TAWFEX,220,365,1694,1580,3274
DAKAR,"KEUR MASSAR",MALIKA,"KEUR MASSAR NORD","ZONE RECASEMENT II (SAM SAM II)",235,363,1204,1384,2588
DAKAR,"KEUR MASSAR",MALIKA,"KEUR MASSAR NORD","CITE HOPITAL TRADITIONNEL",196,254,755,865,1620
DAKAR,"KEUR MASSAR",MALIKA,"KEUR MASSAR NORD","CITE MARINE KEUR MASSAR",50,53,186,168,354
DAKAR,"KEUR MASSAR",MALIKA,"KEUR MASSAR NORD","DAROU SALAM II ZONE MBEUBEUSS",229,320,1225,1067,2292
DAKAR,"KEUR MASSAR",MALIKA,"KEUR MASSAR NORD",FIRDAWSI,259,356,1099,1172,2271
DAKAR,"KEUR MASSAR",MALIKA,"KEUR MASSAR NORD","PARCELLES ASSAINIES UNITE 2",207,438,1374,1277,2651
DAKAR,"KEUR MASSAR",MALIKA,"KEUR MASSAR NORD","PARCELLES ASSAINIES UNITE 3",149,317,937,923,1860
DAKAR,"KEUR MASSAR",MALIKA,"KEUR MASSAR NORD","PARCELLES ASSAINIES UNITE 4",361,757,1968,2050,4018
DAKAR,"KEUR MASSAR",MALIKA,"KEUR MASSAR NORD","PARCELLES ASSAINIES UNITE 5",480,880,2687,2813,5500
DAKAR,"KEUR MASSAR",MALIKA,"KEUR MASSAR NORD","PARCELLES ASSAINIES UNITE 6",351,683,1957,1935,3892
DAKAR,"KEUR MASSAR",MALIKA,"KEUR MASSAR NORD","PARCELLES ASSAINIES UNITE 18",89,205,636,643,1279
DAKAR,"KEUR MASSAR",MALIKA,"KEUR MASSAR NORD","TAWFEKH TYR",134,149,615,555,1170
DAKAR,"KEUR MASSAR",MALIKA,"KEUR MASSAR NORD","ALMADIE KEUR MASSAR",125,153,497,536,1033
DAKAR,"KEUR MASSAR",MALIKA,"KEUR MASSAR NORD","CITE ENDA",35,37,101,131,232
DAKAR,"KEUR MASSAR",MALIKA,"KEUR MASSAR NORD","CITE UNIE",128,153,298,347,645
DAKAR,"KEUR MASSAR",MALIKA,"KEUR MASSAR NORD","DAROU HABIBI",88,107,306,364,670
DAKAR,"KEUR MASSAR",MALIKA,"KEUR MASSAR NORD","DAROU SALAM II",265,458,1025,961,1986
DAKAR,"KEUR MASSAR",MALIKA,"KEUR MASSAR NORD","FIRDAWSI EXTENSION",84,94,302,306,608
DAKAR,"KEUR MASSAR",MALIKA,"KEUR MASSAR NORD",HAFIA,105,122,476,384,860
DAKAR,"KEUR MASSAR",MALIKA,"KEUR MASSAR NORD","KEUR MASSAR/SOUFOU MONTAGNE",190,366,1183,1147,2330
DAKAR,"KEUR MASSAR",MALIKA,"KEUR MASSAR NORD","MEDINA FASS",146,182,557,531,1088
DAKAR,"KEUR MASSAR",MALIKA,"KEUR MASSAR NORD","NGUEDIAGA 2 MALIKA  MONTAGNE",219,360,1400,1308,2708
DAKAR,"KEUR MASSAR",MALIKA,"KEUR MASSAR NORD","NGUEDIAGA I",167,213,959,1023,1982
DAKAR,"KEUR MASSAR",MALIKA,"KEUR MASSAR NORD","NGUEDIEGA  A I MONTAGNE",150,202,820,857,1677
DAKAR,"KEUR MASSAR",MALIKA,"KEUR MASSAR NORD","SERIGNE MANSOUR SY",123,128,440,485,925
DAKAR,"KEUR MASSAR",MALIKA,"KEUR MASSAR NORD","TAÎBA 2 KEUR MASSAR",125,186,750,602,1352
DAKAR,"KEUR MASSAR",MALIKA,MALIKA,"CITE SONATEL",355,853,2052,2058,4110
DAKAR,"KEUR MASSAR",MALIKA,MALIKA,"DIAMAGUENE I",256,414,1403,1455,2858
DAKAR,"KEUR MASSAR",MALIKA,MALIKA,"DIAMAGUENE II",125,216,955,750,1705
DAKAR,"KEUR MASSAR",MALIKA,MALIKA,"DIAMAGUENE III",113,184,788,746,1534
DAKAR,"KEUR MASSAR",MALIKA,MALIKA,"DIAMALAYE MALIKA",954,1592,5222,4737,9959
DAKAR,"KEUR MASSAR",MALIKA,MALIKA,KAWSARA,266,451,1630,1632,3262
DAKAR,"KEUR MASSAR",MALIKA,MALIKA,"MALIKA NORD",117,171,707,716,1423
DAKAR,"KEUR MASSAR",MALIKA,MALIKA,"MALIKA SUR MER",451,783,2408,2678,5086
DAKAR,"KEUR MASSAR",MALIKA,MALIKA,"MEDINA PEULH I",86,170,727,835,1562
DAKAR,"KEUR MASSAR",MALIKA,MALIKA,"MEDINA PEULH II",106,190,684,704,1388
DAKAR,"KEUR MASSAR",MALIKA,MALIKA,ANSAR,84,129,660,669,1329
DAKAR,"KEUR MASSAR",MALIKA,MALIKA,"DAROU SALAM MALIKA",216,360,1226,1316,2542
DAKAR,"KEUR MASSAR",MALIKA,MALIKA,"GRAND MALIKA",130,253,1042,1039,2081
DAKAR,"KEUR MASSAR",MALIKA,MALIKA,"MALIKA EXTENSION NORD",354,598,1870,1982,3852
DAKAR,"KEUR MASSAR",MALIKA,MALIKA,"MAME LAMINE GADIAGA",148,230,885,936,1821
DAKAR,"KEUR MASSAR",MALIKA,MALIKA,"MEDINATOUL MOUNAWARA",132,195,609,671,1280
DAKAR,"KEUR MASSAR",MALIKA,MALIKA,"MEDINATOUL SALAM",329,805,1671,1845,3516
DAKAR,"KEUR MASSAR",MALIKA,MALIKA,"SAM 1",56,87,500,400,900
DAKAR,"KEUR MASSAR",MALIKA,MALIKA,"SAM 2",102,182,839,909,1748
DAKAR,"KEUR MASSAR",MALIKA,MALIKA,"SANTHIABA NDIAGO",71,140,493,477,970
DAKAR,"KEUR MASSAR",MALIKA,MALIKA,"TODD BA",334,469,1934,1847,3781
DAKAR,"KEUR MASSAR",JAXAAY,"JAXAAY PARCELLES","CITE GENDARMERIE",910,1401,3623,3695,7318
DAKAR,"KEUR MASSAR",JAXAAY,"JAXAAY PARCELLES","PARCELLES ASSAINIES UNITE 9",310,443,1195,1305,2500
DAKAR,"KEUR MASSAR",JAXAAY,"JAXAAY PARCELLES","PARCELLES ASSAINIES UNITE 10",303,456,1286,1446,2732
DAKAR,"KEUR MASSAR",JAXAAY,"JAXAAY PARCELLES","JAXAAY PARCELLES UNITE 11 A",202,252,1091,1030,2121
DAKAR,"KEUR MASSAR",JAXAAY,"JAXAAY PARCELLES","PARCELLES ASSAINIES UNITE 11 B",296,422,1687,1639,3326
DAKAR,"KEUR MASSAR",JAXAAY,"JAXAAY PARCELLES","PARCELLES ASSAINIES UNITE 12 A",85,131,448,495,943
DAKAR,"KEUR MASSAR",JAXAAY,"JAXAAY PARCELLES","JAXAAY PARCELLES UNITE 12 B",355,436,2025,2021,4046
DAKAR,"KEUR MASSAR",JAXAAY,"JAXAAY PARCELLES","PARCELLES ASSAINIES UNITE 13",256,436,1304,1292,2596
DAKAR,"KEUR MASSAR",JAXAAY,"JAXAAY PARCELLES","PARCELLES ASSAINIES UNITE 14",271,539,1314,1344,2658
DAKAR,"KEUR MASSAR",JAXAAY,"JAXAAY PARCELLES","PARCELLES ASSAINIES UNITE 19",628,728,2875,2770,5645
DAKAR,"KEUR MASSAR",JAXAAY,"JAXAAY PARCELLES","PARCELLES ASSAINIES UNITE 15",250,371,1079,1120,2199
DAKAR,"KEUR MASSAR",JAXAAY,"JAXAAY PARCELLES","PARCELLES ASSAINIES UNITE 16",233,342,1116,1052,2168
DAKAR,"KEUR MASSAR",JAXAAY,"JAXAAY PARCELLES","PARCELLES ASSAINIES UNITE 17 A",562,732,3134,3107,6241
DAKAR,"KEUR MASSAR",JAXAAY,"JAXAAY PARCELLES","PARCELLES ASSAINIES UNITE 17 B",154,212,778,824,1602
DAKAR,"KEUR MASSAR",JAXAAY,"JAXAAY PARCELLES","PARCELLES ASSAINIES UNITE 18",162,216,698,685,1383
DAKAR,"KEUR MASSAR",JAXAAY,"JAXAAY PARCELLES","PARCELLES ASSAINIES UNITE 20",341,421,1715,1646,3361
DAKAR,"KEUR MASSAR",JAXAAY,"JAXAAY PARCELLES","PARCELLES ASSAINIES UNITE 21",617,833,2966,3076,6042
DAKAR,"KEUR MASSAR",JAXAAY,"JAXAAY PARCELLES","PARCELLES ASSAINIES UNITE 22",231,313,981,999,1980
DAKAR,"KEUR MASSAR",JAXAAY,"JAXAAY PARCELLES","PARCELLES ASSAINIES UNITE 23",259,378,1254,1189,2443
DAKAR,"KEUR MASSAR",JAXAAY,"JAXAAY PARCELLES","PARCELLES ASSAINIES UNITE 24",196,557,900,986,1886
DAKAR,"KEUR MASSAR",JAXAAY,"JAXAAY PARCELLES","PARCELLES ASSAINIES UNITE 25",61,104,321,354,675
DAKAR,"KEUR MASSAR",JAXAAY,"JAXAAY PARCELLES","PARCELLES ASSAINIES UNITE 27",129,199,651,676,1327
DAKAR,"KEUR MASSAR",JAXAAY,"JAXAAY PARCELLES","CITE TERANGA",278,454,1085,1250,2335
DAKAR,"KEUR MASSAR",JAXAAY,"JAXAAY PARCELLES","CITE DUBAI",209,439,1028,972,2000
DAKAR,"KEUR MASSAR",JAXAAY,"JAXAAY PARCELLES","PARCELLES ASSAINIES UNITE 11 A",146,252,732,777,1509
DAKAR,"KEUR MASSAR",JAXAAY,"KEUR MASSAR SUD","ABDOU AZIZ SY DABAKH",327,532,1858,1862,3720
DAKAR,"KEUR MASSAR",JAXAAY,"KEUR MASSAR SUD","AINOUMADY I",115,125,317,261,578
DAKAR,"KEUR MASSAR",JAXAAY,"KEUR MASSAR SUD","AINOUMADY II",252,433,1253,1354,2607
DAKAR,"KEUR MASSAR",JAXAAY,"KEUR MASSAR SUD","AINOUMADY II CITE POLICE",91,139,384,449,833
DAKAR,"KEUR MASSAR",JAXAAY,"KEUR MASSAR SUD","AINOUMADY II CITE SENELEC",116,202,584,538,1122
DAKAR,"KEUR MASSAR",JAXAAY,"KEUR MASSAR SUD","AINOUMADY II CITE SONACOS",181,323,869,874,1743
DAKAR,"KEUR MASSAR",JAXAAY,"KEUR MASSAR SUD","AINOUMADY III",316,600,1723,1702,3425
DAKAR,"KEUR MASSAR",JAXAAY,"KEUR MASSAR SUD","BAYE GANA AW",127,197,652,638,1290
DAKAR,"KEUR MASSAR",JAXAAY,"KEUR MASSAR SUD","BAYE NIASS",170,257,824,794,1618
DAKAR,"KEUR MASSAR",JAXAAY,"KEUR MASSAR SUD","CASTOR SOTRAC EST",179,280,914,974,1888
DAKAR,"KEUR MASSAR",JAXAAY,"KEUR MASSAR SUD","CITE CAMILLE BASSE",282,386,1041,1164,2205
DAKAR,"KEUR MASSAR",JAXAAY,"KEUR MASSAR SUD","CITE MAME DIOR",220,318,874,933,1807
DAKAR,"KEUR MASSAR",JAXAAY,"KEUR MASSAR SUD","CITE MUNICIPALE",374,773,2154,2156,4310
DAKAR,"KEUR MASSAR",JAXAAY,"KEUR MASSAR SUD","CONACHAP CITE PENITENCIERE",244,418,909,887,1796
DAKAR,"KEUR MASSAR",JAXAAY,"KEUR MASSAR SUD","DAROU RAHMANE I",156,253,1045,928,1973
DAKAR,"KEUR MASSAR",JAXAAY,"KEUR MASSAR SUD","DAROU SALAM I",256,412,1265,1361,2626
DAKAR,"KEUR MASSAR",JAXAAY,"KEUR MASSAR SUD","DAROU SALAM II",187,275,1141,998,2139
DAKAR,"KEUR MASSAR",JAXAAY,"KEUR MASSAR SUD",DIAMALAYE,167,245,899,941,1840
DAKAR,"KEUR MASSAR",JAXAAY,"KEUR MASSAR SUD",DIAMWELLI,159,215,798,852,1650
DAKAR,"KEUR MASSAR",JAXAAY,"KEUR MASSAR SUD","DIOKOUL KEUR EL HADJI",290,528,1698,1637,3335
DAKAR,"KEUR MASSAR",JAXAAY,"KEUR MASSAR SUD","GRAND MEDINE",96,147,608,677,1285
DAKAR,"KEUR MASSAR",JAXAAY,"KEUR MASSAR SUD","HAMDALLAHI III",122,154,611,589,1200
DAKAR,"KEUR MASSAR",JAXAAY,"KEUR MASSAR SUD","KANGUE II CITE LA LINGUERE",246,350,966,1032,1998
DAKAR,"KEUR MASSAR",JAXAAY,"KEUR MASSAR SUD","KEUR BAKA",380,693,1832,1906,3738
DAKAR,"KEUR MASSAR",JAXAAY,"KEUR MASSAR SUD","KEUR EL HADJI PATHE",283,372,1458,1394,2852
DAKAR,"KEUR MASSAR",JAXAAY,"KEUR MASSAR SUD","MADIABEL DIOP",111,188,656,636,1292
DAKAR,"KEUR MASSAR",JAXAAY,"KEUR MASSAR SUD","MAMADOU FAYE",185,275,1014,896,1910
DAKAR,"KEUR MASSAR",JAXAAY,"KEUR MASSAR SUD","MEDINA KELLE",234,474,1647,1557,3204
DAKAR,"KEUR MASSAR",JAXAAY,"KEUR MASSAR SUD","MEDINA KEUR MASSAR",109,154,591,554,1145
DAKAR,"KEUR MASSAR",JAXAAY,"KEUR MASSAR SUD","MINAM GABANE",106,139,623,610,1233
DAKAR,"KEUR MASSAR",JAXAAY,"KEUR MASSAR SUD",MISSIRAH,179,261,929,936,1865
DAKAR,"KEUR MASSAR",JAXAAY,"KEUR MASSAR SUD","PARCELLES ASSAINIES UNITE 2",192,351,1004,963,1967
DAKAR,"KEUR MASSAR",JAXAAY,"KEUR MASSAR SUD","PARCELLES ASSAINIES UNITE 3",245,773,1278,1401,2679
DAKAR,"KEUR MASSAR",JAXAAY,"KEUR MASSAR SUD","PARCELLES ASSAINIES UNITE 4",382,739,1784,1803,3587
DAKAR,"KEUR MASSAR",JAXAAY,"KEUR MASSAR SUD","PARCELLES ASSAINIES UNITE 5",258,405,1219,1278,2497
DAKAR,"KEUR MASSAR",JAXAAY,"KEUR MASSAR SUD","PARCELLES ASSAINIES UNITE 6",135,232,680,703,1383
DAKAR,"KEUR MASSAR",JAXAAY,"KEUR MASSAR SUD","SANT YALLA II",289,530,1772,1689,3461
DAKAR,"KEUR MASSAR",JAXAAY,"KEUR MASSAR SUD","TOUBA NIANI",154,209,761,735,1496
DAKAR,"KEUR MASSAR",JAXAAY,"KEUR MASSAR SUD","UCAD I ET UCAD II",186,238,760,875,1635
DAKAR,"KEUR MASSAR",JAXAAY,"KEUR MASSAR SUD","UCAD IV",666,968,3081,3000,6081
DAKAR,"KEUR MASSAR",JAXAAY,"KEUR MASSAR SUD","AINOUMADY EXTENSION",49,77,216,268,484
DAKAR,"KEUR MASSAR",JAXAAY,"KEUR MASSAR SUD","AINOUMADY V",131,201,608,663,1271
DAKAR,"KEUR MASSAR",JAXAAY,"KEUR MASSAR SUD","CITE AL AZHAR",142,240,752,676,1428
DAKAR,"KEUR MASSAR",JAXAAY,"KEUR MASSAR SUD","DAROU SALAM SOTRAC",135,397,675,683,1358
DAKAR,"KEUR MASSAR",JAXAAY,"KEUR MASSAR SUD","MEDINA KELLE II",147,250,817,866,1683
DAKAR,"KEUR MASSAR",JAXAAY,"KEUR MASSAR SUD","PARCELLES ASSAINIES UNITE 1",125,236,703,711,1414
DAKAR,"KEUR MASSAR",JAXAAY,"KEUR MASSAR SUD","PARCELLES ASSAINIES UNITE 26",57,83,271,291,562
DAKAR,"KEUR MASSAR",JAXAAY,"KEUR MASSAR SUD","TAWFEKH 2",135,202,676,700,1376
DAKAR,"KEUR MASSAR",JAXAAY,"KEUR MASSAR SUD","YA SALAM CASTOR SOTRAC",230,421,1329,1436,2765
DAKAR,"KEUR MASSAR",JAXAAY,"KEUR MASSAR SUD","AINOUMADY IV",142,193,591,675,1266
DAKAR,"KEUR MASSAR",JAXAAY,"KEUR MASSAR SUD","GANDEL CISSE",117,276,916,703,1619
DAKAR,"KEUR MASSAR",JAXAAY,"KEUR MASSAR SUD","MEDINA SALAM",93,235,547,576,1123
ZIGUINCHOR,BIGNONA,BIGNONA,BIGNONA,BASSENE,575,829,3169,3034,6203
ZIGUINCHOR,BIGNONA,BIGNONA,BIGNONA,"CHATEAU D'EAU",389,658,2266,2166,4432
ZIGUINCHOR,BIGNONA,BIGNONA,BIGNONA,KADIAMOR,569,663,2315,2260,4575
ZIGUINCHOR,BIGNONA,BIGNONA,BIGNONA,MANGUILINE,334,453,1529,1618,3147
ZIGUINCHOR,BIGNONA,BIGNONA,BIGNONA,"MEDINA PLATEAU",980,1493,5301,4984,10285
ZIGUINCHOR,BIGNONA,"THIONCK ESSYL","THIONCK ESSYL",BATINE,184,280,1031,1019,2050
ZIGUINCHOR,BIGNONA,"THIONCK ESSYL","THIONCK ESSYL",DAGA,301,406,1337,1315,2652
ZIGUINCHOR,BIGNONA,"THIONCK ESSYL","THIONCK ESSYL",KAMANAR,189,247,822,831,1653
ZIGUINCHOR,BIGNONA,"THIONCK ESSYL","THIONCK ESSYL",NIAGANANE,260,382,1363,1243,2606
ZIGUINCHOR,BIGNONA,SINDIAN,DJIBIDIONE,"BADIONCOTO COMBOLI",2,3,20,18,38
ZIGUINCHOR,BIGNONA,SINDIAN,DJIBIDIONE,BAIPEUNG,26,29,179,108,287
ZIGUINCHOR,BIGNONA,SINDIAN,DJIBIDIONE,BALIGNANE,14,23,94,99,193
ZIGUINCHOR,BIGNONA,SINDIAN,DJIBIDIONE,"H1 BANTANARE",9,10,39,33,72
ZIGUINCHOR,BIGNONA,SINDIAN,DJIBIDIONE,"H3 KASSIRANA",1,2,4,5,9
ZIGUINCHOR,BIGNONA,SINDIAN,DJIBIDIONE,"BALLA BASSENE",21,31,143,125,268
ZIGUINCHOR,BIGNONA,SINDIAN,DJIBIDIONE,"BALLA DJIFALONE",9,12,51,49,100
ZIGUINCHOR,BIGNONA,SINDIAN,DJIBIDIONE,"BALLA DJIRING",27,27,154,121,275
ZIGUINCHOR,BIGNONA,SINDIAN,DJIBIDIONE,"BALLA OUGOUNOR",21,26,183,159,342
ZIGUINCHOR,BIGNONA,SINDIAN,DJIBIDIONE,BASSENE,9,10,33,24,57
ZIGUINCHOR,BIGNONA,SINDIAN,DJIBIDIONE,"BATINDING BOUDIAKENE",2,4,18,11,29
ZIGUINCHOR,BIGNONA,SINDIAN,DJIBIDIONE,"BATINDING DIEME",19,25,153,140,293
ZIGUINCHOR,BIGNONA,SINDIAN,DJIBIDIONE,BOULAYOTTE,14,16,124,91,215
ZIGUINCHOR,BIGNONA,SINDIAN,DJIBIDIONE,"H1 GOLEME",2,3,46,9,55
ZIGUINCHOR,BIGNONA,SINDIAN,DJIBIDIONE,BOULELAYE,11,14,49,41,90
ZIGUINCHOR,BIGNONA,SINDIAN,DJIBIDIONE,BOULINGHOYE,27,32,137,104,241
ZIGUINCHOR,BIGNONA,SINDIAN,DJIBIDIONE,BOULIWAYE,6,6,29,21,50
ZIGUINCHOR,BIGNONA,SINDIAN,DJIBIDIONE,BRINDIAGO,43,67,328,299,627
ZIGUINCHOR,BIGNONA,SINDIAN,DJIBIDIONE,"H1 DJIWAYE",11,16,62,53,115
ZIGUINCHOR,BIGNONA,SINDIAN,DJIBIDIONE,"DIABOUDIOR FRONTIERE",20,26,150,114,264
ZIGUINCHOR,BIGNONA,SINDIAN,DJIBIDIONE,"DIABOUDIOR TANGAL",3,4,10,9,19
ZIGUINCHOR,BIGNONA,SINDIAN,DJIBIDIONE,"DIACOYE COMBOLI",21,24,94,88,182
ZIGUINCHOR,BIGNONA,SINDIAN,DJIBIDIONE,DIOCADOU,28,31,211,99,310
ZIGUINCHOR,BIGNONA,SINDIAN,DJIBIDIONE,DJIBIAME,24,28,124,119,243
ZIGUINCHOR,BIGNONA,SINDIAN,DJIBIDIONE,"H1 SABOUDJI",8,8,42,30,72
ZIGUINCHOR,BIGNONA,SINDIAN,DJIBIDIONE,"H2 KAKARE",6,7,24,23,47
ZIGUINCHOR,BIGNONA,SINDIAN,DJIBIDIONE,DJIBIDIONE,48,64,288,189,477
ZIGUINCHOR,BIGNONA,SINDIAN,DJIBIDIONE,"H1 BARANDALATTE",4,4,23,17,40
ZIGUINCHOR,BIGNONA,SINDIAN,DJIBIDIONE,DJIDJIRONE,25,34,136,119,255
ZIGUINCHOR,BIGNONA,SINDIAN,DJIBIDIONE,"H1 DIACOYE",7,7,33,18,51
ZIGUINCHOR,BIGNONA,SINDIAN,DJIBIDIONE,"H2 MANDEGANE",2,2,7,13,20
ZIGUINCHOR,BIGNONA,SINDIAN,DJIBIDIONE,"DJINEA DJIAGUIBE",25,33,119,110,229
ZIGUINCHOR,BIGNONA,SINDIAN,DJIBIDIONE,DJIRAL,10,12,89,58,147
ZIGUINCHOR,BIGNONA,SINDIAN,DJIBIDIONE,DJITER,5,6,33,24,57
ZIGUINCHOR,BIGNONA,SINDIAN,DJIBIDIONE,"H1 PEIGNE",9,9,41,38,79
ZIGUINCHOR,BIGNONA,SINDIAN,DJIBIDIONE,DJIONDJI,33,42,114,98,212
ZIGUINCHOR,BIGNONA,SINDIAN,DJIBIDIONE,"H1 DIEYE",17,22,64,47,111
ZIGUINCHOR,BIGNONA,SINDIAN,DJIBIDIONE,"GRAND KANAO",16,17,93,69,162
ZIGUINCHOR,BIGNONA,SINDIAN,DJIBIDIONE,KAEGHA,1,1,5,7,12
ZIGUINCHOR,BIGNONA,SINDIAN,DJIBIDIONE,KALEOU,11,14,81,50,131
ZIGUINCHOR,BIGNONA,SINDIAN,DJIBIDIONE,MASSARA,25,39,177,179,356
ZIGUINCHOR,BIGNONA,SINDIAN,DJIBIDIONE,"H1 KAROUNOR",6,6,34,43,77
ZIGUINCHOR,BIGNONA,SINDIAN,DJIBIDIONE,"H2 DJITETE",5,11,41,42,83
ZIGUINCHOR,BIGNONA,SINDIAN,DJIBIDIONE,"NEMA DJINARE",18,28,158,115,273
ZIGUINCHOR,BIGNONA,SINDIAN,DJIBIDIONE,"H1 DJINARE",3,7,59,46,105
ZIGUINCHOR,BIGNONA,SINDIAN,DJIBIDIONE,NIAIRE,5,7,28,17,45
ZIGUINCHOR,BIGNONA,SINDIAN,DJIBIDIONE,NIALLE,13,21,129,109,238
ZIGUINCHOR,BIGNONA,SINDIAN,DJIBIDIONE,"H1 WONTO",5,5,32,24,56
ZIGUINCHOR,BIGNONA,SINDIAN,DJIBIDIONE,"H2 FLOUP",3,3,19,14,33
ZIGUINCHOR,BIGNONA,SINDIAN,DJIBIDIONE,OUGONOR,8,8,21,20,41
ZIGUINCHOR,BIGNONA,SINDIAN,DJIBIDIONE,SITOUKENE,39,43,203,182,385
ZIGUINCHOR,BIGNONA,SINDIAN,DJIBIDIONE,"BAÏPEUL FRONTIERE",3,3,10,10,20
ZIGUINCHOR,BIGNONA,SINDIAN,DJIBIDIONE,DIACOYE,4,5,26,34,60
ZIGUINCHOR,BIGNONA,SINDIAN,DJIBIDIONE,DJIREME,17,20,71,76,147
ZIGUINCHOR,BIGNONA,SINDIAN,DJIBIDIONE,ELOL,5,7,35,20,55
ZIGUINCHOR,BIGNONA,SINDIAN,DJIBIDIONE,"ELOL MADIEDAME",11,17,60,47,107
ZIGUINCHOR,BIGNONA,SINDIAN,DJIBIDIONE,KARANAYE,4,6,23,22,45
ZIGUINCHOR,BIGNONA,SINDIAN,DJIBIDIONE,"KAROUNOR NARANG",2,3,16,20,36
ZIGUINCHOR,BIGNONA,SINDIAN,DJIBIDIONE,KONA,8,9,45,37,82
ZIGUINCHOR,BIGNONA,SINDIAN,DJIBIDIONE,KOUREGUE,12,12,45,36,81
ZIGUINCHOR,BIGNONA,SINDIAN,DJIBIDIONE,"PETIT BALANDINE",10,10,30,28,58
ZIGUINCHOR,BIGNONA,SINDIAN,OULAMPANE,ALACOUNDA,1,1,4,2,6
ZIGUINCHOR,BIGNONA,SINDIAN,OULAMPANE,"BALANKINE NORD",44,52,255,250,505
ZIGUINCHOR,BIGNONA,SINDIAN,OULAMPANE,BAMBATOUMA,22,24,141,119,260
ZIGUINCHOR,BIGNONA,SINDIAN,OULAMPANE,"BASSENE MANDOUARD",2,2,5,4,9
ZIGUINCHOR,BIGNONA,SINDIAN,OULAMPANE,"H2 DIWANE",4,4,15,20,35
ZIGUINCHOR,BIGNONA,SINDIAN,OULAMPANE,BOUDIANGATTE,2,3,15,12,27
ZIGUINCHOR,BIGNONA,SINDIAN,OULAMPANE,"BOUGOUTOUB BANI",21,21,123,97,220
ZIGUINCHOR,BIGNONA,SINDIAN,OULAMPANE,"BOUGOUTOUB DJINOUBOR",34,39,203,171,374
ZIGUINCHOR,BIGNONA,SINDIAN,OULAMPANE,"H1 BAANGA",13,15,67,60,127
ZIGUINCHOR,BIGNONA,SINDIAN,OULAMPANE,"H1 SOUNEYE",7,7,38,38,76
ZIGUINCHOR,BIGNONA,SINDIAN,OULAMPANE,BOUKEKOUM,15,15,72,67,139
ZIGUINCHOR,BIGNONA,SINDIAN,OULAMPANE,BOUTO,17,19,126,88,214
ZIGUINCHOR,BIGNONA,SINDIAN,OULAMPANE,KOULICAN,2,3,19,11,30
ZIGUINCHOR,BIGNONA,SINDIAN,OULAMPANE,DIABIR,21,28,146,166,312
ZIGUINCHOR,BIGNONA,SINDIAN,OULAMPANE,"H1 MANJACK",9,9,57,57,114
ZIGUINCHOR,BIGNONA,SINDIAN,OULAMPANE,DIAGOPER,9,11,77,45,122
ZIGUINCHOR,BIGNONA,SINDIAN,OULAMPANE,"DIAMAYE INOR",14,15,79,49,128
ZIGUINCHOR,BIGNONA,SINDIAN,OULAMPANE,KANDIALONG,5,9,54,35,89
ZIGUINCHOR,BIGNONA,SINDIAN,OULAMPANE,KANKANDY,21,27,122,131,253
ZIGUINCHOR,BIGNONA,SINDIAN,OULAMPANE,"DIAMAYE KANSIRANI",5,5,35,32,67
ZIGUINCHOR,BIGNONA,SINDIAN,OULAMPANE,"H1 SINTHIANG DIAMAYE KANSOFI",4,5,22,16,38
ZIGUINCHOR,BIGNONA,SINDIAN,OULAMPANE,DIANGO,82,98,503,441,944
ZIGUINCHOR,BIGNONA,SINDIAN,OULAMPANE,"H1 TAMBELOCK",7,8,36,50,86
ZIGUINCHOR,BIGNONA,SINDIAN,OULAMPANE,"DIOUNDANE KALIORE",9,12,62,61,123
ZIGUINCHOR,BIGNONA,SINDIAN,OULAMPANE,"H2 TILAYE",7,8,54,41,95
ZIGUINCHOR,BIGNONA,SINDIAN,OULAMPANE,"H4 BOULELAYE",4,5,18,22,40
ZIGUINCHOR,BIGNONA,SINDIAN,OULAMPANE,"DIOUNDANE KANTANPOR",13,16,78,49,127
ZIGUINCHOR,BIGNONA,SINDIAN,OULAMPANE,DJIGUIRONE,6,6,46,42,88
ZIGUINCHOR,BIGNONA,SINDIAN,OULAMPANE,DIALANKINE,17,23,99,92,191
ZIGUINCHOR,BIGNONA,SINDIAN,OULAMPANE,"H1 KEUREUNE",5,5,35,29,64
ZIGUINCHOR,BIGNONA,SINDIAN,OULAMPANE,"H2 DJITETE",3,3,14,11,25
ZIGUINCHOR,BIGNONA,SINDIAN,OULAMPANE,"H4 SEYME",7,8,28,25,53
ZIGUINCHOR,BIGNONA,SINDIAN,OULAMPANE,"H5 DIALANKINE CENTRE",5,5,18,12,30
ZIGUINCHOR,BIGNONA,SINDIAN,OULAMPANE,"H6 DIOULEYE",2,2,5,4,9
ZIGUINCHOR,BIGNONA,SINDIAN,OULAMPANE,DJILONGUIA,51,58,284,257,541
ZIGUINCHOR,BIGNONA,SINDIAN,OULAMPANE,DJIPACOUM,17,22,110,75,185
ZIGUINCHOR,BIGNONA,SINDIAN,OULAMPANE,DJIRO,7,7,54,30,84
ZIGUINCHOR,BIGNONA,SINDIAN,OULAMPANE,"H1 DJIBANGORY",2,4,18,8,26
ZIGUINCHOR,BIGNONA,SINDIAN,OULAMPANE,"H1 KAROR",2,5,17,12,29
ZIGUINCHOR,BIGNONA,SINDIAN,OULAMPANE,"H2 SIGUILAYE",2,3,14,13,27
ZIGUINCHOR,BIGNONA,SINDIAN,OULAMPANE,"H4 FELO",2,3,24,15,39
ZIGUINCHOR,BIGNONA,SINDIAN,OULAMPANE,"H8 BARABANG",2,2,14,14,28
ZIGUINCHOR,BIGNONA,SINDIAN,OULAMPANE,"H13 BAIPEU",2,3,12,11,23
ZIGUINCHOR,BIGNONA,SINDIAN,OULAMPANE,FAREGNAB,19,23,125,119,244
ZIGUINCHOR,BIGNONA,SINDIAN,OULAMPANE,GOUNGOULOUNG,20,22,96,107,203
ZIGUINCHOR,BIGNONA,SINDIAN,OULAMPANE,"GRAND COULAYE",20,21,132,95,227
ZIGUINCHOR,BIGNONA,SINDIAN,OULAMPANE,"H3 BOUGOLOR",1,2,12,6,18
ZIGUINCHOR,BIGNONA,SINDIAN,OULAMPANE,"H5 KALAMAKRI",19,21,120,116,236
ZIGUINCHOR,BIGNONA,SINDIAN,OULAMPANE,"H6 KOUINI",15,15,84,78,162
ZIGUINCHOR,BIGNONA,SINDIAN,OULAMPANE,KALOUBALOUB,1,1,13,11,24
ZIGUINCHOR,BIGNONA,SINDIAN,OULAMPANE,"H2 MANGAOUTE",1,1,4,6,10
ZIGUINCHOR,BIGNONA,SINDIAN,OULAMPANE,KANDIADIOU,5,8,21,28,49
ZIGUINCHOR,BIGNONA,SINDIAN,OULAMPANE,KAFENKENE,11,17,101,96,197
ZIGUINCHOR,BIGNONA,SINDIAN,OULAMPANE,"H3 SALEBENO",4,5,21,18,39
ZIGUINCHOR,BIGNONA,SINDIAN,OULAMPANE,"H4 DIADHIOUCOUNDA KAMPAGNE",1,1,6,5,11
ZIGUINCHOR,BIGNONA,SINDIAN,OULAMPANE,KANFOUNDA,16,18,116,93,209
ZIGUINCHOR,BIGNONA,SINDIAN,OULAMPANE,"H1 KAPOUNDOUNG",1,1,6,5,11
ZIGUINCHOR,BIGNONA,SINDIAN,OULAMPANE,"H2 WASSADOU",3,5,30,22,52
ZIGUINCHOR,BIGNONA,SINDIAN,OULAMPANE,KINDIONG,32,32,203,200,403
ZIGUINCHOR,BIGNONA,SINDIAN,OULAMPANE,KOUDIOUGHOR,7,13,62,48,110
ZIGUINCHOR,BIGNONA,SINDIAN,OULAMPANE,MAMPALAGO,96,113,628,630,1258
ZIGUINCHOR,BIGNONA,SINDIAN,OULAMPANE,MARARAN,3,4,11,5,16
ZIGUINCHOR,BIGNONA,SINDIAN,OULAMPANE,MARGOUNE,30,32,186,139,325
ZIGUINCHOR,BIGNONA,SINDIAN,OULAMPANE,"OUEL MOUNDAYE",4,5,20,11,31
ZIGUINCHOR,BIGNONA,SINDIAN,OULAMPANE,"H2 DJITETE MOUNDAYE",1,1,5,1,6
ZIGUINCHOR,BIGNONA,SINDIAN,OULAMPANE,NIALOCANE,20,25,118,90,208
ZIGUINCHOR,BIGNONA,SINDIAN,OULAMPANE,"H1 BROSSO MANSACOUNDA",4,4,19,15,34
ZIGUINCHOR,BIGNONA,SINDIAN,OULAMPANE,"H2 DIAMAYE SIBANOR",7,8,37,38,75
ZIGUINCHOR,BIGNONA,SINDIAN,OULAMPANE,OULAMPANE,97,114,619,528,1147
ZIGUINCHOR,BIGNONA,SINDIAN,OULAMPANE,"H1 KABOUMBE",18,19,117,110,227
ZIGUINCHOR,BIGNONA,SINDIAN,OULAMPANE,"H3 DIATIMBA",21,39,189,169,358
ZIGUINCHOR,BIGNONA,SINDIAN,OULAMPANE,"H4 DIABANG",29,35,252,254,506
ZIGUINCHOR,BIGNONA,SINDIAN,OULAMPANE,"OUEL KALIR",11,12,46,50,96
ZIGUINCHOR,BIGNONA,SINDIAN,OULAMPANE,"H1 DIEPOU",8,8,31,28,59
ZIGUINCHOR,BIGNONA,SINDIAN,OULAMPANE,SILINKINE,97,105,762,699,1461
ZIGUINCHOR,BIGNONA,SINDIAN,OULAMPANE,SINCO,11,11,79,71,150
ZIGUINCHOR,BIGNONA,SINDIAN,OULAMPANE,TAMPINDO,5,6,40,42,82
ZIGUINCHOR,BIGNONA,SINDIAN,OULAMPANE,"H1 KANTAPOR",2,2,17,31,48
ZIGUINCHOR,BIGNONA,SINDIAN,OULAMPANE,"H2 KILANG",1,1,7,8,15
ZIGUINCHOR,BIGNONA,SINDIAN,OULAMPANE,TANNDOUMBOUNE,20,33,150,173,323
ZIGUINCHOR,BIGNONA,SINDIAN,OULAMPANE,YABOCOUNDA,20,21,93,101,194
ZIGUINCHOR,BIGNONA,SINDIAN,OULAMPANE,DJILACOUNDA,2,2,14,2,16
ZIGUINCHOR,BIGNONA,SINDIAN,OULAMPANE,KANTIMBA,5,6,35,32,67
ZIGUINCHOR,BIGNONA,SINDIAN,SINDIAN,BOUYEME,34,38,186,159,345
ZIGUINCHOR,BIGNONA,SINDIAN,SINDIAN,DIAGONGUE,76,79,340,320,660
ZIGUINCHOR,BIGNONA,SINDIAN,SINDIAN,DIEDIEL,23,23,98,87,185
ZIGUINCHOR,BIGNONA,SINDIAN,SINDIAN,"DJINEA SIBOGOLA",16,18,76,69,145
ZIGUINCHOR,BIGNONA,SINDIAN,SINDIAN,DJINAL,11,17,55,59,114
ZIGUINCHOR,BIGNONA,SINDIAN,SINDIAN,DJINIPER,9,9,56,51,107
ZIGUINCHOR,BIGNONA,SINDIAN,SINDIAN,"H1 BALIANG",6,6,32,23,55
ZIGUINCHOR,BIGNONA,SINDIAN,SINDIAN,"H2 EKONETTE",27,28,131,122,253
ZIGUINCHOR,BIGNONA,SINDIAN,SINDIAN,"H3 KANSY",12,13,61,51,112
ZIGUINCHOR,BIGNONA,SINDIAN,SINDIAN,"H4 FEGHO HLM",16,16,114,87,201
ZIGUINCHOR,BIGNONA,SINDIAN,SINDIAN,"H5 KANBAMBA",2,4,15,16,31
ZIGUINCHOR,BIGNONA,SINDIAN,SINDIAN,"H6 FATIYAYE",6,6,38,40,78
ZIGUINCHOR,BIGNONA,SINDIAN,SINDIAN,"H7 BAPONLONDIONCK",9,13,53,46,99
ZIGUINCHOR,BIGNONA,SINDIAN,SINDIAN,"H8 BAWANGA",3,3,22,28,50
ZIGUINCHOR,BIGNONA,SINDIAN,SINDIAN,"H9 DIALAMANTANG",16,17,60,62,122
ZIGUINCHOR,BIGNONA,SINDIAN,SINDIAN,"H10 ERINDIAN",19,20,83,75,158
ZIGUINCHOR,BIGNONA,SINDIAN,SINDIAN,"H11 SANEWATTE",13,14,44,46,90
ZIGUINCHOR,BIGNONA,SINDIAN,SINDIAN,"H12 FAFALABY",9,10,56,45,101
ZIGUINCHOR,BIGNONA,SINDIAN,SINDIAN,KAKENE,49,51,268,257,525
ZIGUINCHOR,BIGNONA,SINDIAN,SINDIAN,KOUROUCK,14,22,86,103,189
ZIGUINCHOR,BIGNONA,SINDIAN,SINDIAN,"H1 BAFIMBARE",3,8,26,22,48
ZIGUINCHOR,BIGNONA,SINDIAN,SINDIAN,"H2 KANDJIRAMBA",24,28,146,102,248
ZIGUINCHOR,BIGNONA,SINDIAN,SINDIAN,"H3 BEUSSOUB",6,6,30,29,59
ZIGUINCHOR,BIGNONA,SINDIAN,SINDIAN,LEFEU,3,3,11,5,16
ZIGUINCHOR,BIGNONA,SINDIAN,SINDIAN,"H1 KALENTEN",2,2,11,8,19
ZIGUINCHOR,BIGNONA,SINDIAN,SINDIAN,"H4 KALATHIAYE",2,2,14,13,27
ZIGUINCHOR,BIGNONA,SINDIAN,SINDIAN,"H5 KADIOUPA",3,4,20,17,37
ZIGUINCHOR,BIGNONA,SINDIAN,SINDIAN,"H6 SANTIDIONE",3,3,9,8,17
ZIGUINCHOR,BIGNONA,SINDIAN,SINDIAN,"H7 SIDJILAYE (SAMPONTHIOLOK)",6,6,39,34,73
ZIGUINCHOR,BIGNONA,SINDIAN,SINDIAN,MANTAKIGNE,9,10,39,29,68
ZIGUINCHOR,BIGNONA,SINDIAN,SINDIAN,MEDIEGUE,115,120,536,539,1075
ZIGUINCHOR,BIGNONA,SINDIAN,SINDIAN,OUNIOCK,18,20,103,79,182
ZIGUINCHOR,BIGNONA,SINDIAN,SINDIAN,"H1 KADIAHINE",10,12,80,74,154
ZIGUINCHOR,BIGNONA,SINDIAN,SINDIAN,PENDITTE,43,47,251,193,444
ZIGUINCHOR,BIGNONA,SINDIAN,SINDIAN,"H1 DJINONAYE",9,9,62,53,115
ZIGUINCHOR,BIGNONA,SINDIAN,SINDIAN,SINDIAN,292,316,1766,1566,3332
ZIGUINCHOR,BIGNONA,SINDIAN,SINDIAN,"H2 TAPOUNAME",18,22,105,83,188
ZIGUINCHOR,BIGNONA,SINDIAN,SINDIAN,"H3 BASSAYITE",9,10,60,55,115
ZIGUINCHOR,BIGNONA,SINDIAN,SINDIAN,"H4 EDIAMADIEKENE",58,69,425,416,841
ZIGUINCHOR,BIGNONA,SINDIAN,SINDIAN,TENDINE,18,22,67,82,149
ZIGUINCHOR,BIGNONA,SINDIAN,SINDIAN,"H1 NADIETO",3,3,17,32,49
ZIGUINCHOR,BIGNONA,SINDIAN,SINDIAN,TANKORON,62,68,360,350,710
ZIGUINCHOR,BIGNONA,SINDIAN,SINDIAN,SIBOGOLA,10,11,52,38,90
ZIGUINCHOR,BIGNONA,SINDIAN,SUELLE,BAILA,228,317,1445,1231,2676
ZIGUINCHOR,BIGNONA,SINDIAN,SUELLE,"H1 KATIPEU",6,16,69,47,116
ZIGUINCHOR,BIGNONA,SINDIAN,SUELLE,BALANDINE,50,55,116,119,235
ZIGUINCHOR,BIGNONA,SINDIAN,SUELLE,"H2 KAFATAYE",1,1,2,4,6
ZIGUINCHOR,BIGNONA,SINDIAN,SUELLE,BAATONG,21,27,74,74,148
ZIGUINCHOR,BIGNONA,SINDIAN,SUELLE,DIABOUDIOR,66,75,236,208,444
ZIGUINCHOR,BIGNONA,SINDIAN,SUELLE,"DIACOYE BANGA",55,75,338,252,590
ZIGUINCHOR,BIGNONA,SINDIAN,SUELLE,"H1 KACOUNOUNE",4,7,23,17,40
ZIGUINCHOR,BIGNONA,SINDIAN,SUELLE,DIATTANG,25,36,105,98,203
ZIGUINCHOR,BIGNONA,SINDIAN,SUELLE,"H1 SIWOKA",5,7,31,27,58
ZIGUINCHOR,BIGNONA,SINDIAN,SUELLE,"H2 DJIMBEUL BODIANG",3,8,28,23,51
ZIGUINCHOR,BIGNONA,SINDIAN,SUELLE,"H3 DJIMBEUL FABOURE",7,11,54,42,96
ZIGUINCHOR,BIGNONA,SINDIAN,SUELLE,DJIONGOL,22,36,127,129,256
ZIGUINCHOR,BIGNONA,SINDIAN,SUELLE,DJILACOUNDA,4,5,25,11,36
ZIGUINCHOR,BIGNONA,SINDIAN,SUELLE,"H1 BATABOUTE",8,8,19,18,37
ZIGUINCHOR,BIGNONA,SINDIAN,SUELLE,"H2 BATINDENG",6,9,69,42,111
ZIGUINCHOR,BIGNONA,SINDIAN,SUELLE,"H3 HEDIEGNOR",3,3,21,11,32
ZIGUINCHOR,BIGNONA,SINDIAN,SUELLE,"H4 SIBANGOTE",6,7,40,24,64
ZIGUINCHOR,BIGNONA,SINDIAN,SUELLE,"H5 SANY",1,1,4,4,8
ZIGUINCHOR,BIGNONA,SINDIAN,SUELLE,CAPARAN,74,91,283,323,606
ZIGUINCHOR,BIGNONA,SINDIAN,SUELLE,"H1 HLM COUBALAR",9,10,23,32,55
ZIGUINCHOR,BIGNONA,SINDIAN,SUELLE,"KAPARAN DIAKINE",18,21,67,58,125
ZIGUINCHOR,BIGNONA,SINDIAN,SUELLE,KATINONG,45,60,212,195,407
ZIGUINCHOR,BIGNONA,SINDIAN,SUELLE,KATOUDIE,37,42,113,112,225
ZIGUINCHOR,BIGNONA,SINDIAN,SUELLE,"H1 BOULOULO (DIANDINE)",9,10,33,22,55
ZIGUINCHOR,BIGNONA,SINDIAN,SUELLE,KINDIENG,8,26,89,82,171
ZIGUINCHOR,BIGNONA,SINDIAN,SUELLE,GHONIAME,9,25,54,67,121
ZIGUINCHOR,BIGNONA,SINDIAN,SUELLE,NIANKITTE,42,59,367,272,639
ZIGUINCHOR,BIGNONA,SINDIAN,SUELLE,SUELLE,83,105,346,274,620
ZIGUINCHOR,BIGNONA,SINDIAN,SUELLE,"H1 KOUNATOUBA",21,33,118,77,195
ZIGUINCHOR,BIGNONA,SINDIAN,SUELLE,"H2 DJIEKO",9,17,62,48,110
ZIGUINCHOR,BIGNONA,SINDIAN,SUELLE,"H3 BAMADJE",7,15,61,49,110
ZIGUINCHOR,BIGNONA,SINDIAN,SUELLE,TALLOUM,39,80,230,224,454
ZIGUINCHOR,BIGNONA,SINDIAN,SUELLE,"H1 FINNAH",3,6,21,10,31
ZIGUINCHOR,BIGNONA,SINDIAN,SUELLE,"H2 DJANAR",2,2,13,6,19
ZIGUINCHOR,BIGNONA,SINDIAN,SUELLE,"H3 NIAYRE",1,4,15,9,24
ZIGUINCHOR,BIGNONA,TENDOUCK,BALINGHORE,BAGAYA,129,132,448,453,901
ZIGUINCHOR,BIGNONA,TENDOUCK,BALINGHORE,BALINGORE,261,309,1167,1040,2207
ZIGUINCHOR,BIGNONA,TENDOUCK,BALINGHORE,"H1 KAOUWEU",7,14,44,43,87
ZIGUINCHOR,BIGNONA,TENDOUCK,BALINGHORE,"H2 KAOUR",7,7,39,34,73
ZIGUINCHOR,BIGNONA,TENDOUCK,BALINGHORE,"H3 DIANAK",9,25,84,72,156
ZIGUINCHOR,BIGNONA,TENDOUCK,BALINGHORE,"H4 KABALINE",18,21,85,71,156
ZIGUINCHOR,BIGNONA,TENDOUCK,BALINGHORE,MANDEGANE,240,272,1011,922,1933
ZIGUINCHOR,BIGNONA,TENDOUCK,DIEGOUNE,DIEGOUNE,222,380,1468,1552,3020
ZIGUINCHOR,BIGNONA,TENDOUCK,DIEGOUNE,"H1 BARAFAYE",27,44,164,174,338
ZIGUINCHOR,BIGNONA,TENDOUCK,DIEGOUNE,DJIMANDE,60,90,367,320,687
ZIGUINCHOR,BIGNONA,TENDOUCK,DIEGOUNE,"H1 BATINDING",14,21,53,61,114
ZIGUINCHOR,BIGNONA,TENDOUCK,DIEGOUNE,KAGNABON,276,341,1361,1349,2710
ZIGUINCHOR,BIGNONA,TENDOUCK,DIEGOUNE,"H1 KABEUMBE",1,1,13,6,19
ZIGUINCHOR,BIGNONA,TENDOUCK,DIEGOUNE,"H2 SAMOUMEUH",10,20,111,122,233
ZIGUINCHOR,BIGNONA,TENDOUCK,DIEGOUNE,"H3 KABALINE",26,30,146,132,278
ZIGUINCHOR,BIGNONA,TENDOUCK,DIEGOUNE,"H4 EGHANA",11,11,72,63,135
ZIGUINCHOR,BIGNONA,TENDOUCK,KARTIACK,BASSIRE,100,125,395,419,814
ZIGUINCHOR,BIGNONA,TENDOUCK,KARTIACK,DIANKI,224,360,1289,1298,2587
ZIGUINCHOR,BIGNONA,TENDOUCK,KARTIACK,KARTIACK,282,335,1324,1217,2541
ZIGUINCHOR,BIGNONA,TENDOUCK,KARTIACK,THIOBON,170,248,991,974,1965
ZIGUINCHOR,BIGNONA,TENDOUCK,KARTIACK,"H1 OUBEUBEU",4,8,29,26,55
ZIGUINCHOR,BIGNONA,TENDOUCK,MANGAGOULACK,AFFINIAM,227,264,811,767,1578
ZIGUINCHOR,BIGNONA,TENDOUCK,MANGAGOULACK,"H1 DJILOGUIR",50,57,224,190,414
ZIGUINCHOR,BIGNONA,TENDOUCK,MANGAGOULACK,BOUTEUM,71,81,181,145,326
ZIGUINCHOR,BIGNONA,TENDOUCK,MANGAGOULACK,"H1 DJILAPAO",11,12,13,12,25
ZIGUINCHOR,BIGNONA,TENDOUCK,MANGAGOULACK,"H2 ELORA",8,11,11,6,17
ZIGUINCHOR,BIGNONA,TENDOUCK,MANGAGOULACK,"BODE (EBOUCK)",37,39,132,117,249
ZIGUINCHOR,BIGNONA,TENDOUCK,MANGAGOULACK,BOUTEGOL,72,97,328,343,671
ZIGUINCHOR,BIGNONA,TENDOUCK,MANGAGOULACK,DIATOCK,46,56,185,181,366
ZIGUINCHOR,BIGNONA,TENDOUCK,MANGAGOULACK,"H1 DJILOKOUL",33,35,115,116,231
ZIGUINCHOR,BIGNONA,TENDOUCK,MANGAGOULACK,"H2 FOUTAMA",26,34,71,100,171
ZIGUINCHOR,BIGNONA,TENDOUCK,MANGAGOULACK,"H3 BRICO",47,48,209,178,387
ZIGUINCHOR,BIGNONA,TENDOUCK,MANGAGOULACK,"H4 ERAMBA",41,44,225,171,396
ZIGUINCHOR,BIGNONA,TENDOUCK,MANGAGOULACK,"H5 PACKAO",23,26,102,101,203
ZIGUINCHOR,BIGNONA,TENDOUCK,MANGAGOULACK,"H6 BOURFOUTOU",30,34,173,148,321
ZIGUINCHOR,BIGNONA,TENDOUCK,MANGAGOULACK,ELANA,101,111,302,302,604
ZIGUINCHOR,BIGNONA,TENDOUCK,MANGAGOULACK,MANGAGOULACK,84,96,281,243,524
ZIGUINCHOR,BIGNONA,TENDOUCK,MANGAGOULACK,TENDOUCK,241,325,1043,977,2020
ZIGUINCHOR,BIGNONA,TENDOUCK,MLOMP,"EDIAMATH (DJIGOTTE)",46,52,282,262,544
ZIGUINCHOR,BIGNONA,TENDOUCK,MLOMP,MLOMP,164,290,1050,1084,2134
ZIGUINCHOR,BIGNONA,TENDOUCK,MLOMP,"H1 KAWAGUIR",56,73,225,225,450
ZIGUINCHOR,BIGNONA,TENGHORI,COUBALAN,BOULINDIENG,27,40,176,187,363
ZIGUINCHOR,BIGNONA,TENGHORI,COUBALAN,BOURECK,32,55,272,235,507
ZIGUINCHOR,BIGNONA,TENGHORI,COUBALAN,"H1 KAFOYE",23,26,124,104,228
ZIGUINCHOR,BIGNONA,TENGHORI,COUBALAN,"H2 FANGOUME",13,19,136,117,253
ZIGUINCHOR,BIGNONA,TENGHORI,COUBALAN,"H3 BANENOUN",5,6,38,38,76
ZIGUINCHOR,BIGNONA,TENGHORI,COUBALAN,"BOUTOLATTE KARAMBA",19,26,127,117,244
ZIGUINCHOR,BIGNONA,TENGHORI,COUBALAN,COUBALAN,181,217,720,691,1411
ZIGUINCHOR,BIGNONA,TENGHORI,COUBALAN,COUBANAO,245,346,1636,1709,3345
ZIGUINCHOR,BIGNONA,TENGHORI,COUBALAN,DIOUBOUR,24,28,182,153,335
ZIGUINCHOR,BIGNONA,TENGHORI,COUBALAN,DJIGUINOUM,65,79,465,426,891
ZIGUINCHOR,BIGNONA,TENGHORI,COUBALAN,"H1 MEDINA YACINE BA",1,2,87,49,136
ZIGUINCHOR,BIGNONA,TENGHORI,COUBALAN,DJILACOUNE,120,125,493,470,963
ZIGUINCHOR,BIGNONA,TENGHORI,COUBALAN,FINTHIOCK,120,141,773,803,1576
ZIGUINCHOR,BIGNONA,TENGHORI,COUBALAN,HATHIOUNE,55,75,343,367,710
ZIGUINCHOR,BIGNONA,TENGHORI,COUBALAN,MANDOUARD,14,15,48,56,104
ZIGUINCHOR,BIGNONA,TENGHORI,COUBALAN,NIANDANE,17,20,145,128,273
ZIGUINCHOR,BIGNONA,TENGHORI,COUBALAN,"H1 KAMOSORE",20,23,144,99,243
ZIGUINCHOR,BIGNONA,TENGHORI,COUBALAN,TAPILANE,25,31,169,178,347
ZIGUINCHOR,BIGNONA,TENGHORI,COUBALAN,"H1 YANDOUM",8,13,50,63,113
ZIGUINCHOR,BIGNONA,TENGHORI,COUBALAN,"H2 DIEMECOUDA",4,4,17,21,38
ZIGUINCHOR,BIGNONA,TENGHORI,NIAMONE,BAGHAGHA,83,96,585,574,1159
ZIGUINCHOR,BIGNONA,TENGHORI,NIAMONE,"H1 KOUDOGHOR",8,8,20,29,49
ZIGUINCHOR,BIGNONA,TENGHORI,NIAMONE,"H2 TAMI",11,11,31,33,64
ZIGUINCHOR,BIGNONA,TENGHORI,NIAMONE,DIAGOBEL,41,46,185,130,315
ZIGUINCHOR,BIGNONA,TENGHORI,NIAMONE,DIANDIALATTE,10,10,44,27,71
ZIGUINCHOR,BIGNONA,TENGHORI,NIAMONE,DIENGUE,50,55,246,196,442
ZIGUINCHOR,BIGNONA,TENGHORI,NIAMONE,"H1 DIAMATOU",24,25,84,71,155
ZIGUINCHOR,BIGNONA,TENGHORI,NIAMONE,GUERINA,23,24,55,50,105
ZIGUINCHOR,BIGNONA,TENGHORI,NIAMONE,COLOMBA,70,71,353,303,656
ZIGUINCHOR,BIGNONA,TENGHORI,NIAMONE,KANDIOU,22,28,138,126,264
ZIGUINCHOR,BIGNONA,TENGHORI,NIAMONE,NIAMONE,69,94,416,393,809
ZIGUINCHOR,BIGNONA,TENGHORI,NIAMONE,"H1 KANDIOUMBE",38,41,185,153,338
ZIGUINCHOR,BIGNONA,TENGHORI,NIAMONE,"H2 KASSANKILE",48,53,235,224,459
ZIGUINCHOR,BIGNONA,TENGHORI,NIAMONE,TABY,101,121,485,544,1029
ZIGUINCHOR,BIGNONA,TENGHORI,NIAMONE,"H1 TONGUE",11,12,38,27,65
ZIGUINCHOR,BIGNONA,TENGHORI,NIAMONE,TOBOR,154,175,766,703,1469
ZIGUINCHOR,BIGNONA,TENGHORI,NIAMONE,"H1 BOUAL",27,29,91,83,174
ZIGUINCHOR,BIGNONA,TENGHORI,NIAMONE,"H2 BOUDONE",30,31,120,74,194
ZIGUINCHOR,BIGNONA,TENGHORI,NIAMONE,"H3 KAGNAROU",16,18,79,85,164
ZIGUINCHOR,BIGNONA,TENGHORI,NIAMONE,"H4 BALINGHORE",22,30,134,124,258
ZIGUINCHOR,BIGNONA,TENGHORI,NIAMONE,"H5 BOUTOUMOL",76,78,283,263,546
ZIGUINCHOR,BIGNONA,TENGHORI,OUONCK,BABATH,25,32,173,146,319
ZIGUINCHOR,BIGNONA,TENGHORI,OUONCK,"BALANKINE SUD",17,19,122,100,222
ZIGUINCHOR,BIGNONA,TENGHORI,OUONCK,BOUHINOR,20,21,118,89,207
ZIGUINCHOR,BIGNONA,TENGHORI,OUONCK,BOULANDOR,43,48,279,276,555
ZIGUINCHOR,BIGNONA,TENGHORI,OUONCK,BOUYAL,26,33,234,233,467
ZIGUINCHOR,BIGNONA,TENGHORI,OUONCK,DIOGHO,23,26,116,115,231
ZIGUINCHOR,BIGNONA,TENGHORI,OUONCK,DIAGOUR,15,22,132,138,270
ZIGUINCHOR,BIGNONA,TENGHORI,OUONCK,DJIGUIPOUNE,36,40,214,215,429
ZIGUINCHOR,BIGNONA,TENGHORI,OUONCK,DJICOUNTANG,6,14,55,51,106
ZIGUINCHOR,BIGNONA,TENGHORI,OUONCK,DJINOUBOR,41,46,305,305,610
ZIGUINCHOR,BIGNONA,TENGHORI,OUONCK,DJIRINGOUMANE,13,18,138,108,246
ZIGUINCHOR,BIGNONA,TENGHORI,OUONCK,GHAMOUNE,23,26,141,135,276
ZIGUINCHOR,BIGNONA,TENGHORI,OUONCK,KIGNINDING,37,49,197,186,383
ZIGUINCHOR,BIGNONA,TENGHORI,OUONCK,"H1 BINTING",14,26,123,110,233
ZIGUINCHOR,BIGNONA,TENGHORI,OUONCK,"H2 NEMA",7,13,54,70,124
ZIGUINCHOR,BIGNONA,TENGHORI,OUONCK,CONGOLY,45,51,258,267,525
ZIGUINCHOR,BIGNONA,TENGHORI,OUONCK,"MANDOUARD 2",19,22,146,120,266
ZIGUINCHOR,BIGNONA,TENGHORI,OUONCK,MARACOUNDA,17,35,155,152,307
ZIGUINCHOR,BIGNONA,TENGHORI,OUONCK,"H1 BARADJI",3,3,24,14,38
ZIGUINCHOR,BIGNONA,TENGHORI,OUONCK,NDIAGNE,30,48,258,259,517
ZIGUINCHOR,BIGNONA,TENGHORI,OUONCK,NDIEBA,32,40,215,229,444
ZIGUINCHOR,BIGNONA,TENGHORI,OUONCK,OUFFOULO,19,21,95,97,192
ZIGUINCHOR,BIGNONA,TENGHORI,OUONCK,OUONCK,114,131,688,646,1334
ZIGUINCHOR,BIGNONA,TENGHORI,OUONCK,SANTACK,42,55,282,303,585
ZIGUINCHOR,BIGNONA,TENGHORI,OUONCK,SINDIALON,24,37,207,216,423
ZIGUINCHOR,BIGNONA,TENGHORI,OUONCK,"H1 KASONNE",5,6,30,36,66
ZIGUINCHOR,BIGNONA,TENGHORI,OUONCK,"H2 BEBOUNE",6,7,33,36,69
ZIGUINCHOR,BIGNONA,TENGHORI,OUONCK,SOUDA,74,84,424,383,807
ZIGUINCHOR,BIGNONA,TENGHORI,OUONCK,"H1 EWONAYE",26,29,181,165,346
ZIGUINCHOR,BIGNONA,TENGHORI,OUONCK,TOGHO,27,33,149,168,317
ZIGUINCHOR,BIGNONA,TENGHORI,TENGHORI,BADIOURE,73,142,823,791,1614
ZIGUINCHOR,BIGNONA,TENGHORI,TENGHORI,BINDAGO,12,14,48,51,99
ZIGUINCHOR,BIGNONA,TENGHORI,TENGHORI,"BOUTOLATE YEU MEUKAY",18,21,109,114,223
ZIGUINCHOR,BIGNONA,TENGHORI,TENGHORI,DIAKINE,14,22,94,79,173
ZIGUINCHOR,BIGNONA,TENGHORI,TENGHORI,DIARONE,26,38,251,213,464
ZIGUINCHOR,BIGNONA,TENGHORI,TENGHORI,"H1 KATOLE",16,27,126,137,263
ZIGUINCHOR,BIGNONA,TENGHORI,TENGHORI,DIOUROU,51,52,145,122,267
ZIGUINCHOR,BIGNONA,TENGHORI,TENGHORI,DJILONDING,19,21,79,72,151
ZIGUINCHOR,BIGNONA,TENGHORI,TENGHORI,DJIMAKAKOR,36,36,103,93,196
ZIGUINCHOR,BIGNONA,TENGHORI,TENGHORI,DJITOUCOUBON,15,25,120,110,230
ZIGUINCHOR,BIGNONA,TENGHORI,TENGHORI,"DJIVA (DJIWA)",15,16,38,51,89
ZIGUINCHOR,BIGNONA,TENGHORI,TENGHORI,EGUILAYE,35,46,131,118,249
ZIGUINCHOR,BIGNONA,TENGHORI,TENGHORI,FALMERE,44,57,256,285,541
ZIGUINCHOR,BIGNONA,TENGHORI,TENGHORI,"H1 KOULEMAKOULE",18,21,91,81,172
ZIGUINCHOR,BIGNONA,TENGHORI,TENGHORI,FRANCOUNDA,15,22,90,76,166
ZIGUINCHOR,BIGNONA,TENGHORI,TENGHORI,GHONIAME,15,19,117,102,219
ZIGUINCHOR,BIGNONA,TENGHORI,TENGHORI,KAFESSE,37,46,246,217,463
ZIGUINCHOR,BIGNONA,TENGHORI,TENGHORI,KAOUDIOUL,7,8,11,10,21
ZIGUINCHOR,BIGNONA,TENGHORI,TENGHORI,KASSILA,11,13,17,24,41
ZIGUINCHOR,BIGNONA,TENGHORI,TENGHORI,COUTENGHOR,67,75,201,162,363
ZIGUINCHOR,BIGNONA,TENGHORI,TENGHORI,"MANGOULENE CENTRE",15,20,81,80,161
ZIGUINCHOR,BIGNONA,TENGHORI,TENGHORI,"H2 FOUSSOULANG MANGOULENE",13,20,82,92,174
ZIGUINCHOR,BIGNONA,TENGHORI,TENGHORI,"H3 BADIOUMEL MANGOULENE",14,23,89,92,181
ZIGUINCHOR,BIGNONA,TENGHORI,TENGHORI,"DIOGA (MANGOULENE DIOGA)",27,44,191,175,366
ZIGUINCHOR,BIGNONA,TENGHORI,TENGHORI,"NIALOR (MANGOULENE NIALOR)",21,25,119,122,241
ZIGUINCHOR,BIGNONA,TENGHORI,TENGHORI,"OUBEME (MANGOULENE OUBEME)",32,39,158,135,293
ZIGUINCHOR,BIGNONA,TENGHORI,TENGHORI,NIASSARANG,39,45,114,86,200
ZIGUINCHOR,BIGNONA,TENGHORI,TENGHORI,OUSSACK,18,22,86,93,179
ZIGUINCHOR,BIGNONA,TENGHORI,TENGHORI,"COULAYE (PETIT COULAYE)",43,53,298,292,590
ZIGUINCHOR,BIGNONA,TENGHORI,TENGHORI,"H1 BAMACK",21,21,142,151,293
ZIGUINCHOR,BIGNONA,TENGHORI,TENGHORI,"H2 BADJI AMDALAYE",2,4,16,20,36
ZIGUINCHOR,BIGNONA,TENGHORI,TENGHORI,PIRAM,27,34,158,112,270
ZIGUINCHOR,BIGNONA,TENGHORI,TENGHORI,SANDOUGOU,15,16,115,74,189
ZIGUINCHOR,BIGNONA,TENGHORI,TENGHORI,SOUTOU,69,73,162,158,320
ZIGUINCHOR,BIGNONA,TENGHORI,TENGHORI,TAKEME,25,27,107,86,193
ZIGUINCHOR,BIGNONA,TENGHORI,TENGHORI,TAO,9,10,28,31,59
ZIGUINCHOR,BIGNONA,TENGHORI,TENGHORI,TENDIEME,64,90,252,233,485
ZIGUINCHOR,BIGNONA,TENGHORI,TENGHORI,TENDIMANE,37,100,258,306,564
ZIGUINCHOR,BIGNONA,TENGHORI,TENGHORI,"TENGHORY COMPLIQUE",2884,3275,13159,12655,25814
ZIGUINCHOR,BIGNONA,TENGHORI,TENGHORI,"H1 DJIKESSE",94,118,694,623,1317
ZIGUINCHOR,BIGNONA,TENGHORI,TENGHORI,TENGOUTH,16,16,56,77,133
ZIGUINCHOR,BIGNONA,TENGHORI,TENGHORI,ETAMA,15,18,103,106,209
ZIGUINCHOR,BIGNONA,TENGHORI,TENGHORI,TAPILANE,14,15,54,39,93
ZIGUINCHOR,BIGNONA,TENGHORI,TENGHORI,TENGHORY,112,123,589,556,1145
ZIGUINCHOR,BIGNONA,"KATABA 1",DJINAKY,BADIANA,92,226,938,880,1818
ZIGUINCHOR,BIGNONA,"KATABA 1",DJINAKY,BALINE,43,60,309,271,580
ZIGUINCHOR,BIGNONA,"KATABA 1",DJINAKY,BALONGUINE,46,54,204,163,367
ZIGUINCHOR,BIGNONA,"KATABA 1",DJINAKY,"H1 BASSENE de BALONGUINE",1,1,2,7,9
ZIGUINCHOR,BIGNONA,"KATABA 1",DJINAKY,BARANLIR,45,70,354,308,662
ZIGUINCHOR,BIGNONA,"KATABA 1",DJINAKY,BELAYE,87,109,436,448,884
ZIGUINCHOR,BIGNONA,"KATABA 1",DJINAKY,"BITI BITI",50,69,337,315,652
ZIGUINCHOR,BIGNONA,"KATABA 1",DJINAKY,"H1 KATIPA",34,39,206,193,399
ZIGUINCHOR,BIGNONA,"KATABA 1",DJINAKY,"BRIKAMANDING 1",37,45,180,164,344
ZIGUINCHOR,BIGNONA,"KATABA 1",DJINAKY,"H1 DJIROUMBA",3,5,15,19,34
ZIGUINCHOR,BIGNONA,"KATABA 1",DJINAKY,COUSSABEL,22,37,117,125,242
ZIGUINCHOR,BIGNONA,"KATABA 1",DJINAKY,DIOUNOUG,28,37,166,144,310
ZIGUINCHOR,BIGNONA,"KATABA 1",DJINAKY,DJINAKY,91,119,514,541,1055
ZIGUINCHOR,BIGNONA,"KATABA 1",DJINAKY,"H1 BASSENE de DJINAKY",12,17,66,63,129
ZIGUINCHOR,BIGNONA,"KATABA 1",DJINAKY,DJINONE,34,66,267,251,518
ZIGUINCHOR,BIGNONA,"KATABA 1",DJINAKY,DJINOUNDIE,14,18,61,61,122
ZIGUINCHOR,BIGNONA,"KATABA 1",DJINAKY,"H1 BAYAYE",10,12,32,33,65
ZIGUINCHOR,BIGNONA,"KATABA 1",DJINAKY,"H2 EBATOR",9,14,69,41,110
ZIGUINCHOR,BIGNONA,"KATABA 1",DJINAKY,"H3 FOUGOPODJI",9,20,62,37,99
ZIGUINCHOR,BIGNONA,"KATABA 1",DJINAKY,EBINAKO,44,54,277,257,534
ZIGUINCHOR,BIGNONA,"KATABA 1",DJINAKY,EBINKINE,108,199,834,799,1633
ZIGUINCHOR,BIGNONA,"KATABA 1",DJINAKY,"H1 DJIBIAM",3,10,31,29,60
ZIGUINCHOR,BIGNONA,"KATABA 1",DJINAKY,"ESSOME SILATHIAYE",43,55,348,264,612
ZIGUINCHOR,BIGNONA,"KATABA 1",DJINAKY,KABILINE,221,240,971,921,1892
ZIGUINCHOR,BIGNONA,"KATABA 1",DJINAKY,"H1 SONKOUTA",7,7,37,32,69
ZIGUINCHOR,BIGNONA,"KATABA 1",DJINAKY,"H2 FOULACOUNDA",7,10,35,40,75
ZIGUINCHOR,BIGNONA,"KATABA 1",DJINAKY,"H3 KABILINE II",141,154,779,751,1530
ZIGUINCHOR,BIGNONA,"KATABA 1",DJINAKY,KAKARE,49,58,224,238,462
ZIGUINCHOR,BIGNONA,"KATABA 1",DJINAKY,KARIAYE,50,65,424,410,834
ZIGUINCHOR,BIGNONA,"KATABA 1",DJINAKY,KARONGUE,79,81,340,261,601
ZIGUINCHOR,BIGNONA,"KATABA 1",DJINAKY,"H1 KAWANE",17,26,101,101,202
ZIGUINCHOR,BIGNONA,"KATABA 1",DJINAKY,"KATEUM TEUM",28,35,181,197,378
ZIGUINCHOR,BIGNONA,"KATABA 1",DJINAKY,"MAHMOUDA CHERIF",65,76,451,433,884
ZIGUINCHOR,BIGNONA,"KATABA 1",DJINAKY,MONGONE,4,5,26,32,58
ZIGUINCHOR,BIGNONA,"KATABA 1",DJINAKY,"H1 BOUSSONOR",2,2,6,9,15
ZIGUINCHOR,BIGNONA,"KATABA 1",DJINAKY,"H2 BADIONCK",19,19,81,96,177
ZIGUINCHOR,BIGNONA,"KATABA 1",DJINAKY,"H3 SOTOKOYE",2,2,3,7,10
ZIGUINCHOR,BIGNONA,"KATABA 1",DJINAKY,NDEMBANE,7,7,34,23,57
ZIGUINCHOR,BIGNONA,"KATABA 1",DJINAKY,TANDINE,50,68,214,216,430
ZIGUINCHOR,BIGNONA,"KATABA 1",DJINAKY,WANGARAN,33,50,246,191,437
ZIGUINCHOR,BIGNONA,"KATABA 1",DJINAKY,"H1 KOUREUMBEU",6,10,37,29,66
ZIGUINCHOR,BIGNONA,"KATABA 1",DJINAKY,"H2 MLOMP",12,14,100,65,165
ZIGUINCHOR,BIGNONA,"KATABA 1",KAFOUNTINE,ABENE,602,805,3056,2657,5713
ZIGUINCHOR,BIGNONA,"KATABA 1",KAFOUNTINE,ALBADAR,224,272,1346,1158,2504
ZIGUINCHOR,BIGNONA,"KATABA 1",KAFOUNTINE,"H1 TRANQUILLE",3,3,12,15,27
ZIGUINCHOR,BIGNONA,"KATABA 1",KAFOUNTINE,BAKASSOUCK,20,23,54,46,100
ZIGUINCHOR,BIGNONA,"KATABA 1",KAFOUNTINE,BOKO,23,51,59,66,125
ZIGUINCHOR,BIGNONA,"KATABA 1",KAFOUNTINE,BOUNE,20,57,63,74,137
ZIGUINCHOR,BIGNONA,"KATABA 1",KAFOUNTINE,COUBA,59,71,203,198,401
ZIGUINCHOR,BIGNONA,"KATABA 1",KAFOUNTINE,DIANNAH,371,473,2487,1844,4331
ZIGUINCHOR,BIGNONA,"KATABA 1",KAFOUNTINE,"H1 BANTANKILING",12,15,72,59,131
ZIGUINCHOR,BIGNONA,"KATABA 1",KAFOUNTINE,"H2 DJINDEMB",86,91,460,373,833
ZIGUINCHOR,BIGNONA,"KATABA 1",KAFOUNTINE,"H3 KEROUANE",7,8,23,29,52
ZIGUINCHOR,BIGNONA,"KATABA 1",KAFOUNTINE,DIOGUE,178,289,719,514,1233
ZIGUINCHOR,BIGNONA,"KATABA 1",KAFOUNTINE,HAERE,23,24,76,69,145
ZIGUINCHOR,BIGNONA,"KATABA 1",KAFOUNTINE,"H1 KANDE",8,8,14,13,27
ZIGUINCHOR,BIGNONA,"KATABA 1",KAFOUNTINE,HILLOL,45,54,209,170,379
ZIGUINCHOR,BIGNONA,"KATABA 1",KAFOUNTINE,HITOU,29,47,99,92,191
ZIGUINCHOR,BIGNONA,"KATABA 1",KAFOUNTINE,"H2 KATENE",14,21,67,59,126
ZIGUINCHOR,BIGNONA,"KATABA 1",KAFOUNTINE,KAFOUNTINE,1817,4241,12799,10318,23117
ZIGUINCHOR,BIGNONA,"KATABA 1",KAFOUNTINE,KAILO,16,55,54,48,102
ZIGUINCHOR,BIGNONA,"KATABA 1",KAFOUNTINE,COLOMBA,75,90,370,361,731
ZIGUINCHOR,BIGNONA,"KATABA 1",KAFOUNTINE,"H1 GOMIS COUNDA",7,8,53,53,106
ZIGUINCHOR,BIGNONA,"KATABA 1",KAFOUNTINE,"H2 DAR SALAM",5,5,13,23,36
ZIGUINCHOR,BIGNONA,"KATABA 1",KAFOUNTINE,MANTATE,7,7,13,11,24
ZIGUINCHOR,BIGNONA,"KATABA 1",KAFOUNTINE,NIOMOUNE,53,148,302,295,597
ZIGUINCHOR,BIGNONA,"KATABA 1",KAFOUNTINE,SALOULOU,43,78,159,141,300
ZIGUINCHOR,BIGNONA,"KATABA 1",KAFOUNTINE,"BADIANCA SALL",6,8,20,16,36
ZIGUINCHOR,BIGNONA,"KATABA 1",KAFOUNTINE,KASSEL,6,15,41,45,86
ZIGUINCHOR,BIGNONA,"KATABA 1","KATABA 1",BANDJIKAKI,106,123,627,531,1158
ZIGUINCHOR,BIGNONA,"KATABA 1","KATABA 1","H1 BODIANCOUNDA",61,61,274,212,486
ZIGUINCHOR,BIGNONA,"KATABA 1","KATABA 1","BANI ISRAEL",16,17,50,53,103
ZIGUINCHOR,BIGNONA,"KATABA 1","KATABA 1",BARAKESSE,22,28,122,136,258
ZIGUINCHOR,BIGNONA,"KATABA 1","KATABA 1",BOUROME,32,32,106,89,195
ZIGUINCHOR,BIGNONA,"KATABA 1","KATABA 1","H1 BADJIRANE",24,26,139,117,256
ZIGUINCHOR,BIGNONA,"KATABA 1","KATABA 1",COUBANACK,154,169,869,651,1520
ZIGUINCHOR,BIGNONA,"KATABA 1","KATABA 1",COULANDIANG,42,46,248,184,432
ZIGUINCHOR,BIGNONA,"KATABA 1","KATABA 1",KOULOBORY,43,48,182,151,333
ZIGUINCHOR,BIGNONA,"KATABA 1","KATABA 1","H1 KATIPA",41,44,153,122,275
ZIGUINCHOR,BIGNONA,"KATABA 1","KATABA 1",KOUNCOUDIANG,72,79,264,208,472
ZIGUINCHOR,BIGNONA,"KATABA 1","KATABA 1",COURAM,46,53,303,277,580
ZIGUINCHOR,BIGNONA,"KATABA 1","KATABA 1","DARSALAM CHERIF",154,182,1105,1076,2181
ZIGUINCHOR,BIGNONA,"KATABA 1","KATABA 1","H1 DARSALAMANDING",1,1,2,3,5
ZIGUINCHOR,BIGNONA,"KATABA 1","KATABA 1","DAROUL KHAIRY",95,97,466,462,928
ZIGUINCHOR,BIGNONA,"KATABA 1","KATABA 1",DIENOUNCOUNDA,75,81,308,234,542
ZIGUINCHOR,BIGNONA,"KATABA 1","KATABA 1","H1 MANJA COUNDA",11,11,28,30,58
ZIGUINCHOR,BIGNONA,"KATABA 1","KATABA 1",DIMBAYA,51,55,238,268,506
ZIGUINCHOR,BIGNONA,"KATABA 1","KATABA 1",DJIBARA,13,16,76,72,148
ZIGUINCHOR,BIGNONA,"KATABA 1","KATABA 1","H1 TALIBOUBESS",31,36,147,128,275
ZIGUINCHOR,BIGNONA,"KATABA 1","KATABA 1",DJILACOUMOUNE,20,24,152,118,270
ZIGUINCHOR,BIGNONA,"KATABA 1","KATABA 1",DOMBONDIR,122,134,520,490,1010
ZIGUINCHOR,BIGNONA,"KATABA 1","KATABA 1",KABADIO,214,279,1554,1412,2966
ZIGUINCHOR,BIGNONA,"KATABA 1","KATABA 1","KATABA 1",63,67,292,301,593
ZIGUINCHOR,BIGNONA,"KATABA 1","KATABA 1","KATABA 2",84,91,491,426,917
ZIGUINCHOR,BIGNONA,"KATABA 1","KATABA 1","H1 FOULACOUNDA",28,33,146,103,249
ZIGUINCHOR,BIGNONA,"KATABA 1","KATABA 1","H2 KANSALA",12,13,62,47,109
ZIGUINCHOR,BIGNONA,"KATABA 1","KATABA 1",KATACK,69,79,294,251,545
ZIGUINCHOR,BIGNONA,"KATABA 1","KATABA 1","H1 BOUDOUCK",65,85,386,300,686
ZIGUINCHOR,BIGNONA,"KATABA 1","KATABA 1","KOBA SELETY",57,58,224,232,456
ZIGUINCHOR,BIGNONA,"KATABA 1","KATABA 1",COUDIOUBE,125,133,560,516,1076
ZIGUINCHOR,BIGNONA,"KATABA 1","KATABA 1","H1 ADJIANFA",5,5,3,11,14
ZIGUINCHOR,BIGNONA,"KATABA 1","KATABA 1","H2 NAMBAROU",6,6,14,14,28
ZIGUINCHOR,BIGNONA,"KATABA 1","KATABA 1","H3 MAURITANIE",4,4,18,11,29
ZIGUINCHOR,BIGNONA,"KATABA 1","KATABA 1","H4 SOTOKOYE",21,21,57,42,99
ZIGUINCHOR,BIGNONA,"KATABA 1","KATABA 1","MADINA BIRASSOU",100,102,424,326,750
ZIGUINCHOR,BIGNONA,"KATABA 1","KATABA 1","MAHMOUDA DIOLA (MAHMOUDA II)",108,119,467,474,941
ZIGUINCHOR,BIGNONA,"KATABA 1","KATABA 1",MACOUDA,95,105,431,397,828
ZIGUINCHOR,BIGNONA,"KATABA 1","KATABA 1","MADINA DAFFE",164,200,1230,1269,2499
ZIGUINCHOR,BIGNONA,"KATABA 1","KATABA 1",NIAFOURANG,55,58,159,122,281
ZIGUINCHOR,BIGNONA,"KATABA 1","KATABA 1",POUKENE,11,15,54,75,129
ZIGUINCHOR,BIGNONA,"KATABA 1","KATABA 1",SAMBOULANDIANG,45,50,210,178,388
ZIGUINCHOR,BIGNONA,"KATABA 1","KATABA 1",SELETY,267,329,1355,1291,2646
ZIGUINCHOR,BIGNONA,"KATABA 1","KATABA 1",SUZANA,9,10,19,32,51
ZIGUINCHOR,BIGNONA,"KATABA 1","KATABA 1","H1 DIOUGOUNE",2,4,11,9,20
ZIGUINCHOR,BIGNONA,"KATABA 1","KATABA 1",TAMBACOUNDA,43,54,337,283,620
ZIGUINCHOR,BIGNONA,"KATABA 1","KATABA 1","TAMBOUILLE (TRANQUILLE)",22,34,225,214,439
ZIGUINCHOR,BIGNONA,"KATABA 1","KATABA 1",TOUBA,96,117,730,687,1417
ZIGUINCHOR,BIGNONA,"KATABA 1","KATABA 1","H1 BANTANGNIMA",65,67,260,218,478
ZIGUINCHOR,BIGNONA,"KATABA 1","KATABA 1","H2 TRANQUILLE",41,41,200,177,377
ZIGUINCHOR,BIGNONA,"KATABA 1","KATABA 1",WONIACK,14,19,95,79,174
ZIGUINCHOR,BIGNONA,"KATABA 1","KATABA 1","H1 BOUSSOI",2,2,17,16,33
ZIGUINCHOR,BIGNONA,"KATABA 1","KATABA 1","H2 KABEKEL",25,26,87,80,167
ZIGUINCHOR,BIGNONA,"KATABA 1",DIOULOULOU,AINOUMANE,14,14,46,38,84
ZIGUINCHOR,BIGNONA,"KATABA 1",DIOULOULOU,BADIONKOTO,36,37,139,106,245
ZIGUINCHOR,BIGNONA,"KATABA 1",DIOULOULOU,"BRIKAMANDING II",72,72,311,256,567
ZIGUINCHOR,BIGNONA,"KATABA 1",DIOULOULOU,DJIABALY,32,32,100,79,179
ZIGUINCHOR,BIGNONA,"KATABA 1",DIOULOULOU,DOUMASSOU,120,188,1024,672,1696
ZIGUINCHOR,BIGNONA,"KATABA 1",DIOULOULOU,MISSIRAH,52,54,137,118,255
ZIGUINCHOR,BIGNONA,"KATABA 1",DIOULOULOU,PLATEAU,263,413,1150,1032,2182
ZIGUINCHOR,BIGNONA,"KATABA 1",DIOULOULOU,SANTASSOU,132,140,605,483,1088
ZIGUINCHOR,BIGNONA,"KATABA 1",DIOULOULOU,SANTHIABA,144,147,504,501,1005
ZIGUINCHOR,BIGNONA,"KATABA 1",DIOULOULOU,TRANQUILLE,113,132,419,389,808
ZIGUINCHOR,OUSSOUYE,OUSSOUYE,OUSSOUYE,KALOBONE,150,180,445,524,969
ZIGUINCHOR,OUSSOUYE,OUSSOUYE,OUSSOUYE,ESSINKINE,126,187,419,427,846
ZIGUINCHOR,OUSSOUYE,OUSSOUYE,OUSSOUYE,ETHIA,91,156,362,347,709
ZIGUINCHOR,OUSSOUYE,OUSSOUYE,OUSSOUYE,"SARE DEMBA",86,114,394,361,755
ZIGUINCHOR,OUSSOUYE,OUSSOUYE,OUSSOUYE,SOULEUK,108,196,433,347,780
ZIGUINCHOR,OUSSOUYE,OUSSOUYE,OUSSOUYE,BUWENTENE,225,362,854,792,1646
ZIGUINCHOR,OUSSOUYE,CABROUSSE,DIEMBERING,"BOUCOTTE DIOLA ETAMBOUDIAL",101,182,484,426,910
ZIGUINCHOR,OUSSOUYE,CABROUSSE,DIEMBERING,"BOUCOTTE OUOLOFF",388,737,2121,1756,3877
ZIGUINCHOR,OUSSOUYE,CABROUSSE,DIEMBERING,BOUYOUYE,38,44,170,126,296
ZIGUINCHOR,OUSSOUYE,CABROUSSE,DIEMBERING,"CABROUSSE KADIAKAYE",98,202,552,575,1127
ZIGUINCHOR,OUSSOUYE,CABROUSSE,DIEMBERING,"CABROUSSE MOSSOR",242,496,1113,1168,2281
ZIGUINCHOR,OUSSOUYE,CABROUSSE,DIEMBERING,"CABROUSSE NIALOU",237,303,806,686,1492
ZIGUINCHOR,OUSSOUYE,CABROUSSE,DIEMBERING,CACHOUANE,42,44,110,92,202
ZIGUINCHOR,OUSSOUYE,CABROUSSE,DIEMBERING,"CAP SKIRING",969,2718,5987,5055,11042
ZIGUINCHOR,OUSSOUYE,CABROUSSE,DIEMBERING,"H1 KAYOUTE (BASSINE)",4,4,3,1,4
ZIGUINCHOR,OUSSOUYE,CABROUSSE,DIEMBERING,"H2 KATACALOUSSE",1,1,2,2,4
ZIGUINCHOR,OUSSOUYE,CABROUSSE,DIEMBERING,"H3 RANDOULENE",139,182,269,213,482
ZIGUINCHOR,OUSSOUYE,CABROUSSE,DIEMBERING,"DIEMBERENG ETAMA",29,43,145,123,268
ZIGUINCHOR,OUSSOUYE,CABROUSSE,DIEMBERING,"DJIEMBERENG HALOUDIA",108,151,356,385,741
ZIGUINCHOR,OUSSOUYE,CABROUSSE,DIEMBERING,"DJIEMBERENG KAENGHA",45,85,215,197,412
ZIGUINCHOR,OUSSOUYE,CABROUSSE,DIEMBERING,"DIEMBERENG KAOUT",27,39,107,100,207
ZIGUINCHOR,OUSSOUYE,CABROUSSE,DIEMBERING,"DJIEMBERENG NIENE",4,11,27,22,49
ZIGUINCHOR,OUSSOUYE,CABROUSSE,DIEMBERING,EHIDJIE,14,15,33,22,55
ZIGUINCHOR,OUSSOUYE,CABROUSSE,DIEMBERING,"GNIKINE (KELLOUM)",22,32,61,64,125
ZIGUINCHOR,OUSSOUYE,CABROUSSE,DIEMBERING,CARABANE,100,109,356,314,670
ZIGUINCHOR,OUSSOUYE,CABROUSSE,DIEMBERING,"H1 EFFRAN",5,5,15,6,21
ZIGUINCHOR,OUSSOUYE,CABROUSSE,DIEMBERING,"H2 GUILAFAGUENE",6,7,13,16,29
ZIGUINCHOR,OUSSOUYE,CABROUSSE,DIEMBERING,OURONG,31,46,117,104,221
ZIGUINCHOR,OUSSOUYE,CABROUSSE,DIEMBERING,"H1 GUISSOR",2,2,4,1,5
ZIGUINCHOR,OUSSOUYE,CABROUSSE,DIEMBERING,SIFOCA,14,15,23,29,52
ZIGUINCHOR,OUSSOUYE,CABROUSSE,DIEMBERING,WENDAYE,31,32,66,76,142
ZIGUINCHOR,OUSSOUYE,CABROUSSE,DIEMBERING,BOUDIEDIETE,19,22,96,63,159
ZIGUINCHOR,OUSSOUYE,CABROUSSE,DIEMBERING,"DJIEMBERENG ETOUNE",48,83,223,226,449
ZIGUINCHOR,OUSSOUYE,CABROUSSE,DIEMBERING,"DJIEMBERENG HOUDIABOUSSE",56,100,318,262,580
ZIGUINCHOR,OUSSOUYE,CABROUSSE,"SANTHIABA MANJACK",DJIRACK,27,30,113,96,209
ZIGUINCHOR,OUSSOUYE,CABROUSSE,"SANTHIABA MANJACK","EFFOCK BALANDIANTE",39,41,103,93,196
ZIGUINCHOR,OUSSOUYE,CABROUSSE,"SANTHIABA MANJACK","EFFOC EHINTING",93,98,182,168,350
ZIGUINCHOR,OUSSOUYE,CABROUSSE,"SANTHIABA MANJACK","EFFOC EGHINA",75,80,189,196,385
ZIGUINCHOR,OUSSOUYE,CABROUSSE,"SANTHIABA MANJACK","EFFOC KAKOUNOUNE",14,16,41,51,92
ZIGUINCHOR,OUSSOUYE,CABROUSSE,"SANTHIABA MANJACK",ESSAOUT,70,72,201,187,388
ZIGUINCHOR,OUSSOUYE,CABROUSSE,"SANTHIABA MANJACK",KAHEME,24,24,67,58,125
ZIGUINCHOR,OUSSOUYE,CABROUSSE,"SANTHIABA MANJACK","YOUTOU BOUHEME",68,71,130,154,284
ZIGUINCHOR,OUSSOUYE,CABROUSSE,"SANTHIABA MANJACK","YOUTOU BRINGO",60,62,129,117,246
ZIGUINCHOR,OUSSOUYE,CABROUSSE,"SANTHIABA MANJACK","YOUTOU DJIBONKER",47,48,94,95,189
ZIGUINCHOR,OUSSOUYE,CABROUSSE,"SANTHIABA MANJACK","YOUTOU ESSOUKAYE",54,56,97,114,211
ZIGUINCHOR,OUSSOUYE,CABROUSSE,"SANTHIABA MANJACK","YOUTOU KAGAR",38,41,61,88,149
ZIGUINCHOR,OUSSOUYE,CABROUSSE,"SANTHIABA MANJACK","YOUTOU KANOKINDO",37,42,105,95,200
ZIGUINCHOR,OUSSOUYE,CABROUSSE,"SANTHIABA MANJACK",ESSOUKOUDIACK,2,3,8,9,17
ZIGUINCHOR,OUSSOUYE,"LOUDIA OUOLOF",MLOMP,"CAGNOUT BOUHIMBANE",84,115,285,290,575
ZIGUINCHOR,OUSSOUYE,"LOUDIA OUOLOF",MLOMP,"CAGNOUT EBROUAYE",57,63,157,151,308
ZIGUINCHOR,OUSSOUYE,"LOUDIA OUOLOF",MLOMP,"CAGNOUT OUYOHO",34,41,128,107,235
ZIGUINCHOR,OUSSOUYE,"LOUDIA OUOLOF",MLOMP,DJIROMAIT,34,36,104,91,195
ZIGUINCHOR,OUSSOUYE,"LOUDIA OUOLOF",MLOMP,"H1 KARIDJITE",4,4,10,8,18
ZIGUINCHOR,OUSSOUYE,"LOUDIA OUOLOF",MLOMP,ELINKINE,371,794,1806,1230,3036
ZIGUINCHOR,OUSSOUYE,"LOUDIA OUOLOF",MLOMP,"MLOMP ETEBEMAYE",30,36,108,88,196
ZIGUINCHOR,OUSSOUYE,"LOUDIA OUOLOF",MLOMP,EFFISSAO,15,15,29,42,71
ZIGUINCHOR,OUSSOUYE,"LOUDIA OUOLOF",MLOMP,"MLOMP HAER",69,80,301,226,527
ZIGUINCHOR,OUSSOUYE,"LOUDIA OUOLOF",MLOMP,"KADJINOLLE EBANKINE",54,63,153,164,317
ZIGUINCHOR,OUSSOUYE,"LOUDIA OUOLOF",MLOMP,"KADJINOLLE HASSOUKA",72,89,177,224,401
ZIGUINCHOR,OUSSOUYE,"LOUDIA OUOLOF",MLOMP,"KADJINOLLE KAFONE",96,113,246,267,513
ZIGUINCHOR,OUSSOUYE,"LOUDIA OUOLOF",MLOMP,"KADJINOLLE KAGNAO",57,84,209,216,425
ZIGUINCHOR,OUSSOUYE,"LOUDIA OUOLOF",MLOMP,"KADJINOLLE KANDIANKA",63,71,173,174,347
ZIGUINCHOR,OUSSOUYE,"LOUDIA OUOLOF",MLOMP,"LOUDIA DIOLA",48,57,135,130,265
ZIGUINCHOR,OUSSOUYE,"LOUDIA OUOLOF",MLOMP,"LOUDIA OUOLOFF",76,85,293,303,596
ZIGUINCHOR,OUSSOUYE,"LOUDIA OUOLOF",MLOMP,"MLOMP DJIBETENE",96,115,285,302,587
ZIGUINCHOR,OUSSOUYE,"LOUDIA OUOLOF",MLOMP,"MLOMP DJICOMOL",148,192,518,442,960
ZIGUINCHOR,OUSSOUYE,"LOUDIA OUOLOF",MLOMP,"MLOMP KADJIFOLONG",150,195,500,536,1036
ZIGUINCHOR,OUSSOUYE,"LOUDIA OUOLOF",MLOMP,"POINTE SAINT GEORGES",23,25,61,67,128
ZIGUINCHOR,OUSSOUYE,"LOUDIA OUOLOF",MLOMP,"KADJINOLLE SAGUEUR",23,27,65,71,136
ZIGUINCHOR,OUSSOUYE,"LOUDIA OUOLOF",MLOMP,"SAM SAM",20,21,47,50,97
ZIGUINCHOR,OUSSOUYE,"LOUDIA OUOLOF",MLOMP,"H1 ANTAYE",2,2,9,2,11
ZIGUINCHOR,OUSSOUYE,"LOUDIA OUOLOF",MLOMP,SAMATITE,40,44,79,78,157
ZIGUINCHOR,OUSSOUYE,"LOUDIA OUOLOF",MLOMP,"SANTHIABA OUOLOFF",30,30,118,102,220
ZIGUINCHOR,OUSSOUYE,"LOUDIA OUOLOF",MLOMP,"PETIT SAINT GEORGES",32,38,54,15,69
ZIGUINCHOR,OUSSOUYE,"LOUDIA OUOLOF",OUKOUT,BATINIERE,43,67,112,109,221
ZIGUINCHOR,OUSSOUYE,"LOUDIA OUOLOF",OUKOUT,BOUKITINGHO,140,159,333,338,671
ZIGUINCHOR,OUSSOUYE,"LOUDIA OUOLOF",OUKOUT,KAROUNATE,113,117,247,259,506
ZIGUINCHOR,OUSSOUYE,"LOUDIA OUOLOF",OUKOUT,"DIAKENE DIOLA",108,121,359,351,710
ZIGUINCHOR,OUSSOUYE,"LOUDIA OUOLOF",OUKOUT,"DIAKENE OUOLOFF",89,98,470,452,922
ZIGUINCHOR,OUSSOUYE,"LOUDIA OUOLOF",OUKOUT,DIANTENE,66,69,166,169,335
ZIGUINCHOR,OUSSOUYE,"LOUDIA OUOLOF",OUKOUT,"H1 NIALOBODJIE",9,9,22,35,57
ZIGUINCHOR,OUSSOUYE,"LOUDIA OUOLOF",OUKOUT,DJIVENTE,132,144,343,381,724
ZIGUINCHOR,OUSSOUYE,"LOUDIA OUOLOF",OUKOUT,EDIOUNGOU,123,219,314,341,655
ZIGUINCHOR,OUSSOUYE,"LOUDIA OUOLOF",OUKOUT,ELOUBALINE,7,17,15,12,27
ZIGUINCHOR,OUSSOUYE,"LOUDIA OUOLOF",OUKOUT,EMAYE,106,114,239,284,523
ZIGUINCHOR,OUSSOUYE,"LOUDIA OUOLOF",OUKOUT,KAHINDA,57,79,166,154,320
ZIGUINCHOR,OUSSOUYE,"LOUDIA OUOLOF",OUKOUT,NIAMBALANG,99,103,233,228,461
ZIGUINCHOR,OUSSOUYE,"LOUDIA OUOLOF",OUKOUT,"OUKOUT ETEILO",69,69,186,200,386
ZIGUINCHOR,OUSSOUYE,"LOUDIA OUOLOF",OUKOUT,"OUKOUT MADIOP",93,95,201,296,497
ZIGUINCHOR,OUSSOUYE,"LOUDIA OUOLOF",OUKOUT,"SIGANAR BOULOUF",67,71,97,131,228
ZIGUINCHOR,OUSSOUYE,"LOUDIA OUOLOF",OUKOUT,"SIGANAR HOUSSAL",77,77,135,151,286
ZIGUINCHOR,OUSSOUYE,"LOUDIA OUOLOF",OUKOUT,"H1 KATIPA",11,11,35,31,66
ZIGUINCHOR,OUSSOUYE,"LOUDIA OUOLOF",OUKOUT,"SIGANAR KABOUNKOUT",54,55,118,117,235
ZIGUINCHOR,OUSSOUYE,"LOUDIA OUOLOF",OUKOUT,"SIGANAR KATAKAL",50,50,82,93,175
ZIGUINCHOR,OUSSOUYE,"LOUDIA OUOLOF",OUKOUT,SENGHALENE,82,88,243,245,488
ZIGUINCHOR,ZIGUINCHOR,ZIGUINCHOR,ZIGUINCHOR,BELFORT,480,869,3207,3020,6227
ZIGUINCHOR,ZIGUINCHOR,ZIGUINCHOR,ZIGUINCHOR,"BOUCOTTE CENTRE",452,931,3184,3152,6336
ZIGUINCHOR,ZIGUINCHOR,ZIGUINCHOR,ZIGUINCHOR,"BOUCOTTE EST",259,626,2265,2205,4470
ZIGUINCHOR,ZIGUINCHOR,ZIGUINCHOR,ZIGUINCHOR,"BOUCOTTE NORD",335,768,2317,2214,4531
ZIGUINCHOR,ZIGUINCHOR,ZIGUINCHOR,ZIGUINCHOR,"BOUCOTTE OUEST",644,1419,5118,4720,9838
ZIGUINCHOR,ZIGUINCHOR,ZIGUINCHOR,ZIGUINCHOR,"BOUCOTTE SUD",830,1421,5522,5612,11134
ZIGUINCHOR,ZIGUINCHOR,ZIGUINCHOR,ZIGUINCHOR,"BOUDODY ESCALE",209,263,1362,652,2014
ZIGUINCHOR,ZIGUINCHOR,ZIGUINCHOR,ZIGUINCHOR,COBITENE,94,145,554,451,1005
ZIGUINCHOR,ZIGUINCHOR,ZIGUINCHOR,ZIGUINCHOR,COBODA,711,981,3616,3617,7233
ZIGUINCHOR,ZIGUINCHOR,ZIGUINCHOR,ZIGUINCHOR,COLOBANE,407,592,2162,2202,4364
ZIGUINCHOR,ZIGUINCHOR,ZIGUINCHOR,ZIGUINCHOR,DIABIR,978,1300,5014,4230,9244
ZIGUINCHOR,ZIGUINCHOR,ZIGUINCHOR,ZIGUINCHOR,DIEFAYE,298,389,1083,1128,2211
ZIGUINCHOR,ZIGUINCHOR,ZIGUINCHOR,ZIGUINCHOR,DJIBOCK,668,925,3540,3391,6931
ZIGUINCHOR,ZIGUINCHOR,ZIGUINCHOR,ZIGUINCHOR,DJIRIGHO,403,690,2667,2603,5270
ZIGUINCHOR,ZIGUINCHOR,ZIGUINCHOR,ZIGUINCHOR,GOUMEL,543,711,2070,1997,4067
ZIGUINCHOR,ZIGUINCHOR,ZIGUINCHOR,ZIGUINCHOR,"GRAND KANDE (KANDE ALASSANE)",605,1239,3489,3453,6942
ZIGUINCHOR,ZIGUINCHOR,ZIGUINCHOR,ZIGUINCHOR,"KANDIALANG EST",826,1095,4539,4312,8851
ZIGUINCHOR,ZIGUINCHOR,ZIGUINCHOR,ZIGUINCHOR,"KANDIALANG OUEST",1191,1740,7427,6377,13804
ZIGUINCHOR,ZIGUINCHOR,ZIGUINCHOR,ZIGUINCHOR,KANSAOUDY,441,492,1399,1503,2902
ZIGUINCHOR,ZIGUINCHOR,ZIGUINCHOR,ZIGUINCHOR,KENIA,448,640,2100,2236,4336
ZIGUINCHOR,ZIGUINCHOR,ZIGUINCHOR,ZIGUINCHOR,"PETIT KANDE (KANDE SIBINK)",913,1629,5816,5819,11635
ZIGUINCHOR,ZIGUINCHOR,ZIGUINCHOR,ZIGUINCHOR,SANTHIABA,716,1240,3789,3892,7681
ZIGUINCHOR,ZIGUINCHOR,ZIGUINCHOR,ZIGUINCHOR,SOUCOUPAPAYE,566,984,3751,3678,7429
ZIGUINCHOR,ZIGUINCHOR,ZIGUINCHOR,ZIGUINCHOR,TILENE,765,1798,4555,5162,9717
ZIGUINCHOR,ZIGUINCHOR,ZIGUINCHOR,ZIGUINCHOR,ALWAR,401,631,2506,2462,4968
ZIGUINCHOR,ZIGUINCHOR,ZIGUINCHOR,ZIGUINCHOR,CASTOR,191,365,1150,1028,2178
ZIGUINCHOR,ZIGUINCHOR,ZIGUINCHOR,ZIGUINCHOR,"COLOBANE FASS",183,240,1019,1020,2039
ZIGUINCHOR,ZIGUINCHOR,ZIGUINCHOR,ZIGUINCHOR,KADIOR,411,785,2945,2858,5803
ZIGUINCHOR,ZIGUINCHOR,ZIGUINCHOR,ZIGUINCHOR,"LYNDIANE I",498,827,2959,2974,5933
ZIGUINCHOR,ZIGUINCHOR,ZIGUINCHOR,ZIGUINCHOR,"LYNDIANE II",635,917,3658,3443,7101
ZIGUINCHOR,ZIGUINCHOR,ZIGUINCHOR,ZIGUINCHOR,"NEMA I",726,1621,5332,5156,10488
ZIGUINCHOR,ZIGUINCHOR,ZIGUINCHOR,ZIGUINCHOR,"NEMA II",1077,1687,6785,6328,13113
ZIGUINCHOR,ZIGUINCHOR,ZIGUINCHOR,ZIGUINCHOR,NIAFOULENE,349,740,2499,2580,5079
ZIGUINCHOR,ZIGUINCHOR,NIAGUIS,ADEANE,ADEANE,393,491,2586,2589,5175
ZIGUINCHOR,ZIGUINCHOR,NIAGUIS,ADEANE,"H1 DAROU SALAM",30,31,239,278,517
ZIGUINCHOR,ZIGUINCHOR,NIAGUIS,ADEANE,"H3 ADEANE SOR",50,53,354,378,732
ZIGUINCHOR,ZIGUINCHOR,NIAGUIS,ADEANE,"AGNACK GRAND",38,50,196,229,425
ZIGUINCHOR,ZIGUINCHOR,NIAGUIS,ADEANE,"AGNACK PETIT",185,218,1173,1089,2262
ZIGUINCHOR,ZIGUINCHOR,NIAGUIS,ADEANE,"H3 KHAR YALLA",67,83,376,390,766
ZIGUINCHOR,ZIGUINCHOR,NIAGUIS,ADEANE,BAGHAGHA,358,410,2270,2001,4271
ZIGUINCHOR,ZIGUINCHOR,NIAGUIS,ADEANE,"H2 GONOUM",27,32,171,158,329
ZIGUINCHOR,ZIGUINCHOR,NIAGUIS,ADEANE,BAINOUNCK,7,7,15,19,34
ZIGUINCHOR,ZIGUINCHOR,NIAGUIS,ADEANE,DIAGNON,80,108,845,757,1602
ZIGUINCHOR,ZIGUINCHOR,NIAGUIS,ADEANE,KOUNDIOUNDOU,48,56,303,308,611
ZIGUINCHOR,ZIGUINCHOR,NIAGUIS,ADEANE,SINDONE,155,164,688,727,1415
ZIGUINCHOR,ZIGUINCHOR,NIAGUIS,ADEANE,"H1 SANTASSOU",9,10,43,59,102
ZIGUINCHOR,ZIGUINCHOR,NIAGUIS,ADEANE,"H2 LAGOUA",32,36,132,142,274
ZIGUINCHOR,ZIGUINCHOR,NIAGUIS,ADEANE,TAMBACOUMBA,91,135,463,520,983
ZIGUINCHOR,ZIGUINCHOR,NIAGUIS,ADEANE,"BISSINE ALBONDY",29,31,113,91,204
ZIGUINCHOR,ZIGUINCHOR,NIAGUIS,ADEANE,"BISSINE TENDA",4,4,14,12,26
ZIGUINCHOR,ZIGUINCHOR,NIAGUIS,"BOUTOUPA CAMARACOUNDA","BINDIALOUM MANJACQUE",8,8,21,13,34
ZIGUINCHOR,ZIGUINCHOR,NIAGUIS,"BOUTOUPA CAMARACOUNDA","H1 BINDIALOUM",1,1,3,1,4
ZIGUINCHOR,ZIGUINCHOR,NIAGUIS,"BOUTOUPA CAMARACOUNDA","BARAKA BOUNAO",7,8,32,33,65
ZIGUINCHOR,ZIGUINCHOR,NIAGUIS,"BOUTOUPA CAMARACOUNDA","H1 LABYSSENTH",23,23,57,51,108
ZIGUINCHOR,ZIGUINCHOR,NIAGUIS,"BOUTOUPA CAMARACOUNDA","BARAKA PAKAO",6,7,16,11,27
ZIGUINCHOR,ZIGUINCHOR,NIAGUIS,"BOUTOUPA CAMARACOUNDA","H2 YABONE (PIDOUR)",6,6,16,16,32
ZIGUINCHOR,ZIGUINCHOR,NIAGUIS,"BOUTOUPA CAMARACOUNDA","H3 SALMINGOU",1,1,2,3,5
ZIGUINCHOR,ZIGUINCHOR,NIAGUIS,"BOUTOUPA CAMARACOUNDA",BOFFA,9,9,23,19,42
ZIGUINCHOR,ZIGUINCHOR,NIAGUIS,"BOUTOUPA CAMARACOUNDA","H1 BOFFA (CAMP MILITAIRE)",3,3,9,3,12
ZIGUINCHOR,ZIGUINCHOR,NIAGUIS,"BOUTOUPA CAMARACOUNDA","BOUROFAYE BAINOUCK",78,85,395,290,685
ZIGUINCHOR,ZIGUINCHOR,NIAGUIS,"BOUTOUPA CAMARACOUNDA","H1 TOURECOUNDA de BOUROFAYE BAINOUCK",6,11,34,35,69
ZIGUINCHOR,ZIGUINCHOR,NIAGUIS,"BOUTOUPA CAMARACOUNDA","H2 TRAWOUL",5,5,5,6,11
ZIGUINCHOR,ZIGUINCHOR,NIAGUIS,"BOUTOUPA CAMARACOUNDA","H3 WASHINGTON",3,3,27,8,35
ZIGUINCHOR,ZIGUINCHOR,NIAGUIS,"BOUTOUPA CAMARACOUNDA","H5 BAGAYA",6,7,22,17,39
ZIGUINCHOR,ZIGUINCHOR,NIAGUIS,"BOUTOUPA CAMARACOUNDA","H8 BADIONKOTO I",2,2,7,2,9
ZIGUINCHOR,ZIGUINCHOR,NIAGUIS,"BOUTOUPA CAMARACOUNDA","H10 POUBOUL",4,4,6,5,11
ZIGUINCHOR,ZIGUINCHOR,NIAGUIS,"BOUTOUPA CAMARACOUNDA","H11 TEMENTO",1,1,5,4,9
ZIGUINCHOR,ZIGUINCHOR,NIAGUIS,"BOUTOUPA CAMARACOUNDA","BOUROFAYE DIOLA",6,7,23,17,40
ZIGUINCHOR,ZIGUINCHOR,NIAGUIS,"BOUTOUPA CAMARACOUNDA","H1 EKEU",7,7,18,13,31
ZIGUINCHOR,ZIGUINCHOR,NIAGUIS,"BOUTOUPA CAMARACOUNDA","H2 NIAFOULENE",67,74,223,207,430
ZIGUINCHOR,ZIGUINCHOR,NIAGUIS,"BOUTOUPA CAMARACOUNDA","H3 BOUNKILING",21,21,78,47,125
ZIGUINCHOR,ZIGUINCHOR,NIAGUIS,"BOUTOUPA CAMARACOUNDA","H4 BOUCOTTE MANCAGNE",169,212,821,726,1547
ZIGUINCHOR,ZIGUINCHOR,NIAGUIS,"BOUTOUPA CAMARACOUNDA","H5 KAKOUNOUM",4,4,18,8,26
ZIGUINCHOR,ZIGUINCHOR,NIAGUIS,"BOUTOUPA CAMARACOUNDA",BOUTOUPA,3,5,18,25,43
ZIGUINCHOR,ZIGUINCHOR,NIAGUIS,"BOUTOUPA CAMARACOUNDA","H1 TRANQUILLE",93,102,413,350,763
ZIGUINCHOR,ZIGUINCHOR,NIAGUIS,"BOUTOUPA CAMARACOUNDA",CAMARACOUNDA,138,146,687,657,1344
ZIGUINCHOR,ZIGUINCHOR,NIAGUIS,"BOUTOUPA CAMARACOUNDA","GUIDEL BAMBADINKA",8,8,11,12,23
ZIGUINCHOR,ZIGUINCHOR,NIAGUIS,"BOUTOUPA CAMARACOUNDA","H1 BAMBADINKA",23,24,66,59,125
ZIGUINCHOR,ZIGUINCHOR,NIAGUIS,"BOUTOUPA CAMARACOUNDA","H3 FANGHOT MANJAQUE",10,10,29,27,56
ZIGUINCHOR,ZIGUINCHOR,NIAGUIS,"BOUTOUPA CAMARACOUNDA","H1 TEMPS",4,4,9,3,12
ZIGUINCHOR,ZIGUINCHOR,NIAGUIS,"BOUTOUPA CAMARACOUNDA",LATY,14,16,67,55,122
ZIGUINCHOR,ZIGUINCHOR,NIAGUIS,"BOUTOUPA CAMARACOUNDA","H2 TEMENTO",7,7,12,19,31
ZIGUINCHOR,ZIGUINCHOR,NIAGUIS,"BOUTOUPA CAMARACOUNDA",MAWA,33,33,139,152,291
ZIGUINCHOR,ZIGUINCHOR,NIAGUIS,"BOUTOUPA CAMARACOUNDA","H1 TOURECOUNDA de MAWA",4,5,10,9,19
ZIGUINCHOR,ZIGUINCHOR,NIAGUIS,"BOUTOUPA CAMARACOUNDA","MPACK BRIGADIER",59,59,253,221,474
ZIGUINCHOR,ZIGUINCHOR,NIAGUIS,"BOUTOUPA CAMARACOUNDA","H1 DRAMECOUNDA",2,2,5,7,12
ZIGUINCHOR,ZIGUINCHOR,NIAGUIS,"BOUTOUPA CAMARACOUNDA","H2 NTABARANE",66,74,191,198,389
ZIGUINCHOR,ZIGUINCHOR,NIAGUIS,"BOUTOUPA CAMARACOUNDA","H3 KABANCANY",28,32,104,91,195
ZIGUINCHOR,ZIGUINCHOR,NIAGUIS,"BOUTOUPA CAMARACOUNDA","H4 KAMPADA",29,39,90,63,153
ZIGUINCHOR,ZIGUINCHOR,NIAGUIS,"BOUTOUPA CAMARACOUNDA",NIABINA,27,27,106,124,230
ZIGUINCHOR,ZIGUINCHOR,NIAGUIS,"BOUTOUPA CAMARACOUNDA","H1 NIABINA II",6,6,26,29,55
ZIGUINCHOR,ZIGUINCHOR,NIAGUIS,"BOUTOUPA CAMARACOUNDA",NIADJOU,27,30,131,110,241
ZIGUINCHOR,ZIGUINCHOR,NIAGUIS,"BOUTOUPA CAMARACOUNDA",NIAFENIA,1,1,1,0,1
ZIGUINCHOR,ZIGUINCHOR,NIAGUIS,"BOUTOUPA CAMARACOUNDA","H1 NIAFETA VAINE",3,3,4,1,5
ZIGUINCHOR,ZIGUINCHOR,NIAGUIS,"BOUTOUPA CAMARACOUNDA",POUBOS,3,3,10,11,21
ZIGUINCHOR,ZIGUINCHOR,NIAGUIS,"BOUTOUPA CAMARACOUNDA",SAMICK,27,28,117,97,214
ZIGUINCHOR,ZIGUINCHOR,NIAGUIS,"BOUTOUPA CAMARACOUNDA","H3 KOUMPENTOU",8,8,19,25,44
ZIGUINCHOR,ZIGUINCHOR,NIAGUIS,"BOUTOUPA CAMARACOUNDA","H4 DIATATA (NTAPNICK)",7,7,25,27,52
ZIGUINCHOR,ZIGUINCHOR,NIAGUIS,"BOUTOUPA CAMARACOUNDA","H6 RANKEUBEUL KANTETOU (LATY MEDINE)",27,28,80,81,161
ZIGUINCHOR,ZIGUINCHOR,NIAGUIS,"BOUTOUPA CAMARACOUNDA","H8 ATOHI (NIAFENIA MANCAGNE)",6,6,13,7,20
ZIGUINCHOR,ZIGUINCHOR,NIAGUIS,"BOUTOUPA CAMARACOUNDA","H9 BALANTE COUNDA",1,1,2,1,3
ZIGUINCHOR,ZIGUINCHOR,NIAGUIS,"BOUTOUPA CAMARACOUNDA",TENDABA,12,14,35,60,95
ZIGUINCHOR,ZIGUINCHOR,NIAGUIS,"BOUTOUPA CAMARACOUNDA",YABONE,10,12,54,38,92
ZIGUINCHOR,ZIGUINCHOR,NIAGUIS,NIAGUIS,"BARAF (SINTHIANG)",58,60,245,194,439
ZIGUINCHOR,ZIGUINCHOR,NIAGUIS,NIAGUIS,"H1 DARAYA",8,8,23,19,42
ZIGUINCHOR,ZIGUINCHOR,NIAGUIS,NIAGUIS,"H2 TRANQUILLE (BARAF)",28,29,95,81,176
ZIGUINCHOR,ZIGUINCHOR,NIAGUIS,NIAGUIS,BOULOM,66,74,514,525,1039
ZIGUINCHOR,ZIGUINCHOR,NIAGUIS,NIAGUIS,BOUTOUTE,250,273,1138,1017,2155
ZIGUINCHOR,ZIGUINCHOR,NIAGUIS,NIAGUIS,DJIBELOR,108,121,384,354,738
ZIGUINCHOR,ZIGUINCHOR,NIAGUIS,NIAGUIS,DJIFANGHOR,95,104,426,528,954
ZIGUINCHOR,ZIGUINCHOR,NIAGUIS,NIAGUIS,"H1 KITOR",40,41,95,96,191
ZIGUINCHOR,ZIGUINCHOR,NIAGUIS,NIAGUIS,FANDA,257,290,1405,1417,2822
ZIGUINCHOR,ZIGUINCHOR,NIAGUIS,NIAGUIS,"H1 ARINGHALA BAINOUCK",19,20,70,100,170
ZIGUINCHOR,ZIGUINCHOR,NIAGUIS,NIAGUIS,"H2 ARINGHALA DIOLA",36,41,193,194,387
ZIGUINCHOR,ZIGUINCHOR,NIAGUIS,NIAGUIS,GOURAF,7,7,18,9,27
ZIGUINCHOR,ZIGUINCHOR,NIAGUIS,NIAGUIS,"MANDINA MANCAGNE",60,64,177,166,343
ZIGUINCHOR,ZIGUINCHOR,NIAGUIS,NIAGUIS,"H2 OUMPONTOU",13,13,41,31,72
ZIGUINCHOR,ZIGUINCHOR,NIAGUIS,NIAGUIS,"MANDINA MANJAQUE",17,18,27,36,63
ZIGUINCHOR,ZIGUINCHOR,NIAGUIS,NIAGUIS,"H5 MALOC",6,7,15,12,27
ZIGUINCHOR,ZIGUINCHOR,NIAGUIS,NIAGUIS,"H5 TILBONKO",5,5,11,0,11
ZIGUINCHOR,ZIGUINCHOR,NIAGUIS,NIAGUIS,NIAGUIS,433,491,2123,2176,4299
ZIGUINCHOR,ZIGUINCHOR,NIAGUIS,NIAGUIS,SONE,5,5,16,7,23
ZIGUINCHOR,ZIGUINCHOR,NIAGUIS,NIAGUIS,"H2 SANTHIE MANJAQUE",6,6,10,7,17
ZIGUINCHOR,ZIGUINCHOR,NIAGUIS,NIAGUIS,"H2 FANGHOTE",46,46,124,127,251
ZIGUINCHOR,ZIGUINCHOR,NIAGUIS,NIAGUIS,SOUCOUTA,36,40,79,103,182
ZIGUINCHOR,ZIGUINCHOR,NIAGUIS,NIAGUIS,KAGUIL,20,20,77,69,146
ZIGUINCHOR,ZIGUINCHOR,NIAGUIS,NIAGUIS,KANTENE,690,800,2970,2796,5766
ZIGUINCHOR,ZIGUINCHOR,NIAGUIS,NIAGUIS,"KANTENE 2",158,162,573,501,1074
ZIGUINCHOR,ZIGUINCHOR,NIAGUIS,NIAGUIS,"MANDINA THIERNO",40,41,137,120,257
ZIGUINCHOR,ZIGUINCHOR,NIASSIA,ENAMPORE,"BADIATE GRAND",61,66,172,155,327
ZIGUINCHOR,ZIGUINCHOR,NIASSIA,ENAMPORE,"BADIATE SOUGHERE (BADIA)",14,18,58,46,104
ZIGUINCHOR,ZIGUINCHOR,NIASSIA,ENAMPORE,BANDIALE,48,59,95,101,196
ZIGUINCHOR,ZIGUINCHOR,NIASSIA,ENAMPORE,DJIBONKER,35,36,73,73,146
ZIGUINCHOR,ZIGUINCHOR,NIASSIA,ENAMPORE,"DJIBONKER ERING",79,85,269,238,507
ZIGUINCHOR,ZIGUINCHOR,NIASSIA,ENAMPORE,ENAMPORE,113,141,315,314,629
ZIGUINCHOR,ZIGUINCHOR,NIASSIA,ENAMPORE,"H1 SOUCOUTA",10,11,29,24,53
ZIGUINCHOR,ZIGUINCHOR,NIASSIA,ENAMPORE,ESSYL,65,70,158,134,292
ZIGUINCHOR,ZIGUINCHOR,NIASSIA,ENAMPORE,ETAMA,20,25,43,46,89
ZIGUINCHOR,ZIGUINCHOR,NIASSIA,ENAMPORE,KAMOBEUL,111,120,318,292,610
ZIGUINCHOR,ZIGUINCHOR,NIASSIA,ENAMPORE,"KAMOBEUL MANJACK",21,21,65,80,145
ZIGUINCHOR,ZIGUINCHOR,NIASSIA,ENAMPORE,"MEDINA (BOUDIALABOU)",59,59,175,144,319
ZIGUINCHOR,ZIGUINCHOR,NIASSIA,ENAMPORE,"H2 BADIONKOTO",4,4,9,14,23
ZIGUINCHOR,ZIGUINCHOR,NIASSIA,ENAMPORE,"SELEKY BAHIMBANE",45,49,84,81,165
ZIGUINCHOR,ZIGUINCHOR,NIASSIA,ENAMPORE,"SELEKY EBOHA",38,41,84,99,183
ZIGUINCHOR,ZIGUINCHOR,NIASSIA,ENAMPORE,"SELEKY KAHINDOUA",30,35,76,54,130
ZIGUINCHOR,ZIGUINCHOR,NIASSIA,ENAMPORE,"SELEKY DIOULOUGHENE",36,41,66,60,126
ZIGUINCHOR,ZIGUINCHOR,NIASSIA,ENAMPORE,"SELEKY DIOULOULOU",13,13,20,24,44
ZIGUINCHOR,ZIGUINCHOR,NIASSIA,ENAMPORE,"BANKOU WOULING",16,17,65,42,107
ZIGUINCHOR,ZIGUINCHOR,NIASSIA,ENAMPORE,BATIGHERE,6,8,15,5,20
ZIGUINCHOR,ZIGUINCHOR,NIASSIA,ENAMPORE,BRIN,119,120,230,227,457
ZIGUINCHOR,ZIGUINCHOR,NIASSIA,ENAMPORE,"DJIBONKER MANJACK",1,1,1,3,4
ZIGUINCHOR,ZIGUINCHOR,NIASSIA,ENAMPORE,MAMATORO,44,44,110,91,201
ZIGUINCHOR,ZIGUINCHOR,NIASSIA,NIASSIA,BACOUNOUM,42,43,108,110,218
ZIGUINCHOR,ZIGUINCHOR,NIASSIA,NIASSIA,BAFICAN,40,40,95,86,181
ZIGUINCHOR,ZIGUINCHOR,NIASSIA,NIASSIA,BAGAME,1,1,6,5,11
ZIGUINCHOR,ZIGUINCHOR,NIASSIA,NIASSIA,BASSERE,15,16,37,39,76
ZIGUINCHOR,ZIGUINCHOR,NIASSIA,NIASSIA,"BOFFA BAYOTTE",17,17,73,62,135
ZIGUINCHOR,ZIGUINCHOR,NIASSIA,NIASSIA,"H1 BISSANOUME PEUL",34,35,94,75,169
ZIGUINCHOR,ZIGUINCHOR,NIASSIA,NIASSIA,BOUHOUYOU,15,15,31,35,66
ZIGUINCHOR,ZIGUINCHOR,NIASSIA,NIASSIA,DARSALAM,71,80,295,272,567
ZIGUINCHOR,ZIGUINCHOR,NIASSIA,NIASSIA,DIALANG,48,50,119,138,257
ZIGUINCHOR,ZIGUINCHOR,NIASSIA,NIASSIA,DIOHER,61,62,122,133,255
ZIGUINCHOR,ZIGUINCHOR,NIASSIA,NIASSIA,EDIOUMA,21,24,46,39,85
ZIGUINCHOR,ZIGUINCHOR,NIASSIA,NIASSIA,ETAFOUNE,17,17,37,38,75
ZIGUINCHOR,ZIGUINCHOR,NIASSIA,NIASSIA,ETOME,40,41,107,132,239
ZIGUINCHOR,ZIGUINCHOR,NIASSIA,NIASSIA,KAGUITTE,249,258,832,695,1527
ZIGUINCHOR,ZIGUINCHOR,NIASSIA,NIASSIA,KAILOU,50,52,106,125,231
ZIGUINCHOR,ZIGUINCHOR,NIASSIA,NIASSIA,KALEANE,50,50,145,144,289
ZIGUINCHOR,ZIGUINCHOR,NIASSIA,NIASSIA,"H1 PONT DE NIAMBALANG",8,8,30,9,39
ZIGUINCHOR,ZIGUINCHOR,NIASSIA,NIASSIA,KASSOULOU,25,26,60,69,129
ZIGUINCHOR,ZIGUINCHOR,NIASSIA,NIASSIA,KATOURE,27,27,62,53,115
ZIGUINCHOR,ZIGUINCHOR,NIASSIA,NIASSIA,KADIENE,14,14,30,28,58
ZIGUINCHOR,ZIGUINCHOR,NIASSIA,NIASSIA,KOURING,16,19,31,25,56
ZIGUINCHOR,ZIGUINCHOR,NIASSIA,NIASSIA,NYASSIA,48,59,196,158,354
ZIGUINCHOR,ZIGUINCHOR,NIASSIA,NIASSIA,"H1 ETOME",2,2,6,6,12
ZIGUINCHOR,ZIGUINCHOR,NIASSIA,NIASSIA,TOUBACOUTA,41,44,191,188,379
ZIGUINCHOR,ZIGUINCHOR,NIASSIA,NIASSIA,"KASSOU SENEGAL",20,22,73,73,146
DIOURBEL,BAMBEY,BAMBEY,BAMBEY,"LEONA NORD",240,281,1230,1469,2699
DIOURBEL,BAMBEY,BAMBEY,BAMBEY,"LEONA SUD",442,554,2190,2522,4712
DIOURBEL,BAMBEY,BAMBEY,BAMBEY,"DVF CENTRE",523,790,2763,2978,5741
DIOURBEL,BAMBEY,BAMBEY,BAMBEY,"DVF EST",365,533,1952,2209,4161
DIOURBEL,BAMBEY,BAMBEY,BAMBEY,"DVF OUEST",479,721,2772,2892,5664
DIOURBEL,BAMBEY,BAMBEY,BAMBEY,ESCALE,86,151,553,353,906
DIOURBEL,BAMBEY,BAMBEY,BAMBEY,"KAYENNE KEUR MASSE",255,307,1506,1738,3244
DIOURBEL,BAMBEY,BAMBEY,BAMBEY,"KEUR SAKOURA BADIANE",333,401,1780,1943,3723
DIOURBEL,BAMBEY,BAMBEY,BAMBEY,"WAKHALDIAM NORD",313,364,1611,1749,3360
DIOURBEL,BAMBEY,BAMBEY,BAMBEY,"WAKHALDIAM SUD",316,405,1435,1729,3164
DIOURBEL,BAMBEY,"BABA GARAGE","BABA GARAGE","BABA GARAGE",147,215,856,907,1763
DIOURBEL,BAMBEY,"BABA GARAGE","BABA GARAGE","BAITY KANE",14,18,135,117,252
DIOURBEL,BAMBEY,"BABA GARAGE","BABA GARAGE","DAROU BAKHOUM",37,57,248,273,521
DIOURBEL,BAMBEY,"BABA GARAGE","BABA GARAGE","DAROU DIOP 1",5,7,28,32,60
DIOURBEL,BAMBEY,"BABA GARAGE","BABA GARAGE","DAROU NGUER",11,18,143,156,299
DIOURBEL,BAMBEY,"BABA GARAGE","BABA GARAGE","H1 KEUR NDIARNDE",6,6,45,28,73
DIOURBEL,BAMBEY,"BABA GARAGE","BABA GARAGE",GNICK,6,9,57,53,110
DIOURBEL,BAMBEY,"BABA GARAGE","BABA GARAGE","H1 PALENE",8,8,54,24,78
DIOURBEL,BAMBEY,"BABA GARAGE","BABA GARAGE",KADE,13,17,115,93,208
DIOURBEL,BAMBEY,"BABA GARAGE","BABA GARAGE","H1 MBADJIE KADE",6,6,33,40,73
DIOURBEL,BAMBEY,"BABA GARAGE","BABA GARAGE","KAIRE MALICK",5,6,35,37,72
DIOURBEL,BAMBEY,"BABA GARAGE","BABA GARAGE","KEUR ASSANE KANE",23,33,133,116,249
DIOURBEL,BAMBEY,"BABA GARAGE","BABA GARAGE","KEUR GORA NDIAYE",10,13,81,55,136
DIOURBEL,BAMBEY,"BABA GARAGE","BABA GARAGE","KEUR MACOUMBA",19,21,105,125,230
DIOURBEL,BAMBEY,"BABA GARAGE","BABA GARAGE","KEUR MAKHOUDIA",17,31,193,192,385
DIOURBEL,BAMBEY,"BABA GARAGE","BABA GARAGE","KEUR MASSAMBA NDOUMBE",79,97,488,429,917
DIOURBEL,BAMBEY,"BABA GARAGE","BABA GARAGE","KEUR MOUSSE SIR",9,13,82,87,169
DIOURBEL,BAMBEY,"BABA GARAGE","BABA GARAGE","KEUR OUSMANE KANE",33,37,197,216,413
DIOURBEL,BAMBEY,"BABA GARAGE","BABA GARAGE","H1 MBARRO",11,14,90,83,173
DIOURBEL,BAMBEY,"BABA GARAGE","BABA GARAGE","H2 DAROU CISS",1,3,25,14,39
DIOURBEL,BAMBEY,"BABA GARAGE","BABA GARAGE","KEUR SAMBA YACINE (TAIBA)",19,22,145,151,296
DIOURBEL,BAMBEY,"BABA GARAGE","BABA GARAGE",KEWRE,18,33,166,197,363
DIOURBEL,BAMBEY,"BABA GARAGE","BABA GARAGE","KHAYE NDIAYE",20,22,166,139,305
DIOURBEL,BAMBEY,"BABA GARAGE","BABA GARAGE",LAMSAR,9,14,98,80,178
DIOURBEL,BAMBEY,"BABA GARAGE","BABA GARAGE",LOYENE,13,17,132,90,222
DIOURBEL,BAMBEY,"BABA GARAGE","BABA GARAGE","MACKA DIOKHANE",5,12,39,43,82
DIOURBEL,BAMBEY,"BABA GARAGE","BABA GARAGE",MBAKHE,34,57,206,207,413
DIOURBEL,BAMBEY,"BABA GARAGE","BABA GARAGE","H1 KEUR DIERY",4,7,31,26,57
DIOURBEL,BAMBEY,"BABA GARAGE","BABA GARAGE","H2 MBALENE",9,14,66,62,128
DIOURBEL,BAMBEY,"BABA GARAGE","BABA GARAGE","MEOUNDOU KANE",17,21,171,117,288
DIOURBEL,BAMBEY,"BABA GARAGE","BABA GARAGE","MERINA KANE",11,11,90,67,157
DIOURBEL,BAMBEY,"BABA GARAGE","BABA GARAGE","NDARY DIOP",27,35,208,145,353
DIOURBEL,BAMBEY,"BABA GARAGE","BABA GARAGE","NDARY GADE",59,73,307,321,628
DIOURBEL,BAMBEY,"BABA GARAGE","BABA GARAGE","NDARY PALENE",17,23,126,127,253
DIOURBEL,BAMBEY,"BABA GARAGE","BABA GARAGE",NDIABY,37,52,248,255,503
DIOURBEL,BAMBEY,"BABA GARAGE","BABA GARAGE","NDIAGNE SITOR",6,8,69,60,129
DIOURBEL,BAMBEY,"BABA GARAGE","BABA GARAGE","H1 FASS",3,3,20,24,44
DIOURBEL,BAMBEY,"BABA GARAGE","BABA GARAGE","NDIARNO NDIOBEL",23,25,62,89,151
DIOURBEL,BAMBEY,"BABA GARAGE","BABA GARAGE",NDIAWAGNE,5,5,38,42,80
DIOURBEL,BAMBEY,"BABA GARAGE","BABA GARAGE",NDIECKINANE,15,15,67,108,175
DIOURBEL,BAMBEY,"BABA GARAGE","BABA GARAGE","NDIEULBER 1",36,37,162,165,327
DIOURBEL,BAMBEY,"BABA GARAGE","BABA GARAGE","NDIEULBER 2",21,23,146,165,311
DIOURBEL,BAMBEY,"BABA GARAGE","BABA GARAGE",NDJILIWENE,20,23,116,158,274
DIOURBEL,BAMBEY,"BABA GARAGE","BABA GARAGE",NDIOBEL,27,45,292,285,577
DIOURBEL,BAMBEY,"BABA GARAGE","BABA GARAGE",NGOKINE,6,8,36,36,72
DIOURBEL,BAMBEY,"BABA GARAGE","BABA GARAGE","SAM SAM",16,22,121,152,273
DIOURBEL,BAMBEY,"BABA GARAGE","BABA GARAGE","H1 KEUR DJIBY NDIAYE",4,4,21,29,50
DIOURBEL,BAMBEY,"BABA GARAGE","BABA GARAGE","H2 TEUGUE SAM SAM",5,5,25,35,60
DIOURBEL,BAMBEY,"BABA GARAGE","BABA GARAGE",SATE,30,35,119,136,255
DIOURBEL,BAMBEY,"BABA GARAGE","BABA GARAGE",SITOR,12,13,71,72,143
DIOURBEL,BAMBEY,"BABA GARAGE","BABA GARAGE","H1 MBAPPY",4,4,31,26,57
DIOURBEL,BAMBEY,"BABA GARAGE","BABA GARAGE","TAWA FALL",71,89,744,643,1387
DIOURBEL,BAMBEY,"BABA GARAGE","BABA GARAGE","H1 NDOGAL FALL",21,23,191,186,377
DIOURBEL,BAMBEY,"BABA GARAGE","BABA GARAGE","H1 PASS FALL",12,23,89,137,226
DIOURBEL,BAMBEY,"BABA GARAGE","BABA GARAGE",THIAGAL,35,49,242,320,562
DIOURBEL,BAMBEY,"BABA GARAGE","BABA GARAGE","THIALLE GNICK",39,43,271,228,499
DIOURBEL,BAMBEY,"BABA GARAGE","BABA GARAGE",THIANGA,1,4,17,10,27
DIOURBEL,BAMBEY,"BABA GARAGE","BABA GARAGE",THIENABA,12,16,122,74,196
DIOURBEL,BAMBEY,"BABA GARAGE","BABA GARAGE","THIEUL FANAYE",7,8,91,77,168
DIOURBEL,BAMBEY,"BABA GARAGE","BABA GARAGE","H1 FANAYE LEYE",20,28,273,256,529
DIOURBEL,BAMBEY,"BABA GARAGE","BABA GARAGE","H2 DAROU DIOP",11,12,112,127,239
DIOURBEL,BAMBEY,"BABA GARAGE","BABA GARAGE","H3 MAKA LEYE",3,3,24,31,55
DIOURBEL,BAMBEY,"BABA GARAGE","BABA GARAGE",TORO,15,19,59,45,104
DIOURBEL,BAMBEY,"BABA GARAGE","BABA GARAGE",YADOU,14,17,89,113,202
DIOURBEL,BAMBEY,"BABA GARAGE","BABA GARAGE","NDIEULBER 3",29,31,137,173,310
DIOURBEL,BAMBEY,"BABA GARAGE",DINGUIRAYE,BADAR,7,7,75,24,99
DIOURBEL,BAMBEY,"BABA GARAGE",DINGUIRAYE,BARIDIAME,31,42,208,210,418
DIOURBEL,BAMBEY,"BABA GARAGE",DINGUIRAYE,"DAROU DIOP 2",5,5,42,17,59
DIOURBEL,BAMBEY,"BABA GARAGE",DINGUIRAYE,DIAMA,6,8,35,41,76
DIOURBEL,BAMBEY,"BABA GARAGE",DINGUIRAYE,DINGUIRAYE,45,57,360,352,712
DIOURBEL,BAMBEY,"BABA GARAGE",DINGUIRAYE,"H1 NDIAMBOUR",13,15,87,80,167
DIOURBEL,BAMBEY,"BABA GARAGE",DINGUIRAYE,DIOLA,10,11,62,51,113
DIOURBEL,BAMBEY,"BABA GARAGE",DINGUIRAYE,GOLL,8,10,45,51,96
DIOURBEL,BAMBEY,"BABA GARAGE",DINGUIRAYE,"H1 NDOB",5,6,21,34,55
DIOURBEL,BAMBEY,"BABA GARAGE",DINGUIRAYE,"H2 TOURE",9,9,31,38,69
DIOURBEL,BAMBEY,"BABA GARAGE",DINGUIRAYE,"H4 RIP",3,6,21,27,48
DIOURBEL,BAMBEY,"BABA GARAGE",DINGUIRAYE,"GRAM FALL",15,18,89,108,197
DIOURBEL,BAMBEY,"BABA GARAGE",DINGUIRAYE,"H1 THIEKANE GRAM",19,25,96,97,193
DIOURBEL,BAMBEY,"BABA GARAGE",DINGUIRAYE,KALOM,10,10,73,55,128
DIOURBEL,BAMBEY,"BABA GARAGE",DINGUIRAYE,KANGHARLO,9,12,100,82,182
DIOURBEL,BAMBEY,"BABA GARAGE",DINGUIRAYE,"KARE (DEUK BOUREY)",11,14,116,47,163
DIOURBEL,BAMBEY,"BABA GARAGE",DINGUIRAYE,"H2 KEUR MADIAKHOU",4,4,24,24,48
DIOURBEL,BAMBEY,"BABA GARAGE",DINGUIRAYE,"H3 THYSSENE",6,8,38,40,78
DIOURBEL,BAMBEY,"BABA GARAGE",DINGUIRAYE,"KEUR BIRAME",12,14,55,59,114
DIOURBEL,BAMBEY,"BABA GARAGE",DINGUIRAYE,"KEUR DEMBA SAB",6,7,39,36,75
DIOURBEL,BAMBEY,"BABA GARAGE",DINGUIRAYE,"H1 DIOKANE",10,11,69,79,148
DIOURBEL,BAMBEY,"BABA GARAGE",DINGUIRAYE,"KEUR MADIOP DIEUMB",44,49,224,324,548
DIOURBEL,BAMBEY,"BABA GARAGE",DINGUIRAYE,"KEUR MAKHALY",34,39,218,216,434
DIOURBEL,BAMBEY,"BABA GARAGE",DINGUIRAYE,"KOURE NDIAGNE",9,10,30,44,74
DIOURBEL,BAMBEY,"BABA GARAGE",DINGUIRAYE,"H2 PARBA ALLA",2,4,19,23,42
DIOURBEL,BAMBEY,"BABA GARAGE",DINGUIRAYE,"H2 PEUL GUI",9,16,78,72,150
DIOURBEL,BAMBEY,"BABA GARAGE",DINGUIRAYE,"MBADIE GOLL",17,17,58,59,117
DIOURBEL,BAMBEY,"BABA GARAGE",DINGUIRAYE,MBAYE,18,18,92,65,157
DIOURBEL,BAMBEY,"BABA GARAGE",DINGUIRAYE,"H1 THIALENE",1,1,7,2,9
DIOURBEL,BAMBEY,"BABA GARAGE",DINGUIRAYE,MBERE,4,4,27,18,45
DIOURBEL,BAMBEY,"BABA GARAGE",DINGUIRAYE,"H1 THIERERE KEUR AMATH NIANG",1,1,11,6,17
DIOURBEL,BAMBEY,"BABA GARAGE",DINGUIRAYE,"MERINA NGEOUL",14,18,104,95,199
DIOURBEL,BAMBEY,"BABA GARAGE",DINGUIRAYE,NDAKHAR,13,18,78,85,163
DIOURBEL,BAMBEY,"BABA GARAGE",DINGUIRAYE,NDATTOU,17,21,162,143,305
DIOURBEL,BAMBEY,"BABA GARAGE",DINGUIRAYE,"H2 KEUR BIRANE",1,1,6,2,8
DIOURBEL,BAMBEY,"BABA GARAGE",DINGUIRAYE,"H3 DAROU NDIAYE",34,36,322,233,555
DIOURBEL,BAMBEY,"BABA GARAGE",DINGUIRAYE,"H4 KEUR IBRA KHARI",6,7,53,50,103
DIOURBEL,BAMBEY,"BABA GARAGE",DINGUIRAYE,"H5 KEUR MEDOUNE",2,2,33,27,60
DIOURBEL,BAMBEY,"BABA GARAGE",DINGUIRAYE,"H6 PALENE",8,10,56,50,106
DIOURBEL,BAMBEY,"BABA GARAGE",DINGUIRAYE,NDEME,14,19,70,78,148
DIOURBEL,BAMBEY,"BABA GARAGE",DINGUIRAYE,"NDIAGNE MBAYE",2,2,23,10,33
DIOURBEL,BAMBEY,"BABA GARAGE",DINGUIRAYE,"H1 NDIAGNE TAMBEDOU",1,1,13,1,14
DIOURBEL,BAMBEY,"BABA GARAGE",DINGUIRAYE,NDIALIGUE,11,13,111,75,186
DIOURBEL,BAMBEY,"BABA GARAGE",DINGUIRAYE,"NDIANE 1",12,18,123,72,195
DIOURBEL,BAMBEY,"BABA GARAGE",DINGUIRAYE,"H1 KEUR ALY MAME TOURE",13,15,90,62,152
DIOURBEL,BAMBEY,"BABA GARAGE",DINGUIRAYE,"H2 KEUR ABLAYE NAR GADEGA",12,16,123,74,197
DIOURBEL,BAMBEY,"BABA GARAGE",DINGUIRAYE,"H3 NDIANE SANTHIE",3,4,49,26,75
DIOURBEL,BAMBEY,"BABA GARAGE",DINGUIRAYE,"NDIANE 2",2,2,22,18,40
DIOURBEL,BAMBEY,"BABA GARAGE",DINGUIRAYE,"NDIAYALLA 1",14,15,119,116,235
DIOURBEL,BAMBEY,"BABA GARAGE",DINGUIRAYE,"NDIAYALLA 2",8,9,53,71,124
DIOURBEL,BAMBEY,"BABA GARAGE",DINGUIRAYE,"H1 NARGA",6,6,23,37,60
DIOURBEL,BAMBEY,"BABA GARAGE",DINGUIRAYE,NDIEGUE,39,46,268,257,525
DIOURBEL,BAMBEY,"BABA GARAGE",DINGUIRAYE,"H1 THIOL FALL",6,7,30,35,65
DIOURBEL,BAMBEY,"BABA GARAGE",DINGUIRAYE,"NGUER PEUL",22,43,214,200,414
DIOURBEL,BAMBEY,"BABA GARAGE",DINGUIRAYE,"PAYE BARIDIAM",9,11,51,42,93
DIOURBEL,BAMBEY,"BABA GARAGE",DINGUIRAYE,"H1 PAYE GOUNDAW",4,8,30,42,72
DIOURBEL,BAMBEY,"BABA GARAGE",DINGUIRAYE,SEMBEME,15,17,126,123,249
DIOURBEL,BAMBEY,"BABA GARAGE",DINGUIRAYE,"H1 DALDIAM",5,6,55,58,113
DIOURBEL,BAMBEY,"BABA GARAGE",DINGUIRAYE,"THIAR GRAM",9,11,50,46,96
DIOURBEL,BAMBEY,"BABA GARAGE",DINGUIRAYE,THIARENE,9,13,79,82,161
DIOURBEL,BAMBEY,"BABA GARAGE",DINGUIRAYE,THIAYTOU,81,112,752,734,1486
DIOURBEL,BAMBEY,"BABA GARAGE",DINGUIRAYE,"H2 DIORDI",4,7,45,26,71
DIOURBEL,BAMBEY,"BABA GARAGE",DINGUIRAYE,"H1 THIAYTOU PEUL",4,6,41,38,79
DIOURBEL,BAMBEY,"BABA GARAGE",DINGUIRAYE,THIEULMBERE,7,10,127,32,159
DIOURBEL,BAMBEY,"BABA GARAGE",DINGUIRAYE,"H1 GANDIOL ET THISSEDE",5,9,58,22,80
DIOURBEL,BAMBEY,"BABA GARAGE",DINGUIRAYE,"H2 KEUR MADIENG",1,1,3,1,4
DIOURBEL,BAMBEY,"BABA GARAGE",DINGUIRAYE,THIOKHOLE,18,24,109,111,220
DIOURBEL,BAMBEY,"BABA GARAGE",DINGUIRAYE,TOUNGHOR,17,21,101,104,205
DIOURBEL,BAMBEY,"BABA GARAGE","KEUR SAMBA KANE",DAFF,18,23,161,159,320
DIOURBEL,BAMBEY,"BABA GARAGE","KEUR SAMBA KANE","H1 KEUR SEYDOU TINE",10,13,82,66,148
DIOURBEL,BAMBEY,"BABA GARAGE","KEUR SAMBA KANE",DAROU,7,9,49,48,97
DIOURBEL,BAMBEY,"BABA GARAGE","KEUR SAMBA KANE","DIMAR KANE",22,26,198,251,449
DIOURBEL,BAMBEY,"BABA GARAGE","KEUR SAMBA KANE",FASSEL,20,28,189,213,402
DIOURBEL,BAMBEY,"BABA GARAGE","KEUR SAMBA KANE","H1 KARE KARE",6,10,43,33,76
DIOURBEL,BAMBEY,"BABA GARAGE","KEUR SAMBA KANE","H2 KEUR MADIAKHATE",9,14,90,75,165
DIOURBEL,BAMBEY,"BABA GARAGE","KEUR SAMBA KANE","H3 KEUR DAME",8,10,83,47,130
DIOURBEL,BAMBEY,"BABA GARAGE","KEUR SAMBA KANE","H4 NDIA",5,6,20,22,42
DIOURBEL,BAMBEY,"BABA GARAGE","KEUR SAMBA KANE","GADE BISSICK",8,8,38,35,73
DIOURBEL,BAMBEY,"BABA GARAGE","KEUR SAMBA KANE",GANDAL,84,116,505,580,1085
DIOURBEL,BAMBEY,"BABA GARAGE","KEUR SAMBA KANE",GAYAME,121,143,661,737,1398
DIOURBEL,BAMBEY,"BABA GARAGE","KEUR SAMBA KANE","H1 SINGUE",5,8,46,51,97
DIOURBEL,BAMBEY,"BABA GARAGE","KEUR SAMBA KANE","H2 SOUREKH",14,22,106,103,209
DIOURBEL,BAMBEY,"BABA GARAGE","KEUR SAMBA KANE","H1 NIASSANE",6,6,51,53,104
DIOURBEL,BAMBEY,"BABA GARAGE","KEUR SAMBA KANE","GOLBY ASSANE (GOLBY DIOP)",26,38,155,217,372
DIOURBEL,BAMBEY,"BABA GARAGE","KEUR SAMBA KANE","GOLBY BIRIMA",1,1,7,10,17
DIOURBEL,BAMBEY,"BABA GARAGE","KEUR SAMBA KANE","GOLBY MADOCKY",2,2,8,6,14
DIOURBEL,BAMBEY,"BABA GARAGE","KEUR SAMBA KANE","GOLBY TEUG",4,5,45,49,94
DIOURBEL,BAMBEY,"BABA GARAGE","KEUR SAMBA KANE","H1 KERY (GOLBY NDIAYE)",11,15,194,92,286
DIOURBEL,BAMBEY,"BABA GARAGE","KEUR SAMBA KANE","GOUYE DOCK",33,42,177,146,323
DIOURBEL,BAMBEY,"BABA GARAGE","KEUR SAMBA KANE",KAHONE,9,9,62,56,118
DIOURBEL,BAMBEY,"BABA GARAGE","KEUR SAMBA KANE","H1 KEUR MOR KHARY DE TAWA FALL (BABA GARAGE)",20,23,140,107,247
DIOURBEL,BAMBEY,"BABA GARAGE","KEUR SAMBA KANE","KAIRE MAPATHE",32,35,100,101,201
DIOURBEL,BAMBEY,"BABA GARAGE","KEUR SAMBA KANE","H3 THIEWENE",7,7,20,27,47
DIOURBEL,BAMBEY,"BABA GARAGE","KEUR SAMBA KANE",KALL,4,4,24,14,38
DIOURBEL,BAMBEY,"BABA GARAGE","KEUR SAMBA KANE","KEUR GAYE SEYE",28,34,217,222,439
DIOURBEL,BAMBEY,"BABA GARAGE","KEUR SAMBA KANE","H1 KEUR ALE",5,6,14,12,26
DIOURBEL,BAMBEY,"BABA GARAGE","KEUR SAMBA KANE","H2 PEULGA KEUR YORO KA",8,10,43,49,92
DIOURBEL,BAMBEY,"BABA GARAGE","KEUR SAMBA KANE","KEUR KHALY COURA",29,32,75,78,153
DIOURBEL,BAMBEY,"BABA GARAGE","KEUR SAMBA KANE","H1 KEUR BOYDO KA",4,5,8,9,17
DIOURBEL,BAMBEY,"BABA GARAGE","KEUR SAMBA KANE","KEUR LEYE FAMBEYE",37,40,208,245,453
DIOURBEL,BAMBEY,"BABA GARAGE","KEUR SAMBA KANE","H1 PEULGA",6,6,31,32,63
DIOURBEL,BAMBEY,"BABA GARAGE","KEUR SAMBA KANE","KEUR MBATTA TOURE",4,4,18,28,46
DIOURBEL,BAMBEY,"BABA GARAGE","KEUR SAMBA KANE","H1 KEUR MAME BINETA GOANA",1,1,10,4,14
DIOURBEL,BAMBEY,"BABA GARAGE","KEUR SAMBA KANE","KEUR MBAYE ANTA",5,5,32,17,49
DIOURBEL,BAMBEY,"BABA GARAGE","KEUR SAMBA KANE","KEUR MEDOUNE FALL",21,22,93,118,211
DIOURBEL,BAMBEY,"BABA GARAGE","KEUR SAMBA KANE","KEUR OMAR BA",9,10,73,66,139
DIOURBEL,BAMBEY,"BABA GARAGE","KEUR SAMBA KANE","KEUR SAMBA KANE 1",57,67,431,537,968
DIOURBEL,BAMBEY,"BABA GARAGE","KEUR SAMBA KANE","KEUR SAMBA KANE 2",97,111,428,500,928
DIOURBEL,BAMBEY,"BABA GARAGE","KEUR SAMBA KANE","KEUR YANGHANE SARR",16,17,124,118,242
DIOURBEL,BAMBEY,"BABA GARAGE","KEUR SAMBA KANE",KHALBANE,6,9,36,39,75
DIOURBEL,BAMBEY,"BABA GARAGE","KEUR SAMBA KANE","KHAYE NDIAMSYL 1",10,12,68,71,139
DIOURBEL,BAMBEY,"BABA GARAGE","KEUR SAMBA KANE","KHAYE NDIAMSYL 2",9,12,49,86,135
DIOURBEL,BAMBEY,"BABA GARAGE","KEUR SAMBA KANE",LALA,21,27,180,192,372
DIOURBEL,BAMBEY,"BABA GARAGE","KEUR SAMBA KANE",MAGNAGNE,16,22,149,126,275
DIOURBEL,BAMBEY,"BABA GARAGE","KEUR SAMBA KANE",MBARIDIAME,25,25,104,124,228
DIOURBEL,BAMBEY,"BABA GARAGE","KEUR SAMBA KANE","H1 NDOURENE ET TOUBA BAiTY",12,12,44,79,123
DIOURBEL,BAMBEY,"BABA GARAGE","KEUR SAMBA KANE","H4 DAROU SEYE",3,3,8,15,23
DIOURBEL,BAMBEY,"BABA GARAGE","KEUR SAMBA KANE",MBOFFI,10,11,61,64,125
DIOURBEL,BAMBEY,"BABA GARAGE","KEUR SAMBA KANE",MBOUYO,11,11,95,76,171
DIOURBEL,BAMBEY,"BABA GARAGE","KEUR SAMBA KANE","NDIAGNE NDIAMSYL",8,10,92,58,150
DIOURBEL,BAMBEY,"BABA GARAGE","KEUR SAMBA KANE","NDIAMSYL PEYE",33,43,236,246,482
DIOURBEL,BAMBEY,"BABA GARAGE","KEUR SAMBA KANE","NDIAMSYL SESSENE",19,26,134,151,285
DIOURBEL,BAMBEY,"BABA GARAGE","KEUR SAMBA KANE","NDIANGA FALL",17,25,93,121,214
DIOURBEL,BAMBEY,"BABA GARAGE","KEUR SAMBA KANE",NDIARAW,72,90,527,548,1075
DIOURBEL,BAMBEY,"BABA GARAGE","KEUR SAMBA KANE",NDIARIGNE,59,70,282,331,613
DIOURBEL,BAMBEY,"BABA GARAGE","KEUR SAMBA KANE","NDIARNO RICADJI 1",44,60,254,305,559
DIOURBEL,BAMBEY,"BABA GARAGE","KEUR SAMBA KANE","NDIARNO RICADJI 2",50,65,355,380,735
DIOURBEL,BAMBEY,"BABA GARAGE","KEUR SAMBA KANE","H1 KEUR YOMBO DIOUF",2,3,8,8,16
DIOURBEL,BAMBEY,"BABA GARAGE","KEUR SAMBA KANE","NDIAYE DANKH",37,41,162,182,344
DIOURBEL,BAMBEY,"BABA GARAGE","KEUR SAMBA KANE","NDIOUDIOUF 1",42,58,329,295,624
DIOURBEL,BAMBEY,"BABA GARAGE","KEUR SAMBA KANE","NDIOUFFENE MBAR",16,25,210,189,399
DIOURBEL,BAMBEY,"BABA GARAGE","KEUR SAMBA KANE",DIOUNGUE,37,45,196,219,415
DIOURBEL,BAMBEY,"BABA GARAGE","KEUR SAMBA KANE",NDJITE,18,20,161,142,303
DIOURBEL,BAMBEY,"BABA GARAGE","KEUR SAMBA KANE","H1 PAKALA",2,3,20,13,33
DIOURBEL,BAMBEY,"BABA GARAGE","KEUR SAMBA KANE",DOURAME,25,29,233,181,414
DIOURBEL,BAMBEY,"BABA GARAGE","KEUR SAMBA KANE",NGAYENNE,9,10,68,70,138
DIOURBEL,BAMBEY,"BABA GARAGE","KEUR SAMBA KANE","NGOMENE DAKHAR",18,19,166,130,296
DIOURBEL,BAMBEY,"BABA GARAGE","KEUR SAMBA KANE","H1 KEUR NDIAGA",6,6,38,38,76
DIOURBEL,BAMBEY,"BABA GARAGE","KEUR SAMBA KANE","NGOMENE KAD",12,17,98,96,194
DIOURBEL,BAMBEY,"BABA GARAGE","KEUR SAMBA KANE",NIAKHENE,5,5,25,24,49
DIOURBEL,BAMBEY,"BABA GARAGE","KEUR SAMBA KANE","SADOU FALL",7,8,45,63,108
DIOURBEL,BAMBEY,"BABA GARAGE","KEUR SAMBA KANE","H1 SADOU MOURIDE ET DAROU FALL",9,10,72,92,164
DIOURBEL,BAMBEY,"BABA GARAGE","KEUR SAMBA KANE","SAM GOLBY",12,12,72,62,134
DIOURBEL,BAMBEY,"BABA GARAGE","KEUR SAMBA KANE",SESSENE,9,11,83,73,156
DIOURBEL,BAMBEY,"BABA GARAGE","KEUR SAMBA KANE","TALL NDIAMSYLL",11,12,113,97,210
DIOURBEL,BAMBEY,"BABA GARAGE","KEUR SAMBA KANE","THIALLE MABOUR",11,14,31,46,77
DIOURBEL,BAMBEY,"BABA GARAGE","KEUR SAMBA KANE","H1 KEUR OMAR DEME",1,1,1,1,2
DIOURBEL,BAMBEY,"BABA GARAGE","KEUR SAMBA KANE","THIAWARE NDIAMSYL",6,11,103,99,202
DIOURBEL,BAMBEY,"BABA GARAGE","KEUR SAMBA KANE","H1 MBABOU",4,5,15,11,26
DIOURBEL,BAMBEY,"BABA GARAGE","KEUR SAMBA KANE","THILMAKHA DIOUM",5,5,13,17,30
DIOURBEL,BAMBEY,"BABA GARAGE","KEUR SAMBA KANE","NDIOUDIOUF 2",18,32,248,207,455
DIOURBEL,BAMBEY,LAMBAYE,GAWANE,"BOUDJI BOUDJI (MBAALE)",6,12,60,59,119
DIOURBEL,BAMBEY,LAMBAYE,GAWANE,"BOUNGHOYE PEULH",23,26,158,174,332
DIOURBEL,BAMBEY,LAMBAYE,GAWANE,"H1 NDIONE KEUR MAWA DIONE",8,9,65,65,130
DIOURBEL,BAMBEY,LAMBAYE,GAWANE,"DAROU KHOUDOSS",22,24,127,166,293
DIOURBEL,BAMBEY,LAMBAYE,GAWANE,DIAKHAL,13,15,128,87,215
DIOURBEL,BAMBEY,LAMBAYE,GAWANE,"H1 DIAKHALE SERERE",11,12,117,109,226
DIOURBEL,BAMBEY,LAMBAYE,GAWANE,FASSEL,6,7,48,44,92
DIOURBEL,BAMBEY,LAMBAYE,GAWANE,GAPP,75,80,598,366,964
DIOURBEL,BAMBEY,LAMBAYE,GAWANE,"H2 THIOUMP PEULH",4,4,28,26,54
DIOURBEL,BAMBEY,LAMBAYE,GAWANE,"H3 KEUR SALIOU GNINGUE",3,3,39,34,73
DIOURBEL,BAMBEY,LAMBAYE,GAWANE,"GAWANE ESCALE",72,79,475,511,986
DIOURBEL,BAMBEY,LAMBAYE,GAWANE,"GAWANE M’BACKE",79,83,485,512,997
DIOURBEL,BAMBEY,LAMBAYE,GAWANE,"H1 KEUR BOCAR KA",7,9,41,42,83
DIOURBEL,BAMBEY,LAMBAYE,GAWANE,"H2 TIBO",13,22,111,129,240
DIOURBEL,BAMBEY,LAMBAYE,GAWANE,"H3 THIAMENE",22,30,218,168,386
DIOURBEL,BAMBEY,LAMBAYE,GAWANE,"H4 KEUR OUSMANE FAYE",1,1,10,9,19
DIOURBEL,BAMBEY,LAMBAYE,GAWANE,"H5 CADIOR",5,5,42,35,77
DIOURBEL,BAMBEY,LAMBAYE,GAWANE,"GOUYE MBAM",16,20,118,123,241
DIOURBEL,BAMBEY,LAMBAYE,GAWANE,"H2 KEUR GANA",13,15,104,120,224
DIOURBEL,BAMBEY,LAMBAYE,GAWANE,"KEUR ABDOU SALL",10,12,162,135,297
DIOURBEL,BAMBEY,LAMBAYE,GAWANE,"H1 BELELE GAOUDI",6,8,45,39,84
DIOURBEL,BAMBEY,LAMBAYE,GAWANE,"KEUR ALLE BABA",30,35,319,277,596
DIOURBEL,BAMBEY,LAMBAYE,GAWANE,"KEUR DIEUMB DIA (KEUR PATHE)",22,28,155,127,282
DIOURBEL,BAMBEY,LAMBAYE,GAWANE,"KEUR MASSAMBA NIANG",45,47,185,187,372
DIOURBEL,BAMBEY,LAMBAYE,GAWANE,"KEUR MBAR",34,40,376,362,738
DIOURBEL,BAMBEY,LAMBAYE,GAWANE,"LANGAR DEUNE",25,38,279,250,529
DIOURBEL,BAMBEY,LAMBAYE,GAWANE,"H1 WAKHALDIAM",14,16,110,110,220
DIOURBEL,BAMBEY,LAMBAYE,GAWANE,"LANGAR PEYE",27,31,151,179,330
DIOURBEL,BAMBEY,LAMBAYE,GAWANE,"MBAMBA TALL",9,14,97,107,204
DIOURBEL,BAMBEY,LAMBAYE,GAWANE,MBARICKER,14,17,135,126,261
DIOURBEL,BAMBEY,LAMBAYE,GAWANE,MBATHIE,5,5,40,27,67
DIOURBEL,BAMBEY,LAMBAYE,GAWANE,"H1 KEUR MAMADOU LY",1,2,17,10,27
DIOURBEL,BAMBEY,LAMBAYE,GAWANE,"H2 MBOUBENE",7,10,61,51,112
DIOURBEL,BAMBEY,LAMBAYE,GAWANE,MBENGUENE,2,3,15,10,25
DIOURBEL,BAMBEY,LAMBAYE,GAWANE,"H1 KEUR DEMBA BA",6,6,32,25,57
DIOURBEL,BAMBEY,LAMBAYE,GAWANE,"H2 KEUR ASSANE SOW",4,10,29,24,53
DIOURBEL,BAMBEY,LAMBAYE,GAWANE,NACKE,37,49,353,287,640
DIOURBEL,BAMBEY,LAMBAYE,GAWANE,"NDIARGA THIENENE",11,24,182,124,306
DIOURBEL,BAMBEY,LAMBAYE,GAWANE,NDIAWE,9,9,38,55,93
DIOURBEL,BAMBEY,LAMBAYE,GAWANE,"NDIEYENE THIALAO",17,25,187,171,358
DIOURBEL,BAMBEY,LAMBAYE,GAWANE,"H1 NDIOME NEKH",15,19,116,114,230
DIOURBEL,BAMBEY,LAMBAYE,GAWANE,"NDIMB BOUNGHOYE",8,9,36,36,72
DIOURBEL,BAMBEY,LAMBAYE,GAWANE,NDIOMBO,26,33,267,241,508
DIOURBEL,BAMBEY,LAMBAYE,GAWANE,NDIOMNEKH,8,9,71,61,132
DIOURBEL,BAMBEY,LAMBAYE,GAWANE,NDIONE,13,15,113,116,229
DIOURBEL,BAMBEY,LAMBAYE,GAWANE,NDIOURENE,18,29,207,158,365
DIOURBEL,BAMBEY,LAMBAYE,GAWANE,"NGARAFF 2",9,10,48,55,103
DIOURBEL,BAMBEY,LAMBAYE,GAWANE,NGARASSE,28,59,342,333,675
DIOURBEL,BAMBEY,LAMBAYE,GAWANE,NGAWANE,31,50,461,391,852
DIOURBEL,BAMBEY,LAMBAYE,GAWANE,"NGOKARE KA 1",7,12,84,68,152
DIOURBEL,BAMBEY,LAMBAYE,GAWANE,"NGOKARE KA 2",17,25,148,128,276
DIOURBEL,BAMBEY,LAMBAYE,GAWANE,"H1 TOUFFA",9,10,67,68,135
DIOURBEL,BAMBEY,LAMBAYE,GAWANE,"H3 KEUR LAT DIAGNE",5,9,54,41,95
DIOURBEL,BAMBEY,LAMBAYE,GAWANE,"NGOKARE SOW",21,23,144,169,313
DIOURBEL,BAMBEY,LAMBAYE,GAWANE,"H1 KEUR DEMBA SOW",9,9,46,41,87
DIOURBEL,BAMBEY,LAMBAYE,GAWANE,"H2 KEUR FADY",6,6,43,42,85
DIOURBEL,BAMBEY,LAMBAYE,GAWANE,"H1 KEURY KAW",5,10,65,57,122
DIOURBEL,BAMBEY,LAMBAYE,GAWANE,"PARBA LANGAR",10,13,111,109,220
DIOURBEL,BAMBEY,LAMBAYE,GAWANE,"PEULH NDIAYE",11,16,125,108,233
DIOURBEL,BAMBEY,LAMBAYE,GAWANE,"BOUNGHOYE PEYE",15,26,181,146,327
DIOURBEL,BAMBEY,LAMBAYE,GAWANE,"H1 THIARENE",5,5,32,28,60
DIOURBEL,BAMBEY,LAMBAYE,GAWANE,RINTABE,13,14,105,87,192
DIOURBEL,BAMBEY,LAMBAYE,GAWANE,"H1 KEUR SENY DIOUF",2,2,9,13,22
DIOURBEL,BAMBEY,LAMBAYE,GAWANE,"ROMBAL SARR",8,12,122,125,247
DIOURBEL,BAMBEY,LAMBAYE,GAWANE,SARR,45,57,357,378,735
DIOURBEL,BAMBEY,LAMBAYE,GAWANE,"H1 GOUYE NDIOGOU",36,50,323,329,652
DIOURBEL,BAMBEY,LAMBAYE,GAWANE,"H2 KEUR WAGANE",9,12,45,59,104
DIOURBEL,BAMBEY,LAMBAYE,GAWANE,"H3 KEUR SANOU",16,18,87,81,168
DIOURBEL,BAMBEY,LAMBAYE,GAWANE,"THIEYENE 1",8,9,78,62,140
DIOURBEL,BAMBEY,LAMBAYE,GAWANE,"THIEYENE 2",9,13,84,83,167
DIOURBEL,BAMBEY,LAMBAYE,GAWANE,THIOKEME,9,9,91,77,168
DIOURBEL,BAMBEY,LAMBAYE,GAWANE,"TOUBA LOYENE (COMMUNE LAMBAYE)",8,13,76,78,154
DIOURBEL,BAMBEY,LAMBAYE,GAWANE,"NGALLA 1",17,22,171,154,325
DIOURBEL,BAMBEY,LAMBAYE,GAWANE,"NGALLA 2",7,8,50,71,121
DIOURBEL,BAMBEY,LAMBAYE,GAWANE,"NDIALAP NGOKARE",3,3,18,21,39
DIOURBEL,BAMBEY,LAMBAYE,LAMBAYE,"DAGAYE TOURE (MBOULAME)",31,33,158,170,328
DIOURBEL,BAMBEY,LAMBAYE,LAMBAYE,"H1 NGUEWELGUI",9,11,78,59,137
DIOURBEL,BAMBEY,LAMBAYE,LAMBAYE,"DIAMA THIADA",18,24,163,140,303
DIOURBEL,BAMBEY,LAMBAYE,LAMBAYE,DIOKANE,54,66,240,355,595
DIOURBEL,BAMBEY,LAMBAYE,LAMBAYE,"H1 GOUMOUNE",13,18,98,115,213
DIOURBEL,BAMBEY,LAMBAYE,LAMBAYE,"H2 SANTHIOU KEUR MOUSSEU",15,18,112,158,270
DIOURBEL,BAMBEY,LAMBAYE,LAMBAYE,"H2 KEUR BARA TINE",8,9,35,64,99
DIOURBEL,BAMBEY,LAMBAYE,LAMBAYE,"NDOUGANE THIOUNE",4,6,21,30,51
DIOURBEL,BAMBEY,LAMBAYE,LAMBAYE,"H1 NDOUGANE BADIANE",1,2,19,22,41
DIOURBEL,BAMBEY,LAMBAYE,LAMBAYE,KALOM,16,21,119,109,228
DIOURBEL,BAMBEY,LAMBAYE,LAMBAYE,"KEUR DAOUDA NDIAYE",18,26,204,219,423
DIOURBEL,BAMBEY,LAMBAYE,LAMBAYE,"KEUR DAOUR SALL",14,20,138,177,315
DIOURBEL,BAMBEY,LAMBAYE,LAMBAYE,"KEUR IBRA KHOYANE (TAIBA KASSE)",17,26,82,75,157
DIOURBEL,BAMBEY,LAMBAYE,LAMBAYE,"KEUR LAT POTHIE",9,11,42,74,116
DIOURBEL,BAMBEY,LAMBAYE,LAMBAYE,"H1 DAROU FAYE",5,7,27,41,68
DIOURBEL,BAMBEY,LAMBAYE,LAMBAYE,"H2 GOUYE MOUMAH",4,6,19,38,57
DIOURBEL,BAMBEY,LAMBAYE,LAMBAYE,"KEUR NDIACK",6,8,33,38,71
DIOURBEL,BAMBEY,LAMBAYE,LAMBAYE,"KEUR SAMBA GAYE",33,43,295,317,612
DIOURBEL,BAMBEY,LAMBAYE,LAMBAYE,"H1 NGAGA SERERE",14,26,213,207,420
DIOURBEL,BAMBEY,LAMBAYE,LAMBAYE,"H2 MAKA",8,18,63,76,139
DIOURBEL,BAMBEY,LAMBAYE,LAMBAYE,"H3 NGAGA WOLOF",5,5,38,30,68
DIOURBEL,BAMBEY,LAMBAYE,LAMBAYE,"LAMBAYE ESCALE",106,141,689,799,1488
DIOURBEL,BAMBEY,LAMBAYE,LAMBAYE,"H1 GUAIDEUL",13,15,185,157,342
DIOURBEL,BAMBEY,LAMBAYE,LAMBAYE,"H2 KEUR KHALY",18,28,222,197,419
DIOURBEL,BAMBEY,LAMBAYE,LAMBAYE,"PEYE LAMBAYE",80,97,390,471,861
DIOURBEL,BAMBEY,LAMBAYE,LAMBAYE,"H1 KOUL",23,35,195,215,410
DIOURBEL,BAMBEY,LAMBAYE,LAMBAYE,"MAKA TASSAR",20,25,85,205,290
DIOURBEL,BAMBEY,LAMBAYE,LAMBAYE,"H1 MAKA SANTHIE",22,25,115,177,292
DIOURBEL,BAMBEY,LAMBAYE,LAMBAYE,"MBADIANE GORA",17,22,140,203,343
DIOURBEL,BAMBEY,LAMBAYE,LAMBAYE,"MBADIANE SAMBA AWA",43,47,261,330,591
DIOURBEL,BAMBEY,LAMBAYE,LAMBAYE,"H1 GOUYE DALLY",13,13,80,71,151
DIOURBEL,BAMBEY,LAMBAYE,LAMBAYE,"H2 KEUR BARA",4,5,28,40,68
DIOURBEL,BAMBEY,LAMBAYE,LAMBAYE,MBALMY,103,137,512,779,1291
DIOURBEL,BAMBEY,LAMBAYE,LAMBAYE,"H2 MBENE",10,15,71,69,140
DIOURBEL,BAMBEY,LAMBAYE,LAMBAYE,"MBOTAL LAMBAYE",61,70,322,411,733
DIOURBEL,BAMBEY,LAMBAYE,LAMBAYE,"H1 THIEMANE",12,13,55,65,120
DIOURBEL,BAMBEY,LAMBAYE,LAMBAYE,"H2 THIENO",11,22,87,101,188
DIOURBEL,BAMBEY,LAMBAYE,LAMBAYE,"H3 LOBETTE",12,16,80,100,180
DIOURBEL,BAMBEY,LAMBAYE,LAMBAYE,MBOUBANE,69,83,299,394,693
DIOURBEL,BAMBEY,LAMBAYE,LAMBAYE,"H1 TEUGUE",4,8,21,38,59
DIOURBEL,BAMBEY,LAMBAYE,LAMBAYE,"H2 SESSENE",1,1,3,5,8
DIOURBEL,BAMBEY,LAMBAYE,LAMBAYE,"H3 NDIANE",8,9,37,49,86
DIOURBEL,BAMBEY,LAMBAYE,LAMBAYE,"H4 NDIOSI",7,7,15,28,43
DIOURBEL,BAMBEY,LAMBAYE,LAMBAYE,MBOUSSO,49,76,311,304,615
DIOURBEL,BAMBEY,LAMBAYE,LAMBAYE,"H1 SANTHIOU MBOUSSO",15,22,180,144,324
DIOURBEL,BAMBEY,LAMBAYE,LAMBAYE,MEKHE,31,36,193,320,513
DIOURBEL,BAMBEY,LAMBAYE,LAMBAYE,"MERINA DIOP",8,9,63,76,139
DIOURBEL,BAMBEY,LAMBAYE,LAMBAYE,"NDIALIGUE MERINA",92,127,703,912,1615
DIOURBEL,BAMBEY,LAMBAYE,LAMBAYE,"NDAGA LAMBAYE",21,27,104,110,214
DIOURBEL,BAMBEY,LAMBAYE,LAMBAYE,NDIAGNE,44,63,189,290,479
DIOURBEL,BAMBEY,LAMBAYE,LAMBAYE,"NDIALIGUE LAMBAYE",78,112,505,797,1302
DIOURBEL,BAMBEY,LAMBAYE,LAMBAYE,"NDIARGA LAMBAYE",42,65,238,371,609
DIOURBEL,BAMBEY,LAMBAYE,LAMBAYE,NDIAWRIGNE,10,14,64,122,186
DIOURBEL,BAMBEY,LAMBAYE,LAMBAYE,NDIENGUE,9,9,56,51,107
DIOURBEL,BAMBEY,LAMBAYE,LAMBAYE,"H1 DAROU MBOW",5,5,23,38,61
DIOURBEL,BAMBEY,LAMBAYE,LAMBAYE,"H2 NDIEUGUE NDIOUFENE",7,12,48,58,106
DIOURBEL,BAMBEY,LAMBAYE,LAMBAYE,"H3 NDIENGUE SALLENE",11,14,54,75,129
DIOURBEL,BAMBEY,LAMBAYE,LAMBAYE,"H4 NDIENGUE KEUR ABDOU DE NDEME MEISSA (COMMUNE NGOGOM)",11,15,64,82,146
DIOURBEL,BAMBEY,LAMBAYE,LAMBAYE,"NDONDOL CODOU NGOYE",86,111,604,815,1419
DIOURBEL,BAMBEY,LAMBAYE,LAMBAYE,"H2 NGAOUL",22,29,113,155,268
DIOURBEL,BAMBEY,LAMBAYE,LAMBAYE,NGANDIAL,24,26,100,127,227
DIOURBEL,BAMBEY,LAMBAYE,LAMBAYE,"H1 NGANDIAL KEUR MOR THIAW",51,65,380,402,782
DIOURBEL,BAMBEY,LAMBAYE,LAMBAYE,"NGANE LAMBAYE",24,38,246,255,501
DIOURBEL,BAMBEY,LAMBAYE,LAMBAYE,"GARASSE MBOUSSO",13,19,107,147,254
DIOURBEL,BAMBEY,LAMBAYE,LAMBAYE,"NGOUYE LAMBAYE",45,66,293,416,709
DIOURBEL,BAMBEY,LAMBAYE,LAMBAYE,NIAKHAP,28,43,288,353,641
DIOURBEL,BAMBEY,LAMBAYE,LAMBAYE,"PARBA LAMBAYE",33,40,251,254,505
DIOURBEL,BAMBEY,LAMBAYE,LAMBAYE,"H1 MBEYENE",6,6,29,33,62
DIOURBEL,BAMBEY,LAMBAYE,LAMBAYE,"H3 NGHAYE",1,1,7,12,19
DIOURBEL,BAMBEY,LAMBAYE,LAMBAYE,"H4 SANTHIE PARBA",21,28,157,149,306
DIOURBEL,BAMBEY,LAMBAYE,LAMBAYE,POUGNAR,22,26,191,177,368
DIOURBEL,BAMBEY,LAMBAYE,LAMBAYE,"H1 PEYE DOMB",6,7,15,32,47
DIOURBEL,BAMBEY,LAMBAYE,LAMBAYE,"H2 PATOU",5,9,66,65,131
DIOURBEL,BAMBEY,LAMBAYE,LAMBAYE,"H3 NDIODJI",9,10,90,76,166
DIOURBEL,BAMBEY,LAMBAYE,LAMBAYE,TASSAR,8,12,62,61,123
DIOURBEL,BAMBEY,LAMBAYE,LAMBAYE,THIALLA,13,15,78,74,152
DIOURBEL,BAMBEY,LAMBAYE,LAMBAYE,THIENENE,15,18,80,136,216
DIOURBEL,BAMBEY,LAMBAYE,LAMBAYE,"THIEPPE NDIAWRIGNE",44,57,354,396,750
DIOURBEL,BAMBEY,LAMBAYE,LAMBAYE,"H1 DAROU NDIAYE",27,36,210,232,442
DIOURBEL,BAMBEY,LAMBAYE,LAMBAYE,"THIEPPE PANATHIE",35,46,159,184,343
DIOURBEL,BAMBEY,LAMBAYE,LAMBAYE,"THIEPPE PARBA",57,82,425,464,889
DIOURBEL,BAMBEY,LAMBAYE,LAMBAYE,"THIEPPE THIAMB",12,14,76,66,142
DIOURBEL,BAMBEY,LAMBAYE,LAMBAYE,"THIEUL (KERE)",6,7,58,65,123
DIOURBEL,BAMBEY,LAMBAYE,LAMBAYE,TOUGOUTHIE,25,35,220,268,488
DIOURBEL,BAMBEY,LAMBAYE,LAMBAYE,GOLKOTE,17,23,188,173,361
DIOURBEL,BAMBEY,LAMBAYE,NGOGOM,"KEUR ALIOU DIOUF",49,72,439,439,878
DIOURBEL,BAMBEY,LAMBAYE,NGOGOM,"BAMBEY SERERE 1",93,125,787,863,1650
DIOURBEL,BAMBEY,LAMBAYE,NGOGOM,"H1 MBIDE NDOUNEME ET GNIGUENE",240,324,2503,2557,5060
DIOURBEL,BAMBEY,LAMBAYE,NGOGOM,"BAMBEY SERERE 2",286,371,2826,2887,5713
DIOURBEL,BAMBEY,LAMBAYE,NGOGOM,"BAMBEY SERERE 3",61,80,607,647,1254
DIOURBEL,BAMBEY,LAMBAYE,NGOGOM,"H1 KEUR YIGO",13,16,102,107,209
DIOURBEL,BAMBEY,LAMBAYE,NGOGOM,"H2 KEUR SECK",10,12,38,40,78
DIOURBEL,BAMBEY,LAMBAYE,NGOGOM,"DAROU DIOUF",23,29,215,172,387
DIOURBEL,BAMBEY,LAMBAYE,NGOGOM,"H1 KEUR IBRA FALL DIENG",7,8,58,55,113
DIOURBEL,BAMBEY,LAMBAYE,NGOGOM,"ISRA (CNRA)",77,82,177,158,335
DIOURBEL,BAMBEY,LAMBAYE,NGOGOM,"KEUR COLY DIOUF (COMMUNE LAMBAYE)",32,42,248,281,529
DIOURBEL,BAMBEY,LAMBAYE,NGOGOM,"H1 DAROU THIAW",18,28,236,236,472
DIOURBEL,BAMBEY,LAMBAYE,NGOGOM,"KEUR IBRA DIOP",36,45,281,299,580
DIOURBEL,BAMBEY,LAMBAYE,NGOGOM,"KEUR MOR SELLE (COMMUNE LAMBAYE)",22,26,330,265,595
DIOURBEL,BAMBEY,LAMBAYE,NGOGOM,"H1 MBARI",2,2,23,19,42
DIOURBEL,BAMBEY,LAMBAYE,NGOGOM,"KEUR SAPOLECK",22,35,234,273,507
DIOURBEL,BAMBEY,LAMBAYE,NGOGOM,"KEUR SEGUE NDIAYE (COMMUNE LAMBAYE)",41,47,286,291,577
DIOURBEL,BAMBEY,LAMBAYE,NGOGOM,"KHALI MOUSTAPHA (COMMUNE LAMBAYE)",10,11,84,50,134
DIOURBEL,BAMBEY,LAMBAYE,NGOGOM,"KOUGOUNE (GOL KEUR MOR BADIANE)",1,6,40,36,76
DIOURBEL,BAMBEY,LAMBAYE,NGOGOM,MBANKHEME,23,33,264,243,507
DIOURBEL,BAMBEY,LAMBAYE,NGOGOM,"MBARRY ALLE NDIAYE (SANTHIE)",15,16,114,110,224
DIOURBEL,BAMBEY,LAMBAYE,NGOGOM,"H1 NGUEWAR",20,28,200,196,396
DIOURBEL,BAMBEY,LAMBAYE,NGOGOM,"H2 GOUYE TANE",19,32,196,250,446
DIOURBEL,BAMBEY,LAMBAYE,NGOGOM,"H3 KEUR BIRIMA",21,25,186,152,338
DIOURBEL,BAMBEY,LAMBAYE,NGOGOM,"H4 DAROU",19,22,237,161,398
DIOURBEL,BAMBEY,LAMBAYE,NGOGOM,"H5 KEUR GOUMACK",10,11,93,61,154
DIOURBEL,BAMBEY,LAMBAYE,NGOGOM,MBOUKHOUM,28,30,238,206,444
DIOURBEL,BAMBEY,LAMBAYE,NGOGOM,"H1 KEUR BIRAME FAYE ET GOL MBOUKHOUM",11,16,87,79,166
DIOURBEL,BAMBEY,LAMBAYE,NGOGOM,NDIAKALACK,22,36,142,234,376
DIOURBEL,BAMBEY,LAMBAYE,NGOGOM,"H1 KEUR IBRAHIMA NDIAYE NGOL",14,15,97,123,220
DIOURBEL,BAMBEY,LAMBAYE,NGOGOM,"H2 NGOUYE",10,13,99,92,191
DIOURBEL,BAMBEY,LAMBAYE,NGOGOM,"H3 TEUGUE",8,12,49,90,139
DIOURBEL,BAMBEY,LAMBAYE,NGOGOM,"H1 NDIOUDIOUF",28,39,309,354,663
DIOURBEL,BAMBEY,LAMBAYE,NGOGOM,NDIANDE,12,18,123,124,247
DIOURBEL,BAMBEY,LAMBAYE,NGOGOM,"H1 KEUR MADIAW",8,10,72,38,110
DIOURBEL,BAMBEY,LAMBAYE,NGOGOM,"H1 NDIOGO PENE",28,39,176,207,383
DIOURBEL,BAMBEY,LAMBAYE,NGOGOM,"NDIARGA POLECK",29,38,159,246,405
DIOURBEL,BAMBEY,LAMBAYE,NGOGOM,"NDIOBENE BAYAKH",9,14,71,78,149
DIOURBEL,BAMBEY,LAMBAYE,NGOGOM,"H1 BAYAKH",10,14,90,87,177
DIOURBEL,BAMBEY,LAMBAYE,NGOGOM,"NDIOBENE NDIANDE",11,16,63,55,118
DIOURBEL,BAMBEY,LAMBAYE,NGOGOM,NDIOUDIOUF,57,74,350,460,810
DIOURBEL,BAMBEY,LAMBAYE,NGOGOM,NDIOUM,43,58,525,536,1061
DIOURBEL,BAMBEY,LAMBAYE,NGOGOM,"NDORONG (NDORONG POLECK)",20,27,171,187,358
DIOURBEL,BAMBEY,LAMBAYE,NGOGOM,NDOUCOUMANE,21,24,109,111,220
DIOURBEL,BAMBEY,LAMBAYE,NGOGOM,NGALBANE,21,24,170,138,308
DIOURBEL,BAMBEY,LAMBAYE,NGOGOM,"NGARAFF POLECK",41,63,472,453,925
DIOURBEL,BAMBEY,LAMBAYE,NGOGOM,NGOGOM,35,51,268,286,554
DIOURBEL,BAMBEY,LAMBAYE,NGOGOM,"NGOTHIE 1",39,48,343,323,666
DIOURBEL,BAMBEY,LAMBAYE,NGOGOM,"NGOTHIE 2",31,47,247,273,520
DIOURBEL,BAMBEY,LAMBAYE,NGOGOM,"H1 KEUR NDIAYE NGOR",11,11,65,60,125
DIOURBEL,BAMBEY,LAMBAYE,NGOGOM,"NGUITHIE DIEYENNE",16,23,132,158,290
DIOURBEL,BAMBEY,LAMBAYE,NGOGOM,"H1 KEUR  ALASSANE NGUINGUE",7,8,59,69,128
DIOURBEL,BAMBEY,LAMBAYE,NGOGOM,"H2 KEUR DAOUDA DIENG",5,8,72,127,199
DIOURBEL,BAMBEY,LAMBAYE,NGOGOM,"NGUITHIE THIANDIGUE",69,81,677,438,1115
DIOURBEL,BAMBEY,LAMBAYE,NGOGOM,NIOKETTE,68,173,522,631,1153
DIOURBEL,BAMBEY,LAMBAYE,NGOGOM,PALENE,34,38,131,225,356
DIOURBEL,BAMBEY,LAMBAYE,NGOGOM,"H1 GOUYE NDIOGOU DAKHAR",20,23,111,139,250
DIOURBEL,BAMBEY,LAMBAYE,NGOGOM,"H3 KEUR BADIANE",11,14,126,100,226
DIOURBEL,BAMBEY,LAMBAYE,NGOGOM,"SEO NGARAFF",18,36,213,255,468
DIOURBEL,BAMBEY,LAMBAYE,NGOGOM,"SILANE (MBAYAR SOUF)",6,6,38,31,69
DIOURBEL,BAMBEY,LAMBAYE,NGOGOM,"H2 MBAYAR SANTHIE",20,28,151,155,306
DIOURBEL,BAMBEY,LAMBAYE,NGOGOM,"H3 NDAMBANE",21,21,81,84,165
DIOURBEL,BAMBEY,LAMBAYE,NGOGOM,"H4 KEUR KAME NDICK",27,35,195,178,373
DIOURBEL,BAMBEY,LAMBAYE,NGOGOM,"H6 KEUR IBRA SEYE (COMMUNE LAMBAYE)",4,6,65,30,95
DIOURBEL,BAMBEY,LAMBAYE,NGOGOM,"H7 MBAYAR KAW",10,10,54,41,95
DIOURBEL,BAMBEY,LAMBAYE,NGOGOM,"H8 NDIAW",14,21,94,92,186
DIOURBEL,BAMBEY,LAMBAYE,NGOGOM,"THIATHIAW (THIATHIAW POLECK)",25,37,246,230,476
DIOURBEL,BAMBEY,LAMBAYE,NGOGOM,"THILMAKHA POLECK",49,70,413,414,827
DIOURBEL,BAMBEY,LAMBAYE,NGOGOM,"TOUBE DIEYE",16,17,114,138,252
DIOURBEL,BAMBEY,LAMBAYE,NGOGOM,"WADJI KANE",17,20,201,168,369
DIOURBEL,BAMBEY,LAMBAYE,NGOGOM,"KEUR KOLY THIAW",35,48,255,295,550
DIOURBEL,BAMBEY,LAMBAYE,NGOGOM,MBODIENE,13,16,71,84,155
DIOURBEL,BAMBEY,LAMBAYE,NGOGOM,"NDEME MEISSA",41,57,251,262,513
DIOURBEL,BAMBEY,LAMBAYE,NGOGOM,"SANTHIE SARR",23,25,111,198,309
DIOURBEL,BAMBEY,LAMBAYE,NGOGOM,"SEO 2",28,38,176,238,414
DIOURBEL,BAMBEY,LAMBAYE,NGOGOM,"THIEGNE SILANE",7,12,73,73,146
DIOURBEL,BAMBEY,LAMBAYE,NGOGOM,"H1 MAKA SERERE",17,32,220,256,476
DIOURBEL,BAMBEY,LAMBAYE,REFANE,"BOKH (KEUR LAMANE)",118,139,916,990,1906
DIOURBEL,BAMBEY,LAMBAYE,REFANE,COKY,25,41,347,304,651
DIOURBEL,BAMBEY,LAMBAYE,REFANE,COMBELANE,76,89,389,380,769
DIOURBEL,BAMBEY,LAMBAYE,REFANE,DIATONG,11,13,201,61,262
DIOURBEL,BAMBEY,LAMBAYE,REFANE,LOULOUPE,38,54,427,438,865
DIOURBEL,BAMBEY,LAMBAYE,REFANE,MBAFAYE,79,86,444,447,891
DIOURBEL,BAMBEY,LAMBAYE,REFANE,"MBAFAYE 2 (NDIARNO)",71,80,528,489,1017
DIOURBEL,BAMBEY,LAMBAYE,REFANE,MBAMBEY,121,135,800,912,1712
DIOURBEL,BAMBEY,LAMBAYE,REFANE,"H1 MBOTAL",17,22,153,162,315
DIOURBEL,BAMBEY,LAMBAYE,REFANE,NDEREPPE,178,191,1132,1210,2342
DIOURBEL,BAMBEY,LAMBAYE,REFANE,"H1 SASSAR ET MBADIE",144,157,1233,1200,2433
DIOURBEL,BAMBEY,LAMBAYE,REFANE,"H2 NDIOGONE",99,110,764,428,1192
DIOURBEL,BAMBEY,LAMBAYE,REFANE,"H1 NDOUR NDOUR ET SANTHIE",108,117,721,686,1407
DIOURBEL,BAMBEY,LAMBAYE,REFANE,"NDIE LAMBAYE",17,24,181,167,348
DIOURBEL,BAMBEY,LAMBAYE,REFANE,NDIEYE,19,27,124,134,258
DIOURBEL,BAMBEY,LAMBAYE,REFANE,NDIODIOME,184,231,1622,1504,3126
DIOURBEL,BAMBEY,LAMBAYE,REFANE,NDIRENE,30,32,266,206,472
DIOURBEL,BAMBEY,LAMBAYE,REFANE,NDONGUE,57,86,358,488,846
DIOURBEL,BAMBEY,LAMBAYE,REFANE,"NDORONG MALICK",47,74,388,398,786
DIOURBEL,BAMBEY,LAMBAYE,REFANE,NGANGOUNE,64,73,360,369,729
DIOURBEL,BAMBEY,LAMBAYE,REFANE,"H1 FASS",15,15,91,85,176
DIOURBEL,BAMBEY,LAMBAYE,REFANE,"NGOUYE THIANDIGNE",55,67,405,421,826
DIOURBEL,BAMBEY,LAMBAYE,REFANE,"H1 NGOUYE GOU NDAW",35,40,224,243,467
DIOURBEL,BAMBEY,LAMBAYE,REFANE,"H2 PARGUINE",22,24,171,201,372
DIOURBEL,BAMBEY,LAMBAYE,REFANE,"REFANE PEYE SINDIANE",199,248,1400,1753,3153
DIOURBEL,BAMBEY,LAMBAYE,REFANE,"H1 NIANIAR",103,115,554,653,1207
DIOURBEL,BAMBEY,LAMBAYE,REFANE,"REO MAO 1",144,170,1063,999,2062
DIOURBEL,BAMBEY,LAMBAYE,REFANE,"REO MAO 2 (MBEDIE)",131,153,988,929,1917
DIOURBEL,BAMBEY,LAMBAYE,REFANE,"H1 NDIANE",69,81,384,473,857
DIOURBEL,BAMBEY,LAMBAYE,REFANE,"H2 SEO THIATHIAW",59,73,470,501,971
DIOURBEL,BAMBEY,LAMBAYE,REFANE,"THIATHIAO KABA",32,39,281,272,553
DIOURBEL,BAMBEY,LAMBAYE,REFANE,"H1 KEUR DIAWRIGNE THIAW",5,6,29,37,66
DIOURBEL,BAMBEY,LAMBAYE,REFANE,"H2 THIANDE",20,26,152,142,294
DIOURBEL,BAMBEY,LAMBAYE,REFANE,THIOLLA,307,352,2020,2115,4135
DIOURBEL,BAMBEY,LAMBAYE,REFANE,"THIATHIAW KHANKH",33,40,285,287,572
DIOURBEL,BAMBEY,NGOYE,NDANGALMA,"BABACK DIOMEGOR",41,60,439,465,904
DIOURBEL,BAMBEY,NGOYE,NDANGALMA,"H1 KEUR DJIB SARR",19,25,204,212,416
DIOURBEL,BAMBEY,NGOYE,NDANGALMA,"H2 SINDIANE",11,13,111,79,190
DIOURBEL,BAMBEY,NGOYE,NDANGALMA,"BABACK NDIOUDIOUF",70,106,897,883,1780
DIOURBEL,BAMBEY,NGOYE,NDANGALMA,"BAMBEY SERERE",118,163,1056,1113,2169
DIOURBEL,BAMBEY,NGOYE,NDANGALMA,DADACK,50,71,366,427,793
DIOURBEL,BAMBEY,NGOYE,NDANGALMA,"DAROU FALL",51,61,257,327,584
DIOURBEL,BAMBEY,NGOYE,NDANGALMA,DIARIGNE,68,97,616,705,1321
DIOURBEL,BAMBEY,NGOYE,NDANGALMA,"H1 MBAYE FALL",19,25,185,154,339
DIOURBEL,BAMBEY,NGOYE,NDANGALMA,"H2 TABLEAU GOURANE",16,24,106,126,232
DIOURBEL,BAMBEY,NGOYE,NDANGALMA,"GATTE DIOCOUL 1",64,102,665,656,1321
DIOURBEL,BAMBEY,NGOYE,NDANGALMA,"GATTE DIOCOUL 2",103,145,989,1007,1996
DIOURBEL,BAMBEY,NGOYE,NDANGALMA,"GATTE GALLO",189,306,2127,2191,4318
DIOURBEL,BAMBEY,NGOYE,NDANGALMA,"GATTE NGARAFF 1",86,153,998,989,1987
DIOURBEL,BAMBEY,NGOYE,NDANGALMA,"GATTE NGARAFF 2",65,90,662,620,1282
DIOURBEL,BAMBEY,NGOYE,NDANGALMA,"GATTE NGARAFF 3",44,78,515,506,1021
DIOURBEL,BAMBEY,NGOYE,NDANGALMA,"H1 KEUR DEMBA",58,77,588,596,1184
DIOURBEL,BAMBEY,NGOYE,NDANGALMA,"KEUR GALLO",18,24,185,148,333
DIOURBEL,BAMBEY,NGOYE,NDANGALMA,KHALALENE,14,16,131,99,230
DIOURBEL,BAMBEY,NGOYE,NDANGALMA,"MBAFAYE NGOYE",11,15,86,84,170
DIOURBEL,BAMBEY,NGOYE,NDANGALMA,MERINA,61,69,390,437,827
DIOURBEL,BAMBEY,NGOYE,NDANGALMA,"DANGALMA 1",177,214,996,1207,2203
DIOURBEL,BAMBEY,NGOYE,NDANGALMA,"DANGALMA 2",102,141,728,744,1472
DIOURBEL,BAMBEY,NGOYE,NDANGALMA,"NDIADIANE SASSENE",38,54,380,358,738
DIOURBEL,BAMBEY,NGOYE,NDANGALMA,"NDIADIANE THIECKENE",57,71,383,401,784
DIOURBEL,BAMBEY,NGOYE,NDANGALMA,NDIAYENE,41,48,283,316,599
DIOURBEL,BAMBEY,NGOYE,NDANGALMA,"NDIMB (NDIM NGOYE)",21,30,206,242,448
DIOURBEL,BAMBEY,NGOYE,NDANGALMA,"H1 SANTHIE",20,32,293,229,522
DIOURBEL,BAMBEY,NGOYE,NDANGALMA,"NDIOBENE NGOYE",30,40,303,297,600
DIOURBEL,BAMBEY,NGOYE,NDANGALMA,"H1 KEUR MBAYE NDAO",5,8,51,65,116
DIOURBEL,BAMBEY,NGOYE,NDANGALMA,NDIOP,12,13,83,80,163
DIOURBEL,BAMBEY,NGOYE,NDANGALMA,"NGOKHOTHIE EX LAMBAYE",22,28,204,229,433
DIOURBEL,BAMBEY,NGOYE,NDANGALMA,"H2 NDIAMA FALL",30,34,139,250,389
DIOURBEL,BAMBEY,NGOYE,NDANGALMA,"H3 DIEGANE",12,20,138,137,275
DIOURBEL,BAMBEY,NGOYE,NDANGALMA,"H4 KEUR GASSA FAYE",8,12,81,72,153
DIOURBEL,BAMBEY,NGOYE,NDANGALMA,"H5 NGOUTE",14,16,131,128,259
DIOURBEL,BAMBEY,NGOYE,NDANGALMA,"NGOKHOTHIE (NDIASSANE)",27,28,171,167,338
DIOURBEL,BAMBEY,NGOYE,NDANGALMA,"H1 PAYE",28,28,117,194,311
DIOURBEL,BAMBEY,NGOYE,NDANGALMA,"NGUEME YADIAMA",19,30,230,169,399
DIOURBEL,BAMBEY,NGOYE,NDANGALMA,NGUITHIE,72,76,458,506,964
DIOURBEL,BAMBEY,NGOYE,NDANGALMA,"NGUITHIE PEYE",8,8,32,41,73
DIOURBEL,BAMBEY,NGOYE,NDANGALMA,SAGALEME,34,35,277,245,522
DIOURBEL,BAMBEY,NGOYE,NDANGALMA,"H2 KEUR MODOU TINE",6,6,76,69,145
DIOURBEL,BAMBEY,NGOYE,NDANGALMA,SANGAL,21,27,185,153,338
DIOURBEL,BAMBEY,NGOYE,NDANGALMA,"H1 NGOUYE",12,17,101,94,195
DIOURBEL,BAMBEY,NGOYE,NDANGALMA,"SANGHAYE (SAMBE)",44,45,267,174,441
DIOURBEL,BAMBEY,NGOYE,NDANGALMA,"H1 KAIRE",16,16,91,94,185
DIOURBEL,BAMBEY,NGOYE,NDANGALMA,"H2 NDINDY",6,10,43,60,103
DIOURBEL,BAMBEY,NGOYE,NDANGALMA,"H3 NGUINTH",35,37,233,167,400
DIOURBEL,BAMBEY,NGOYE,NDANGALMA,SAO,181,202,919,1151,2070
DIOURBEL,BAMBEY,NGOYE,NDANGALMA,"SEO GATTE",31,34,232,262,494
DIOURBEL,BAMBEY,NGOYE,NDANGALMA,"H2 TOUBE SEO",21,24,158,159,317
DIOURBEL,BAMBEY,NGOYE,NDANGALMA,SESSOU,29,38,239,208,447
DIOURBEL,BAMBEY,NGOYE,NDANGALMA,"H1 TANOR",8,8,66,59,125
DIOURBEL,BAMBEY,NGOYE,NDANGALMA,SINDIANE,78,94,596,593,1189
DIOURBEL,BAMBEY,NGOYE,NDANGALMA,"H1 SINDIANE II",38,49,375,413,788
DIOURBEL,BAMBEY,NGOYE,NDANGALMA,TALLEGNE,23,35,197,227,424
DIOURBEL,BAMBEY,NGOYE,NDANGALMA,"H2 TENE MOR",7,10,72,70,142
DIOURBEL,BAMBEY,NGOYE,NDANGALMA,"H4 KEUR MALAW",6,9,46,36,82
DIOURBEL,BAMBEY,NGOYE,NDANGALMA,"H5 SANTHIE KAW ET SANTHIE SOUFF",55,59,327,357,684
DIOURBEL,BAMBEY,NGOYE,NDANGALMA,"TOUBE TALEGNE",41,46,254,260,514
DIOURBEL,BAMBEY,NGOYE,NDANGALMA,"H1 LOUKOUK",11,11,88,69,157
DIOURBEL,BAMBEY,NGOYE,NDONDOL,BAKAPOM,22,34,219,223,442
DIOURBEL,BAMBEY,NGOYE,NDONDOL,"H1 KEUR FOUDAYE (KEUR PATHE)",2,4,22,35,57
DIOURBEL,BAMBEY,NGOYE,NDONDOL,"H2 SOMBEME",8,14,82,94,176
DIOURBEL,BAMBEY,NGOYE,NDONDOL,"MBELKHAOUL 1",55,60,319,361,680
DIOURBEL,BAMBEY,NGOYE,NDONDOL,"MBELKHAOUL 2",8,9,62,45,107
DIOURBEL,BAMBEY,NGOYE,NDONDOL,"H1 AYE",38,70,345,414,759
DIOURBEL,BAMBEY,NGOYE,NDONDOL,"MBOMBOYE 1",39,46,192,234,426
DIOURBEL,BAMBEY,NGOYE,NDONDOL,"H2 KEUR NDIAP",26,36,137,149,286
DIOURBEL,BAMBEY,NGOYE,NDONDOL,"H3 NGONE DIAGNE (THIESSELE)",26,36,226,278,504
DIOURBEL,BAMBEY,NGOYE,NDONDOL,"H4 MALICK FAYE",4,4,17,31,48
DIOURBEL,BAMBEY,NGOYE,NDONDOL,"H8 KEUR SOMBEL DIENG",12,12,68,80,148
DIOURBEL,BAMBEY,NGOYE,NDONDOL,"H9 KEUR WALY",33,36,210,245,455
DIOURBEL,BAMBEY,NGOYE,NDONDOL,"MBOMBOYE 2",70,82,401,537,938
DIOURBEL,BAMBEY,NGOYE,NDONDOL,"H1 DAARADJI",7,9,45,59,104
DIOURBEL,BAMBEY,NGOYE,NDONDOL,"H2 KEUR BAKAR KAMA",18,19,89,118,207
DIOURBEL,BAMBEY,NGOYE,NDONDOL,"H3 KEUR COUMBA DIOP (MAO)",2,3,10,10,20
DIOURBEL,BAMBEY,NGOYE,NDONDOL,NDECKH,68,72,355,402,757
DIOURBEL,BAMBEY,NGOYE,NDONDOL,"H1 KEUR MAR",11,18,86,116,202
DIOURBEL,BAMBEY,NGOYE,NDONDOL,"H2 KEUR WALY SENE",3,3,38,37,75
DIOURBEL,BAMBEY,NGOYE,NDONDOL,"NDIEDIENG 1",35,38,191,196,387
DIOURBEL,BAMBEY,NGOYE,NDONDOL,"H1 NGOPOP",56,67,312,313,625
DIOURBEL,BAMBEY,NGOYE,NDONDOL,"H2 NGARE DIEME",9,12,47,53,100
DIOURBEL,BAMBEY,NGOYE,NDONDOL,"H4 FORAGE",8,11,58,70,128
DIOURBEL,BAMBEY,NGOYE,NDONDOL,NDIEMANE,65,75,442,477,919
DIOURBEL,BAMBEY,NGOYE,NDONDOL,"H1 TITINE",11,32,252,235,487
DIOURBEL,BAMBEY,NGOYE,NDONDOL,"H2 THIARGANE",8,9,81,83,164
DIOURBEL,BAMBEY,NGOYE,NDONDOL,"H3 TOUBA NDIEMANE",7,12,63,71,134
DIOURBEL,BAMBEY,NGOYE,NDONDOL,"H5 NGOKOLY",24,46,339,383,722
DIOURBEL,BAMBEY,NGOYE,NDONDOL,"H6 NGOKHOYE (KEUR MALICK SARR)",23,38,252,266,518
DIOURBEL,BAMBEY,NGOYE,NDONDOL,"H7 NGARE DIAM",8,16,124,122,246
DIOURBEL,BAMBEY,NGOYE,NDONDOL,"H8 MBELEME",18,47,244,270,514
DIOURBEL,BAMBEY,NGOYE,NDONDOL,"NDONDOL SESSENE",243,294,1798,2025,3823
DIOURBEL,BAMBEY,NGOYE,NDONDOL,"H1 SAME KHADANE",20,20,125,152,277
DIOURBEL,BAMBEY,NGOYE,NDONDOL,"NDONDOL WOLOF",77,137,586,633,1219
DIOURBEL,BAMBEY,NGOYE,NDONDOL,"NGOUYE NGOYE",64,81,480,601,1081
DIOURBEL,BAMBEY,NGOYE,NDONDOL,"NGUEME ISSA",32,44,264,244,508
DIOURBEL,BAMBEY,NGOYE,NDONDOL,"H1 DIAGNE KEUR CHEIKH SOW",12,15,93,136,229
DIOURBEL,BAMBEY,NGOYE,NDONDOL,"H2 GOUYE NDIAYE",8,15,69,67,136
DIOURBEL,BAMBEY,NGOYE,NDONDOL,"H3 NGUEME SANTHIE (KEUR SABASSY FALL)",53,56,323,363,686
DIOURBEL,BAMBEY,NGOYE,NDONDOL,"H4 KEUR DIOULDE",12,14,113,102,215
DIOURBEL,BAMBEY,NGOYE,NDONDOL,"H5 NDIOBENE",11,14,74,88,162
DIOURBEL,BAMBEY,NGOYE,NDONDOL,"H6 PALENE (NGUEME TEUGUE)",21,23,106,112,218
DIOURBEL,BAMBEY,NGOYE,NDONDOL,"H7 NDOUKOURA",18,32,250,206,456
DIOURBEL,BAMBEY,NGOYE,NDONDOL,"H8 NIANGUE",9,10,77,73,150
DIOURBEL,BAMBEY,NGOYE,NDONDOL,"H9 NDOUROKH",11,13,97,93,190
DIOURBEL,BAMBEY,NGOYE,NDONDOL,"H10 KEUR MBAR",14,16,147,142,289
DIOURBEL,BAMBEY,NGOYE,NDONDOL,"H11 SERIGNE MOR NDIAYE",2,4,28,19,47
DIOURBEL,BAMBEY,NGOYE,NDONDOL,"WAKHALDIAM 1",28,36,145,171,316
DIOURBEL,BAMBEY,NGOYE,NDONDOL,"H1 KHASSAB",5,6,28,35,63
DIOURBEL,BAMBEY,NGOYE,NDONDOL,"H2 NDIANGAYE ET KEUR SAMME",8,21,84,102,186
DIOURBEL,BAMBEY,NGOYE,NDONDOL,"H3 NDIAGNE",26,37,138,172,310
DIOURBEL,BAMBEY,NGOYE,NDONDOL,"H4 KEUR NDIAW (NDIOP)",8,10,83,90,173
DIOURBEL,BAMBEY,NGOYE,NDONDOL,"WAKHALDIAM 2",34,40,211,216,427
DIOURBEL,BAMBEY,NGOYE,NDONDOL,"AK YAYE (AGOUYAYE)",137,152,807,982,1789
DIOURBEL,BAMBEY,NGOYE,NDONDOL,"DAROU FALL",5,6,69,78,147
DIOURBEL,BAMBEY,NGOYE,NDONDOL,"KEUR BIRANE NGARY",12,17,83,102,185
DIOURBEL,BAMBEY,NGOYE,NDONDOL,"NDIEDIENG 2",44,47,254,259,513
DIOURBEL,BAMBEY,NGOYE,NDONDOL,NDIODIOME,30,36,207,218,425
DIOURBEL,BAMBEY,NGOYE,NDONDOL,"SOBEME (GNIGNING)",26,26,122,166,288
DIOURBEL,BAMBEY,NGOYE,NGOYE,BAKAKACK,35,86,537,634,1171
DIOURBEL,BAMBEY,NGOYE,NGOYE,"H1 MOURIDEGUI",6,19,159,165,324
DIOURBEL,BAMBEY,NGOYE,NGOYE,"TOUBA SHAM THIANE (BANEME WOLOF)",14,16,96,93,189
DIOURBEL,BAMBEY,NGOYE,NGOYE,"BANEME SERERE",36,37,306,382,688
DIOURBEL,BAMBEY,NGOYE,NGOYE,"BARRY NDONDOL",46,89,581,618,1199
DIOURBEL,BAMBEY,NGOYE,NGOYE,"H1 KEUR BOCAR NDAO",10,17,95,84,179
DIOURBEL,BAMBEY,NGOYE,NGOYE,"H2 MBEKOUT",30,72,393,492,885
DIOURBEL,BAMBEY,NGOYE,NGOYE,"H3 NDALANE",44,71,534,557,1091
DIOURBEL,BAMBEY,NGOYE,NGOYE,"H4 NDIOKH",21,42,263,284,547
DIOURBEL,BAMBEY,NGOYE,NGOYE,BATAL,72,93,453,506,959
DIOURBEL,BAMBEY,NGOYE,NGOYE,"DANOU NGAYE",22,38,248,266,514
DIOURBEL,BAMBEY,NGOYE,NGOYE,"DARA MANGO",7,8,30,37,67
DIOURBEL,BAMBEY,NGOYE,NGOYE,"DAROU NDIOULY",68,98,559,630,1189
DIOURBEL,BAMBEY,NGOYE,NGOYE,"DAROU NGUEYE NGUEYE",24,45,405,393,798
DIOURBEL,BAMBEY,NGOYE,NGOYE,DOUTKY,25,27,232,246,478
DIOURBEL,BAMBEY,NGOYE,NGOYE,"GADE NDINE",3,4,12,15,27
DIOURBEL,BAMBEY,NGOYE,NGOYE,GALLO,64,86,629,689,1318
DIOURBEL,BAMBEY,NGOYE,NGOYE,"H1 TEUGUE",8,12,96,92,188
DIOURBEL,BAMBEY,NGOYE,NGOYE,NGASCOP,142,165,873,1006,1879
DIOURBEL,BAMBEY,NGOYE,NGOYE,GOURGOURENE,75,134,549,634,1183
DIOURBEL,BAMBEY,NGOYE,NGOYE,"KEUR LAT MBISSINE",45,58,383,394,777
DIOURBEL,BAMBEY,NGOYE,NGOYE,"KEUR MACADOU",3,4,25,30,55
DIOURBEL,BAMBEY,NGOYE,NGOYE,"H3 NGUIRLY",5,10,97,61,158
DIOURBEL,BAMBEY,NGOYE,NGOYE,"H4 NDOGODEME 2",11,20,93,105,198
DIOURBEL,BAMBEY,NGOYE,NGOYE,"H5 NDOGODEME 1",7,14,73,112,185
DIOURBEL,BAMBEY,NGOYE,NGOYE,"KEUR MAISSA",34,44,223,236,459
DIOURBEL,BAMBEY,NGOYE,NGOYE,"KEUR WALFATMA",20,24,148,171,319
DIOURBEL,BAMBEY,NGOYE,NGOYE,"H1 KOTHIAW KEUR MBAYE THIAW",13,17,82,94,176
DIOURBEL,BAMBEY,NGOYE,NGOYE,"KEURY KAO (BAKEM)",63,79,529,560,1089
DIOURBEL,BAMBEY,NGOYE,NGOYE,KHANDIAR,15,48,121,138,259
DIOURBEL,BAMBEY,NGOYE,NGOYE,"H1 KEUR DJIMITTE",9,16,107,109,216
DIOURBEL,BAMBEY,NGOYE,NGOYE,"H2 KEUR SERIGNE MOUSTAPHA GUEYE",27,35,186,184,370
DIOURBEL,BAMBEY,NGOYE,NGOYE,"H4 NDIASEWE",33,77,251,276,527
DIOURBEL,BAMBEY,NGOYE,NGOYE,"H5 RIMBAKH",28,30,183,185,368
DIOURBEL,BAMBEY,NGOYE,NGOYE,KHOUDOMBETHIE,12,14,84,75,159
DIOURBEL,BAMBEY,NGOYE,NGOYE,KOURTY,24,35,185,184,369
DIOURBEL,BAMBEY,NGOYE,NGOYE,"PAGUI LAGNAR",9,15,131,132,263
DIOURBEL,BAMBEY,NGOYE,NGOYE,"MAKA TOULANE",23,41,204,222,426
DIOURBEL,BAMBEY,NGOYE,NGOYE,MBOUL,12,24,130,143,273
DIOURBEL,BAMBEY,NGOYE,NGOYE,"NDIATTA NGOYE",11,23,154,169,323
DIOURBEL,BAMBEY,NGOYE,NGOYE,NDIMB,96,126,671,801,1472
DIOURBEL,BAMBEY,NGOYE,NGOYE,"H1 DAROU TOCKNGOL",54,75,433,495,928
DIOURBEL,BAMBEY,NGOYE,NGOYE,"H2 TOCKNGOL",45,50,278,330,608
DIOURBEL,BAMBEY,NGOYE,NGOYE,NDINE,10,16,64,85,149
DIOURBEL,BAMBEY,NGOYE,NGOYE,NDIODIOME,74,90,468,427,895
DIOURBEL,BAMBEY,NGOYE,NGOYE,"NDIONE MATENING",63,70,418,460,878
DIOURBEL,BAMBEY,NGOYE,NGOYE,"H1 KEUR ABLAYE NDEBA DIOUF",35,42,306,348,654
DIOURBEL,BAMBEY,NGOYE,NGOYE,"H2 KEUR KHOURY ET ANGLE DIASS",15,17,75,86,161
DIOURBEL,BAMBEY,NGOYE,NGOYE,"NDIOULY 2",71,91,570,666,1236
DIOURBEL,BAMBEY,NGOYE,NGOYE,NGANDECK,68,81,309,354,663
DIOURBEL,BAMBEY,NGOYE,NGOYE,NGODJILEME,72,86,514,547,1061
DIOURBEL,BAMBEY,NGOYE,NGOYE,"NGUEYE NGUEYE",187,207,1326,1390,2716
DIOURBEL,BAMBEY,NGOYE,NGOYE,"H1 NDOCKA",8,9,64,62,126
DIOURBEL,BAMBEY,NGOYE,NGOYE,"PEYE NGOYE 1",55,74,399,425,824
DIOURBEL,BAMBEY,NGOYE,NGOYE,"H1 SOUYEME",39,45,409,380,789
DIOURBEL,BAMBEY,NGOYE,NGOYE,"H3 GARAF",33,36,241,276,517
DIOURBEL,BAMBEY,NGOYE,NGOYE,"H4 KEUR MBAYE DIOUF",12,16,101,97,198
DIOURBEL,BAMBEY,NGOYE,NGOYE,"PEYE NGOYE 2",188,230,1535,1566,3101
DIOURBEL,BAMBEY,NGOYE,NGOYE,ROFANGUI,24,26,173,190,363
DIOURBEL,BAMBEY,NGOYE,NGOYE,"H1 KEUR DAME",14,16,97,107,204
DIOURBEL,BAMBEY,NGOYE,NGOYE,SESSENE,144,175,1239,1251,2490
DIOURBEL,BAMBEY,NGOYE,NGOYE,SOBEME,62,95,599,611,1210
DIOURBEL,BAMBEY,NGOYE,NGOYE,"ZONE KADE 1",7,12,55,79,134
DIOURBEL,BAMBEY,NGOYE,NGOYE,"H1 KEUR NDEME NDIAYE ET GOUTE",8,19,121,118,239
DIOURBEL,BAMBEY,NGOYE,NGOYE,"H2 PETHIE SIWE",4,8,41,57,98
DIOURBEL,BAMBEY,NGOYE,NGOYE,"ZONE KADE 2",33,41,193,200,393
DIOURBEL,BAMBEY,NGOYE,NGOYE,"H1 KEUR SENY NIOME",5,22,184,166,350
DIOURBEL,BAMBEY,NGOYE,NGOYE,"H3 MBOUNDAYE",11,27,181,175,356
DIOURBEL,BAMBEY,NGOYE,NGOYE,SOUSSEUB,14,14,59,90,149
DIOURBEL,BAMBEY,NGOYE,NGOYE,"H1 BOKO",3,6,70,62,132
DIOURBEL,BAMBEY,NGOYE,NGOYE,THIODIOGOYE,11,23,137,155,292
DIOURBEL,BAMBEY,NGOYE,NGOYE,"H2 MALO",12,12,80,71,151
DIOURBEL,BAMBEY,NGOYE,NGOYE,"H3 SASSEME",23,24,190,178,368
DIOURBEL,BAMBEY,NGOYE,NGOYE,"H4 TEUGUE",14,23,120,126,246
DIOURBEL,BAMBEY,NGOYE,NGOYE,"TOCK DIADJI",54,90,669,587,1256
DIOURBEL,BAMBEY,NGOYE,NGOYE,TOCORAGUE,79,91,629,597,1226
DIOURBEL,BAMBEY,NGOYE,NGOYE,YADOU,2,8,49,39,88
DIOURBEL,BAMBEY,NGOYE,NGOYE,"H1 LOYENE",3,4,21,13,34
DIOURBEL,BAMBEY,NGOYE,NGOYE,"H2 KEUR BOCAR NIANG",5,9,64,50,114
DIOURBEL,BAMBEY,NGOYE,NGOYE,BAYAKH,20,26,113,145,258
DIOURBEL,BAMBEY,NGOYE,NGOYE,"DAROU MINAM",13,14,87,80,167
DIOURBEL,BAMBEY,NGOYE,NGOYE,"H1 TOUBA KEURY KAW",45,57,380,429,809
DIOURBEL,BAMBEY,NGOYE,NGOYE,"KEUR DIARAB FAYE",6,9,71,85,156
DIOURBEL,BAMBEY,NGOYE,NGOYE,"MBOKHODANE 1",13,15,104,129,233
DIOURBEL,BAMBEY,NGOYE,NGOYE,"MBOKHODANE 2",42,69,380,480,860
DIOURBEL,BAMBEY,NGOYE,NGOYE,"H1 BAKHAMAYE",21,37,221,244,465
DIOURBEL,BAMBEY,NGOYE,NGOYE,"H2 NGANEME",14,17,93,120,213
DIOURBEL,BAMBEY,NGOYE,NGOYE,"H3 TOKHOMEDE",18,35,237,243,480
DIOURBEL,BAMBEY,NGOYE,NGOYE,NDIALITTE,38,46,349,389,738
DIOURBEL,BAMBEY,NGOYE,NGOYE,"H1 NDIALITTE",21,27,182,188,370
DIOURBEL,BAMBEY,NGOYE,NGOYE,"NDIOULY 1",40,44,260,302,562
DIOURBEL,BAMBEY,NGOYE,NGOYE,"TOUBA SAM THIANE 2",16,17,116,100,216
DIOURBEL,BAMBEY,NGOYE,THIAKHAR,BAITY,8,15,93,89,182
DIOURBEL,BAMBEY,NGOYE,THIAKHAR,"H1 BOUCARY",6,13,62,61,123
DIOURBEL,BAMBEY,NGOYE,THIAKHAR,"BANGATHIE (NDIAGNE TOUFA)",13,15,90,93,183
DIOURBEL,BAMBEY,NGOYE,THIAKHAR,"H1 DOCOS",3,3,20,21,41
DIOURBEL,BAMBEY,NGOYE,THIAKHAR,DAARA,23,26,162,169,331
DIOURBEL,BAMBEY,NGOYE,THIAKHAR,"H1 DARA KADD",3,3,17,15,32
DIOURBEL,BAMBEY,NGOYE,THIAKHAR,"H2 MBAFAYE DAARA",16,16,105,107,212
DIOURBEL,BAMBEY,NGOYE,THIAKHAR,"H3 TEUG DARA",34,60,425,448,873
DIOURBEL,BAMBEY,NGOYE,THIAKHAR,"DAROU SALAM",20,20,167,161,328
DIOURBEL,BAMBEY,NGOYE,THIAKHAR,NDIABAYE,20,34,263,207,470
DIOURBEL,BAMBEY,NGOYE,THIAKHAR,"NDIAGNE BOUMY",40,48,339,345,684
DIOURBEL,BAMBEY,NGOYE,THIAKHAR,"H1 NIANGHENE (NDIAGNE NIANGUENE)",16,31,282,217,499
DIOURBEL,BAMBEY,NGOYE,THIAKHAR,"H2 NDIOUFENE",5,18,121,124,245
DIOURBEL,BAMBEY,NGOYE,THIAKHAR,DIOREL,7,10,96,76,172
DIOURBEL,BAMBEY,NGOYE,THIAKHAR,"H1 THIENIAYE",1,1,9,11,20
DIOURBEL,BAMBEY,NGOYE,THIAKHAR,"H2 MAPELANE",11,14,122,140,262
DIOURBEL,BAMBEY,NGOYE,THIAKHAR,DIOCOUL,36,37,282,315,597
DIOURBEL,BAMBEY,NGOYE,THIAKHAR,"DOMB 1",5,8,48,47,95
DIOURBEL,BAMBEY,NGOYE,THIAKHAR,"H1 KEUR IBRA FAYE",5,7,46,49,95
DIOURBEL,BAMBEY,NGOYE,THIAKHAR,"DOMB 2",40,51,284,262,546
DIOURBEL,BAMBEY,NGOYE,THIAKHAR,"H1 BABACK",3,4,27,24,51
DIOURBEL,BAMBEY,NGOYE,THIAKHAR,FAKHANE,70,80,579,663,1242
DIOURBEL,BAMBEY,NGOYE,THIAKHAR,"GALLO PEYE",12,15,125,114,239
DIOURBEL,BAMBEY,NGOYE,THIAKHAR,KADIAO,27,38,317,307,624
DIOURBEL,BAMBEY,NGOYE,THIAKHAR,"KEUR BADIE",10,14,83,84,167
DIOURBEL,BAMBEY,NGOYE,THIAKHAR,"KEUR MAFATIM (KEUR MALICK)",15,22,121,157,278
DIOURBEL,BAMBEY,NGOYE,THIAKHAR,"H1 MBAKHE",1,1,5,8,13
DIOURBEL,BAMBEY,NGOYE,THIAKHAR,"KEUR MANGA",19,34,251,253,504
DIOURBEL,BAMBEY,NGOYE,THIAKHAR,"KEUR SENY DIOUF",22,26,221,150,371
DIOURBEL,BAMBEY,NGOYE,THIAKHAR,KHOLKHOTORANE,45,56,349,387,736
DIOURBEL,BAMBEY,NGOYE,THIAKHAR,"H1 KHOTORANE",21,27,191,174,365
DIOURBEL,BAMBEY,NGOYE,THIAKHAR,KHOURANE,15,17,114,119,233
DIOURBEL,BAMBEY,NGOYE,THIAKHAR,"H1 NGOTTE",5,10,62,56,118
DIOURBEL,BAMBEY,NGOYE,THIAKHAR,"MAKA BASSE",22,26,179,198,377
DIOURBEL,BAMBEY,NGOYE,THIAKHAR,"H1 KEUR MBAYE DIOUF",1,3,22,15,37
DIOURBEL,BAMBEY,NGOYE,THIAKHAR,"MBADIA KADD",21,29,209,177,386
DIOURBEL,BAMBEY,NGOYE,THIAKHAR,"MBADIE NDIOUFFENE",15,24,164,172,336
DIOURBEL,BAMBEY,NGOYE,THIAKHAR,MBADIANEME,30,32,174,163,337
DIOURBEL,BAMBEY,NGOYE,THIAKHAR,"H1 KEUR CHEIKH COUMBA FALL",5,7,33,30,63
DIOURBEL,BAMBEY,NGOYE,THIAKHAR,"H1 GOUYE NDIOLE",5,5,25,22,47
DIOURBEL,BAMBEY,NGOYE,THIAKHAR,"MBAFAYE (MBAFAYE DADENE)",10,12,89,63,152
DIOURBEL,BAMBEY,NGOYE,THIAKHAR,MBAYANE,9,19,113,110,223
DIOURBEL,BAMBEY,NGOYE,THIAKHAR,MBEYE,6,7,45,38,83
DIOURBEL,BAMBEY,NGOYE,THIAKHAR,MBOYENE,67,86,602,667,1269
DIOURBEL,BAMBEY,NGOYE,THIAKHAR,"H1 NDIONE",7,12,80,77,157
DIOURBEL,BAMBEY,NGOYE,THIAKHAR,NDAKH,9,12,274,225,499
DIOURBEL,BAMBEY,NGOYE,THIAKHAR,"H1 NDOKA",10,11,85,82,167
DIOURBEL,BAMBEY,NGOYE,THIAKHAR,"H2 NDIETATOU ET NGOMENE",16,26,203,160,363
DIOURBEL,BAMBEY,NGOYE,THIAKHAR,"H3 NDAKH DIAMA ET NDAKH NDIOBENE",9,12,124,72,196
DIOURBEL,BAMBEY,NGOYE,THIAKHAR,"H4 TEUGUE ET NDAKH KAO",4,4,31,31,62
DIOURBEL,BAMBEY,NGOYE,THIAKHAR,"NDIAGUENE DIOREL",13,16,180,144,324
DIOURBEL,BAMBEY,NGOYE,THIAKHAR,"H3 DAGA DIOREL",3,6,77,58,135
DIOURBEL,BAMBEY,NGOYE,THIAKHAR,"NDIAGUENE MBAR",25,27,360,276,636
DIOURBEL,BAMBEY,NGOYE,THIAKHAR,"H2 TAWFEKH",1,2,31,23,54
DIOURBEL,BAMBEY,NGOYE,THIAKHAR,NDIAKANE,20,23,184,204,388
DIOURBEL,BAMBEY,NGOYE,THIAKHAR,"H1 GARASSE",5,5,22,27,49
DIOURBEL,BAMBEY,NGOYE,THIAKHAR,"H2 DAROU GUEYE",13,21,174,170,344
DIOURBEL,BAMBEY,NGOYE,THIAKHAR,"H3 KEUR KOULY ET KEUR NDICK",12,18,129,125,254
DIOURBEL,BAMBEY,NGOYE,THIAKHAR,NDIARNO,16,18,102,130,232
DIOURBEL,BAMBEY,NGOYE,THIAKHAR,"H1 THIAKHOURENE",4,4,30,33,63
DIOURBEL,BAMBEY,NGOYE,THIAKHAR,"NDIATTA NDADENE",11,18,138,101,239
DIOURBEL,BAMBEY,NGOYE,THIAKHAR,NDIEULBERT,8,11,49,85,134
DIOURBEL,BAMBEY,NGOYE,THIAKHAR,"NDIMB NDADENE",13,15,71,59,130
DIOURBEL,BAMBEY,NGOYE,THIAKHAR,"NDIOBENE NDADENE",10,14,115,102,217
DIOURBEL,BAMBEY,NGOYE,THIAKHAR,"H1 NDIAWENE",9,10,109,70,179
DIOURBEL,BAMBEY,NGOYE,THIAKHAR,NDOUDIOUR,15,31,258,250,508
DIOURBEL,BAMBEY,NGOYE,THIAKHAR,"NGATHIE FALL",25,34,151,176,327
DIOURBEL,BAMBEY,NGOYE,THIAKHAR,"NGATHIE NGOGOM",38,54,396,428,824
DIOURBEL,BAMBEY,NGOYE,THIAKHAR,"H1 NGATHIE KEUR BIRAME",17,17,157,172,329
DIOURBEL,BAMBEY,NGOYE,THIAKHAR,NGAYOKHEME,41,64,372,359,731
DIOURBEL,BAMBEY,NGOYE,THIAKHAR,NGOUSSE,25,27,137,151,288
DIOURBEL,BAMBEY,NGOYE,THIAKHAR,"NGOUYE DIOR (MAFANE)",6,6,18,10,28
DIOURBEL,BAMBEY,NGOYE,THIAKHAR,"NGOUYE NDADENE",10,11,61,58,119
DIOURBEL,BAMBEY,NGOYE,THIAKHAR,"H2 KEUR SECK",3,7,48,56,104
DIOURBEL,BAMBEY,NGOYE,THIAKHAR,"PAI PAI",9,10,116,70,186
DIOURBEL,BAMBEY,NGOYE,THIAKHAR,"PALENE DIOREL",20,24,242,193,435
DIOURBEL,BAMBEY,NGOYE,THIAKHAR,"PEULH LAMASSAS",18,25,161,145,306
DIOURBEL,BAMBEY,NGOYE,THIAKHAR,"SANDIARA THIATHIAW",35,43,333,319,652
DIOURBEL,BAMBEY,NGOYE,THIAKHAR,"SANTHIOU LAM",20,23,150,164,314
DIOURBEL,BAMBEY,NGOYE,THIAKHAR,"SEO LEFF",31,46,408,317,725
DIOURBEL,BAMBEY,NGOYE,THIAKHAR,"H1 NGATHIE GUEYE",17,23,249,205,454
DIOURBEL,BAMBEY,NGOYE,THIAKHAR,SINKANE,31,39,219,202,421
DIOURBEL,BAMBEY,NGOYE,THIAKHAR,SOCANO,16,27,207,180,387
DIOURBEL,BAMBEY,NGOYE,THIAKHAR,"H1 KEUR MADIAB",13,26,175,150,325
DIOURBEL,BAMBEY,NGOYE,THIAKHAR,"TEUG DAPA",6,8,47,43,90
DIOURBEL,BAMBEY,NGOYE,THIAKHAR,THIAKHAR,47,70,556,519,1075
DIOURBEL,BAMBEY,NGOYE,THIAKHAR,THIATHIAO,37,42,275,300,575
DIOURBEL,BAMBEY,NGOYE,THIAKHAR,THIEGNE,5,7,57,62,119
DIOURBEL,BAMBEY,NGOYE,THIAKHAR,"THIEKENE MBEYE",4,6,70,46,116
DIOURBEL,BAMBEY,NGOYE,THIAKHAR,WAKHALDIAM,17,31,272,241,513
DIOURBEL,BAMBEY,NGOYE,THIAKHAR,YARGOUYE,32,35,205,195,400
DIOURBEL,BAMBEY,NGOYE,THIAKHAR,YARWAYE,56,69,446,456,902
DIOURBEL,BAMBEY,NGOYE,THIAKHAR,DAGA,11,16,70,70,140
DIOURBEL,BAMBEY,NGOYE,THIAKHAR,"H1 NGOUYE NDIAYE DAGA DEUNE",8,8,84,45,129
DIOURBEL,BAMBEY,NGOYE,THIAKHAR,"KEUR SAER NGOM",73,89,607,596,1203
DIOURBEL,BAMBEY,NGOYE,THIAKHAR,"H1 DAARA KEUR DJIRE",10,17,101,126,227
DIOURBEL,BAMBEY,NGOYE,THIAKHAR,"NDOSS FALL",7,7,37,44,81
DIOURBEL,DIOURBEL,DIOURBEL,DIOURBEL,"CHEIKH ANTA M’BACKE",2247,2628,12558,13554,26112
DIOURBEL,DIOURBEL,DIOURBEL,DIOURBEL,"KEUR CHEIKH IBRA FALL",1782,2110,10452,11391,21843
DIOURBEL,DIOURBEL,DIOURBEL,DIOURBEL,"MEDINATOUL (KEUR GOUMACK)",5069,5722,31698,31114,62812
DIOURBEL,DIOURBEL,DIOURBEL,DIOURBEL,"THIERNO KANDJI",4610,5514,23295,23492,46787
DIOURBEL,DIOURBEL,NDINDY,"NDANKH SENE","DANKH SENE 1",35,51,256,344,600
DIOURBEL,DIOURBEL,NDINDY,"NDANKH SENE","DAROU KHADIM",5,9,133,72,205
DIOURBEL,DIOURBEL,NDINDY,"NDANKH SENE","H1 KEUR DIENE DIAGNE",8,8,61,48,109
DIOURBEL,DIOURBEL,NDINDY,"NDANKH SENE","H2 KEUR OUSMANE NIANG",2,3,30,19,49
DIOURBEL,DIOURBEL,NDINDY,"NDANKH SENE","H3 DEGUE SANGHE",11,17,132,147,279
DIOURBEL,DIOURBEL,NDINDY,"NDANKH SENE","DAROU SALAM GALLE 1",7,8,49,53,102
DIOURBEL,DIOURBEL,NDINDY,"NDANKH SENE","H1 KEUR BADARA KONTEYE",3,5,135,84,219
DIOURBEL,DIOURBEL,NDINDY,"NDANKH SENE","DAROU SALAM GALLE 2",4,4,24,3,27
DIOURBEL,DIOURBEL,NDINDY,"NDANKH SENE","H1 KITAL",31,43,246,298,544
DIOURBEL,DIOURBEL,NDINDY,"NDANKH SENE",DONGHO,22,28,210,207,417
DIOURBEL,DIOURBEL,NDINDY,"NDANKH SENE",GALLE,14,19,124,103,227
DIOURBEL,DIOURBEL,NDINDY,"NDANKH SENE","H3 GALLE PEUL",8,9,70,57,127
DIOURBEL,DIOURBEL,NDINDY,"NDANKH SENE","H1 NGUEL SASSE",6,9,58,56,114
DIOURBEL,DIOURBEL,NDINDY,"NDANKH SENE","KEUR NDIANKOU",2,2,13,12,25
DIOURBEL,DIOURBEL,NDINDY,"NDANKH SENE","H1 NDABO",4,4,22,20,42
DIOURBEL,DIOURBEL,NDINDY,"NDANKH SENE","H2 MBOYENE",4,7,65,68,133
DIOURBEL,DIOURBEL,NDINDY,"NDANKH SENE",LOMENE,33,34,170,205,375
DIOURBEL,DIOURBEL,NDINDY,"NDANKH SENE","H1 KEUR SERIGNE DIA",1,1,9,1,10
DIOURBEL,DIOURBEL,NDINDY,"NDANKH SENE",MBAPPE,19,34,151,133,284
DIOURBEL,DIOURBEL,NDINDY,"NDANKH SENE","H2 DEGOUNE",1,4,12,10,22
DIOURBEL,DIOURBEL,NDINDY,"NDANKH SENE","H5 NGUIDITE",14,25,109,126,235
DIOURBEL,DIOURBEL,NDINDY,"NDANKH SENE","H6 KANENE",4,5,23,29,52
DIOURBEL,DIOURBEL,NDINDY,"NDANKH SENE","H7 MALANE (COMMUNE DAROU MOUKHTY)",3,7,31,26,57
DIOURBEL,DIOURBEL,NDINDY,"NDANKH SENE","H9 BOWDE",2,3,19,22,41
DIOURBEL,DIOURBEL,NDINDY,"NDANKH SENE","H10 BAWDE",6,13,112,109,221
DIOURBEL,DIOURBEL,NDINDY,"NDANKH SENE","MBAYENE DANKH",15,25,137,161,298
DIOURBEL,DIOURBEL,NDINDY,"NDANKH SENE","H1 MEKHANE",1,1,11,8,19
DIOURBEL,DIOURBEL,NDINDY,"NDANKH SENE","H2 MEKHAYE",2,2,30,13,43
DIOURBEL,DIOURBEL,NDINDY,"NDANKH SENE",MBOUMY,7,12,72,70,142
DIOURBEL,DIOURBEL,NDINDY,"NDANKH SENE","H2 KEUR OUSMANE DIOP",3,3,25,16,41
DIOURBEL,DIOURBEL,NDINDY,"NDANKH SENE","H3 KEUR  ABOU KA",1,1,5,3,8
DIOURBEL,DIOURBEL,NDINDY,"NDANKH SENE",NDIAGUINTH,2,2,17,29,46
DIOURBEL,DIOURBEL,NDINDY,"NDANKH SENE","H1 KEUR ADIOUMA BA",5,11,77,74,151
DIOURBEL,DIOURBEL,NDINDY,"NDANKH SENE","H2 KEUR SOUDOU POUYE",7,10,92,119,211
DIOURBEL,DIOURBEL,NDINDY,"NDANKH SENE","NDIA 1",5,5,39,37,76
DIOURBEL,DIOURBEL,NDINDY,"NDANKH SENE","NDIA 2",19,22,164,165,329
DIOURBEL,DIOURBEL,NDINDY,"NDANKH SENE","H2 LOMENE",4,4,25,16,41
DIOURBEL,DIOURBEL,NDINDY,"NDANKH SENE","NDIA 3",5,5,24,4,28
DIOURBEL,DIOURBEL,NDINDY,"NDANKH SENE","NDIOGOP DIOP",90,117,665,734,1399
DIOURBEL,DIOURBEL,NDINDY,"NDANKH SENE","NDIOGOP NDIAYE",37,47,224,257,481
DIOURBEL,DIOURBEL,NDINDY,"NDANKH SENE","NGUEYE NGUEYE",35,39,252,225,477
DIOURBEL,DIOURBEL,NDINDY,"NDANKH SENE","H1 THIERERE KALOM",3,3,20,23,43
DIOURBEL,DIOURBEL,NDINDY,"NDANKH SENE","H2 BASSEL",5,5,23,15,38
DIOURBEL,DIOURBEL,NDINDY,"NDANKH SENE","H3 KEUR GUIDIE DIAGNE",7,9,51,87,138
DIOURBEL,DIOURBEL,NDINDY,"NDANKH SENE","H4 KEUR WAGANE",14,21,179,133,312
DIOURBEL,DIOURBEL,NDINDY,"NDANKH SENE",TAMAKA,12,16,68,74,142
DIOURBEL,DIOURBEL,NDINDY,"NDANKH SENE","H1 KEUR MASS FALL",3,4,21,14,35
DIOURBEL,DIOURBEL,NDINDY,"NDANKH SENE","H2 KEUR IBRAHIMA FAYE",10,23,101,130,231
DIOURBEL,DIOURBEL,NDINDY,"NDANKH SENE","THIAKH KEUR MASSALE (SANTHIE SOUF)",16,22,133,141,274
DIOURBEL,DIOURBEL,NDINDY,"NDANKH SENE","H2 THIARENE ET MBAYENE",10,10,113,80,193
DIOURBEL,DIOURBEL,NDINDY,"NDANKH SENE","H4 KEUR BAIDI",7,9,42,54,96
DIOURBEL,DIOURBEL,NDINDY,"NDANKH SENE","H5 SOW KARY",8,16,161,145,306
DIOURBEL,DIOURBEL,NDINDY,"NDANKH SENE",THIAKH,57,72,282,433,715
DIOURBEL,DIOURBEL,NDINDY,"NDANKH SENE",THIEYE,51,63,304,289,593
DIOURBEL,DIOURBEL,NDINDY,"NDANKH SENE","H3 BEP TOUCOULEUR",5,5,51,44,95
DIOURBEL,DIOURBEL,NDINDY,"NDANKH SENE",THIOUREN,7,10,72,45,117
DIOURBEL,DIOURBEL,NDINDY,"NDANKH SENE","TOUBA MBAYENE",17,20,108,101,209
DIOURBEL,DIOURBEL,NDINDY,"NDANKH SENE","H1 NGAWAYE",1,2,18,25,43
DIOURBEL,DIOURBEL,NDINDY,"NDANKH SENE","DANKH SENE 2",41,50,267,257,524
DIOURBEL,DIOURBEL,NDINDY,"GADE ESCALE","GADE ESCALE",23,27,159,144,303
DIOURBEL,DIOURBEL,NDINDY,"GADE ESCALE","H1 DAROU THIOUMP",25,28,225,212,437
DIOURBEL,DIOURBEL,NDINDY,"GADE ESCALE","H1 DIADJI (TAIBA OUOLOF)",2,2,23,25,48
DIOURBEL,DIOURBEL,NDINDY,"GADE ESCALE","KEUR LAYE",17,24,145,131,276
DIOURBEL,DIOURBEL,NDINDY,"GADE ESCALE","MERINA DIENG",12,18,110,97,207
DIOURBEL,DIOURBEL,NDINDY,"GADE ESCALE","MOUSLADJI 1 (NDAKHAR)",21,28,208,188,396
DIOURBEL,DIOURBEL,NDINDY,"GADE ESCALE",NAOLE,15,16,131,106,237
DIOURBEL,DIOURBEL,NDINDY,"GADE ESCALE",NDOUGOUBENE,10,10,107,75,182
DIOURBEL,DIOURBEL,NDINDY,"GADE ESCALE","H1 LAPAI TOURE",1,1,5,2,7
DIOURBEL,DIOURBEL,NDINDY,"GADE ESCALE",NGUEUTH,13,15,127,119,246
DIOURBEL,DIOURBEL,NDINDY,"GADE ESCALE","H1 KEUR BIRANE DIOP",9,10,108,97,205
DIOURBEL,DIOURBEL,NDINDY,"GADE ESCALE",SOUNE,9,9,66,61,127
DIOURBEL,DIOURBEL,NDINDY,"GADE ESCALE","TAIBA BEPP",5,5,59,24,83
DIOURBEL,DIOURBEL,NDINDY,"GADE ESCALE","H1 KEUR MANDIEME",5,6,37,29,66
DIOURBEL,DIOURBEL,NDINDY,"GADE ESCALE","H2 KEUR POLO FALL (NARGA)",4,5,25,24,49
DIOURBEL,DIOURBEL,NDINDY,"GADE ESCALE","H4 PEULGA",6,8,44,33,77
DIOURBEL,DIOURBEL,NDINDY,"GADE ESCALE","TAIBA KALLOM",18,23,135,124,259
DIOURBEL,DIOURBEL,NDINDY,"GADE ESCALE","H2 TAIBA SERERE",22,45,370,369,739
DIOURBEL,DIOURBEL,NDINDY,"GADE ESCALE","TAIBA KHAYE",8,11,108,85,193
DIOURBEL,DIOURBEL,NDINDY,"GADE ESCALE","H2 MBIEDIENE",14,15,103,121,224
DIOURBEL,DIOURBEL,NDINDY,"GADE ESCALE","H2 KEUR AMADOU",6,7,54,46,100
DIOURBEL,DIOURBEL,NDINDY,"GADE ESCALE","H3 KEUR MASSAER",4,4,16,23,39
DIOURBEL,DIOURBEL,NDINDY,"GADE ESCALE","TAIBA SANTHIE",3,3,11,10,21
DIOURBEL,DIOURBEL,NDINDY,NDINDY,"COCKI GOUYE",18,21,144,124,268
DIOURBEL,DIOURBEL,NDINDY,NDINDY,"H1 DJIB GOLLO",4,5,49,31,80
DIOURBEL,DIOURBEL,NDINDY,NDINDY,"H3 BOULEL COKI",13,18,100,103,203
DIOURBEL,DIOURBEL,NDINDY,NDINDY,"H4 MBADIANENE",11,12,67,47,114
DIOURBEL,DIOURBEL,NDINDY,NDINDY,"H5 KEUR BALA",3,3,16,15,31
DIOURBEL,DIOURBEL,NDINDY,NDINDY,"H6 KEUR BALLA KANE",4,5,29,23,52
DIOURBEL,DIOURBEL,NDINDY,NDINDY,"H7 KEUR IBRA SENE",7,8,44,49,93
DIOURBEL,DIOURBEL,NDINDY,NDINDY,"H8 KEUR NGOR NDONG",4,5,29,30,59
DIOURBEL,DIOURBEL,NDINDY,NDINDY,"H9 KEUR YORO BA",6,7,54,56,110
DIOURBEL,DIOURBEL,NDINDY,NDINDY,"H10 LEREE",4,7,31,25,56
DIOURBEL,DIOURBEL,NDINDY,NDINDY,"H11 NDIAYENE",5,8,54,53,107
DIOURBEL,DIOURBEL,NDINDY,NDINDY,"H13 PEULGA",2,2,19,9,28
DIOURBEL,DIOURBEL,NDINDY,NDINDY,"H14 WENDOU MBAYE",5,5,20,22,42
DIOURBEL,DIOURBEL,NDINDY,NDINDY,DAGA,15,22,112,107,219
DIOURBEL,DIOURBEL,NDINDY,NDINDY,"DAROU DIA",12,17,100,85,185
DIOURBEL,DIOURBEL,NDINDY,NDINDY,"DAROU NDIMB",7,11,102,96,198
DIOURBEL,DIOURBEL,NDINDY,NDINDY,"H1 NGARY DIOUF",1,2,22,14,36
DIOURBEL,DIOURBEL,NDINDY,NDINDY,"DAROU SALAO (DAROU SALAM)",9,9,55,66,121
DIOURBEL,DIOURBEL,NDINDY,NDINDY,"DIAMAKHEUL 1",5,7,64,49,113
DIOURBEL,DIOURBEL,NDINDY,NDINDY,"DIAMAKHEUL 2",9,11,83,74,157
DIOURBEL,DIOURBEL,NDINDY,NDINDY,DIONGO,33,39,171,188,359
DIOURBEL,DIOURBEL,NDINDY,NDINDY,"GOUYE GAYE",5,7,38,29,67
DIOURBEL,DIOURBEL,NDINDY,NDINDY,"H1 BIRANE MBAYE",2,11,103,98,201
DIOURBEL,DIOURBEL,NDINDY,NDINDY,"H2 KEUR DIOMAYE DIOUF",3,7,51,41,92
DIOURBEL,DIOURBEL,NDINDY,NDINDY,"H3 KEUR DIAPP",1,1,10,8,18
DIOURBEL,DIOURBEL,NDINDY,NDINDY,"H4 KEUR DETHIE NDONG",4,5,43,51,94
DIOURBEL,DIOURBEL,NDINDY,NDINDY,"H5 KEUR NGOR FAYE",6,14,101,110,211
DIOURBEL,DIOURBEL,NDINDY,NDINDY,"KEUR AMADOU COUMBANE",4,4,19,15,34
DIOURBEL,DIOURBEL,NDINDY,NDINDY,"H1 NGUIMANE",8,14,80,81,161
DIOURBEL,DIOURBEL,NDINDY,NDINDY,"KEUR MOUSSEU SALL",12,14,114,112,226
DIOURBEL,DIOURBEL,NDINDY,NDINDY,"H1 KEUR LAT DEMBA FAYE",3,3,14,15,29
DIOURBEL,DIOURBEL,NDINDY,NDINDY,"H2 KEUR LAT DIOUF",4,4,22,22,44
DIOURBEL,DIOURBEL,NDINDY,NDINDY,"H3 KEUR IBRAHIMA POUYE",3,4,39,38,77
DIOURBEL,DIOURBEL,NDINDY,NDINDY,LAYABE,21,28,93,122,215
DIOURBEL,DIOURBEL,NDINDY,NDINDY,LOUMBEL,9,11,48,42,90
DIOURBEL,DIOURBEL,NDINDY,NDINDY,LOUMENE,27,31,152,150,302
DIOURBEL,DIOURBEL,NDINDY,NDINDY,MBARASSY,3,10,53,40,93
DIOURBEL,DIOURBEL,NDINDY,NDINDY,"H1 KEUR ASSANE SYLLA",2,2,45,17,62
DIOURBEL,DIOURBEL,NDINDY,NDINDY,"MBOBENE GOUYE",17,19,114,114,228
DIOURBEL,DIOURBEL,NDINDY,NDINDY,"H1 KEUR DJIBY DIOP",4,9,15,17,32
DIOURBEL,DIOURBEL,NDINDY,NDINDY,"H2 KEUR NDIORO ET NIANGUENE",9,10,67,76,143
DIOURBEL,DIOURBEL,NDINDY,NDINDY,"MERINA SYLL",18,31,175,186,361
DIOURBEL,DIOURBEL,NDINDY,NDINDY,"H1 PEULGA KEUR AMADOU KA",1,1,7,2,9
DIOURBEL,DIOURBEL,NDINDY,NDINDY,"NDEME NDIAYE",38,79,310,398,708
DIOURBEL,DIOURBEL,NDINDY,NDINDY,"H1 KEUR MBANDA NDOYE",5,6,28,27,55
DIOURBEL,DIOURBEL,NDINDY,NDINDY,"H2 KEUR MOR NDELLA",1,2,4,10,14
DIOURBEL,DIOURBEL,NDINDY,NDINDY,"NDEME SARR",4,4,18,16,34
DIOURBEL,DIOURBEL,NDINDY,NDINDY,"H2 SANTHIOU NDEME NGOLO",2,2,14,15,29
DIOURBEL,DIOURBEL,NDINDY,NDINDY,NDIATACK,5,8,51,31,82
DIOURBEL,DIOURBEL,NDINDY,NDINDY,"H1 MBARE PEULH",8,15,78,81,159
DIOURBEL,DIOURBEL,NDINDY,NDINDY,"H2 KEUR NDIOUGA KANE",18,34,214,191,405
DIOURBEL,DIOURBEL,NDINDY,NDINDY,"H3 KEUR NGOR NGOM",10,16,100,91,191
DIOURBEL,DIOURBEL,NDINDY,NDINDY,"H4 RIMBAX",6,7,23,36,59
DIOURBEL,DIOURBEL,NDINDY,NDINDY,"NDIEK PINTHIE",11,14,97,89,186
DIOURBEL,DIOURBEL,NDINDY,NDINDY,"NDIMB 2",6,9,68,59,127
DIOURBEL,DIOURBEL,NDINDY,NDINDY,"H2 KEUR DIENE FAYE",6,7,87,62,149
DIOURBEL,DIOURBEL,NDINDY,NDINDY,"H5 KEUR SOUDOU SARR",2,3,28,23,51
DIOURBEL,DIOURBEL,NDINDY,NDINDY,"H6 KEUR DIANA DIOUF",10,10,75,72,147
DIOURBEL,DIOURBEL,NDINDY,NDINDY,NDINDY,151,191,1013,936,1949
DIOURBEL,DIOURBEL,NDINDY,NDINDY,"H1 NDINDY GOUYE",29,33,171,180,351
DIOURBEL,DIOURBEL,NDINDY,NDINDY,"H2 KEUR DIASS NIANG",4,7,48,49,97
DIOURBEL,DIOURBEL,NDINDY,NDINDY,"H3 KEUR ALIOU GASSAMA",5,5,22,24,46
DIOURBEL,DIOURBEL,NDINDY,NDINDY,"H4 KEUR DETHIE THIAW",11,18,116,117,233
DIOURBEL,DIOURBEL,NDINDY,NDINDY,"H5 KEUR DEMBA NGOM (MBOYENNE)",18,23,167,140,307
DIOURBEL,DIOURBEL,NDINDY,NDINDY,"H6 KEUR LATYR NDONG",7,9,62,64,126
DIOURBEL,DIOURBEL,NDINDY,NDINDY,"H7 KEUR MODOU GUEYE",2,3,19,20,39
DIOURBEL,DIOURBEL,NDINDY,NDINDY,"NDJIGUEL 1",7,8,85,59,144
DIOURBEL,DIOURBEL,NDINDY,NDINDY,"NDJIGUEL 2",7,10,65,67,132
DIOURBEL,DIOURBEL,NDINDY,NDINDY,"NGAYE NGAYE",5,5,25,38,63
DIOURBEL,DIOURBEL,NDINDY,NDINDY,"H2 PEULGA KEUR SADIBOU KA",3,3,13,13,26
DIOURBEL,DIOURBEL,NDINDY,NDINDY,"H2 KEUR SALIOU DIOME",9,13,81,87,168
DIOURBEL,DIOURBEL,NDINDY,NDINDY,"NGHAYE NGOM",7,10,37,37,74
DIOURBEL,DIOURBEL,NDINDY,NDINDY,"H1 THIOK GUEYE",4,7,37,45,82
DIOURBEL,DIOURBEL,NDINDY,NDINDY,NGOSS,17,31,135,166,301
DIOURBEL,DIOURBEL,NDINDY,NDINDY,NGUEYENE,9,9,51,43,94
DIOURBEL,DIOURBEL,NDINDY,NDINDY,"H1 KEUR MALICK",11,20,98,107,205
DIOURBEL,DIOURBEL,NDINDY,NDINDY,"H2 BOUSTANE",17,26,176,184,360
DIOURBEL,DIOURBEL,NDINDY,NDINDY,"PAYE PAYE",23,30,137,137,274
DIOURBEL,DIOURBEL,NDINDY,NDINDY,"H1 SANTHIE",13,13,62,48,110
DIOURBEL,DIOURBEL,NDINDY,NDINDY,"TAIBA NDAO",12,14,51,81,132
DIOURBEL,DIOURBEL,NDINDY,NDINDY,"TAIBA NDIAGNE 1",5,5,48,33,81
DIOURBEL,DIOURBEL,NDINDY,NDINDY,"H1 THIERERE (KEUR BIRAME)",2,4,18,22,40
DIOURBEL,DIOURBEL,NDINDY,NDINDY,"H2 PEULGA",2,5,22,16,38
DIOURBEL,DIOURBEL,NDINDY,NDINDY,"H3 THIAMBENE (COMMUNE TOUBA LAPPE)",2,3,13,20,33
DIOURBEL,DIOURBEL,NDINDY,NDINDY,"TAIBA NDIAGNE 2",5,7,32,49,81
DIOURBEL,DIOURBEL,NDINDY,NDINDY,"H1 KEUR AMADOU SYLL",1,2,15,18,33
DIOURBEL,DIOURBEL,NDINDY,NDINDY,"TAIBA SANTHIE",15,16,108,122,230
DIOURBEL,DIOURBEL,NDINDY,NDINDY,"H2 KEUR MODOU NIANG",5,9,60,70,130
DIOURBEL,DIOURBEL,NDINDY,NDINDY,"H3 SANTHIE NGOMENE (COMMUNE TOUBA LAPPE)",5,5,24,26,50
DIOURBEL,DIOURBEL,NDINDY,NDINDY,TALLAKH,25,33,196,164,360
DIOURBEL,DIOURBEL,NDINDY,NDINDY,"H1 DODE",8,8,32,51,83
DIOURBEL,DIOURBEL,NDINDY,NDINDY,"H2 KEUR KOLOU NIOME",4,7,38,37,75
DIOURBEL,DIOURBEL,NDINDY,NDINDY,"H3 KEUR SADY SARR",5,8,84,57,141
DIOURBEL,DIOURBEL,NDINDY,NDINDY,"H4 NDIOBENE",3,5,29,39,68
DIOURBEL,DIOURBEL,NDINDY,NDINDY,"H5 TALLAH MBABERY",5,6,44,48,92
DIOURBEL,DIOURBEL,NDINDY,NDINDY,"H6 TAMAKA ET MBINE WALY",5,8,38,42,80
DIOURBEL,DIOURBEL,NDINDY,NDINDY,THIAMENE,10,12,70,66,136
DIOURBEL,DIOURBEL,NDINDY,NDINDY,"H1 KEUR NGAGNE FAYE",8,11,76,62,138
DIOURBEL,DIOURBEL,NDINDY,NDINDY,THIEGNE,6,7,23,21,44
DIOURBEL,DIOURBEL,NDINDY,NDINDY,"TOUBA COKY",20,25,179,101,280
DIOURBEL,DIOURBEL,NDINDY,NDINDY,"H2 SAKEBE",17,32,254,244,498
DIOURBEL,DIOURBEL,NDINDY,NDINDY,"H4 COKI SERERE",24,47,267,277,544
DIOURBEL,DIOURBEL,NDINDY,NDINDY,"H5 NDIBA",6,9,72,60,132
DIOURBEL,DIOURBEL,NDINDY,NDINDY,YEOUL,6,9,48,37,85
DIOURBEL,DIOURBEL,NDINDY,NDINDY,"H1 GABEL SOW",3,3,16,15,31
DIOURBEL,DIOURBEL,NDINDY,NDINDY,"BOHE BAOL (KEUR DAME KA)",13,19,106,115,221
DIOURBEL,DIOURBEL,NDINDY,NDINDY,"KEUR ALIOU DIOUF",8,8,59,61,120
DIOURBEL,DIOURBEL,NDINDY,NDINDY,"NDIMB 1 (KEUR BIRAME TINE)",7,7,45,37,82
DIOURBEL,DIOURBEL,NDINDY,NDINDY,"H1 KEUR MANGUI FAYE",13,18,149,114,263
DIOURBEL,DIOURBEL,NDINDY,NDINDY,"H7 KEUR NDAYANE SOW",1,1,3,5,8
DIOURBEL,DIOURBEL,NDINDY,"KEUR NGALGOU","DIOKOUL 2",10,12,68,53,121
DIOURBEL,DIOURBEL,NDINDY,"KEUR NGALGOU","GADE KHAPSOU",14,15,79,74,153
DIOURBEL,DIOURBEL,NDINDY,"KEUR NGALGOU","H1 MBAKHOUM",17,37,225,263,488
DIOURBEL,DIOURBEL,NDINDY,"KEUR NGALGOU","H2 PEULGA",2,2,23,11,34
DIOURBEL,DIOURBEL,NDINDY,"KEUR NGALGOU",KANENE,1,1,12,0,12
DIOURBEL,DIOURBEL,NDINDY,"KEUR NGALGOU","KEUR ALLA NIANG",9,10,37,32,69
DIOURBEL,DIOURBEL,NDINDY,"KEUR NGALGOU","H2 MBATYR",3,3,18,7,25
DIOURBEL,DIOURBEL,NDINDY,"KEUR NGALGOU","H3 NDIOLEFA",1,1,3,0,3
DIOURBEL,DIOURBEL,NDINDY,"KEUR NGALGOU","H4 THIASKY",7,7,40,40,80
DIOURBEL,DIOURBEL,NDINDY,"KEUR NGALGOU","H5 THIASKY PEUL",5,5,19,15,34
DIOURBEL,DIOURBEL,NDINDY,"KEUR NGALGOU","KEUR BIRIMA NDAO",5,8,45,40,85
DIOURBEL,DIOURBEL,NDINDY,"KEUR NGALGOU","KEUR MASSAER",11,12,129,57,186
DIOURBEL,DIOURBEL,NDINDY,"KEUR NGALGOU","H1 KEUR NDIAP FALL",1,8,65,35,100
DIOURBEL,DIOURBEL,NDINDY,"KEUR NGALGOU","KEUR NDIOUGA MBAYE",14,17,116,109,225
DIOURBEL,DIOURBEL,NDINDY,"KEUR NGALGOU","H3 KEUR ABDOULAYE KA",2,4,22,24,46
DIOURBEL,DIOURBEL,NDINDY,"KEUR NGALGOU","KEUR NGALGOU",36,41,295,327,622
DIOURBEL,DIOURBEL,NDINDY,"KEUR NGALGOU","H1 KEUR DAOUDA GUEYE",2,2,15,9,24
DIOURBEL,DIOURBEL,NDINDY,"KEUR NGALGOU","KEUR SALLA NDIAYE",3,4,37,37,74
DIOURBEL,DIOURBEL,NDINDY,"KEUR NGALGOU","H2 KEUR MOR DIOP",1,1,2,2,4
DIOURBEL,DIOURBEL,NDINDY,"KEUR NGALGOU",KHAPSOU,2,3,50,32,82
DIOURBEL,DIOURBEL,NDINDY,"KEUR NGALGOU",KHAYGUENE,15,19,129,98,227
DIOURBEL,DIOURBEL,NDINDY,"KEUR NGALGOU",MBOBA,9,12,63,47,110
DIOURBEL,DIOURBEL,NDINDY,"KEUR NGALGOU","H1 KEUR MODOU FAYE ET DIABAYE",16,20,129,107,236
DIOURBEL,DIOURBEL,NDINDY,"KEUR NGALGOU","MBOBENE NGAWAO",13,16,85,81,166
DIOURBEL,DIOURBEL,NDINDY,"KEUR NGALGOU","H2 KEUR MODOU BADIANE",6,7,36,44,80
DIOURBEL,DIOURBEL,NDINDY,"KEUR NGALGOU","H3 KEUR SAMOUR GUEYE",14,18,123,108,231
DIOURBEL,DIOURBEL,NDINDY,"KEUR NGALGOU",NDIOUSS,15,18,131,120,251
DIOURBEL,DIOURBEL,NDINDY,"KEUR NGALGOU","H1 KEUR IBRA NDIAYE",2,2,12,19,31
DIOURBEL,DIOURBEL,NDINDY,"KEUR NGALGOU","NGANGAL PEULH",14,19,136,94,230
DIOURBEL,DIOURBEL,NDINDY,"KEUR NGALGOU","NGANKAL WOLOF",21,28,163,171,334
DIOURBEL,DIOURBEL,NDINDY,"KEUR NGALGOU","H1 KEUR DEMBA SARR",6,11,116,101,217
DIOURBEL,DIOURBEL,NDINDY,"KEUR NGALGOU","H2 NGANGAL KEUR ISSA SENE",7,7,69,60,129
DIOURBEL,DIOURBEL,NDINDY,"KEUR NGALGOU",NGHAWAW,6,6,48,53,101
DIOURBEL,DIOURBEL,NDINDY,"KEUR NGALGOU","H2 KONTEYENNE",9,13,108,83,191
DIOURBEL,DIOURBEL,NDINDY,"KEUR NGALGOU","H3 NDIANOU KEUR ALY BA DE NGAWAW",7,8,41,41,82
DIOURBEL,DIOURBEL,NDINDY,"KEUR NGALGOU","H4 THIOMBOLY",20,25,170,193,363
DIOURBEL,DIOURBEL,NDINDY,"KEUR NGALGOU",PALLENE,17,21,198,173,371
DIOURBEL,DIOURBEL,NDINDY,"KEUR NGALGOU","H1 PALENE SERERE",15,26,221,204,425
DIOURBEL,DIOURBEL,NDINDY,"KEUR NGALGOU","H4 GOUDIANE (COMMUNE DE NDINDY)",6,11,96,72,168
DIOURBEL,DIOURBEL,NDINDY,"KEUR NGALGOU","H5 PALLENE 3",13,20,218,200,418
DIOURBEL,DIOURBEL,NDINDY,"KEUR NGALGOU","PEO FALL",14,14,65,106,171
DIOURBEL,DIOURBEL,NDINDY,"KEUR NGALGOU","H2 PEO SERERE",14,24,168,202,370
DIOURBEL,DIOURBEL,NDINDY,"KEUR NGALGOU","TAIBA DAKHAR",8,11,118,42,160
DIOURBEL,DIOURBEL,NDINDY,"KEUR NGALGOU","H2 TAIBA SANTHIE",1,1,4,4,8
DIOURBEL,DIOURBEL,NDINDY,"KEUR NGALGOU",TAWA,20,35,252,233,485
DIOURBEL,DIOURBEL,NDINDY,"KEUR NGALGOU","H1 KEBE",1,1,1,2,3
DIOURBEL,DIOURBEL,NDINDY,"KEUR NGALGOU","H2 KEUR NDIAYE",1,2,11,11,22
DIOURBEL,DIOURBEL,NDINDY,"KEUR NGALGOU","TEIGNE TEIGNE",22,35,223,222,445
DIOURBEL,DIOURBEL,NDINDY,"KEUR NGALGOU","H2 KEUR DIAGA ET LAGNAR",10,12,95,93,188
DIOURBEL,DIOURBEL,NDINDY,"KEUR NGALGOU","THIOK NIANG",5,6,34,34,68
DIOURBEL,DIOURBEL,NDINDY,"KEUR NGALGOU","H2 KEUR GAYANE SENE",2,3,29,11,40
DIOURBEL,DIOURBEL,NDINDY,"KEUR NGALGOU","H3 KEUR BIRANE SARR",4,4,40,28,68
DIOURBEL,DIOURBEL,NDINDY,"KEUR NGALGOU",THYSSE,4,4,25,21,46
DIOURBEL,DIOURBEL,NDINDY,"KEUR NGALGOU","H1 KEUR AMATH GNING",9,9,59,54,113
DIOURBEL,DIOURBEL,NDINDY,"KEUR NGALGOU","H2 KEUR MODOU MBAYE",7,12,118,100,218
DIOURBEL,DIOURBEL,NDINDY,"KEUR NGALGOU","THYSSE KELIMANE",6,6,51,59,110
DIOURBEL,DIOURBEL,NDINDY,"KEUR NGALGOU","H1 DAROU SALAM",12,13,139,111,250
DIOURBEL,DIOURBEL,NDINDY,"KEUR NGALGOU",MBATHIE,2,2,7,8,15
DIOURBEL,DIOURBEL,NDINDY,"KEUR NGALGOU",NDOMBOUR,1,1,4,11,15
DIOURBEL,DIOURBEL,NDINDY,"KEUR NGALGOU","TOUBA NDIAYENE",6,7,56,68,124
DIOURBEL,DIOURBEL,NDINDY,"KEUR NGALGOU","H3 DIERE (COMMUNE TOUBA LAPPE)",2,2,5,8,13
DIOURBEL,DIOURBEL,NDINDY,"TAIBA MOUTOUPHA","DAROU MBAYE",6,7,32,32,64
DIOURBEL,DIOURBEL,NDINDY,"TAIBA MOUTOUPHA","H2 KEUR ARDO POUYE",6,6,41,41,82
DIOURBEL,DIOURBEL,NDINDY,"TAIBA MOUTOUPHA","H3 NDIA",2,2,14,16,30
DIOURBEL,DIOURBEL,NDINDY,"TAIBA MOUTOUPHA","H4 DAROU SERERE",14,19,136,137,273
DIOURBEL,DIOURBEL,NDINDY,"TAIBA MOUTOUPHA","DAROU SALAM (NDOURENE)",5,5,25,26,51
DIOURBEL,DIOURBEL,NDINDY,"TAIBA MOUTOUPHA",DIOKOUL,6,7,45,50,95
DIOURBEL,DIOURBEL,NDINDY,"TAIBA MOUTOUPHA",NDJITHIAR,18,27,146,174,320
DIOURBEL,DIOURBEL,NDINDY,"TAIBA MOUTOUPHA","H1 GATTE ET GOUYE DIOR",9,16,104,89,193
DIOURBEL,DIOURBEL,NDINDY,"TAIBA MOUTOUPHA","H2 GNIMEL",22,25,210,198,408
DIOURBEL,DIOURBEL,NDINDY,"TAIBA MOUTOUPHA",GNINGUENE,36,45,206,225,431
DIOURBEL,DIOURBEL,NDINDY,"TAIBA MOUTOUPHA","H1 DAROU NGUINGUENE",2,4,14,13,27
DIOURBEL,DIOURBEL,NDINDY,"TAIBA MOUTOUPHA","GOUYE NDIAYE",18,20,154,146,300
DIOURBEL,DIOURBEL,NDINDY,"TAIBA MOUTOUPHA",KEDIAO,6,8,49,45,94
DIOURBEL,DIOURBEL,NDINDY,"TAIBA MOUTOUPHA","KEUR MBAYE ISSA",12,15,126,81,207
DIOURBEL,DIOURBEL,NDINDY,"TAIBA MOUTOUPHA",KHEUL,20,21,144,126,270
DIOURBEL,DIOURBEL,NDINDY,"TAIBA MOUTOUPHA",KHOUPOYE,7,9,80,68,148
DIOURBEL,DIOURBEL,NDINDY,"TAIBA MOUTOUPHA","H2 KEUR DIAPP",3,3,22,21,43
DIOURBEL,DIOURBEL,NDINDY,"TAIBA MOUTOUPHA",KOURE,14,18,89,69,158
DIOURBEL,DIOURBEL,NDINDY,"TAIBA MOUTOUPHA","LAMBEYE (COMMUNE NDINDY)",2,2,16,14,30
DIOURBEL,DIOURBEL,NDINDY,"TAIBA MOUTOUPHA","H1 KEUR NDIEUGOU THIAW (COMMUNE NDINDY)",6,6,53,48,101
DIOURBEL,DIOURBEL,NDINDY,"TAIBA MOUTOUPHA",LAYAM,7,16,82,76,158
DIOURBEL,DIOURBEL,NDINDY,"TAIBA MOUTOUPHA","MBAMB (MBAMB DIA)",16,18,145,121,266
DIOURBEL,DIOURBEL,NDINDY,"TAIBA MOUTOUPHA","H1 KEUR ADIOUMA NIOME (NIOMENE)",7,11,95,84,179
DIOURBEL,DIOURBEL,NDINDY,"TAIBA MOUTOUPHA","H3 KEUR ALLA DIENG",3,5,21,36,57
DIOURBEL,DIOURBEL,NDINDY,"TAIBA MOUTOUPHA","H5 KEUR MOR CONTEY",1,4,5,15,20
DIOURBEL,DIOURBEL,NDINDY,"TAIBA MOUTOUPHA",MBARASSANE,62,75,584,455,1039
DIOURBEL,DIOURBEL,NDINDY,"TAIBA MOUTOUPHA","H1 KOTE ET KEUR CHEIKHOU",14,17,117,95,212
DIOURBEL,DIOURBEL,NDINDY,"TAIBA MOUTOUPHA","MBAYENE SOB",7,7,43,32,75
DIOURBEL,DIOURBEL,NDINDY,"TAIBA MOUTOUPHA","H2 NGUEMBE",1,2,10,13,23
DIOURBEL,DIOURBEL,NDINDY,"TAIBA MOUTOUPHA","H3 KEUR MANGONE KHOUMA",1,2,11,16,27
DIOURBEL,DIOURBEL,NDINDY,"TAIBA MOUTOUPHA","H4 KEUR NGAGNE TINE",1,2,37,36,73
DIOURBEL,DIOURBEL,NDINDY,"TAIBA MOUTOUPHA","H5 THIENENE",2,3,30,29,59
DIOURBEL,DIOURBEL,NDINDY,"TAIBA MOUTOUPHA",NDEUNGUEGNE,3,4,29,16,45
DIOURBEL,DIOURBEL,NDINDY,"TAIBA MOUTOUPHA",NDIADAKHAR,6,7,42,38,80
DIOURBEL,DIOURBEL,NDINDY,"TAIBA MOUTOUPHA","H1 KEUR BARA SOW",1,1,10,5,15
DIOURBEL,DIOURBEL,NDINDY,"TAIBA MOUTOUPHA","NDIALAP (DAROU DIALAP)",19,19,135,139,274
DIOURBEL,DIOURBEL,NDINDY,"TAIBA MOUTOUPHA","H1 GANDIOUL",5,6,42,34,76
DIOURBEL,DIOURBEL,NDINDY,"TAIBA MOUTOUPHA","H2 PARBA DIOP ET PARBA SARR",14,19,124,103,227
DIOURBEL,DIOURBEL,NDINDY,"TAIBA MOUTOUPHA",NDIALAKHASS,6,7,33,32,65
DIOURBEL,DIOURBEL,NDINDY,"TAIBA MOUTOUPHA","H2 KEUR DEMBA KHOKH",4,4,32,31,63
DIOURBEL,DIOURBEL,NDINDY,"TAIBA MOUTOUPHA",NDIAMBOUTY,9,13,129,113,242
DIOURBEL,DIOURBEL,NDINDY,"TAIBA MOUTOUPHA","H1 KEUR MODOU GNING",1,2,47,38,85
DIOURBEL,DIOURBEL,NDINDY,"TAIBA MOUTOUPHA","H2 NDIA SOUMP",2,3,11,23,34
DIOURBEL,DIOURBEL,NDINDY,"TAIBA MOUTOUPHA",NDIAO,20,21,155,136,291
DIOURBEL,DIOURBEL,NDINDY,"TAIBA MOUTOUPHA","H1 KEUR GALEL KA",6,6,48,34,82
DIOURBEL,DIOURBEL,NDINDY,"TAIBA MOUTOUPHA",NDIETTE,30,35,278,275,553
DIOURBEL,DIOURBEL,NDINDY,"TAIBA MOUTOUPHA","H3 KEUR ALY",8,8,77,85,162
DIOURBEL,DIOURBEL,NDINDY,"TAIBA MOUTOUPHA","H4 KEUR BAKAR SENE",5,5,53,51,104
DIOURBEL,DIOURBEL,NDINDY,"TAIBA MOUTOUPHA","H5 KEUR DJERY",3,4,51,42,93
DIOURBEL,DIOURBEL,NDINDY,"TAIBA MOUTOUPHA","H6 KEUR MBAYE MBOLOU",2,2,12,12,24
DIOURBEL,DIOURBEL,NDINDY,"TAIBA MOUTOUPHA","H7 KEUR MBAYE NDIETTE",8,8,54,50,104
DIOURBEL,DIOURBEL,NDINDY,"TAIBA MOUTOUPHA","H8 KEUR NDIAGA NDONG",4,5,53,30,83
DIOURBEL,DIOURBEL,NDINDY,"TAIBA MOUTOUPHA","NDIMB DAPA",1,1,1,0,1
DIOURBEL,DIOURBEL,NDINDY,"TAIBA MOUTOUPHA",NGABOU,7,12,77,75,152
DIOURBEL,DIOURBEL,NDINDY,"TAIBA MOUTOUPHA","H2 SANTHIE",7,9,107,77,184
DIOURBEL,DIOURBEL,NDINDY,"TAIBA MOUTOUPHA",NGOUYE,1,1,19,16,35
DIOURBEL,DIOURBEL,NDINDY,"TAIBA MOUTOUPHA","NIOLE (TOUBA SALAO)",17,24,80,122,202
DIOURBEL,DIOURBEL,NDINDY,"TAIBA MOUTOUPHA","SANTHIE MBAMB",9,11,87,72,159
DIOURBEL,DIOURBEL,NDINDY,"TAIBA MOUTOUPHA",SIGUIDIADJI,7,10,55,40,95
DIOURBEL,DIOURBEL,NDINDY,"TAIBA MOUTOUPHA","H1 NDJIGUEUL",7,7,27,31,58
DIOURBEL,DIOURBEL,NDINDY,"TAIBA MOUTOUPHA","H2 MA YAYE",2,2,10,12,22
DIOURBEL,DIOURBEL,NDINDY,"TAIBA MOUTOUPHA","TAIBA MOUTOUPHA",52,57,376,351,727
DIOURBEL,DIOURBEL,NDINDY,"TAIBA MOUTOUPHA","H1 KEUR MBAKHAR NIANG",17,19,171,189,360
DIOURBEL,DIOURBEL,NDINDY,"TAIBA MOUTOUPHA","H2 KEUR MOR SOKHNA ET KEUR ASSANE DIA",1,1,13,11,24
DIOURBEL,DIOURBEL,NDINDY,"TAIBA MOUTOUPHA",THIALY,40,43,249,285,534
DIOURBEL,DIOURBEL,NDINDY,"TAIBA MOUTOUPHA","H2 NDIA KANDJI",4,6,19,17,36
DIOURBEL,DIOURBEL,NDINDY,"TAIBA MOUTOUPHA",THIENDIENG,24,25,142,215,357
DIOURBEL,DIOURBEL,NDINDY,"TAIBA MOUTOUPHA","H2 KEUR BABA KHARY",28,33,209,193,402
DIOURBEL,DIOURBEL,NDINDY,"TAIBA MOUTOUPHA",TOUBE,6,7,37,41,78
DIOURBEL,DIOURBEL,NDINDY,"TAIBA MOUTOUPHA","H1 NGOMENE (TOUBE 2)",7,7,50,45,95
DIOURBEL,DIOURBEL,NDINDY,"TAIBA MOUTOUPHA",YAMAL,36,48,321,362,683
DIOURBEL,DIOURBEL,NDINDY,"TAIBA MOUTOUPHA","H1 PAYE",5,5,44,38,82
DIOURBEL,DIOURBEL,NDINDY,"TAIBA MOUTOUPHA","H2 KEUR ALIOU FAYE",2,3,16,9,25
DIOURBEL,DIOURBEL,NDINDY,"TAIBA MOUTOUPHA","KEUR DAME KANE",26,33,225,218,443
DIOURBEL,DIOURBEL,NDINDY,"TAIBA MOUTOUPHA","MBABLOL 1",3,3,26,18,44
DIOURBEL,DIOURBEL,NDINDY,"TAIBA MOUTOUPHA","MBABLOL 2",22,27,173,168,341
DIOURBEL,DIOURBEL,NDINDY,"TAIBA MOUTOUPHA",NDIAMB,26,31,273,263,536
DIOURBEL,DIOURBEL,NDINDY,"TOUBA LAPPE","COKI NDIAGUENE",9,11,63,73,136
DIOURBEL,DIOURBEL,NDINDY,"TOUBA LAPPE","H1 TOURE (KEUR SERIGNE TOURE)",5,5,65,41,106
DIOURBEL,DIOURBEL,NDINDY,"TOUBA LAPPE","DAROU DIENG",17,19,174,107,281
DIOURBEL,DIOURBEL,NDINDY,"TOUBA LAPPE","H2 DARA SERIGNE ABDOU",1,1,4,0,4
DIOURBEL,DIOURBEL,NDINDY,"TOUBA LAPPE","NDIOMPY 1",7,7,55,66,121
DIOURBEL,DIOURBEL,NDINDY,"TOUBA LAPPE","H1 DAROU SEYE",1,1,15,9,24
DIOURBEL,DIOURBEL,NDINDY,"TOUBA LAPPE","H2 KEUR ABDOU HANN",8,10,76,59,135
DIOURBEL,DIOURBEL,NDINDY,"TOUBA LAPPE","H3 KEUR BALLA KHOUMA",21,23,167,129,296
DIOURBEL,DIOURBEL,NDINDY,"TOUBA LAPPE",FETODIE,5,5,22,25,47
DIOURBEL,DIOURBEL,NDINDY,"TOUBA LAPPE","KALOM 1",6,9,58,47,105
DIOURBEL,DIOURBEL,NDINDY,"TOUBA LAPPE","KALOM 2",7,8,54,50,104
DIOURBEL,DIOURBEL,NDINDY,"TOUBA LAPPE","H1 KALAMINE",8,10,73,53,126
DIOURBEL,DIOURBEL,NDINDY,"TOUBA LAPPE","KEUR KHAR",5,5,46,14,60
DIOURBEL,DIOURBEL,NDINDY,"TOUBA LAPPE","KEUR MATAR DIENG",14,16,91,103,194
DIOURBEL,DIOURBEL,NDINDY,"TOUBA LAPPE","LAPPE 1",13,13,115,98,213
DIOURBEL,DIOURBEL,NDINDY,"TOUBA LAPPE","H1 KEUR MALICK",10,13,69,60,129
DIOURBEL,DIOURBEL,NDINDY,"TOUBA LAPPE","H3 NDIAKHATE",4,4,65,45,110
DIOURBEL,DIOURBEL,NDINDY,"TOUBA LAPPE","LAPPE 2",20,25,170,140,310
DIOURBEL,DIOURBEL,NDINDY,"TOUBA LAPPE","H1 KEUR SERIGNE BALLA",4,6,41,27,68
DIOURBEL,DIOURBEL,NDINDY,"TOUBA LAPPE","H2 KEUR NGANA",31,34,199,191,390
DIOURBEL,DIOURBEL,NDINDY,"TOUBA LAPPE","MEOUNDOU KALOM",2,2,13,8,21
DIOURBEL,DIOURBEL,NDINDY,"TOUBA LAPPE","MOUSLADJI 2",9,10,114,88,202
DIOURBEL,DIOURBEL,NDINDY,"TOUBA LAPPE","H1 DAROU TOURE",6,6,88,35,123
DIOURBEL,DIOURBEL,NDINDY,"TOUBA LAPPE","NDIOMPY 2",9,10,65,56,121
DIOURBEL,DIOURBEL,NDINDY,"TOUBA LAPPE","H1 RIMBAKH",6,7,39,38,77
DIOURBEL,DIOURBEL,NDINDY,"TOUBA LAPPE","H2 NDIRENE",3,3,29,16,45
DIOURBEL,DIOURBEL,NDINDY,"TOUBA LAPPE","NDOGAL SANTHIE",5,9,48,48,96
DIOURBEL,DIOURBEL,NDINDY,"TOUBA LAPPE","H1 NDIA GANDIOLE",13,13,59,65,124
DIOURBEL,DIOURBEL,NDINDY,"TOUBA LAPPE","H3 AFFE",4,4,19,9,28
DIOURBEL,DIOURBEL,NDINDY,"TOUBA LAPPE","H4 DAARA SERIGNE ABDOU DIENG",1,1,6,0,6
DIOURBEL,DIOURBEL,NDINDY,"TOUBA LAPPE","H5 DAROU TOURE",6,8,58,41,99
DIOURBEL,DIOURBEL,NDINDY,"TOUBA LAPPE",NDOUCOUMANE,12,13,66,51,117
DIOURBEL,DIOURBEL,NDINDY,"TOUBA LAPPE","H2 DIERE NGOMENE",13,16,98,106,204
DIOURBEL,DIOURBEL,NDINDY,"TOUBA LAPPE","H3 DIERE DIENG",4,5,44,55,99
DIOURBEL,DIOURBEL,NDINDY,"TOUBA LAPPE","THIAKHAMY TOURE",8,8,61,79,140
DIOURBEL,DIOURBEL,NDINDY,"TOUBA LAPPE","H1 KEUR CHEIKH SOKHNA MBAYE TOURE",19,20,120,104,224
DIOURBEL,DIOURBEL,NDINDY,"TOUBA LAPPE",THIECKANE,10,10,84,51,135
DIOURBEL,DIOURBEL,NDINDY,"TOUBA LAPPE","H1 THIEKANE NEWE",5,5,33,30,63
DIOURBEL,DIOURBEL,NDINDY,"TOUBA LAPPE","TOUBA NGOMENE (NGOMENE)",5,6,25,33,58
DIOURBEL,DIOURBEL,NDINDY,"TOUBA LAPPE","THIAKHAMY NIASSENE",4,4,44,39,83
DIOURBEL,DIOURBEL,NDINDY,"TOUBA LAPPE","H1 DAROU SALAM",3,3,21,25,46
DIOURBEL,DIOURBEL,NDINDY,"TOUBA LAPPE","H2 TINENE",4,5,32,25,57
DIOURBEL,DIOURBEL,NDOULO,NDOULO,"DAKAR MBAYARD 1",3,6,41,45,86
DIOURBEL,DIOURBEL,NDOULO,NDOULO,"H1 NARGA",6,6,29,30,59
DIOURBEL,DIOURBEL,NDOULO,NDOULO,"DAKAR MBAYARD 2",14,17,105,119,224
DIOURBEL,DIOURBEL,NDOULO,NDOULO,"H2 NDIOMENE",7,13,101,85,186
DIOURBEL,DIOURBEL,NDOULO,NDOULO,DIOLLO,8,8,38,26,64
DIOURBEL,DIOURBEL,NDOULO,NDOULO,"DIOUGAL PEULH",3,3,20,16,36
DIOURBEL,DIOURBEL,NDOULO,NDOULO,"H1 KALOM",2,2,13,28,41
DIOURBEL,DIOURBEL,NDOULO,NDOULO,"DIOUGAL WOLOF",5,5,20,29,49
DIOURBEL,DIOURBEL,NDOULO,NDOULO,GADE,7,7,34,23,57
DIOURBEL,DIOURBEL,NDOULO,NDOULO,"GALLE MBAYAR",10,10,27,27,54
DIOURBEL,DIOURBEL,NDOULO,NDOULO,GORETTE,20,27,188,185,373
DIOURBEL,DIOURBEL,NDOULO,NDOULO,"H1 KEUR ABDOU BA",3,4,42,38,80
DIOURBEL,DIOURBEL,NDOULO,NDOULO,"H2 MBOUKY",8,12,61,70,131
DIOURBEL,DIOURBEL,NDOULO,NDOULO,KANDJI,5,11,38,39,77
DIOURBEL,DIOURBEL,NDOULO,NDOULO,"KEBE KHOULE",9,17,92,68,160
DIOURBEL,DIOURBEL,NDOULO,NDOULO,"KEUR EL HADJI BIRANE",12,17,71,71,142
DIOURBEL,DIOURBEL,NDOULO,NDOULO,"H2 THIENENE MOURIDE",8,8,54,55,109
DIOURBEL,DIOURBEL,NDOULO,NDOULO,"KEUR MOMAR NIANG (KEUR MADY NDACK)",13,14,53,59,112
DIOURBEL,DIOURBEL,NDOULO,NDOULO,"H1 KEUR DETHIE",4,4,27,29,56
DIOURBEL,DIOURBEL,NDOULO,NDOULO,"H2 KEUR FAP DIOME",1,1,8,9,17
DIOURBEL,DIOURBEL,NDOULO,NDOULO,"KHOKHE NDIOUFFENE",16,19,154,136,290
DIOURBEL,DIOURBEL,NDOULO,NDOULO,"KHOKHE NGADIAGA",14,15,75,84,159
DIOURBEL,DIOURBEL,NDOULO,NDOULO,KHOULE,25,37,216,252,468
DIOURBEL,DIOURBEL,NDOULO,NDOULO,"H1 SANTHIE",4,4,22,28,50
DIOURBEL,DIOURBEL,NDOULO,NDOULO,"H2 PETIT KHOULE",1,1,3,3,6
DIOURBEL,DIOURBEL,NDOULO,NDOULO,"H3 THYLLA",4,4,21,20,41
DIOURBEL,DIOURBEL,NDOULO,NDOULO,"H4 DAROU DIOP KHOULE",5,6,20,19,39
DIOURBEL,DIOURBEL,NDOULO,NDOULO,"KONTEYENNE NDOULO",18,19,108,107,215
DIOURBEL,DIOURBEL,NDOULO,NDOULO,KOUDE,2,3,14,21,35
DIOURBEL,DIOURBEL,NDOULO,NDOULO,"MBAPPE (SABEYE)",12,14,67,71,138
DIOURBEL,DIOURBEL,NDOULO,NDOULO,MBATTY,14,14,108,58,166
DIOURBEL,DIOURBEL,NDOULO,NDOULO,"H4 KEUR WALY DIAGNE",4,4,42,37,79
DIOURBEL,DIOURBEL,NDOULO,NDOULO,"H5 KEUR NGAGNE",4,4,19,25,44
DIOURBEL,DIOURBEL,NDOULO,NDOULO,MBAYENNE,8,10,47,53,100
DIOURBEL,DIOURBEL,NDOULO,NDOULO,MBEUSSINE,4,5,15,29,44
DIOURBEL,DIOURBEL,NDOULO,NDOULO,"MBEYE WOKANE",28,30,140,180,320
DIOURBEL,DIOURBEL,NDOULO,NDOULO,"MERINA THIAKHO",12,16,85,86,171
DIOURBEL,DIOURBEL,NDOULO,NDOULO,"NDIASSY DIAGNE",20,24,176,178,354
DIOURBEL,DIOURBEL,NDOULO,NDOULO,"NDIASSY MBAYE",22,25,166,182,348
DIOURBEL,DIOURBEL,NDOULO,NDOULO,"NDIEGUENE THIOUTHE",17,29,131,134,265
DIOURBEL,DIOURBEL,NDOULO,NDOULO,"NDIEGUENE WOCANE",10,11,84,63,147
DIOURBEL,DIOURBEL,NDOULO,NDOULO,"NDIOUFENE WOKANE",38,51,318,260,578
DIOURBEL,DIOURBEL,NDOULO,NDOULO,NDOUCOURA,17,32,185,190,375
DIOURBEL,DIOURBEL,NDOULO,NDOULO,NDOULO,281,322,1828,1864,3692
DIOURBEL,DIOURBEL,NDOULO,NDOULO,"NDOULO PEULH MBOUKI",12,15,86,79,165
DIOURBEL,DIOURBEL,NDOULO,NDOULO,NGAYENNE,12,14,41,35,76
DIOURBEL,DIOURBEL,NDOULO,NDOULO,"NGOUNDJODJI TEN",25,40,263,266,529
DIOURBEL,DIOURBEL,NDOULO,NDOULO,"H1 KOLDAGA",8,14,88,103,191
DIOURBEL,DIOURBEL,NDOULO,NDOULO,"H2 GUIRY MBAYE SERERE",11,14,89,90,179
DIOURBEL,DIOURBEL,NDOULO,NDOULO,"H3 KEUR GAYANE SENE",10,11,99,95,194
DIOURBEL,DIOURBEL,NDOULO,NDOULO,"H4 KEUR MBAYE NGOM",4,4,35,31,66
DIOURBEL,DIOURBEL,NDOULO,NDOULO,"NGOUNDIODJI (KELEMBEL)",6,25,200,169,369
DIOURBEL,DIOURBEL,NDOULO,NDOULO,"H1 KELEMBEL",5,8,60,62,122
DIOURBEL,DIOURBEL,NDOULO,NDOULO,NIANGHE,5,7,53,38,91
DIOURBEL,DIOURBEL,NDOULO,NDOULO,"H1 KEUR NDIAGA SARR",7,7,34,42,76
DIOURBEL,DIOURBEL,NDOULO,NDOULO,"PETIT MBEYE",3,8,24,33,57
DIOURBEL,DIOURBEL,NDOULO,NDOULO,"SOW KHARY",5,6,53,36,89
DIOURBEL,DIOURBEL,NDOULO,NDOULO,"H2 KEUR YAWA DIOUF",2,2,20,19,39
DIOURBEL,DIOURBEL,NDOULO,NDOULO,"TAIRE SERERE",15,24,119,88,207
DIOURBEL,DIOURBEL,NDOULO,NDOULO,"H1 MELINTE (KEUR WAGANE)",2,5,22,18,40
DIOURBEL,DIOURBEL,NDOULO,NDOULO,"H2 TAIRE KEUR DETHIE",4,7,44,23,67
DIOURBEL,DIOURBEL,NDOULO,NDOULO,"H3 TAIRE THIAWENE",5,19,96,64,160
DIOURBEL,DIOURBEL,NDOULO,NDOULO,"TAIRE WOLOF",9,13,55,33,88
DIOURBEL,DIOURBEL,NDOULO,NDOULO,"TAWA MBAYAR",6,8,43,55,98
DIOURBEL,DIOURBEL,NDOULO,NDOULO,TENE,11,26,181,169,350
DIOURBEL,DIOURBEL,NDOULO,NDOULO,THIONGO,5,6,15,17,32
DIOURBEL,DIOURBEL,NDOULO,NDOULO,THIOUTHIE,27,33,183,202,385
DIOURBEL,DIOURBEL,NDOULO,NDOULO,"TOURE NDOULO",23,25,120,179,299
DIOURBEL,DIOURBEL,NDOULO,NDOULO,"H2 TOURE KHOUTY",1,1,14,13,27
DIOURBEL,DIOURBEL,NDOULO,NDOULO,"H3 TOUBA TAIBA",4,5,43,56,99
DIOURBEL,DIOURBEL,NDOULO,NDOULO,YADOU,1,1,12,10,22
DIOURBEL,DIOURBEL,NDOULO,NDOULO,"H1 BAYE",1,1,11,6,17
DIOURBEL,DIOURBEL,NDOULO,NDOULO,DIAMENGUENE,2,2,9,9,18
DIOURBEL,DIOURBEL,NDOULO,NDOULO,"TAIRE WALO",6,8,24,19,43
DIOURBEL,DIOURBEL,NDOULO,NDOULO,THIAKHO,5,5,71,27,98
DIOURBEL,DIOURBEL,NDOULO,NDOULO,"THYLLA KHOULE",1,1,10,7,17
DIOURBEL,DIOURBEL,NDOULO,NDOULO,"TOUBA NIANGUENE",2,5,33,23,56
DIOURBEL,DIOURBEL,NDOULO,NDOULO,"TOUBA SAW KARY",6,11,67,77,144
DIOURBEL,DIOURBEL,NDOULO,NDOULO,"H1 KEUR MBAYE NDIAYE",6,6,35,38,73
DIOURBEL,DIOURBEL,NDOULO,NGOHE,BOUNDOU,32,64,489,466,955
DIOURBEL,DIOURBEL,NDOULO,NGOHE,"CITE OUVRIERE SEIB",262,286,768,758,1526
DIOURBEL,DIOURBEL,NDOULO,NGOHE,"H1 CITE OUVRIERE EXTENSION",43,42,164,185,349
DIOURBEL,DIOURBEL,NDOULO,NGOHE,"DAROU (RAHMANE)",16,21,153,79,232
DIOURBEL,DIOURBEL,NDOULO,NGOHE,NDIABAYE,36,68,416,409,825
DIOURBEL,DIOURBEL,NDOULO,NGOHE,"H1 NDIABAYE LAGNAR",19,35,211,233,444
DIOURBEL,DIOURBEL,NDOULO,NGOHE,DIAMSELY,23,35,236,242,478
DIOURBEL,DIOURBEL,NDOULO,NGOHE,NDIOKHOBA,32,54,72,66,138
DIOURBEL,DIOURBEL,NDOULO,NGOHE,"H1 NGOGOM",3,5,8,6,14
DIOURBEL,DIOURBEL,NDOULO,NGOHE,"DIOMKHEL (BACK)",33,51,324,339,663
DIOURBEL,DIOURBEL,NDOULO,NGOHE,"H1 SASSE DOLL",42,57,386,336,722
DIOURBEL,DIOURBEL,NDOULO,NGOHE,"H2 MBOBENE",15,18,92,104,196
DIOURBEL,DIOURBEL,NDOULO,NGOHE,"H3 MBOUMY",16,23,113,83,196
DIOURBEL,DIOURBEL,NDOULO,NGOHE,"H4 CENTRE EVANGELIQUE BAPTISTE",1,1,9,8,17
DIOURBEL,DIOURBEL,NDOULO,NGOHE,"NDIOUFFENE MBAKHANE",17,25,212,191,403
DIOURBEL,DIOURBEL,NDOULO,NGOHE,"DOMB 1",13,16,113,154,267
DIOURBEL,DIOURBEL,NDOULO,NGOHE,"H2 NDOMBE DIAGNE",9,14,98,96,194
DIOURBEL,DIOURBEL,NDOULO,NGOHE,"H1 DOMB FISSEL",7,13,97,101,198
DIOURBEL,DIOURBEL,NDOULO,NGOHE,"FINTEL DJIGATTE",46,100,716,664,1380
DIOURBEL,DIOURBEL,NDOULO,NGOHE,"FINTEL SOMB 1",44,95,729,750,1479
DIOURBEL,DIOURBEL,NDOULO,NGOHE,"FINTEL TOUCOULEUR",15,20,99,103,202
DIOURBEL,DIOURBEL,NDOULO,NGOHE,"H1 FINTEL",3,5,32,35,67
DIOURBEL,DIOURBEL,NDOULO,NGOHE,GNIGNAKH,30,45,360,349,709
DIOURBEL,DIOURBEL,NDOULO,NGOHE,"H2 BILE",4,4,30,25,55
DIOURBEL,DIOURBEL,NDOULO,NGOHE,"KADAM (THIENE)",24,43,276,221,497
DIOURBEL,DIOURBEL,NDOULO,NGOHE,"H2 KADAM POUYE",31,42,241,193,434
DIOURBEL,DIOURBEL,NDOULO,NGOHE,"H4 KADAM ALOM",6,13,108,96,204
DIOURBEL,DIOURBEL,NDOULO,NGOHE,"H5 NDIOUFFENE KADAM",8,17,116,127,243
DIOURBEL,DIOURBEL,NDOULO,NGOHE,KALOM,44,60,393,395,788
DIOURBEL,DIOURBEL,NDOULO,NGOHE,KALYR,23,35,214,190,404
DIOURBEL,DIOURBEL,NDOULO,NGOHE,"H1 NGANENE",6,9,70,80,150
DIOURBEL,DIOURBEL,NDOULO,NGOHE,"H2 KEUR OUSMANE LO",3,4,23,27,50
DIOURBEL,DIOURBEL,NDOULO,NGOHE,"H3 TITINE",5,6,53,57,110
DIOURBEL,DIOURBEL,NDOULO,NGOHE,"KEUR GANE (DIAWBI)",96,139,1068,991,2059
DIOURBEL,DIOURBEL,NDOULO,NGOHE,KHAYAGUE,21,29,200,190,390
DIOURBEL,DIOURBEL,NDOULO,NGOHE,"H1 SARAFY",6,11,79,63,142
DIOURBEL,DIOURBEL,NDOULO,NGOHE,"KHAYAGUE 2 (BACKO NOP)",8,9,61,51,112
DIOURBEL,DIOURBEL,NDOULO,NGOHE,"H3 BACKO NDONGO",8,14,78,78,156
DIOURBEL,DIOURBEL,NDOULO,NGOHE,"LAGNAR GOUMACK",69,98,681,637,1318
DIOURBEL,DIOURBEL,NDOULO,NGOHE,"H1 THIOURKHEME",13,20,26,16,42
DIOURBEL,DIOURBEL,NDOULO,NGOHE,"LAGNAR POKH",36,59,395,384,779
DIOURBEL,DIOURBEL,NDOULO,NGOHE,"H1 POKH",8,15,113,97,210
DIOURBEL,DIOURBEL,NDOULO,NGOHE,MBINDO,33,63,566,548,1114
DIOURBEL,DIOURBEL,NDOULO,NGOHE,"TOUBA MBAYARD (NDAME)",23,33,233,252,485
DIOURBEL,DIOURBEL,NDOULO,NGOHE,NDARAPPE,19,39,269,279,548
DIOURBEL,DIOURBEL,NDOULO,NGOHE,"NDIANDE (MAKA)",11,15,75,72,147
DIOURBEL,DIOURBEL,NDOULO,NGOHE,"NDIETTE NGOHE",33,59,418,396,814
DIOURBEL,DIOURBEL,NDOULO,NGOHE,"NDIGALEME 1",7,10,60,54,114
DIOURBEL,DIOURBEL,NDOULO,NGOHE,"NDIOBENE MBAFAYE",52,64,378,427,805
DIOURBEL,DIOURBEL,NDOULO,NGOHE,NDJISSE,13,28,179,176,355
DIOURBEL,DIOURBEL,NDOULO,NGOHE,"H1 MBOUL DEMBA",21,38,249,239,488
DIOURBEL,DIOURBEL,NDOULO,NGOHE,"H2 MBEL FOULANE",6,13,113,123,236
DIOURBEL,DIOURBEL,NDOULO,NGOHE,"H3 MBELNOU BAPP",5,9,83,76,159
DIOURBEL,DIOURBEL,NDOULO,NGOHE,"NDOFFENE 1",50,87,641,614,1255
DIOURBEL,DIOURBEL,NDOULO,NGOHE,"NDOFFENE 2",44,77,565,619,1184
DIOURBEL,DIOURBEL,NDOULO,NGOHE,NGODJILENE,31,44,304,336,640
DIOURBEL,DIOURBEL,NDOULO,NGOHE,SALMENE,32,59,466,504,970
DIOURBEL,DIOURBEL,NDOULO,NGOHE,"SESSENE (SESSENE TOCK)",61,68,372,331,703
DIOURBEL,DIOURBEL,NDOULO,NGOHE,SINDIANE,49,78,472,514,986
DIOURBEL,DIOURBEL,NDOULO,NGOHE,SOBEME,19,42,265,275,540
DIOURBEL,DIOURBEL,NDOULO,NGOHE,SOBMACK,36,71,430,518,948
DIOURBEL,DIOURBEL,NDOULO,NGOHE,"THIOLOM NDIANDE",16,29,147,120,267
DIOURBEL,DIOURBEL,NDOULO,NGOHE,"H2 NGOKHOYE",7,12,81,77,158
DIOURBEL,DIOURBEL,NDOULO,NGOHE,"H3 DIOUCK",3,10,44,42,86
DIOURBEL,DIOURBEL,NDOULO,NGOHE,THIOUTHIOUNE,24,38,293,262,555
DIOURBEL,DIOURBEL,NDOULO,NGOHE,"TOCK NGOL",31,46,310,306,616
DIOURBEL,DIOURBEL,NDOULO,NGOHE,"H1 NDIONE",4,7,53,56,109
DIOURBEL,DIOURBEL,NDOULO,NGOHE,YEREDY,28,70,411,394,805
DIOURBEL,DIOURBEL,NDOULO,NGOHE,"YOLY (YOLY HANENE)",1,6,46,46,92
DIOURBEL,DIOURBEL,NDOULO,NGOHE,"H1 KEUR THIERNO DIENG",5,12,95,68,163
DIOURBEL,DIOURBEL,NDOULO,NGOHE,"H3 YOLI SAMBA SALL (YOLLY TOUBA)",7,8,30,30,60
DIOURBEL,DIOURBEL,NDOULO,NGOHE,"BATHIE FASSAGAL (BACK FASSAGAL)",37,73,372,431,803
DIOURBEL,DIOURBEL,NDOULO,NGOHE,"DOMB 2",30,38,237,288,525
DIOURBEL,DIOURBEL,NDOULO,NGOHE,"H1 DOMB TEUGUE",4,9,44,31,75
DIOURBEL,DIOURBEL,NDOULO,NGOHE,"FINTEL SOMB 2",19,30,206,209,415
DIOURBEL,DIOURBEL,NDOULO,NGOHE,LEREL,18,28,272,254,526
DIOURBEL,DIOURBEL,NDOULO,NGOHE,NDESSERE,13,24,167,196,363
DIOURBEL,DIOURBEL,NDOULO,NGOHE,"NDIGALEME 2",27,50,324,308,632
DIOURBEL,DIOURBEL,NDOULO,NGOHE,"NDOFFENE NDANGRA",23,41,359,377,736
DIOURBEL,DIOURBEL,NDOULO,NGOHE,TAWFEKH,100,104,610,512,1122
DIOURBEL,DIOURBEL,NDOULO,NGOHE,"TOUBA MBOUL",8,12,127,104,231
DIOURBEL,DIOURBEL,NDOULO,NGOHE,"H1 MAKA TOULANE",4,8,72,59,131
DIOURBEL,DIOURBEL,NDOULO,PATTAR,"DABEL BARA",21,34,218,209,427
DIOURBEL,DIOURBEL,NDOULO,PATTAR,"DAROU SAMBE",117,138,836,842,1678
DIOURBEL,DIOURBEL,NDOULO,PATTAR,"DIAKAEL DIGUE",25,33,352,286,638
DIOURBEL,DIOURBEL,NDOULO,PATTAR,"H1 DADANGUE",7,9,87,66,153
DIOURBEL,DIOURBEL,NDOULO,PATTAR,"H2 GOULOUGNTHIE",7,8,63,71,134
DIOURBEL,DIOURBEL,NDOULO,PATTAR,"H3 KABENE",12,15,122,116,238
DIOURBEL,DIOURBEL,NDOULO,PATTAR,"H4 KOUNEME",12,17,185,169,354
DIOURBEL,DIOURBEL,NDOULO,PATTAR,"DIAKAEL TOKOSSONE",14,17,121,108,229
DIOURBEL,DIOURBEL,NDOULO,PATTAR,GAPPO,117,140,772,757,1529
DIOURBEL,DIOURBEL,NDOULO,PATTAR,"H1 GAPPO THIADIANE",5,6,28,32,60
DIOURBEL,DIOURBEL,NDOULO,PATTAR,"H2 THIANDIANE GAPPO",4,6,43,36,79
DIOURBEL,DIOURBEL,NDOULO,PATTAR,"H3 KEUR MODOU GUEYE (COMMUNE NDINDY)",7,7,35,36,71
DIOURBEL,DIOURBEL,NDOULO,PATTAR,GOULOUNTHIE,5,12,97,91,188
DIOURBEL,DIOURBEL,NDOULO,PATTAR,"GUIRI MBAYE",1,4,28,31,59
DIOURBEL,DIOURBEL,NDOULO,PATTAR,KHABANE,10,11,47,30,77
DIOURBEL,DIOURBEL,NDOULO,PATTAR,"H2 THIEKENE",1,4,21,19,40
DIOURBEL,DIOURBEL,NDOULO,PATTAR,"KHODJI BALING",50,69,528,452,980
DIOURBEL,DIOURBEL,NDOULO,PATTAR,"KHODJIL MBOSSECK",152,176,1063,1003,2066
DIOURBEL,DIOURBEL,NDOULO,PATTAR,KHOUBE,15,22,159,165,324
DIOURBEL,DIOURBEL,NDOULO,PATTAR,COKYOLETTE,5,6,37,31,68
DIOURBEL,DIOURBEL,NDOULO,PATTAR,"H1 KEUR GANA",6,7,47,38,85
DIOURBEL,DIOURBEL,NDOULO,PATTAR,"KOEL PEUL",6,7,48,44,92
DIOURBEL,DIOURBEL,NDOULO,PATTAR,"KOEL SERERE",23,27,169,204,373
DIOURBEL,DIOURBEL,NDOULO,PATTAR,"H1 GUEREL",5,6,33,32,65
DIOURBEL,DIOURBEL,NDOULO,PATTAR,"H2 GUEREL",3,7,37,28,65
DIOURBEL,DIOURBEL,NDOULO,PATTAR,"H3 GUERAL",1,1,3,3,6
DIOURBEL,DIOURBEL,NDOULO,PATTAR,"H4 KEUR NDEM",1,4,31,23,54
DIOURBEL,DIOURBEL,NDOULO,PATTAR,"H5 GUERAL",6,6,50,39,89
DIOURBEL,DIOURBEL,NDOULO,PATTAR,"H6 WAGA",7,11,68,61,129
DIOURBEL,DIOURBEL,NDOULO,PATTAR,LEYENE,2,2,11,19,30
DIOURBEL,DIOURBEL,NDOULO,PATTAR,LONDIOR,3,4,24,19,43
DIOURBEL,DIOURBEL,NDOULO,PATTAR,MBAMPANA,7,7,14,4,18
DIOURBEL,DIOURBEL,NDOULO,PATTAR,"MBEYE MBAYE",6,7,40,43,83
DIOURBEL,DIOURBEL,NDOULO,PATTAR,MELENE,3,6,51,72,123
DIOURBEL,DIOURBEL,NDOULO,PATTAR,NDEUKSI,46,65,378,313,691
DIOURBEL,DIOURBEL,NDOULO,PATTAR,NDIANKHENE,6,11,59,59,118
DIOURBEL,DIOURBEL,NDOULO,PATTAR,"NDIAYENE KEUR MAKHARY",2,2,3,0,3
DIOURBEL,DIOURBEL,NDOULO,PATTAR,NDIONAYE,28,37,197,184,381
DIOURBEL,DIOURBEL,NDOULO,PATTAR,NDONGUENE,9,10,43,49,92
DIOURBEL,DIOURBEL,NDOULO,PATTAR,NDOUNDOYE,6,7,79,58,137
DIOURBEL,DIOURBEL,NDOULO,PATTAR,NGARAFF,11,23,158,142,300
DIOURBEL,DIOURBEL,NDOULO,PATTAR,"H1 THIOC (COMMUNE TOURE MBONDE)",2,3,29,33,62
DIOURBEL,DIOURBEL,NDOULO,PATTAR,PATTAR,47,56,348,332,680
DIOURBEL,DIOURBEL,NDOULO,PATTAR,"H1 HALTE PATAR",8,8,57,55,112
DIOURBEL,DIOURBEL,NDOULO,PATTAR,"H3 THIEKENE",4,10,79,76,155
DIOURBEL,DIOURBEL,NDOULO,PATTAR,"SAMBE DIGUE",63,71,450,448,898
DIOURBEL,DIOURBEL,NDOULO,PATTAR,"SAMBE MOURIDE",17,19,103,124,227
DIOURBEL,DIOURBEL,NDOULO,PATTAR,"H1 NDIAWE",9,9,58,55,113
DIOURBEL,DIOURBEL,NDOULO,PATTAR,"H2 KEUR MODOU GUEYE",10,10,59,51,110
DIOURBEL,DIOURBEL,NDOULO,PATTAR,"SAMBE NGUINTH",36,55,330,269,599
DIOURBEL,DIOURBEL,NDOULO,PATTAR,"H1 MBELO",4,7,36,37,73
DIOURBEL,DIOURBEL,NDOULO,PATTAR,"SAMBE NIAKHENE",18,30,202,218,420
DIOURBEL,DIOURBEL,NDOULO,PATTAR,"H1 DIAMANE",2,4,24,24,48
DIOURBEL,DIOURBEL,NDOULO,PATTAR,"H2 KEUR NIOKHOR DIAGNE",5,6,51,40,91
DIOURBEL,DIOURBEL,NDOULO,PATTAR,"SAMBE PEUL 1",30,57,373,426,799
DIOURBEL,DIOURBEL,NDOULO,PATTAR,"H1 GOUYE MARAME",14,20,206,186,392
DIOURBEL,DIOURBEL,NDOULO,PATTAR,"SAMBE PEUL 2",25,36,234,254,488
DIOURBEL,DIOURBEL,NDOULO,PATTAR,"SAMBE TOKOSSONE 2",58,75,435,433,868
DIOURBEL,DIOURBEL,NDOULO,PATTAR,SASSE,14,24,171,163,334
DIOURBEL,DIOURBEL,NDOULO,PATTAR,"H1 BAKH YALLA",6,12,76,90,166
DIOURBEL,DIOURBEL,NDOULO,PATTAR,"H2 SOMME",10,15,108,87,195
DIOURBEL,DIOURBEL,NDOULO,PATTAR,"H3 KHAYOKK",6,7,61,67,128
DIOURBEL,DIOURBEL,NDOULO,PATTAR,MBOKNIR,5,15,107,105,212
DIOURBEL,DIOURBEL,NDOULO,PATTAR,"H1 TOUBA MBOKNDIR",4,4,35,39,74
DIOURBEL,DIOURBEL,NDOULO,PATTAR,"THIOBE OUOLOF",29,37,180,169,349
DIOURBEL,DIOURBEL,NDOULO,PATTAR,"H1 BOUBOUL",7,12,92,77,169
DIOURBEL,DIOURBEL,NDOULO,PATTAR,"THIOBE SENE",8,10,78,72,150
DIOURBEL,DIOURBEL,NDOULO,PATTAR,"H1 GOTEGNE",13,19,119,104,223
DIOURBEL,DIOURBEL,NDOULO,PATTAR,"H2 THIENENE",2,6,36,38,74
DIOURBEL,DIOURBEL,NDOULO,PATTAR,"THIOBE SERERE",24,33,223,209,432
DIOURBEL,DIOURBEL,NDOULO,PATTAR,"H3 KEUR M’BACKE FAYE",6,13,78,81,159
DIOURBEL,DIOURBEL,NDOULO,PATTAR,"H4 KEUR DETHIE SENE",2,6,45,33,78
DIOURBEL,DIOURBEL,NDOULO,PATTAR,BABROU,15,21,175,145,320
DIOURBEL,DIOURBEL,NDOULO,PATTAR,"BALOR SAMBE",12,22,211,217,428
DIOURBEL,DIOURBEL,NDOULO,PATTAR,"DAROU KHODJIL",42,48,333,343,676
DIOURBEL,DIOURBEL,NDOULO,PATTAR,KHAYOKH,11,20,104,122,226
DIOURBEL,DIOURBEL,NDOULO,PATTAR,"H1 KHAYOKH YAYE",2,6,25,25,50
DIOURBEL,DIOURBEL,NDOULO,PATTAR,"MBARY DOUGOUB",8,16,103,93,196
DIOURBEL,DIOURBEL,NDOULO,PATTAR,NDINGKOU,6,17,115,129,244
DIOURBEL,DIOURBEL,NDOULO,PATTAR,NDIOMENE,17,24,159,132,291
DIOURBEL,DIOURBEL,NDOULO,PATTAR,"SAMBE NGOTHIE",9,11,70,65,135
DIOURBEL,DIOURBEL,NDOULO,PATTAR,"SAMBE SANTE YALLA",19,20,91,109,200
DIOURBEL,DIOURBEL,NDOULO,PATTAR,"SAMBE TOKOSSONE 1",38,47,348,339,687
DIOURBEL,DIOURBEL,NDOULO,PATTAR,"SASSE 2",6,15,104,102,206
DIOURBEL,DIOURBEL,NDOULO,PATTAR,SOSSOSSE,19,35,221,257,478
DIOURBEL,DIOURBEL,NDOULO,PATTAR,"H1 DIABROU",10,19,216,238,454
DIOURBEL,DIOURBEL,NDOULO,PATTAR,"THIOGOYE 1",8,18,111,105,216
DIOURBEL,DIOURBEL,NDOULO,PATTAR,"THIOGOYE 2",10,18,119,125,244
DIOURBEL,DIOURBEL,NDOULO,PATTAR,"WAROU LAOBE",6,19,147,159,306
DIOURBEL,DIOURBEL,NDOULO,PATTAR,"H1 NDOURENE",3,6,29,23,52
DIOURBEL,DIOURBEL,NDOULO,"TOCKY GARE","AFIA M’BACKE (AFIA M’BACKE LAKRAM)",32,37,222,204,426
DIOURBEL,DIOURBEL,NDOULO,"TOCKY GARE","BAYTI (NDIODIONE)",17,44,331,332,663
DIOURBEL,DIOURBEL,NDOULO,"TOCKY GARE",BELKY,13,22,179,177,356
DIOURBEL,DIOURBEL,NDOULO,"TOCKY GARE","H1 KEUR DAOUDA DIONE",5,11,86,73,159
DIOURBEL,DIOURBEL,NDOULO,"TOCKY GARE",BOROLELLO,11,16,106,114,220
DIOURBEL,DIOURBEL,NDOULO,"TOCKY GARE","BOULIDIAMA 1",23,29,162,152,314
DIOURBEL,DIOURBEL,NDOULO,"TOCKY GARE","H1 KEUR NDOUDY",1,4,25,23,48
DIOURBEL,DIOURBEL,NDOULO,"TOCKY GARE",DEYERE,18,33,196,212,408
DIOURBEL,DIOURBEL,NDOULO,"TOCKY GARE","H1 KEUR SOUDOU DIOP (TOUBA MOURIDE)",2,4,32,34,66
DIOURBEL,DIOURBEL,NDOULO,"TOCKY GARE",DIAWRE,27,45,354,341,695
DIOURBEL,DIOURBEL,NDOULO,"TOCKY GARE",DIOKAM,45,72,376,349,725
DIOURBEL,DIOURBEL,NDOULO,"TOCKY GARE","DOUGOUL PEULH",4,9,47,48,95
DIOURBEL,DIOURBEL,NDOULO,"TOCKY GARE","H1 YEWAKE",3,4,14,15,29
DIOURBEL,DIOURBEL,NDOULO,"TOCKY GARE","H2 SAYAGO PEUL ET SERERE",8,11,168,123,291
DIOURBEL,DIOURBEL,NDOULO,"TOCKY GARE","DOUGOUL SAMBE NGUINTH",16,22,150,137,287
DIOURBEL,DIOURBEL,NDOULO,"TOCKY GARE","H2 LOUKI BOUNDAW",3,6,37,31,68
DIOURBEL,DIOURBEL,NDOULO,"TOCKY GARE","H3 TOCKA MBEL",8,14,83,69,152
DIOURBEL,DIOURBEL,NDOULO,"TOCKY GARE","DOUGOUL SERERE",11,19,113,109,222
DIOURBEL,DIOURBEL,NDOULO,"TOCKY GARE","H1 DIANAL",9,13,109,62,171
DIOURBEL,DIOURBEL,NDOULO,"TOCKY GARE","H3 LOUKI BOUMACK",8,11,77,64,141
DIOURBEL,DIOURBEL,NDOULO,"TOCKY GARE","DOUGOUL TOUCOULEUR",11,14,89,62,151
DIOURBEL,DIOURBEL,NDOULO,"TOCKY GARE",GOBACK,20,44,280,267,547
DIOURBEL,DIOURBEL,NDOULO,"TOCKY GARE","H1 NDIODIONE",7,20,146,154,300
DIOURBEL,DIOURBEL,NDOULO,"TOCKY GARE","KEUR AMADOU DIOP (TENEFOUL)",62,69,312,281,593
DIOURBEL,DIOURBEL,NDOULO,"TOCKY GARE","KEUR SAKH SAKH",10,12,66,65,131
DIOURBEL,DIOURBEL,NDOULO,"TOCKY GARE",KHAYOKH,10,21,112,102,214
DIOURBEL,DIOURBEL,NDOULO,"TOCKY GARE","H1 GUITHMONE ET LAGNA",11,23,165,124,289
DIOURBEL,DIOURBEL,NDOULO,"TOCKY GARE","KOBA 1",21,31,286,223,509
DIOURBEL,DIOURBEL,NDOULO,"TOCKY GARE","H2 PENTHIOUM DIOGAYE DIOUF",6,12,71,51,122
DIOURBEL,DIOURBEL,NDOULO,"TOCKY GARE","LAMANE BAMBARA",7,7,32,30,62
DIOURBEL,DIOURBEL,NDOULO,"TOCKY GARE","LAMANE SERERE",19,31,197,201,398
DIOURBEL,DIOURBEL,NDOULO,"TOCKY GARE","LORFY (LORFY 1)",13,16,91,108,199
DIOURBEL,DIOURBEL,NDOULO,"TOCKY GARE","H2 LORFY 2",17,23,155,149,304
DIOURBEL,DIOURBEL,NDOULO,"TOCKY GARE","H3 WANGHA MBAYENE",6,8,34,55,89
DIOURBEL,DIOURBEL,NDOULO,"TOCKY GARE","LOUMBEL THIAO",12,13,60,51,111
DIOURBEL,DIOURBEL,NDOULO,"TOCKY GARE","H2 PALEME",3,14,94,102,196
DIOURBEL,DIOURBEL,NDOULO,"TOCKY GARE","MBEYNA SERERE",19,26,181,197,378
DIOURBEL,DIOURBEL,NDOULO,"TOCKY GARE","H1 MBEYNA SERERE 2",6,13,96,114,210
DIOURBEL,DIOURBEL,NDOULO,"TOCKY GARE","MBEYNA OUOLOF",10,13,75,73,148
DIOURBEL,DIOURBEL,NDOULO,"TOCKY GARE","H1 NGOYE (MBEYNA THIAKHAR)",19,33,222,212,434
DIOURBEL,DIOURBEL,NDOULO,"TOCKY GARE","MBOUDAYE PEULH",11,20,155,141,296
DIOURBEL,DIOURBEL,NDOULO,"TOCKY GARE","MERINA SARR",17,20,90,89,179
DIOURBEL,DIOURBEL,NDOULO,"TOCKY GARE",MEDE,11,18,137,119,256
DIOURBEL,DIOURBEL,NDOULO,"TOCKY GARE","H1 GOWE",3,10,71,59,130
DIOURBEL,DIOURBEL,NDOULO,"TOCKY GARE",NDAYANE,13,17,172,88,260
DIOURBEL,DIOURBEL,NDOULO,"TOCKY GARE","H1 NGOUFFOR",10,20,127,120,247
DIOURBEL,DIOURBEL,NDOULO,"TOCKY GARE","H2 BAKO NDIIT",2,7,46,34,80
DIOURBEL,DIOURBEL,NDOULO,"TOCKY GARE","H3 LADIEGANE",2,6,36,14,50
DIOURBEL,DIOURBEL,NDOULO,"TOCKY GARE","H4 MBELANE",4,7,62,57,119
DIOURBEL,DIOURBEL,NDOULO,"TOCKY GARE","H5 NDESSERE TOCK",11,17,81,58,139
DIOURBEL,DIOURBEL,NDOULO,"TOCKY GARE","H6 TOKOSSONE",16,24,157,166,323
DIOURBEL,DIOURBEL,NDOULO,"TOCKY GARE",NENE,19,33,197,186,383
DIOURBEL,DIOURBEL,NDOULO,"TOCKY GARE","H1 YATHEME",6,11,78,82,160
DIOURBEL,DIOURBEL,NDOULO,"TOCKY GARE","NEBE SERERE",31,40,192,203,395
DIOURBEL,DIOURBEL,NDOULO,"TOCKY GARE","H1 DIABAKH",3,8,66,41,107
DIOURBEL,DIOURBEL,NDOULO,"TOCKY GARE","NEBE TEUGH",25,32,238,217,455
DIOURBEL,DIOURBEL,NDOULO,"TOCKY GARE",GODAGUENE,15,23,171,171,342
DIOURBEL,DIOURBEL,NDOULO,"TOCKY GARE","NGOGNICK LEYTY",13,27,184,191,375
DIOURBEL,DIOURBEL,NDOULO,"TOCKY GARE","NGOGNICK MIGNANE",21,33,258,245,503
DIOURBEL,DIOURBEL,NDOULO,"TOCKY GARE",NGOLOMONE,13,28,162,169,331
DIOURBEL,DIOURBEL,NDOULO,"TOCKY GARE",NGOMENE,9,17,117,105,222
DIOURBEL,DIOURBEL,NDOULO,"TOCKY GARE",NGOULE,40,59,373,350,723
DIOURBEL,DIOURBEL,NDOULO,"TOCKY GARE",PIDJI,8,13,70,73,143
DIOURBEL,DIOURBEL,NDOULO,"TOCKY GARE",POBE,12,20,149,133,282
DIOURBEL,DIOURBEL,NDOULO,"TOCKY GARE","POUTE NDIADJI",10,14,77,112,189
DIOURBEL,DIOURBEL,NDOULO,"TOCKY GARE","H1 KEUR PART",2,5,57,44,101
DIOURBEL,DIOURBEL,NDOULO,"TOCKY GARE",SEBANE,17,28,198,155,353
DIOURBEL,DIOURBEL,NDOULO,"TOCKY GARE","H1 KEUR NGAGNE NGOM",9,18,115,93,208
DIOURBEL,DIOURBEL,NDOULO,"TOCKY GARE",SIDAILLE,4,10,85,80,165
DIOURBEL,DIOURBEL,NDOULO,"TOCKY GARE","SOUPANE (KEUR MAR LOUM)",3,7,42,38,80
DIOURBEL,DIOURBEL,NDOULO,"TOCKY GARE","TENEFOUL TOUCOULEUR",28,38,312,275,587
DIOURBEL,DIOURBEL,NDOULO,"TOCKY GARE","THIOLOM TENEFOUL",10,11,77,78,155
DIOURBEL,DIOURBEL,NDOULO,"TOCKY GARE","TOCKY GARE",92,112,597,631,1228
DIOURBEL,DIOURBEL,NDOULO,"TOCKY GARE","TOCKY SERERE",12,26,196,178,374
DIOURBEL,DIOURBEL,NDOULO,"TOCKY GARE","TOCKY TOUCOULEUR (TOCKY DIOUMA)",30,33,190,157,347
DIOURBEL,DIOURBEL,NDOULO,"TOCKY GARE",WALALANE,37,78,485,473,958
DIOURBEL,DIOURBEL,NDOULO,"TOCKY GARE","H1 KEUR  IBRA FALL",1,1,12,16,28
DIOURBEL,DIOURBEL,NDOULO,"TOCKY GARE",WANGHA,16,24,184,240,424
DIOURBEL,DIOURBEL,NDOULO,"TOCKY GARE","H1 WANGA NGOMENE",5,11,91,75,166
DIOURBEL,DIOURBEL,NDOULO,"TOCKY GARE","KEUR AMADY DIOUCK WALALANE",2,3,19,11,30
DIOURBEL,DIOURBEL,NDOULO,"TOCKY GARE","KOBA 2",8,10,177,69,246
DIOURBEL,DIOURBEL,NDOULO,"TOCKY GARE","LAMANE TOUCOULEUR",13,21,130,125,255
DIOURBEL,DIOURBEL,NDOULO,"TOCKY GARE",SANTHIANE,44,45,214,177,391
DIOURBEL,DIOURBEL,NDOULO,"TOCKY GARE","H1 DAROU SALAM TOCKY",74,78,375,266,641
DIOURBEL,DIOURBEL,NDOULO,"TOCKY GARE","TOUBA DIAWRE",10,15,132,128,260
DIOURBEL,DIOURBEL,NDOULO,"TOCKY GARE","TOUBA MBELGAYE",12,13,99,94,193
DIOURBEL,DIOURBEL,NDOULO,"TOCKY GARE","TOUBA MOURIDE LAKRAM",2,3,17,4,21
DIOURBEL,DIOURBEL,NDOULO,"TOURE MBONDE","DARA 1",11,21,185,194,379
DIOURBEL,DIOURBEL,NDOULO,"TOURE MBONDE","NDIOUKEME (NDIAYE)",14,16,116,98,214
DIOURBEL,DIOURBEL,NDOULO,"TOURE MBONDE","H1 NDIOUKEME FALL",6,8,70,50,120
DIOURBEL,DIOURBEL,NDOULO,"TOURE MBONDE","H2 NDIOUKEME BOUNDAW",2,2,29,20,49
DIOURBEL,DIOURBEL,NDOULO,"TOURE MBONDE","GUINTH MATAR",14,18,149,162,311
DIOURBEL,DIOURBEL,NDOULO,"TOURE MBONDE","H1 KEUR MBAGNICK DIOP",10,18,108,103,211
DIOURBEL,DIOURBEL,NDOULO,"TOURE MBONDE","KADE DIEYE",6,9,59,56,115
DIOURBEL,DIOURBEL,NDOULO,"TOURE MBONDE","H1 BANGAL ET KOUDE",9,15,118,94,212
DIOURBEL,DIOURBEL,NDOULO,"TOURE MBONDE","KADE NDIAYE",9,12,78,57,135
DIOURBEL,DIOURBEL,NDOULO,"TOURE MBONDE","KANE KANE",12,15,94,132,226
DIOURBEL,DIOURBEL,NDOULO,"TOURE MBONDE","H1 KANE KANE",3,4,30,34,64
DIOURBEL,DIOURBEL,NDOULO,"TOURE MBONDE","H2 KEUR SOGUI",6,6,63,49,112
DIOURBEL,DIOURBEL,NDOULO,"TOURE MBONDE","H3 KEUR YAMBOU",12,19,176,143,319
DIOURBEL,DIOURBEL,NDOULO,"TOURE MBONDE","KEUR ALLE FALL",15,19,114,114,228
DIOURBEL,DIOURBEL,NDOULO,"TOURE MBONDE","KEUR DIABEL",5,11,33,31,64
DIOURBEL,DIOURBEL,NDOULO,"TOURE MBONDE","KEUR TAMSIR",18,20,95,98,193
DIOURBEL,DIOURBEL,NDOULO,"TOURE MBONDE","KONTEYENE DAPPA",28,32,241,246,487
DIOURBEL,DIOURBEL,NDOULO,"TOURE MBONDE","H1 MOUSSY",8,10,43,57,100
DIOURBEL,DIOURBEL,NDOULO,"TOURE MBONDE",LOYENE,10,13,75,71,146
DIOURBEL,DIOURBEL,NDOULO,"TOURE MBONDE","MBAYENNE DIMB",4,10,67,55,122
DIOURBEL,DIOURBEL,NDOULO,"TOURE MBONDE",MBOSSEKH,18,28,204,160,364
DIOURBEL,DIOURBEL,NDOULO,"TOURE MBONDE",MELLO,14,22,186,144,330
DIOURBEL,DIOURBEL,NDOULO,"TOURE MBONDE","H1 SANTHIE NDIBA  ET KEUR NGOL",19,52,191,192,383
DIOURBEL,DIOURBEL,NDOULO,"TOURE MBONDE","NDOUCOU WANE",23,28,196,190,386
DIOURBEL,DIOURBEL,NDOULO,"TOURE MBONDE",NDOUMBE,8,10,71,66,137
DIOURBEL,DIOURBEL,NDOULO,"TOURE MBONDE","H1 NDOUMBE SERERE",9,12,122,115,237
DIOURBEL,DIOURBEL,NDOULO,"TOURE MBONDE","NGALAGNE 2",22,35,228,241,469
DIOURBEL,DIOURBEL,NDOULO,"TOURE MBONDE",NGOKOLE,29,49,293,245,538
DIOURBEL,DIOURBEL,NDOULO,"TOURE MBONDE",NIANGHENE,12,13,81,66,147
DIOURBEL,DIOURBEL,NDOULO,"TOURE MBONDE","PAL SECK",12,21,68,48,116
DIOURBEL,DIOURBEL,NDOULO,"TOURE MBONDE","H1 NGUEYENE",8,10,76,56,132
DIOURBEL,DIOURBEL,NDOULO,"TOURE MBONDE",PAYENE,23,35,237,221,458
DIOURBEL,DIOURBEL,NDOULO,"TOURE MBONDE",SAKAL,1,3,12,15,27
DIOURBEL,DIOURBEL,NDOULO,"TOURE MBONDE","SAREME COOPE",13,18,151,163,314
DIOURBEL,DIOURBEL,NDOULO,"TOURE MBONDE","H1 KEUR SANGUE",4,8,62,69,131
DIOURBEL,DIOURBEL,NDOULO,"TOURE MBONDE","SAREME MOURIDE (SAM SEYE)",5,7,39,34,73
DIOURBEL,DIOURBEL,NDOULO,"TOURE MBONDE","H2 KEUR MANDIAYE ET KEUR WAGANE",11,11,70,79,149
DIOURBEL,DIOURBEL,NDOULO,"TOURE MBONDE","H3 KEUR CHEIKH KANE",2,2,18,16,34
DIOURBEL,DIOURBEL,NDOULO,"TOURE MBONDE","SAREME OUOLOF",36,44,255,326,581
DIOURBEL,DIOURBEL,NDOULO,"TOURE MBONDE","SAREME SERERE",47,58,429,324,753
DIOURBEL,DIOURBEL,NDOULO,"TOURE MBONDE","H1 NDJIGONE SARR",2,9,66,63,129
DIOURBEL,DIOURBEL,NDOULO,"TOURE MBONDE","H2 KEURY KAW",9,10,45,49,94
DIOURBEL,DIOURBEL,NDOULO,"TOURE MBONDE",SEMBENE,73,79,589,588,1177
DIOURBEL,DIOURBEL,NDOULO,"TOURE MBONDE",SOUSSE,21,29,176,149,325
DIOURBEL,DIOURBEL,NDOULO,"TOURE MBONDE","H1 NDORONG SOUSSE",10,18,108,96,204
DIOURBEL,DIOURBEL,NDOULO,"TOURE MBONDE","TEUNGH OUOLOF",1,3,30,17,47
DIOURBEL,DIOURBEL,NDOULO,"TOURE MBONDE","H1 GOUYE COUMBA",3,3,32,25,57
DIOURBEL,DIOURBEL,NDOULO,"TOURE MBONDE","TEUNGH SERERE",18,26,224,212,436
DIOURBEL,DIOURBEL,NDOULO,"TOURE MBONDE","THILLA DAPPA",2,2,13,6,19
DIOURBEL,DIOURBEL,NDOULO,"TOURE MBONDE","H1 DAPPA",4,6,44,27,71
DIOURBEL,DIOURBEL,NDOULO,"TOURE MBONDE","H2 KEUR MBAYE SYLLA",2,2,27,6,33
DIOURBEL,DIOURBEL,NDOULO,"TOURE MBONDE","H3 DIADJ",2,2,8,8,16
DIOURBEL,DIOURBEL,NDOULO,"TOURE MBONDE","H4 SEMBENE",6,6,32,29,61
DIOURBEL,DIOURBEL,NDOULO,"TOURE MBONDE",THIALLE,15,23,157,167,324
DIOURBEL,DIOURBEL,NDOULO,"TOURE MBONDE",THIANDIGUE,9,10,64,50,114
DIOURBEL,DIOURBEL,NDOULO,"TOURE MBONDE","H1 KEUR MBAR",4,9,100,61,161
DIOURBEL,DIOURBEL,NDOULO,"TOURE MBONDE","H2 KEUR SOMBEL",3,3,40,32,72
DIOURBEL,DIOURBEL,NDOULO,"TOURE MBONDE","H3 KHOURINE",9,13,105,97,202
DIOURBEL,DIOURBEL,NDOULO,"TOURE MBONDE","H4 DIA DIA ET NGOUYE",14,23,150,114,264
DIOURBEL,DIOURBEL,NDOULO,"TOURE MBONDE","H5 KEUR MOR NDIAYE ARDIANA",1,1,19,6,25
DIOURBEL,DIOURBEL,NDOULO,"TOURE MBONDE","H6 KEUR IBOU GAYE",1,1,5,2,7
DIOURBEL,DIOURBEL,NDOULO,"TOURE MBONDE","THIARENE DIAMA",12,15,167,121,288
DIOURBEL,DIOURBEL,NDOULO,"TOURE MBONDE","H2 THIARENE KHEWERE",7,8,66,56,122
DIOURBEL,DIOURBEL,NDOULO,"TOURE MBONDE",THIOKHEME,34,37,295,276,571
DIOURBEL,DIOURBEL,NDOULO,"TOURE MBONDE","THIOLOM DAPPA",10,16,99,75,174
DIOURBEL,DIOURBEL,NDOULO,"TOURE MBONDE","THIOUTHIE DIAMA",7,10,47,41,88
DIOURBEL,DIOURBEL,NDOULO,"TOURE MBONDE","H1 DAROU LO",6,6,33,36,69
DIOURBEL,DIOURBEL,NDOULO,"TOURE MBONDE",THISSE,8,14,44,16,60
DIOURBEL,DIOURBEL,NDOULO,"TOURE MBONDE","TOURE MBONDE",23,31,187,185,372
DIOURBEL,DIOURBEL,NDOULO,"TOURE MBONDE","DARA 2",29,62,400,345,745
DIOURBEL,DIOURBEL,NDOULO,"TOURE MBONDE","KONTEYENE (KONTEYENE WOLOF)",3,3,22,19,41
DIOURBEL,DIOURBEL,NDOULO,"TOURE MBONDE","H1 KEUR KHOLE NDIAYE",7,11,70,72,142
DIOURBEL,DIOURBEL,NDOULO,"TOURE MBONDE","NGALAGNE 1",17,25,192,198,390
DIOURBEL,M’BACKE,M’BACKE,M’BACKE,"DAROU SALAM",2746,2885,13860,13929,27789
DIOURBEL,M’BACKE,M’BACKE,M’BACKE,"M’BACKE KHEWAR",3456,3843,18706,19158,37864
DIOURBEL,M’BACKE,M’BACKE,M’BACKE,"M’BACKE MOURIDE",217,250,1189,1432,2621
DIOURBEL,M’BACKE,M’BACKE,M’BACKE,"M’BACKE NDIMBE (M’BACKE)",1183,1459,6091,6740,12831
DIOURBEL,M’BACKE,M’BACKE,M’BACKE,NDOYENE,275,312,1711,1958,3669
DIOURBEL,M’BACKE,M’BACKE,M’BACKE,"PALENE (M’BACKE BARRY)",1603,1839,7812,8865,16677
DIOURBEL,M’BACKE,KAEL,"DENDEYE GOUY GUI","BATHIE ROYE",5,6,26,35,61
DIOURBEL,M’BACKE,KAEL,"DENDEYE GOUY GUI","DENDEYE ESCALE",79,82,421,443,864
DIOURBEL,M’BACKE,KAEL,"DENDEYE GOUY GUI","DENDEYE 2 WOLOF",15,15,91,64,155
DIOURBEL,M’BACKE,KAEL,"DENDEYE GOUY GUI","DENDEYE PEULH",8,10,70,44,114
DIOURBEL,M’BACKE,KAEL,"DENDEYE GOUY GUI","GOUYE GUI",35,42,264,233,497
DIOURBEL,M’BACKE,KAEL,"DENDEYE GOUY GUI","H1 BELELE MBABA",4,4,38,39,77
DIOURBEL,M’BACKE,KAEL,"DENDEYE GOUY GUI","H2 BERE",2,4,15,9,24
DIOURBEL,M’BACKE,KAEL,"DENDEYE GOUY GUI","H3 KEUR MOR SARR",4,4,33,22,55
DIOURBEL,M’BACKE,KAEL,"DENDEYE GOUY GUI","H4 KEUR BANDJIRY KA",6,6,28,21,49
DIOURBEL,M’BACKE,KAEL,"DENDEYE GOUY GUI","KELEL CONTOR",4,4,21,25,46
DIOURBEL,M’BACKE,KAEL,"DENDEYE GOUY GUI","H2 KEUR ALIOU KA",2,2,35,31,66
DIOURBEL,M’BACKE,KAEL,"DENDEYE GOUY GUI","KEUR CHEIKH DIOP",16,25,130,144,274
DIOURBEL,M’BACKE,KAEL,"DENDEYE GOUY GUI","KEUR MABALY SENE",7,7,37,36,73
DIOURBEL,M’BACKE,KAEL,"DENDEYE GOUY GUI","KEUR MAR BOYE",3,3,12,6,18
DIOURBEL,M’BACKE,KAEL,"DENDEYE GOUY GUI","KEUR MAR NDIAYE",6,11,89,71,160
DIOURBEL,M’BACKE,KAEL,"DENDEYE GOUY GUI","KEUR SOULEYE DIAGNE",5,5,41,14,55
DIOURBEL,M’BACKE,KAEL,"DENDEYE GOUY GUI","H1 KEUR DJIBY YADE",5,5,47,39,86
DIOURBEL,M’BACKE,KAEL,"DENDEYE GOUY GUI","KEUR YORO NDIAYE",2,4,33,36,69
DIOURBEL,M’BACKE,KAEL,"DENDEYE GOUY GUI",NDIAMBOUL,2,4,17,25,42
DIOURBEL,M’BACKE,KAEL,"DENDEYE GOUY GUI","NDIAWALDY 1",10,10,74,48,122
DIOURBEL,M’BACKE,KAEL,"DENDEYE GOUY GUI","NDIAWALDY 2",16,21,130,125,255
DIOURBEL,M’BACKE,KAEL,"DENDEYE GOUY GUI","H1 KEUR MALICK",6,6,59,37,96
DIOURBEL,M’BACKE,KAEL,"DENDEYE GOUY GUI",NDIOLOFFENE,75,109,700,687,1387
DIOURBEL,M’BACKE,KAEL,"DENDEYE GOUY GUI",NGUERANE,28,48,299,256,555
DIOURBEL,M’BACKE,KAEL,"DENDEYE GOUY GUI",NIANGHENE,16,16,111,101,212
DIOURBEL,M’BACKE,KAEL,"DENDEYE GOUY GUI","OURO DIOUMA DIADJI",5,8,49,40,89
DIOURBEL,M’BACKE,KAEL,"DENDEYE GOUY GUI","OURO DIOUMA MBISSANE",6,6,23,23,46
DIOURBEL,M’BACKE,KAEL,"DENDEYE GOUY GUI","OUROUR NDIAWALDY",2,4,16,10,26
DIOURBEL,M’BACKE,KAEL,"DENDEYE GOUY GUI",PADE,38,57,300,327,627
DIOURBEL,M’BACKE,KAEL,"DENDEYE GOUY GUI","SAME CONTOR",29,35,181,200,381
DIOURBEL,M’BACKE,KAEL,"DENDEYE GOUY GUI","H1 DAROU NDIAYE KEUR MOR THIAMA",3,4,40,12,52
DIOURBEL,M’BACKE,KAEL,"DENDEYE GOUY GUI","H2 MBODIENE SOUF",2,2,11,7,18
DIOURBEL,M’BACKE,KAEL,"DENDEYE GOUY GUI","H3 MBODIENE KAO",6,9,60,28,88
DIOURBEL,M’BACKE,KAEL,"DENDEYE GOUY GUI","H3 KEUR ATIM",6,6,41,37,78
DIOURBEL,M’BACKE,KAEL,"DENDEYE GOUY GUI","TOUBA NGOUNDIOURA",15,15,102,93,195
DIOURBEL,M’BACKE,KAEL,"DENDEYE GOUY GUI",WEYNDOULERY,3,5,32,17,49
DIOURBEL,M’BACKE,KAEL,"DAROU SALAM TYP","BOUSTANE M’BACKE",33,36,236,225,461
DIOURBEL,M’BACKE,KAEL,"DAROU SALAM TYP","H2 KEUR MODOU KAMA",6,13,72,72,144
DIOURBEL,M’BACKE,KAEL,"DAROU SALAM TYP","DAROU GUEYE",42,48,244,202,446
DIOURBEL,M’BACKE,KAEL,"DAROU SALAM TYP","H2 GANDE ET GANA NIANG",10,28,193,148,341
DIOURBEL,M’BACKE,KAEL,"DAROU SALAM TYP","H3 KEUR AMATH KA",4,12,81,51,132
DIOURBEL,M’BACKE,KAEL,"DAROU SALAM TYP","H5 KEUR MBAYE NIANG",2,5,20,24,44
DIOURBEL,M’BACKE,KAEL,"DAROU SALAM TYP","DAROU MARNANE",7,13,103,96,199
DIOURBEL,M’BACKE,KAEL,"DAROU SALAM TYP","H2 TAWFEKH DAROU MARNANE",10,23,182,145,327
DIOURBEL,M’BACKE,KAEL,"DAROU SALAM TYP","DAROU SALAM TYP",98,108,687,642,1329
DIOURBEL,M’BACKE,KAEL,"DAROU SALAM TYP","H1 DAARA MOUNTAKHA BASSIROU M’BACKE",1,1,64,0,64
DIOURBEL,M’BACKE,KAEL,"DAROU SALAM TYP","H2 MBELOGNE GALLELE 1 ET 2",5,14,59,70,129
DIOURBEL,M’BACKE,KAEL,"DAROU SALAM TYP","H3 TEWEL",11,15,78,60,138
DIOURBEL,M’BACKE,KAEL,"DAROU SALAM TYP","H4 KEUR AMADOU BOSSO KA",5,8,76,55,131
DIOURBEL,M’BACKE,KAEL,"DAROU SALAM TYP","H5 KEUR MBAYE FALL TINE",2,2,12,9,21
DIOURBEL,M’BACKE,KAEL,"DAROU SALAM TYP","H6 MBOFY",14,26,203,154,357
DIOURBEL,M’BACKE,KAEL,"DAROU SALAM TYP","NASROU KEUR DIOMBO (NDOURENE)",45,55,414,344,758
DIOURBEL,M’BACKE,KAEL,"DAROU SALAM TYP","H1 KEUR BASSIROU NIANG",4,7,35,24,59
DIOURBEL,M’BACKE,KAEL,"DAROU SALAM TYP","H2 KEUR SOUDOU PELOKH DIOME",20,27,200,129,329
DIOURBEL,M’BACKE,KAEL,"DAROU SALAM TYP","NASROU M’BACKE",45,50,375,276,651
DIOURBEL,M’BACKE,KAEL,"DAROU SALAM TYP","H1 MEDINA SALAM",8,8,54,36,90
DIOURBEL,M’BACKE,KAEL,"DAROU SALAM TYP","TAWFEKH KHAYGA",15,16,79,59,138
DIOURBEL,M’BACKE,KAEL,"DAROU SALAM TYP","H2 KEUR SAMBA FAYE",4,13,106,66,172
DIOURBEL,M’BACKE,KAEL,"DAROU SALAM TYP","H3 KEUR SAMBA MBAYE",13,25,170,132,302
DIOURBEL,M’BACKE,KAEL,"DAROU SALAM TYP","H4 NGUINDE",5,7,51,46,97
DIOURBEL,M’BACKE,KAEL,"DAROU SALAM TYP","H5 KEUR DIAB DIOME",18,23,137,150,287
DIOURBEL,M’BACKE,KAEL,"DAROU SALAM TYP","TEWEL (KEUR MASSEYE)",7,8,74,25,99
DIOURBEL,M’BACKE,KAEL,KAEL,"AFFE KAEL",6,8,78,61,139
DIOURBEL,M’BACKE,KAEL,KAEL,CONTOR,24,42,288,275,563
DIOURBEL,M’BACKE,KAEL,KAEL,"H1 HAMED NGIWEL",12,17,76,49,125
DIOURBEL,M’BACKE,KAEL,KAEL,"CONTOR 2 (NGUESS BOGEL)",11,18,141,114,255
DIOURBEL,M’BACKE,KAEL,KAEL,"DAROU GUEYE",1,1,9,2,11
DIOURBEL,M’BACKE,KAEL,KAEL,"DAROU MBAYENE",11,14,85,114,199
DIOURBEL,M’BACKE,KAEL,KAEL,"DAROU SALAM KAEL",5,5,44,6,50
DIOURBEL,M’BACKE,KAEL,KAEL,"DAROU WAHAB",17,18,58,57,115
DIOURBEL,M’BACKE,KAEL,KAEL,"DIABY (BOULEL)",3,10,50,52,102
DIOURBEL,M’BACKE,KAEL,KAEL,"DIROYE 1",6,8,50,62,112
DIOURBEL,M’BACKE,KAEL,KAEL,"DIROYE 2",9,12,80,81,161
DIOURBEL,M’BACKE,KAEL,KAEL,"FASS KAEL",15,20,154,167,321
DIOURBEL,M’BACKE,KAEL,KAEL,"H1 KEUR DIAM BOULO",1,1,9,9,18
DIOURBEL,M’BACKE,KAEL,KAEL,"GOUBE 1",3,3,35,26,61
DIOURBEL,M’BACKE,KAEL,KAEL,"GOUBE 2",3,4,27,18,45
DIOURBEL,M’BACKE,KAEL,KAEL,"LALOYE FONDE 1",2,2,14,17,31
DIOURBEL,M’BACKE,KAEL,KAEL,"H1 MBAMBADO",1,6,25,23,48
DIOURBEL,M’BACKE,KAEL,KAEL,"LALOYE FONDE 2",3,3,29,13,42
DIOURBEL,M’BACKE,KAEL,KAEL,"H1 BELELE DIABE",4,6,37,35,72
DIOURBEL,M’BACKE,KAEL,KAEL,"LAMA 1",3,3,12,10,22
DIOURBEL,M’BACKE,KAEL,KAEL,"H1 KEUR SEYDOU BA",8,12,86,92,178
DIOURBEL,M’BACKE,KAEL,KAEL,"H2 THIOGO",11,14,120,120,240
DIOURBEL,M’BACKE,KAEL,KAEL,"LAMA 2",4,4,34,37,71
DIOURBEL,M’BACKE,KAEL,KAEL,"H1 HAMET (KEUR SERIGNE BA)",1,1,5,13,18
DIOURBEL,M’BACKE,KAEL,KAEL,"MAGOUMBA NDAO",1,1,5,7,12
DIOURBEL,M’BACKE,KAEL,KAEL,"MAKA KAEL",74,75,420,389,809
DIOURBEL,M’BACKE,KAEL,KAEL,"H2 BOKI TOKI",8,20,145,156,301
DIOURBEL,M’BACKE,KAEL,KAEL,"H3 DAARA SERIGNE CHEIKH M’BACKE",1,2,19,0,19
DIOURBEL,M’BACKE,KAEL,KAEL,"H4 FORAGE LAMA",12,32,225,191,416
DIOURBEL,M’BACKE,KAEL,KAEL,"H5 LANDAGOL",2,2,9,7,16
DIOURBEL,M’BACKE,KAEL,KAEL,"H6 NDINDE",1,1,13,7,20
DIOURBEL,M’BACKE,KAEL,KAEL,"H7 THIEWA",3,7,40,39,79
DIOURBEL,M’BACKE,KAEL,KAEL,"MBAGNE SEO",1,1,4,7,11
DIOURBEL,M’BACKE,KAEL,KAEL,"MBANAMY 1",11,13,77,73,150
DIOURBEL,M’BACKE,KAEL,KAEL,"H1 GOUNODE",4,5,22,33,55
DIOURBEL,M’BACKE,KAEL,KAEL,"MBANAMY 2",12,12,68,71,139
DIOURBEL,M’BACKE,KAEL,KAEL,"H2 KANDYSSADA",1,2,29,12,41
DIOURBEL,M’BACKE,KAEL,KAEL,"MBANDY PEULH",11,12,102,40,142
DIOURBEL,M’BACKE,KAEL,KAEL,"NDAM KAEL",5,5,20,16,36
DIOURBEL,M’BACKE,KAEL,KAEL,"H1 BOUNDOU BIRASSI",6,10,48,46,94
DIOURBEL,M’BACKE,KAEL,KAEL,NGASSAMA,3,5,22,12,34
DIOURBEL,M’BACKE,KAEL,KAEL,"H1 NDEMENE",1,1,16,13,29
DIOURBEL,M’BACKE,KAEL,KAEL,"NIOL NGUEL",9,16,79,97,176
DIOURBEL,M’BACKE,KAEL,KAEL,SAMTHIALLE,47,57,377,301,678
DIOURBEL,M’BACKE,KAEL,KAEL,THIENENE,10,14,96,85,181
DIOURBEL,M’BACKE,KAEL,KAEL,"TOUBA DABEL",2,2,53,0,53
DIOURBEL,M’BACKE,KAEL,KAEL,"TOUBA KAEL",11,12,66,82,148
DIOURBEL,M’BACKE,KAEL,KAEL,"H2 DIAMWELLY",1,1,6,0,6
DIOURBEL,M’BACKE,KAEL,KAEL,"H3 THIAMENE",1,1,9,2,11
DIOURBEL,M’BACKE,KAEL,KAEL,"H4 NDIA",1,2,8,3,11
DIOURBEL,M’BACKE,KAEL,KAEL,"TOUBA KAEL PEULH",4,5,23,34,57
DIOURBEL,M’BACKE,KAEL,KAEL,"TYPE SAMBA",30,43,223,198,421
DIOURBEL,M’BACKE,KAEL,MADINA,"BOBY KANDJI",33,35,180,272,452
DIOURBEL,M’BACKE,KAEL,MADINA,"BOBY M’BACKE",27,27,127,115,242
DIOURBEL,M’BACKE,KAEL,MADINA,BOURSAKH,12,20,103,93,196
DIOURBEL,M’BACKE,KAEL,MADINA,"DAROU NAHIM",3,3,12,11,23
DIOURBEL,M’BACKE,KAEL,MADINA,DIOUROUL,10,11,56,42,98
DIOURBEL,M’BACKE,KAEL,MADINA,"H1 KEUR SADIBOU KA",2,2,16,13,29
DIOURBEL,M’BACKE,KAEL,MADINA,"GADIEDJI PEULH",8,9,65,67,132
DIOURBEL,M’BACKE,KAEL,MADINA,"GADIEDJI OUOLOF",11,13,93,67,160
DIOURBEL,M’BACKE,KAEL,MADINA,GRINIEL,49,60,378,359,737
DIOURBEL,M’BACKE,KAEL,MADINA,MADINA,82,96,627,595,1222
DIOURBEL,M’BACKE,KAEL,MADINA,"H3 KADOUYEL 1",9,13,64,48,112
DIOURBEL,M’BACKE,KAEL,MADINA,"H4 DAROU RAHMANE",17,21,113,80,193
DIOURBEL,M’BACKE,KAEL,MADINA,"H5 RASS OUOLOF ET RASS PEULH",16,28,172,150,322
DIOURBEL,M’BACKE,KAEL,MADINA,"H6 KADOUYEL 2",20,31,162,101,263
DIOURBEL,M’BACKE,KAEL,MADINA,"H7 BELELE OGO",2,3,18,10,28
DIOURBEL,M’BACKE,KAEL,MADINA,"H9 DAGANABE 1",9,11,74,77,151
DIOURBEL,M’BACKE,KAEL,MADINA,"H10 DAGANABE 2",3,3,12,27,39
DIOURBEL,M’BACKE,KAEL,MADINA,"H11 LEYENE",12,16,85,73,158
DIOURBEL,M’BACKE,KAEL,MADINA,"H12 SOPADE",5,6,55,47,102
DIOURBEL,M’BACKE,KAEL,MADINA,MBAYENE,15,18,91,110,201
DIOURBEL,M’BACKE,KAEL,MADINA,"H1 KEUR YORO BA",5,5,37,27,64
DIOURBEL,M’BACKE,KAEL,MADINA,"H2 NIBANE ET BANE",7,9,58,60,118
DIOURBEL,M’BACKE,KAEL,MADINA,NDOCK,91,94,591,558,1149
DIOURBEL,M’BACKE,KAEL,MADINA,"H2 KEUR SERIGNE CHEIKH M’BACKE",1,1,9,0,9
DIOURBEL,M’BACKE,KAEL,MADINA,"H3 KEUR SERIGNE M’BACKE ASTOU",1,2,27,11,38
DIOURBEL,M’BACKE,KAEL,MADINA,NGASSAMA,46,63,477,461,938
DIOURBEL,M’BACKE,KAEL,MADINA,"TAW FEKH (DAROU MARNANE)",7,8,60,13,73
DIOURBEL,M’BACKE,KAEL,MADINA,THIENGOU,24,40,219,205,424
DIOURBEL,M’BACKE,KAEL,MADINA,"TOUBA YONGO",2,2,295,11,306
DIOURBEL,M’BACKE,KAEL,MADINA,"TOUNE MBARANY",14,34,166,107,273
DIOURBEL,M’BACKE,KAEL,MADINA,TYPNAR,20,31,180,158,338
DIOURBEL,M’BACKE,KAEL,MADINA,"H1 MBELOGNE SAMBA LOUMBEL",11,14,91,82,173
DIOURBEL,M’BACKE,KAEL,NDIOUMANE,"BAITY GUEYE",9,10,88,47,135
DIOURBEL,M’BACKE,KAEL,NDIOUMANE,"H1 KEUR MODOU MODOU POUYE",1,6,55,57,112
DIOURBEL,M’BACKE,KAEL,NDIOUMANE,"BOUSTANE DIAO (DIAWE)",15,15,60,63,123
DIOURBEL,M’BACKE,KAEL,NDIOUMANE,"DAROU NAHIM DIA",20,29,197,199,396
DIOURBEL,M’BACKE,KAEL,NDIOUMANE,"H1 DEPPE DE TAINABE",15,20,152,151,303
DIOURBEL,M’BACKE,KAEL,NDIOUMANE,"H3 KEUR NGOR",2,6,40,39,79
DIOURBEL,M’BACKE,KAEL,NDIOUMANE,DIOKANE,1,1,22,14,36
DIOURBEL,M’BACKE,KAEL,NDIOUMANE,"H1 KEUR NGOUYE SENE",4,8,53,55,108
DIOURBEL,M’BACKE,KAEL,NDIOUMANE,"H3 KEUR LIBASSE GNINGUE",1,2,15,15,30
DIOURBEL,M’BACKE,KAEL,NDIOUMANE,"DOYOLY 2",35,42,210,149,359
DIOURBEL,M’BACKE,KAEL,NDIOUMANE,"H1 KEUR SOUDOU FALL (THIERERE FALL)",7,8,85,78,163
DIOURBEL,M’BACKE,KAEL,NDIOUMANE,"H3 KEUR ABLAYE NDIAYE",3,3,13,17,30
DIOURBEL,M’BACKE,KAEL,NDIOUMANE,GAPASSE,9,18,107,127,234
DIOURBEL,M’BACKE,KAEL,NDIOUMANE,"GOUYE NDIAYE",1,1,2,0,2
DIOURBEL,M’BACKE,KAEL,NDIOUMANE,GOWE,5,7,46,43,89
DIOURBEL,M’BACKE,KAEL,NDIOUMANE,"H1 GOWE KEUR DALY NDIAYE",7,10,60,76,136
DIOURBEL,M’BACKE,KAEL,NDIOUMANE,"GUERALE 1",6,10,57,55,112
DIOURBEL,M’BACKE,KAEL,NDIOUMANE,"H1 NDIOUMANE PEULH",7,7,58,60,118
DIOURBEL,M’BACKE,KAEL,NDIOUMANE,"H2 SAFOUTE POUYE",1,3,30,33,63
DIOURBEL,M’BACKE,KAEL,NDIOUMANE,"H3 KEUR SADIOU KA SALL",2,2,13,12,25
DIOURBEL,M’BACKE,KAEL,NDIOUMANE,"KEUR MADJIEUMBA LO",6,7,46,47,93
DIOURBEL,M’BACKE,KAEL,NDIOUMANE,KOFFA,42,59,404,350,754
DIOURBEL,M’BACKE,KAEL,NDIOUMANE,"LOUMBEL NDOULO",3,4,22,17,39
DIOURBEL,M’BACKE,KAEL,NDIOUMANE,"H1 KEUR AMADOU BASS",3,4,19,8,27
DIOURBEL,M’BACKE,KAEL,NDIOUMANE,"M’BACKE MBAYARD",8,8,53,63,116
DIOURBEL,M’BACKE,KAEL,NDIOUMANE,"MBAME PEULH",4,5,49,43,92
DIOURBEL,M’BACKE,KAEL,NDIOUMANE,NDIOUMANE,27,34,200,218,418
DIOURBEL,M’BACKE,KAEL,NDIOUMANE,"H1 KEUR GORY KA (NDIOUMANE PEULH)",2,2,14,10,24
DIOURBEL,M’BACKE,KAEL,NDIOUMANE,"H2 LAGAMBAL",16,21,199,183,382
DIOURBEL,M’BACKE,KAEL,NDIOUMANE,"H3 NDIOUMANE KEUR CHEIKH FATY",7,11,58,54,112
DIOURBEL,M’BACKE,KAEL,NDIOUMANE,"H5 DAARA SERIGNE SALIOU M’BACKE",1,1,66,16,82
DIOURBEL,M’BACKE,KAEL,NDIOUMANE,"H6 KEUR WOULA FAYE",11,17,103,105,208
DIOURBEL,M’BACKE,KAEL,NDIOUMANE,"H7 NDIOUMANE SERERE",22,33,231,255,486
DIOURBEL,M’BACKE,KAEL,NDIOUMANE,"H8 DEGUE AISSA",3,5,48,45,93
DIOURBEL,M’BACKE,KAEL,NDIOUMANE,"H9 KEUR BASS TINE",4,6,45,35,80
DIOURBEL,M’BACKE,KAEL,NDIOUMANE,"H10 KEUR SALIOU DIAGNE",1,1,9,3,12
DIOURBEL,M’BACKE,KAEL,NDIOUMANE,"H11 KEUR MOR GUEYE NIANG",6,6,49,37,86
DIOURBEL,M’BACKE,KAEL,NDIOUMANE,"NGUIDIANE NDIAYE",7,15,115,131,246
DIOURBEL,M’BACKE,KAEL,NDIOUMANE,"H1 DAARA NGUIOUMANE",1,1,24,1,25
DIOURBEL,M’BACKE,KAEL,NDIOUMANE,"H2 GUERAL 2 (KEUR NDIANE POUYE)",13,20,131,130,261
DIOURBEL,M’BACKE,KAEL,NDIOUMANE,"NGUIDIANE SALL",12,21,141,129,270
DIOURBEL,M’BACKE,KAEL,NDIOUMANE,"YADOU KAEL (KEUR NGAGNE DIAGNE)",6,8,46,46,92
DIOURBEL,M’BACKE,KAEL,"TOUBA MBOUL","DIAWE SERERE",15,23,136,103,239
DIOURBEL,M’BACKE,KAEL,"TOUBA MBOUL","H1 KEUR ALASSANE DIABAYE",6,11,58,37,95
DIOURBEL,M’BACKE,KAEL,"TOUBA MBOUL","H2 KEUR NGOR SENE",5,8,51,33,84
DIOURBEL,M’BACKE,KAEL,"TOUBA MBOUL","H3 KEUR DALY FAYE",17,27,182,163,345
DIOURBEL,M’BACKE,KAEL,"TOUBA MBOUL","H5 KEUR AMATH DIOUF",8,14,81,72,153
DIOURBEL,M’BACKE,KAEL,"TOUBA MBOUL",KAMADOU,22,33,230,219,449
DIOURBEL,M’BACKE,KAEL,"TOUBA MBOUL","H2 KEUR WALY NDIAYE",2,6,39,29,68
DIOURBEL,M’BACKE,KAEL,"TOUBA MBOUL","H3 KEUR NGOR TINE",12,18,111,118,229
DIOURBEL,M’BACKE,KAEL,"TOUBA MBOUL","H4 KEUR BIRAME NGOM",2,7,72,61,133
DIOURBEL,M’BACKE,KAEL,"TOUBA MBOUL","H5 KEUR NDIOUGA DIAGNE",7,17,172,141,313
DIOURBEL,M’BACKE,KAEL,"TOUBA MBOUL","H6 KEUR MBAGNICK NDAO",3,11,97,92,189
DIOURBEL,M’BACKE,KAEL,"TOUBA MBOUL","KELEWE TEW SERERE",12,39,176,118,294
DIOURBEL,M’BACKE,KAEL,"TOUBA MBOUL","H1 KEUR NGAYO SECK",6,12,92,85,177
DIOURBEL,M’BACKE,KAEL,"TOUBA MBOUL","H2 BARKEYEL",1,6,29,15,44
DIOURBEL,M’BACKE,KAEL,"TOUBA MBOUL","H3 KEUR FAPP POUYE",6,7,63,56,119
DIOURBEL,M’BACKE,KAEL,"TOUBA MBOUL","H4 KEUR SAMBA NGOM",8,12,95,84,179
DIOURBEL,M’BACKE,KAEL,"TOUBA MBOUL","H5 KELEWTEW",5,5,47,33,80
DIOURBEL,M’BACKE,KAEL,"TOUBA MBOUL","KEUR MADIOP SERERE",90,108,709,627,1336
DIOURBEL,M’BACKE,KAEL,"TOUBA MBOUL","LAGANE M’BACKE",5,6,37,26,63
DIOURBEL,M’BACKE,KAEL,"TOUBA MBOUL","H2 DARA LAGANE M’BACKE",2,2,195,23,218
DIOURBEL,M’BACKE,KAEL,"TOUBA MBOUL","H3 KEUR SAMBA NIANG",1,2,16,23,39
DIOURBEL,M’BACKE,KAEL,"TOUBA MBOUL","LAGANE PEULH",4,4,40,25,65
DIOURBEL,M’BACKE,KAEL,"TOUBA MBOUL",MBOBENE,20,24,121,104,225
DIOURBEL,M’BACKE,KAEL,"TOUBA MBOUL","H1 KEUR BALLA MBOULE KA",4,7,34,31,65
DIOURBEL,M’BACKE,KAEL,"TOUBA MBOUL","H2 KEUR MOUSTAPHA WELLE",1,1,3,3,6
DIOURBEL,M’BACKE,KAEL,"TOUBA MBOUL","MBOUL KAEL",1,1,8,2,10
DIOURBEL,M’BACKE,KAEL,"TOUBA MBOUL","H1 MBOUL LAPPY",9,14,51,35,86
DIOURBEL,M’BACKE,KAEL,"TOUBA MBOUL","MERINA SARR",9,12,98,80,178
DIOURBEL,M’BACKE,KAEL,"TOUBA MBOUL","H1 KEUR MAMADOU DIALLO",4,8,15,10,25
DIOURBEL,M’BACKE,KAEL,"TOUBA MBOUL","H2 KEUR IBRA NGOM",7,13,27,16,43
DIOURBEL,M’BACKE,KAEL,"TOUBA MBOUL","H2 KEUR NGOR FAYE",5,11,66,75,141
DIOURBEL,M’BACKE,KAEL,"TOUBA MBOUL","NDIAWRE COUTA",14,21,103,108,211
DIOURBEL,M’BACKE,KAEL,"TOUBA MBOUL","NDOCKA OUOLOF 1",7,7,35,31,66
DIOURBEL,M’BACKE,KAEL,"TOUBA MBOUL","NDOCKA OUOLOF 2",25,34,196,209,405
DIOURBEL,M’BACKE,KAEL,"TOUBA MBOUL","NDOCKA PEULH",11,15,123,130,253
DIOURBEL,M’BACKE,KAEL,"TOUBA MBOUL","H1 NDAKH NDIAYE",2,5,34,25,59
DIOURBEL,M’BACKE,KAEL,"TOUBA MBOUL",NDOYENE,6,6,67,73,140
DIOURBEL,M’BACKE,KAEL,"TOUBA MBOUL",NOUKOUYEL,30,58,379,365,744
DIOURBEL,M’BACKE,KAEL,"TOUBA MBOUL","H1 KEUR SEYDOU DIONE",9,15,109,105,214
DIOURBEL,M’BACKE,KAEL,"TOUBA MBOUL","PATHIEM PEULH",13,14,127,89,216
DIOURBEL,M’BACKE,KAEL,"TOUBA MBOUL","H1 PATHIEM II (GAOUROU)",16,27,250,243,493
DIOURBEL,M’BACKE,KAEL,"TOUBA MBOUL","PATHIEM YEL",14,27,188,183,371
DIOURBEL,M’BACKE,KAEL,"TOUBA MBOUL","H3 KOUTOURFA",13,15,98,105,203
DIOURBEL,M’BACKE,KAEL,"TOUBA MBOUL","H4 KEUR MAMADOU SOW",3,3,13,10,23
DIOURBEL,M’BACKE,KAEL,"TOUBA MBOUL","SEO TOURE",15,25,136,120,256
DIOURBEL,M’BACKE,KAEL,"TOUBA MBOUL","H1 SEO SERERE",15,45,293,289,582
DIOURBEL,M’BACKE,KAEL,"TOUBA MBOUL","H2 KEUR DJIBY SENE",24,27,196,242,438
DIOURBEL,M’BACKE,KAEL,"TOUBA MBOUL","H4 DIOYE",1,4,21,17,38
DIOURBEL,M’BACKE,KAEL,"TOUBA MBOUL","TEOUROU KOSSAM (KEUR MBASSIROU NDIAYE)",5,19,93,83,176
DIOURBEL,M’BACKE,KAEL,"TOUBA MBOUL","H2 NDOURENE",7,10,65,57,122
DIOURBEL,M’BACKE,KAEL,"TOUBA MBOUL","TOUBA MBOUL",74,82,516,511,1027
DIOURBEL,M’BACKE,KAEL,"TOUBA MBOUL","H3 SADJI",4,5,47,43,90
DIOURBEL,M’BACKE,KAEL,"TOUBA MBOUL","H4 BARKEYEL",13,27,98,76,174
DIOURBEL,M’BACKE,KAEL,"TOUBA MBOUL","H6 KEUR ADIOUMA DIOUF",5,14,65,67,132
DIOURBEL,M’BACKE,KAEL,"TOUBA MBOUL","H7 KEUR ELHADJI TINE (TEOUROU M’BACKE TINE)",10,15,85,64,149
DIOURBEL,M’BACKE,KAEL,"TOUBA MBOUL","H8 KEUR SERIGNE ALIOU NGOM",10,18,143,139,282
DIOURBEL,M’BACKE,KAEL,"TOUBA MBOUL","H9 KEUR SOUDOU FAYE",12,16,98,98,196
DIOURBEL,M’BACKE,KAEL,"TOUBA MBOUL","KEUR GOUAROU (MBOUL SERERE)",17,28,283,198,481
DIOURBEL,M’BACKE,KAEL,"DAROU NAHIM","DAROU M’BACKE",11,13,89,59,148
DIOURBEL,M’BACKE,KAEL,"DAROU NAHIM","H1 DARADJI",1,2,37,17,54
DIOURBEL,M’BACKE,KAEL,"DAROU NAHIM","DAROU NAHIM",76,93,536,506,1042
DIOURBEL,M’BACKE,KAEL,"DAROU NAHIM","H1 BOUTIKI",4,5,45,22,67
DIOURBEL,M’BACKE,KAEL,"DAROU NAHIM","H2 MBELLA",3,3,20,15,35
DIOURBEL,M’BACKE,KAEL,"DAROU NAHIM","H3 DIAYLA SOW",1,1,6,2,8
DIOURBEL,M’BACKE,KAEL,"DAROU NAHIM","H4 LOUMENE",1,2,37,0,37
DIOURBEL,M’BACKE,KAEL,"DAROU NAHIM","GOWANE FAYE",15,18,112,80,192
DIOURBEL,M’BACKE,KAEL,"DAROU NAHIM","H1 KEUR MACOUMBA NGOM",3,4,28,24,52
DIOURBEL,M’BACKE,KAEL,"DAROU NAHIM","H4 KEUR SADY SOW",3,5,19,21,40
DIOURBEL,M’BACKE,KAEL,"DAROU NAHIM","KEUR MAFARY NDIAYE",4,5,24,17,41
DIOURBEL,M’BACKE,KAEL,"DAROU NAHIM","KEUR SIDATE",15,16,100,63,163
DIOURBEL,M’BACKE,KAEL,"DAROU NAHIM",LODOYE,3,5,31,42,73
DIOURBEL,M’BACKE,KAEL,"DAROU NAHIM",MBABARY,6,7,23,11,34
DIOURBEL,M’BACKE,KAEL,"DAROU NAHIM",NDIAYENE,1,1,6,6,12
DIOURBEL,M’BACKE,KAEL,"DAROU NAHIM",NDIOBENE,2,3,12,12,24
DIOURBEL,M’BACKE,KAEL,"DAROU NAHIM",NDIOL,10,16,88,78,166
DIOURBEL,M’BACKE,KAEL,"DAROU NAHIM","NDIOPAME PEULH",6,6,51,46,97
DIOURBEL,M’BACKE,KAEL,"DAROU NAHIM",NGASSAMA,1,1,4,4,8
DIOURBEL,M’BACKE,KAEL,"DAROU NAHIM",THIALAGA,2,2,19,3,22
DIOURBEL,M’BACKE,KAEL,"DAROU NAHIM",THIALLE,26,31,187,175,362
DIOURBEL,M’BACKE,KAEL,"DAROU NAHIM","H1 KEUR ARONA BA",1,1,5,4,9
DIOURBEL,M’BACKE,KAEL,"DAROU NAHIM","H2 NDIA",1,1,11,7,18
DIOURBEL,M’BACKE,KAEL,"DAROU NAHIM",THIECKENE,13,14,80,53,133
DIOURBEL,M’BACKE,KAEL,"DAROU NAHIM","TOUBA KANE (NDIOPANE WOLOF)",4,6,26,16,42
DIOURBEL,M’BACKE,KAEL,"DAROU NAHIM","H1 GOWANE PEULH (KEUR GORGUI)",6,7,35,28,63
DIOURBEL,M’BACKE,KAEL,"TAIBA THIEKENE",GORETTE,6,7,44,33,77
DIOURBEL,M’BACKE,KAEL,"TAIBA THIEKENE","LOUMBEUL SAYE SERERE",16,29,176,161,337
DIOURBEL,M’BACKE,KAEL,"TAIBA THIEKENE","H1 BOUBOUL",3,3,50,29,79
DIOURBEL,M’BACKE,KAEL,"TAIBA THIEKENE","LOUMBEUL SAYE WOLOF",9,21,194,146,340
DIOURBEL,M’BACKE,KAEL,"TAIBA THIEKENE","H1 GAWANE SERERE",9,10,92,62,154
DIOURBEL,M’BACKE,KAEL,"TAIBA THIEKENE","H2 KEUR DJIBANE POUYE",16,28,183,127,310
DIOURBEL,M’BACKE,KAEL,"TAIBA THIEKENE",NDIAMA,6,9,44,38,82
DIOURBEL,M’BACKE,KAEL,"TAIBA THIEKENE","TAIBA THIAREME",3,3,19,16,35
DIOURBEL,M’BACKE,KAEL,"TAIBA THIEKENE","TAIBA THIECKENE",28,27,153,127,280
DIOURBEL,M’BACKE,KAEL,"TAIBA THIEKENE","H1 TAIBA GOUYE",4,4,38,11,49
DIOURBEL,M’BACKE,KAEL,"TAIBA THIEKENE","H2 GAWANE NDIAMA",3,4,30,21,51
DIOURBEL,M’BACKE,KAEL,"TAIBA THIEKENE","H3 GOWANE PEULH",1,3,35,14,49
DIOURBEL,M’BACKE,KAEL,"TAIBA THIEKENE","H4 MBAPPE",2,5,39,30,69
DIOURBEL,M’BACKE,KAEL,"TAIBA THIEKENE","H5 MOURE",5,6,51,34,85
DIOURBEL,M’BACKE,KAEL,"TAIBA THIEKENE",TAINABE,7,12,90,68,158
DIOURBEL,M’BACKE,KAEL,"TAIBA THIEKENE","H1 DJIGOBE",7,7,41,51,92
DIOURBEL,M’BACKE,KAEL,"TAIBA THIEKENE","H2 KEUR IDY DIAKOU KA",1,3,21,18,39
DIOURBEL,M’BACKE,KAEL,"TAIBA THIEKENE","H3 KEUR MBEGANE NDOUR",7,9,51,35,86
DIOURBEL,M’BACKE,KAEL,"TAIBA THIEKENE","H4 NGUETTE",3,3,19,18,37
DIOURBEL,M’BACKE,KAEL,"TAIBA THIEKENE","TOUBA LOUMBEL (COUMBEL WOLOF)",5,5,33,23,56
DIOURBEL,M’BACKE,NDAME,"DALLA NGABOU","BAITY DIA",18,18,86,66,152
DIOURBEL,M’BACKE,NDAME,"DALLA NGABOU","BAITY MADIA GUEYE",1,1,2,2,4
DIOURBEL,M’BACKE,NDAME,"DALLA NGABOU","BAITY NDIAYE",2,2,6,5,11
DIOURBEL,M’BACKE,NDAME,"DALLA NGABOU","BAITY PALENE",6,8,30,33,63
DIOURBEL,M’BACKE,NDAME,"DALLA NGABOU",BANANE,4,4,23,24,47
DIOURBEL,M’BACKE,NDAME,"DALLA NGABOU","H1 BANANE TEUGUE",5,9,43,41,84
DIOURBEL,M’BACKE,NDAME,"DALLA NGABOU","H2 KEUR BIRAME DIOUF",3,4,26,21,47
DIOURBEL,M’BACKE,NDAME,"DALLA NGABOU","H3 KEUR LAT SARR",4,4,25,16,41
DIOURBEL,M’BACKE,NDAME,"DALLA NGABOU","H4 KEUR ALY KANE",3,5,31,44,75
DIOURBEL,M’BACKE,NDAME,"DALLA NGABOU","DAGA DIOUF 1",8,9,42,41,83
DIOURBEL,M’BACKE,NDAME,"DALLA NGABOU","DAGA DIOUF 2",16,20,132,126,258
DIOURBEL,M’BACKE,NDAME,"DALLA NGABOU","DALLA OUOLOF",6,7,47,38,85
DIOURBEL,M’BACKE,NDAME,"DALLA NGABOU","DALLA PEULH 1",73,77,426,366,792
DIOURBEL,M’BACKE,NDAME,"DALLA NGABOU","H1 DAGA NDIAYE",1,2,7,6,13
DIOURBEL,M’BACKE,NDAME,"DALLA NGABOU","H2 NDIAGNE",1,1,6,0,6
DIOURBEL,M’BACKE,NDAME,"DALLA NGABOU","DALLA PEULH 2",17,27,142,127,269
DIOURBEL,M’BACKE,NDAME,"DALLA NGABOU","DAROU KHAFFOR",56,65,373,396,769
DIOURBEL,M’BACKE,NDAME,"DALLA NGABOU","DAROU KHOUDOSS 3",2,2,6,6,12
DIOURBEL,M’BACKE,NDAME,"DALLA NGABOU","H1 KIPDALL",6,6,48,48,96
DIOURBEL,M’BACKE,NDAME,"DALLA NGABOU","DAROU M’BACKE",35,43,195,204,399
DIOURBEL,M’BACKE,NDAME,"DALLA NGABOU",DIGANE,86,92,417,434,851
DIOURBEL,M’BACKE,NDAME,"DALLA NGABOU","DOUYE SANGOU",47,57,371,340,711
DIOURBEL,M’BACKE,NDAME,"DALLA NGABOU","FINTEL SERERE",18,41,245,269,514
DIOURBEL,M’BACKE,NDAME,"DALLA NGABOU","GOUYE NGUENE OUOLOF",25,29,181,171,352
DIOURBEL,M’BACKE,NDAME,"DALLA NGABOU","H1 DARAAY GOUYE NGUENE",12,12,85,68,153
DIOURBEL,M’BACKE,NDAME,"DALLA NGABOU","GOUYE NGUENE PEULH",16,17,135,139,274
DIOURBEL,M’BACKE,NDAME,"DALLA NGABOU","KHOUROU M’BACKE",10,13,66,47,113
DIOURBEL,M’BACKE,NDAME,"DALLA NGABOU",LAH,11,13,85,61,146
DIOURBEL,M’BACKE,NDAME,"DALLA NGABOU",NDAKHAR,2,4,29,5,34
DIOURBEL,M’BACKE,NDAME,"DALLA NGABOU","NGABOU 1",52,54,314,265,579
DIOURBEL,M’BACKE,NDAME,"DALLA NGABOU","H1 KEUR SENGAR DIOUF",2,2,7,6,13
DIOURBEL,M’BACKE,NDAME,"DALLA NGABOU","H2 KHAYE NDIAYE",7,7,31,25,56
DIOURBEL,M’BACKE,NDAME,"DALLA NGABOU","NGABOU 2 (DAROU LO)",75,83,729,519,1248
DIOURBEL,M’BACKE,NDAME,"DALLA NGABOU","NGABOU 3",40,41,204,174,378
DIOURBEL,M’BACKE,NDAME,"DALLA NGABOU","NGABOU 4",86,92,821,337,1158
DIOURBEL,M’BACKE,NDAME,"DALLA NGABOU","NGABOU SANKHAYE",4,4,23,27,50
DIOURBEL,M’BACKE,NDAME,"DALLA NGABOU",SATTE,73,81,854,494,1348
DIOURBEL,M’BACKE,NDAME,"DALLA NGABOU",TAINABE,14,15,100,114,214
DIOURBEL,M’BACKE,NDAME,"DALLA NGABOU","TAWA FALL",22,24,157,120,277
DIOURBEL,M’BACKE,NDAME,"DALLA NGABOU","THIENTHIE 2",3,3,6,6,12
DIOURBEL,M’BACKE,NDAME,"DALLA NGABOU","THIENTHIE 3",10,10,45,35,80
DIOURBEL,M’BACKE,NDAME,"DALLA NGABOU","H1 KEUR MOR ASSE",4,12,51,44,95
DIOURBEL,M’BACKE,NDAME,"DALLA NGABOU","THIENTHIE 4",5,6,31,31,62
DIOURBEL,M’BACKE,NDAME,"DALLA NGABOU","THIEP DALLA",2,3,22,27,49
DIOURBEL,M’BACKE,NDAME,"DALLA NGABOU","THIEYE PEULH",5,5,28,21,49
DIOURBEL,M’BACKE,NDAME,"DALLA NGABOU",THIOMBE,22,27,204,212,416
DIOURBEL,M’BACKE,NDAME,"DALLA NGABOU","TOUBA DALLA",4,4,17,13,30
DIOURBEL,M’BACKE,NDAME,"DALLA NGABOU","NGUEYENE NDAME",4,4,29,12,41
DIOURBEL,M’BACKE,NDAME,MISSIRAH,"DIAMWELY 2",27,30,120,141,261
DIOURBEL,M’BACKE,NDAME,MISSIRAH,DIOREL,3,3,19,12,31
DIOURBEL,M’BACKE,NDAME,MISSIRAH,"GOLY NDIAYE",9,9,44,36,80
DIOURBEL,M’BACKE,NDAME,MISSIRAH,"KEUR MACOUMBA NDIONE",7,9,71,40,111
DIOURBEL,M’BACKE,NDAME,MISSIRAH,"H1 KEUR OGO KA",2,2,17,18,35
DIOURBEL,M’BACKE,NDAME,MISSIRAH,"H2 KEUR MBAYE DIAGNE",1,1,4,7,11
DIOURBEL,M’BACKE,NDAME,MISSIRAH,KHAMNANE,16,25,120,118,238
DIOURBEL,M’BACKE,NDAME,MISSIRAH,"H1 LOUMENE",18,22,143,119,262
DIOURBEL,M’BACKE,NDAME,MISSIRAH,"KHEWAR MISSIRAH",30,29,177,132,309
DIOURBEL,M’BACKE,NDAME,MISSIRAH,"H1 KEUR DEMBA GUEYE",4,6,40,36,76
DIOURBEL,M’BACKE,NDAME,MISSIRAH,"H2 THIARGHE ET KARLOL",15,18,138,152,290
DIOURBEL,M’BACKE,NDAME,MISSIRAH,"H3 KEUR NDIAGA GUEYE",15,16,138,147,285
DIOURBEL,M’BACKE,NDAME,MISSIRAH,"H4  BAKAR NDIAYE",1,2,16,13,29
DIOURBEL,M’BACKE,NDAME,MISSIRAH,"H5 KEUR SALIOU GUEYE",10,15,83,89,172
DIOURBEL,M’BACKE,NDAME,MISSIRAH,KOBA,3,6,33,19,52
DIOURBEL,M’BACKE,NDAME,MISSIRAH,LAOUNIANDE,7,13,108,114,222
DIOURBEL,M’BACKE,NDAME,MISSIRAH,"H1 KEUR NIOKHOR SENE",2,5,51,46,97
DIOURBEL,M’BACKE,NDAME,MISSIRAH,LOUGOUL,22,25,177,138,315
DIOURBEL,M’BACKE,NDAME,MISSIRAH,"H1 DAARA HAMDY KHADY FALL",2,2,37,8,45
DIOURBEL,M’BACKE,NDAME,MISSIRAH,"H2 KEUR ARONA BA",4,4,49,30,79
DIOURBEL,M’BACKE,NDAME,MISSIRAH,"H3 TAWFEKH",8,13,99,72,171
DIOURBEL,M’BACKE,NDAME,MISSIRAH,"H4 DAARA CHEIKH KHADY",3,4,48,27,75
DIOURBEL,M’BACKE,NDAME,MISSIRAH,"MBARANE DIENG",5,5,47,20,67
DIOURBEL,M’BACKE,NDAME,MISSIRAH,"MBARANE THIAM",11,13,134,74,208
DIOURBEL,M’BACKE,NDAME,MISSIRAH,"H1 THIARENE SARR",15,16,91,66,157
DIOURBEL,M’BACKE,NDAME,MISSIRAH,"MBAYENE MISSIRAH",22,26,125,99,224
DIOURBEL,M’BACKE,NDAME,MISSIRAH,MISSIRAH,146,160,1007,834,1841
DIOURBEL,M’BACKE,NDAME,MISSIRAH,"H1 KEUR OMAR KANDADE KA",5,5,31,26,57
DIOURBEL,M’BACKE,NDAME,MISSIRAH,"H2 THIOUMP",56,59,317,349,666
DIOURBEL,M’BACKE,NDAME,MISSIRAH,"H3 KEUR MANAR",1,1,7,6,13
DIOURBEL,M’BACKE,NDAME,MISSIRAH,"H4 BEYE OUOLOF ET BEYE PEULH",21,29,216,166,382
DIOURBEL,M’BACKE,NDAME,MISSIRAH,"NDAME LO",9,9,56,33,89
DIOURBEL,M’BACKE,NDAME,MISSIRAH,NDIOUMENE,11,18,78,97,175
DIOURBEL,M’BACKE,NDAME,MISSIRAH,TAIBA,2,3,22,18,40
DIOURBEL,M’BACKE,NDAME,MISSIRAH,THIASKY,13,15,66,72,138
DIOURBEL,M’BACKE,NDAME,MISSIRAH,"H1 KEUR GANE",6,11,97,69,166
DIOURBEL,M’BACKE,NDAME,MISSIRAH,"H2 SAMBE",15,24,158,138,296
DIOURBEL,M’BACKE,NDAME,MISSIRAH,"H4 NDIOUFENE",1,4,15,15,30
DIOURBEL,M’BACKE,NDAME,MISSIRAH,"THYSSE 2",7,8,51,17,68
DIOURBEL,M’BACKE,NDAME,MISSIRAH,"YASSY MISSIRAH",42,43,262,291,553
DIOURBEL,M’BACKE,NDAME,NGHAYE,BELELE,9,12,73,81,154
DIOURBEL,M’BACKE,NDAME,NGHAYE,"H1 KEUR ELHADJ KA",5,5,29,37,66
DIOURBEL,M’BACKE,NDAME,NGHAYE,"H2 KEUR OUMAR FALL",3,5,39,46,85
DIOURBEL,M’BACKE,NDAME,NGHAYE,"DAROU KHOUDOSS 2",3,3,22,9,31
DIOURBEL,M’BACKE,NDAME,NGHAYE,"H1 NDIOKANE",6,6,41,42,83
DIOURBEL,M’BACKE,NDAME,NGHAYE,"H2 TEWROU",11,16,90,80,170
DIOURBEL,M’BACKE,NDAME,NGHAYE,"H3 YAWARA",2,2,17,13,30
DIOURBEL,M’BACKE,NDAME,NGHAYE,"DAROU NDIAYE",7,8,50,32,82
DIOURBEL,M’BACKE,NDAME,NGHAYE,GANDIOLE,41,53,196,237,433
DIOURBEL,M’BACKE,NDAME,NGHAYE,"GROTTE 2",12,14,111,104,215
DIOURBEL,M’BACKE,NDAME,NGHAYE,"GUEDJIALY 1",4,4,42,38,80
DIOURBEL,M’BACKE,NDAME,NGHAYE,"H1 KEURY SOUF",7,14,79,69,148
DIOURBEL,M’BACKE,NDAME,NGHAYE,"GUEDJIALY 2",31,48,303,263,566
DIOURBEL,M’BACKE,NDAME,NGHAYE,"KEUR SAMBA NDIAYE NIANG",4,6,57,37,94
DIOURBEL,M’BACKE,NDAME,NGHAYE,MBARENE,6,6,18,30,48
DIOURBEL,M’BACKE,NDAME,NGHAYE,"H1 BABOU",3,3,13,7,20
DIOURBEL,M’BACKE,NDAME,NGHAYE,MBILLY,13,19,180,135,315
DIOURBEL,M’BACKE,NDAME,NGHAYE,MBOUCKY,13,13,101,79,180
DIOURBEL,M’BACKE,NDAME,NGHAYE,NDEUNEUKH,3,6,46,24,70
DIOURBEL,M’BACKE,NDAME,NGHAYE,"H1 NIANKHENE",6,6,38,30,68
DIOURBEL,M’BACKE,NDAME,NGHAYE,"NDIA GUEMB",8,8,43,35,78
DIOURBEL,M’BACKE,NDAME,NGHAYE,"H1 NDIA KEUR MADIEYE",6,6,31,50,81
DIOURBEL,M’BACKE,NDAME,NGHAYE,"H2 NDIOBENE NDIMB",7,7,37,24,61
DIOURBEL,M’BACKE,NDAME,NGHAYE,NDIATHIAKHO,4,4,54,35,89
DIOURBEL,M’BACKE,NDAME,NGHAYE,NGHAYE,31,34,201,215,416
DIOURBEL,M’BACKE,NDAME,NGHAYE,"H1 DAROU NDIAYE",13,16,78,69,147
DIOURBEL,M’BACKE,NDAME,NGHAYE,"H2 KEUR LATYR FAYE",3,6,29,32,61
DIOURBEL,M’BACKE,NDAME,NGHAYE,NGONGO,11,27,209,205,414
DIOURBEL,M’BACKE,NDAME,NGHAYE,"H1 GAISSIR",6,8,74,43,117
DIOURBEL,M’BACKE,NDAME,NGHAYE,NGUEYENE,7,7,23,27,50
DIOURBEL,M’BACKE,NDAME,NGHAYE,NIAKHENE,5,7,45,4,49
DIOURBEL,M’BACKE,NDAME,NGHAYE,THIANGHA,2,5,27,21,48
DIOURBEL,M’BACKE,NDAME,NGHAYE,"THIENTHIE 1",17,22,119,129,248
DIOURBEL,M’BACKE,NDAME,NGHAYE,"H1 KEUR GALLO",2,3,20,21,41
DIOURBEL,M’BACKE,NDAME,NGHAYE,YASSY,59,65,417,392,809
DIOURBEL,M’BACKE,NDAME,NGHAYE,YERI,74,94,560,541,1101
DIOURBEL,M’BACKE,NDAME,NGHAYE,"H1 MBALKHASSE",4,4,18,11,29
DIOURBEL,M’BACKE,NDAME,"TOUBA FALL","BAITY DIMB",13,13,80,45,125
DIOURBEL,M’BACKE,NDAME,"TOUBA FALL","BAYE NDIAYE",8,9,92,57,149
DIOURBEL,M’BACKE,NDAME,"TOUBA FALL","DAROU RAHIM 1",10,13,84,64,148
DIOURBEL,M’BACKE,NDAME,"TOUBA FALL","DAROU RAHIM 2",14,18,161,117,278
DIOURBEL,M’BACKE,NDAME,"TOUBA FALL","DAROU RAHMANE",9,12,96,72,168
DIOURBEL,M’BACKE,NDAME,"TOUBA FALL","H1 KEUR SAGAR KA",5,5,57,19,76
DIOURBEL,M’BACKE,NDAME,"TOUBA FALL","DIAMWELY 1",4,5,39,27,66
DIOURBEL,M’BACKE,NDAME,"TOUBA FALL","H1 KIRE",26,30,122,100,222
DIOURBEL,M’BACKE,NDAME,"TOUBA FALL","H2 SOUYTA",6,7,51,33,84
DIOURBEL,M’BACKE,NDAME,"TOUBA FALL","GORETTE 1",18,31,222,141,363
DIOURBEL,M’BACKE,NDAME,"TOUBA FALL","GUEBE 1",24,26,191,140,331
DIOURBEL,M’BACKE,NDAME,"TOUBA FALL","GUEBE 2",13,13,101,63,164
DIOURBEL,M’BACKE,NDAME,"TOUBA FALL","H1 BARIKEL",21,28,200,123,323
DIOURBEL,M’BACKE,NDAME,"TOUBA FALL","GUELE 2",9,12,113,68,181
DIOURBEL,M’BACKE,NDAME,"TOUBA FALL","GUELE TENE",149,153,584,477,1061
DIOURBEL,M’BACKE,NDAME,"TOUBA FALL",KAWSARA,46,51,282,250,532
DIOURBEL,M’BACKE,NDAME,"TOUBA FALL","H1 KEUR SOUDOU DIAGNE (KAWSARA SERERE)",6,18,88,83,171
DIOURBEL,M’BACKE,NDAME,"TOUBA FALL","H2 KEUR MALICK FAYE",2,3,17,16,33
DIOURBEL,M’BACKE,NDAME,"TOUBA FALL","H3 DABAYE ET NGUEMBE",8,10,40,44,84
DIOURBEL,M’BACKE,NDAME,"TOUBA FALL","KEUR MATAR BA",6,7,62,34,96
DIOURBEL,M’BACKE,NDAME,"TOUBA FALL",KOLONABE,11,19,81,98,179
DIOURBEL,M’BACKE,NDAME,"TOUBA FALL","MBAME PEULH 1",20,33,212,187,399
DIOURBEL,M’BACKE,NDAME,"TOUBA FALL","MBAME PEULH 2",19,27,254,164,418
DIOURBEL,M’BACKE,NDAME,"TOUBA FALL","MEDINA TOURE",37,41,244,227,471
DIOURBEL,M’BACKE,NDAME,"TOUBA FALL","H1 NDIEYENE WODIA",2,2,18,15,33
DIOURBEL,M’BACKE,NDAME,"TOUBA FALL",OUROUR,8,13,91,61,152
DIOURBEL,M’BACKE,NDAME,"TOUBA FALL","SAM SAM",17,18,260,146,406
DIOURBEL,M’BACKE,NDAME,"TOUBA FALL","TAWA FALL",68,78,412,382,794
DIOURBEL,M’BACKE,NDAME,"TOUBA FALL","TOUBA FALL 1",40,40,170,170,340
DIOURBEL,M’BACKE,NDAME,"TOUBA FALL","TOUBA FALL 2",29,34,197,226,423
DIOURBEL,M’BACKE,NDAME,"TOUBA FALL","H2 BELEL",4,4,20,17,37
DIOURBEL,M’BACKE,NDAME,"TOUBA FALL","H3 KEUR ADAMA SAMB ET KEUR MAME NDIAYE",8,8,55,27,82
DIOURBEL,M’BACKE,NDAME,"TOUBA FALL","TOUBA NDIAWADY",291,305,1179,1095,2274
DIOURBEL,M’BACKE,NDAME,"TOUBA FALL",YOLLY,43,58,447,390,837
DIOURBEL,M’BACKE,NDAME,"TOUBA MOSQUEE",AFFE,55,57,749,291,1040
DIOURBEL,M’BACKE,NDAME,"TOUBA MOSQUEE","H1 AFFE SANTHIE (AFFE KHOUR)",28,29,157,179,336
DIOURBEL,M’BACKE,NDAME,"TOUBA MOSQUEE",ALIA,1385,1436,7350,6667,14017
DIOURBEL,M’BACKE,NDAME,"TOUBA MOSQUEE","TOUBA BAGDAD",306,417,1405,1433,2838
DIOURBEL,M’BACKE,NDAME,"TOUBA MOSQUEE","H1 RIP GAYE",10,13,85,82,167
DIOURBEL,M’BACKE,NDAME,"TOUBA MOSQUEE","H2 GOUYE MBAME",70,82,470,434,904
DIOURBEL,M’BACKE,NDAME,"TOUBA MOSQUEE","H4 KODIDE",12,14,186,49,235
DIOURBEL,M’BACKE,NDAME,"TOUBA MOSQUEE","BANGATHIE 1",9,14,82,87,169
DIOURBEL,M’BACKE,NDAME,"TOUBA MOSQUEE","BANGATHIE 2",11,13,114,64,178
DIOURBEL,M’BACKE,NDAME,"TOUBA MOSQUEE",MBAPE,2,3,11,16,27
DIOURBEL,M’BACKE,NDAME,"TOUBA MOSQUEE","BELEL NAYE",42,50,278,220,498
DIOURBEL,M’BACKE,NDAME,"TOUBA MOSQUEE","BODE 1",4,4,16,14,30
DIOURBEL,M’BACKE,NDAME,"TOUBA MOSQUEE","H1 KEUR SOULEYE BA",3,3,20,18,38
DIOURBEL,M’BACKE,NDAME,"TOUBA MOSQUEE","BODE 2 (KELEL DIENG)",21,67,129,90,219
DIOURBEL,M’BACKE,NDAME,"TOUBA MOSQUEE","H1 KELEL PEULH",5,29,53,45,98
DIOURBEL,M’BACKE,NDAME,"TOUBA MOSQUEE","BOFFEL TOUBA OIL",220,231,1354,1061,2415
DIOURBEL,M’BACKE,NDAME,"TOUBA MOSQUEE","BOUKHATOUL MOUBARACK",10181,11857,51270,50880,102150
DIOURBEL,M’BACKE,NDAME,"TOUBA MOSQUEE","BOUSTANOUL ARIFINA",410,424,2143,2651,4794
DIOURBEL,M’BACKE,NDAME,"TOUBA MOSQUEE","DAROU KARIM",1096,1118,4497,4310,8807
DIOURBEL,M’BACKE,NDAME,"TOUBA MOSQUEE","DAROU KHADIM",908,931,4450,3387,7837
DIOURBEL,M’BACKE,NDAME,"TOUBA MOSQUEE","DAROU KHALIMOUL KHABIR",1506,1646,8065,8869,16934
DIOURBEL,M’BACKE,NDAME,"TOUBA MOSQUEE","DAROU KHOUDOSS",10428,11026,60992,68746,129738
DIOURBEL,M’BACKE,NDAME,"TOUBA MOSQUEE","H1 BALLA NDIAYE",2,2,16,10,26
DIOURBEL,M’BACKE,NDAME,"TOUBA MOSQUEE","DAROU MARNANE",5652,6090,32211,35298,67509
DIOURBEL,M’BACKE,NDAME,"TOUBA MOSQUEE","DAROU MINAM",4406,4702,25092,28279,53371
DIOURBEL,M’BACKE,NDAME,"TOUBA MOSQUEE","DAROU NAHIM",373,383,1663,1989,3652
DIOURBEL,M’BACKE,NDAME,"TOUBA MOSQUEE","DAROU RAHMANE",157,165,941,1037,1978
DIOURBEL,M’BACKE,NDAME,"TOUBA MOSQUEE","H1 KEUR SERIGNE HABIB",7,7,63,15,78
DIOURBEL,M’BACKE,NDAME,"TOUBA MOSQUEE","DAROU RAHMANE (SANTHIE)",217,229,1248,1183,2431
DIOURBEL,M’BACKE,NDAME,"TOUBA MOSQUEE","DAROU RAHMANE 1",359,363,2020,1993,4013
DIOURBEL,M’BACKE,NDAME,"TOUBA MOSQUEE","DAROU SALAM NDAME",317,359,1832,1823,3655
DIOURBEL,M’BACKE,NDAME,"TOUBA MOSQUEE",DIAKHAYE,729,744,3776,3655,7431
DIOURBEL,M’BACKE,NDAME,"TOUBA MOSQUEE",DIALAKHAR,14,15,97,65,162
DIOURBEL,M’BACKE,NDAME,"TOUBA MOSQUEE","H1 MBAYENE",13,15,82,69,151
DIOURBEL,M’BACKE,NDAME,"TOUBA MOSQUEE","H2 DAROU DIOP",11,11,38,29,67
DIOURBEL,M’BACKE,NDAME,"TOUBA MOSQUEE","H3 DEMBA WOUNTOU",3,4,23,20,43
DIOURBEL,M’BACKE,NDAME,"TOUBA MOSQUEE","DIANATOUL MAHWA",2464,2791,12675,12881,25556
DIOURBEL,M’BACKE,NDAME,"TOUBA MOSQUEE","GOUYE MBIND",1978,2121,10696,11753,22449
DIOURBEL,M’BACKE,NDAME,"TOUBA MOSQUEE","GOUYE NABE",12,14,82,58,140
DIOURBEL,M’BACKE,NDAME,"TOUBA MOSQUEE","GUEDE BOUSSO",5714,6014,29309,31495,60804
DIOURBEL,M’BACKE,NDAME,"TOUBA MOSQUEE","H1 LAMBY GADIO",13,34,107,77,184
DIOURBEL,M’BACKE,NDAME,"TOUBA MOSQUEE","H2 NDAR KHAKHAME",116,117,409,397,806
DIOURBEL,M’BACKE,NDAME,"TOUBA MOSQUEE","KANKA (DEUK BOU REY)",51,56,327,331,658
DIOURBEL,M’BACKE,NDAME,"TOUBA MOSQUEE","KELELE DIOP (KELELE OUOLOF)",54,68,393,344,737
DIOURBEL,M’BACKE,NDAME,"TOUBA MOSQUEE","H1 KEUR HOGGO SOW",10,70,128,113,241
DIOURBEL,M’BACKE,NDAME,"TOUBA MOSQUEE","H2 NAIDE",7,10,54,51,105
DIOURBEL,M’BACKE,NDAME,"TOUBA MOSQUEE","KERE MBAYE",282,600,1331,1150,2481
DIOURBEL,M’BACKE,NDAME,"TOUBA MOSQUEE","H1 MACOUMBA DIABY",8,9,49,46,95
DIOURBEL,M’BACKE,NDAME,"TOUBA MOSQUEE","H2 POFDY PEULH",14,24,122,138,260
DIOURBEL,M’BACKE,NDAME,"TOUBA MOSQUEE","H3 TOUBA DIADEL",48,49,162,159,321
DIOURBEL,M’BACKE,NDAME,"TOUBA MOSQUEE","KERE NDIAGA NDAO",31,34,260,189,449
DIOURBEL,M’BACKE,NDAME,"TOUBA MOSQUEE","H2 THYSSE",4,4,30,34,64
DIOURBEL,M’BACKE,NDAME,"TOUBA MOSQUEE","KEUR MACOUMBA KEBE (KEUR KABE)",283,559,1515,1175,2690
DIOURBEL,M’BACKE,NDAME,"TOUBA MOSQUEE","KEUR NIANG",2034,2235,12466,13741,26207
DIOURBEL,M’BACKE,NDAME,"TOUBA MOSQUEE","KEUR NIANG EXTENSION",137,139,844,828,1672
DIOURBEL,M’BACKE,NDAME,"TOUBA MOSQUEE",KHAIRA,3339,3565,18377,20640,39017
DIOURBEL,M’BACKE,NDAME,"TOUBA MOSQUEE","TOUBA MADIYANA",3694,4148,22319,23472,45791
DIOURBEL,M’BACKE,NDAME,"TOUBA MOSQUEE","MAYE LANDANG",33,38,240,290,530
DIOURBEL,M’BACKE,NDAME,"TOUBA MOSQUEE","H1 BOWEL",12,15,109,123,232
DIOURBEL,M’BACKE,NDAME,"TOUBA MOSQUEE","H2 THIERERE",2,4,25,28,53
DIOURBEL,M’BACKE,NDAME,"TOUBA MOSQUEE","MERINA DIOP (MBOULOUGNE)",328,331,1694,1502,3196
DIOURBEL,M’BACKE,NDAME,"TOUBA MOSQUEE","MBOUSSOBE (DIANATOU FIRDAWSHI)",599,613,2495,2557,5052
DIOURBEL,M’BACKE,NDAME,"TOUBA MOSQUEE","MERI LAH",9,15,115,103,218
DIOURBEL,M’BACKE,NDAME,"TOUBA MOSQUEE","H1 KEUR MAMADOU GORY KA",5,7,52,26,78
DIOURBEL,M’BACKE,NDAME,"TOUBA MOSQUEE",NAIDE,41,58,315,215,530
DIOURBEL,M’BACKE,NDAME,"TOUBA MOSQUEE","H1 KEUR BIRAME",21,32,196,182,378
DIOURBEL,M’BACKE,NDAME,"TOUBA MOSQUEE",NDIAYENE,19,19,132,115,247
DIOURBEL,M’BACKE,NDAME,"TOUBA MOSQUEE",NDILIKY,70,77,437,373,810
DIOURBEL,M’BACKE,NDAME,"TOUBA MOSQUEE","NDINDY ABDOU",4549,4840,22325,21820,44145
DIOURBEL,M’BACKE,NDAME,"TOUBA MOSQUEE",NDIOGOP,12,18,90,70,160
DIOURBEL,M’BACKE,NDAME,"TOUBA MOSQUEE",NGASSAMA,53,54,346,365,711
DIOURBEL,M’BACKE,NDAME,"TOUBA MOSQUEE",GUELODE,104,112,726,557,1283
DIOURBEL,M’BACKE,NDAME,"TOUBA MOSQUEE","POFDY WOLOF",33,36,217,242,459
DIOURBEL,M’BACKE,NDAME,"TOUBA MOSQUEE","H1 KEUR SAMBA YOUMBEL BA",7,13,90,84,174
DIOURBEL,M’BACKE,NDAME,"TOUBA MOSQUEE","SAME LAH",2149,2235,11889,12323,24212
DIOURBEL,M’BACKE,NDAME,"TOUBA MOSQUEE",SOLBOCK,605,705,2884,2999,5883
DIOURBEL,M’BACKE,NDAME,"TOUBA MOSQUEE","SOURANG PEULH",33,42,232,232,464
DIOURBEL,M’BACKE,NDAME,"TOUBA MOSQUEE","H1 DJEMBERE",49,61,340,274,614
DIOURBEL,M’BACKE,NDAME,"TOUBA MOSQUEE","H2 YAMANE ET KOUTHIOUTHIE",21,24,221,60,281
DIOURBEL,M’BACKE,NDAME,"TOUBA MOSQUEE","H3 BOUBRE",5,13,107,101,208
DIOURBEL,M’BACKE,NDAME,"TOUBA MOSQUEE","H4 KEUR MANDIAYE DE NDINDY ABDOU",1,1,13,8,21
DIOURBEL,M’BACKE,NDAME,"TOUBA MOSQUEE","H5 SOURANG NDIAYENE",8,12,55,53,108
DIOURBEL,M’BACKE,NDAME,"TOUBA MOSQUEE","TAW FEKH BOUSSO",413,422,1259,968,2227
DIOURBEL,M’BACKE,NDAME,"TOUBA MOSQUEE","H1 NAIGUEDE",8,9,17,29,46
DIOURBEL,M’BACKE,NDAME,"TOUBA MOSQUEE","H2 BODE PEULH",3,6,13,18,31
DIOURBEL,M’BACKE,NDAME,"TOUBA MOSQUEE",TAWFEKH,1065,1090,5399,5113,10512
DIOURBEL,M’BACKE,NDAME,"TOUBA MOSQUEE",THIAWENE,1524,2073,7466,7421,14887
DIOURBEL,M’BACKE,NDAME,"TOUBA MOSQUEE","THIAWENE NDICKOU",318,328,1342,1336,2678
DIOURBEL,M’BACKE,NDAME,"TOUBA MOSQUEE","H1 DAROU KA",107,108,432,398,830
DIOURBEL,M’BACKE,NDAME,"TOUBA MOSQUEE",THYLLENE,5,11,70,50,120
DIOURBEL,M’BACKE,NDAME,"TOUBA MOSQUEE","THYSSE 1",5,5,47,16,63
DIOURBEL,M’BACKE,NDAME,"TOUBA MOSQUEE",TINDODY,1685,1736,7529,7430,14959
DIOURBEL,M’BACKE,NDAME,"TOUBA MOSQUEE","H2 KEUR AMADOU NDENE SOW",2,4,19,14,33
DIOURBEL,M’BACKE,NDAME,"TOUBA MOSQUEE","H3 BALLA FALL",42,46,115,125,240
DIOURBEL,M’BACKE,NDAME,"TOUBA MOSQUEE","H4 DIALAL",193,297,622,527,1149
DIOURBEL,M’BACKE,NDAME,"TOUBA MOSQUEE","H5 MEDINATOUL ABRARY",73,75,212,227,439
DIOURBEL,M’BACKE,NDAME,"TOUBA MOSQUEE","H6 POLLE",7,15,67,40,107
DIOURBEL,M’BACKE,NDAME,"TOUBA MOSQUEE","TOUBA AL AZAR",5179,5369,27183,27037,54220
DIOURBEL,M’BACKE,NDAME,"TOUBA MOSQUEE","TOUBA BOBOREL",1246,1278,5068,4726,9794
DIOURBEL,M’BACKE,NDAME,"TOUBA MOSQUEE","TOUBA FALL DIANATOUL",642,988,3127,2742,5869
DIOURBEL,M’BACKE,NDAME,"TOUBA MOSQUEE","H1 TOUBA FALL KHAR YALLA",137,141,542,497,1039
DIOURBEL,M’BACKE,NDAME,"TOUBA MOSQUEE","TOUBA GUEDE",863,931,4789,6019,10808
DIOURBEL,M’BACKE,NDAME,"TOUBA MOSQUEE","TOUBA HLM",3186,4035,17928,18426,36354
DIOURBEL,M’BACKE,NDAME,"TOUBA MOSQUEE","TOUBA MOSQUEE",11687,12369,69700,70909,140609
DIOURBEL,M’BACKE,NDAME,"TOUBA MOSQUEE","TOUBA NDIAREME",4155,4338,21489,21815,43304
DIOURBEL,M’BACKE,NDAME,"TOUBA MOSQUEE","TOUBA YAGNE",112,125,653,575,1228
DIOURBEL,M’BACKE,NDAME,"TOUBA MOSQUEE","THIAWENE SANTHIE ET DAROU SOW",636,656,2778,2564,5342
DIOURBEL,M’BACKE,NDAME,"TOUBA MOSQUEE","TOUBA BELEL",145,160,1071,868,1939
DIOURBEL,M’BACKE,NDAME,"TOUBA MOSQUEE","H1 THIONGUENE",17,45,85,78,163
DIOURBEL,M’BACKE,NDAME,"TOUBA MOSQUEE","TOUBA TAWFEKH ROUTE DE DAROU",394,859,1565,1459,3024
DIOURBEL,M’BACKE,TAIF,SADIO,BADJI,38,47,265,284,549
DIOURBEL,M’BACKE,TAIF,SADIO,"H1 BOWDO TATY (BADJI SERERE)",10,13,104,82,186
DIOURBEL,M’BACKE,TAIF,SADIO,"H2 NGANTOUR (BADJI PEULH )",9,11,68,60,128
DIOURBEL,M’BACKE,TAIF,SADIO,"H3 TOUPA",12,19,77,80,157
DIOURBEL,M’BACKE,TAIF,SADIO,"BANANE NDIOLOFENE",41,46,189,221,410
DIOURBEL,M’BACKE,TAIF,SADIO,"BANANE WAGADOU",74,82,419,406,825
DIOURBEL,M’BACKE,TAIF,SADIO,BOUSRA,10,12,160,98,258
DIOURBEL,M’BACKE,TAIF,SADIO,"DIABY 1",5,9,35,42,77
DIOURBEL,M’BACKE,TAIF,SADIO,"H1 LOULDE",19,23,134,117,251
DIOURBEL,M’BACKE,TAIF,SADIO,"DIABY 2",7,8,38,28,66
DIOURBEL,M’BACKE,TAIF,SADIO,"DIABY 3",5,5,38,38,76
DIOURBEL,M’BACKE,TAIF,SADIO,"DIABY KEUR SERIGNE BARA (DIABY WOLOF)",8,12,128,96,224
DIOURBEL,M’BACKE,TAIF,SADIO,"H1 NGASSAMA",10,14,78,73,151
DIOURBEL,M’BACKE,TAIF,SADIO,"H2 KEUR MBAYE BANA ET DIABY KEUR CHEIKH SAMBA THIAM",10,10,81,72,153
DIOURBEL,M’BACKE,TAIF,SADIO,DIOUFENE,25,28,112,146,258
DIOURBEL,M’BACKE,TAIF,SADIO,"GAINA KEUR TAMSIR",105,122,522,593,1115
DIOURBEL,M’BACKE,TAIF,SADIO,"GUERLE PEULH",30,32,143,146,289
DIOURBEL,M’BACKE,TAIF,SADIO,"GUERLE WOLOF",68,73,577,496,1073
DIOURBEL,M’BACKE,TAIF,SADIO,KAMBEL,66,86,411,651,1062
DIOURBEL,M’BACKE,TAIF,SADIO,"H1 MBEUP",14,27,170,116,286
DIOURBEL,M’BACKE,TAIF,SADIO,"MEDINA BOURLE",22,27,223,150,373
DIOURBEL,M’BACKE,TAIF,SADIO,"H1 BIDE",2,3,25,37,62
DIOURBEL,M’BACKE,TAIF,SADIO,"NGARAF (KEUR OUMAR GUEYE)",91,104,564,578,1142
DIOURBEL,M’BACKE,TAIF,SADIO,"NGARAF MBAYENE",37,63,451,404,855
DIOURBEL,M’BACKE,TAIF,SADIO,"SADIO ESCALE",228,254,1574,1781,3355
DIOURBEL,M’BACKE,TAIF,SADIO,"SADIO MBAYARD (THIODORDE)",105,140,1116,927,2043
DIOURBEL,M’BACKE,TAIF,SADIO,"SADIO NDIAKHAYE",177,201,1120,1279,2399
DIOURBEL,M’BACKE,TAIF,SADIO,"SADIO NDOMENE",99,126,790,743,1533
DIOURBEL,M’BACKE,TAIF,SADIO,"SADIO NDONDOL",64,88,648,544,1192
DIOURBEL,M’BACKE,TAIF,SADIO,"SADIO PALENE",72,83,553,444,997
DIOURBEL,M’BACKE,TAIF,SADIO,"SADIO THIAKHO",71,85,388,560,948
DIOURBEL,M’BACKE,TAIF,SADIO,"SADIO TOBENE",103,126,750,713,1463
DIOURBEL,M’BACKE,TAIF,SADIO,"TALL TALL",15,17,110,129,239
DIOURBEL,M’BACKE,TAIF,SADIO,"H1 POUMANENE",6,7,60,57,117
DIOURBEL,M’BACKE,TAIF,SADIO,"H2 DAGA TALL TALL",11,14,75,57,132
DIOURBEL,M’BACKE,TAIF,TAIF,BAILA,114,130,602,744,1346
DIOURBEL,M’BACKE,TAIF,TAIF,"H1 DIAMAGUENE",2,2,23,0,23
DIOURBEL,M’BACKE,TAIF,TAIF,BOMBALY,39,41,247,233,480
DIOURBEL,M’BACKE,TAIF,TAIF,"H2 DIOR BANGO",17,17,101,97,198
DIOURBEL,M’BACKE,TAIF,TAIF,"H3 DARAYE MOUSTAPHA ABDOU KHADRE M’BACKE",2,2,108,0,108
DIOURBEL,M’BACKE,TAIF,TAIF,"BOULERI NDIOLOFENE (KEUR BAMARY NDIOLOFENE)",63,70,293,389,682
DIOURBEL,M’BACKE,TAIF,TAIF,"BOULERI PEULH",11,20,112,102,214
DIOURBEL,M’BACKE,TAIF,TAIF,"H1 NDEGUE",13,18,128,90,218
DIOURBEL,M’BACKE,TAIF,TAIF,"DANKY (DAROU ISLAM)",43,44,242,218,460
DIOURBEL,M’BACKE,TAIF,TAIF,"H1 NDIARIGNE NDIOFO",3,3,34,30,64
DIOURBEL,M’BACKE,TAIF,TAIF,"H2 NARGA",9,11,60,57,117
DIOURBEL,M’BACKE,TAIF,TAIF,"DAROU MINAM TAIF (DAROU MINAM M’BACKE)",14,16,177,86,263
DIOURBEL,M’BACKE,TAIF,TAIF,"H1 DAARA SERIGNE MODOU M’BACKE",4,4,13,16,29
DIOURBEL,M’BACKE,TAIF,TAIF,"DAROU SALAM NGHAYE (MINAM SARR)",29,33,231,156,387
DIOURBEL,M’BACKE,TAIF,TAIF,"DIGUIGNE (MBAYENE)",18,21,129,94,223
DIOURBEL,M’BACKE,TAIF,TAIF,"H1 DIGUIGNE PEULH",4,6,22,22,44
DIOURBEL,M’BACKE,TAIF,TAIF,"DIGUIGNE SERERE",32,41,257,225,482
DIOURBEL,M’BACKE,TAIF,TAIF,SANDATOU,26,27,146,132,278
DIOURBEL,M’BACKE,TAIF,TAIF,"H1 KEUR BOYDO KA",3,3,17,12,29
DIOURBEL,M’BACKE,TAIF,TAIF,TAIF,650,731,3973,4615,8588
DIOURBEL,M’BACKE,TAIF,TAIF,"H1 MAKA SARR",22,27,147,150,297
DIOURBEL,M’BACKE,TAIF,TAIF,"H3 DAARA KHADIM M’BACKE",3,3,16,0,16
DIOURBEL,M’BACKE,TAIF,TAIF,"H4 IRADA",8,9,55,41,96
DIOURBEL,M’BACKE,TAIF,TAIF,"H5 DAROU BAILA",18,18,137,111,248
DIOURBEL,M’BACKE,TAIF,TAIF,"H6 GOUYE NAROU",12,18,75,72,147
DIOURBEL,M’BACKE,TAIF,TAIF,"H7 BAWDO TATI (TOUBA TAIF SERERE)",30,37,266,234,500
DIOURBEL,M’BACKE,TAIF,TAIF,"H8 GOUDOUGUEL",15,24,92,90,182
DIOURBEL,M’BACKE,TAIF,TAIF,"H9 NABA",9,11,72,74,146
DIOURBEL,M’BACKE,TAIF,TAIF,TANE,22,27,222,195,417
DIOURBEL,M’BACKE,TAIF,TAIF,"H1 BELELE SENE",4,6,31,27,58
DIOURBEL,M’BACKE,TAIF,TAIF,"TOUBA NABA (THISSE)",32,41,266,214,480
DIOURBEL,M’BACKE,TAIF,TAIF,"TOUBA NGHAYE (DAROU NDIAYE)",39,40,266,201,467
DIOURBEL,M’BACKE,TAIF,TAIF,"H1 PEULGHA",4,5,38,19,57
DIOURBEL,M’BACKE,TAIF,TAIF,"H2 DAROU NDIAYE KEUR SERIGNE BATHI",17,19,161,129,290
DIOURBEL,M’BACKE,TAIF,TAIF,WOUGA,38,61,304,295,599
SAINT-LOUIS,DAGANA,DAGANA,DAGANA,"SECTEUR I",354,444,1813,1750,3563
SAINT-LOUIS,DAGANA,DAGANA,DAGANA,"SECTEUR II",475,550,2339,2173,4512
SAINT-LOUIS,DAGANA,DAGANA,DAGANA,"SECTEUR III",177,196,841,828,1669
SAINT-LOUIS,DAGANA,DAGANA,DAGANA,"SECTEUR IV",279,310,1466,1340,2806
SAINT-LOUIS,DAGANA,DAGANA,DAGANA,"SECTEUR V",260,273,1271,1108,2379
SAINT-LOUIS,DAGANA,DAGANA,DAGANA,"SECTEUR VI",227,234,1022,782,1804
SAINT-LOUIS,DAGANA,DAGANA,DAGANA,"SECTEUR VII",368,386,1539,1509,3048
SAINT-LOUIS,DAGANA,DAGANA,DAGANA,"SECTEUR VIII",309,339,1665,1354,3019
SAINT-LOUIS,DAGANA,DAGANA,DAGANA,"SECTEUR IX",179,201,819,759,1578
SAINT-LOUIS,DAGANA,DAGANA,DAGANA,"SECTEUR X",114,119,502,524,1026
SAINT-LOUIS,DAGANA,DAGANA,DAGANA,"SECTEUR XI",122,137,616,548,1164
SAINT-LOUIS,DAGANA,"RICHARD TOLL","RICHARD TOLL","CAMPEMENT CIVIL",687,985,3902,3507,7409
SAINT-LOUIS,DAGANA,"RICHARD TOLL","RICHARD TOLL",ESCALE,386,608,2359,2042,4401
SAINT-LOUIS,DAGANA,"RICHARD TOLL","RICHARD TOLL","GAE II",408,546,2271,2133,4404
SAINT-LOUIS,DAGANA,"RICHARD TOLL","RICHARD TOLL","GALLO MALICK",454,683,2926,2454,5380
SAINT-LOUIS,DAGANA,"RICHARD TOLL","RICHARD TOLL","KHOUMA WOLOF",1108,1547,6693,6147,12840
SAINT-LOUIS,DAGANA,"RICHARD TOLL","RICHARD TOLL","YAKH SABAR",465,582,2339,2165,4504
SAINT-LOUIS,DAGANA,"RICHARD TOLL","RICHARD TOLL",NDIANGUE,341,476,2251,2154,4405
SAINT-LOUIS,DAGANA,"RICHARD TOLL","RICHARD TOLL",NDIAW,699,853,3941,3350,7291
SAINT-LOUIS,DAGANA,"RICHARD TOLL","RICHARD TOLL","NDOMBO ALARBA",100,111,660,596,1256
SAINT-LOUIS,DAGANA,"RICHARD TOLL","RICHARD TOLL",NOUROU,306,440,2267,1922,4189
SAINT-LOUIS,DAGANA,"RICHARD TOLL","RICHARD TOLL",THIABAKH,1940,2342,9178,7890,17068
SAINT-LOUIS,DAGANA,MBANE,MBANE,"MADINA MARE",28,41,137,156,293
SAINT-LOUIS,DAGANA,MBANE,MBANE,"H1 LOUGUERE 2",16,38,98,101,199
SAINT-LOUIS,DAGANA,MBANE,MBANE,"BALLANDE BADJINCOBE",10,16,37,49,86
SAINT-LOUIS,DAGANA,MBANE,MBANE,"H4 MAR 2",31,53,137,156,293
SAINT-LOUIS,DAGANA,MBANE,MBANE,BALANDE,20,27,76,103,179
SAINT-LOUIS,DAGANA,MBANE,MBANE,"BELEL NGUELOBA",12,18,68,67,135
SAINT-LOUIS,DAGANA,MBANE,MBANE,"H2 KEUR SIDY SOW",9,10,21,31,52
SAINT-LOUIS,DAGANA,MBANE,MBANE,"BISNABE BOKIDIWE",18,30,92,110,202
SAINT-LOUIS,DAGANA,MBANE,MBANE,"H1 PAMPINABE",10,14,64,45,109
SAINT-LOUIS,DAGANA,MBANE,MBANE,"H2 LOUMBE DIADBE",13,21,82,81,163
SAINT-LOUIS,DAGANA,MBANE,MBANE,"H3BOLEDI LESSO",3,3,8,13,21
SAINT-LOUIS,DAGANA,MBANE,MBANE,"BISNABE BIRAM SOKONE",16,29,113,66,179
SAINT-LOUIS,DAGANA,MBANE,MBANE,"H3 BELELLE SADIEGUI WORO MODERY",2,2,8,5,13
SAINT-LOUIS,DAGANA,MBANE,MBANE,"H2 KEUR  KOULO SOW",7,8,22,34,56
SAINT-LOUIS,DAGANA,MBANE,MBANE,"H3 KEUR MAMADOU BA",3,5,19,15,34
SAINT-LOUIS,DAGANA,MBANE,MBANE,"H4 KEUR TALIBE SOW (BELELE GOUDEL)",6,9,23,24,47
SAINT-LOUIS,DAGANA,MBANE,MBANE,"BELEL SADIEGUI ( KEUR SAMBA GNAGNA SOW)",8,10,73,48,121
SAINT-LOUIS,DAGANA,MBANE,MBANE,"H2 BELEL SADIEGUI 2",8,14,69,60,129
SAINT-LOUIS,DAGANA,MBANE,MBANE,"BISNABE BOUTEYNI",7,9,31,29,60
SAINT-LOUIS,DAGANA,MBANE,MBANE,"H2 KEUR GNELY THIENGUEL",8,18,66,90,156
SAINT-LOUIS,DAGANA,MBANE,MBANE,"H1 KEUR ABOU DIA",1,2,2,5,7
SAINT-LOUIS,DAGANA,MBANE,MBANE,"BISNABE DIAPOBE",12,21,58,72,130
SAINT-LOUIS,DAGANA,MBANE,MBANE,FEDIA,6,14,48,49,97
SAINT-LOUIS,DAGANA,MBANE,MBANE,"SAM SAM",44,60,201,222,423
SAINT-LOUIS,DAGANA,MBANE,MBANE,"BISNABE SAM SAM",3,13,31,35,66
SAINT-LOUIS,DAGANA,MBANE,MBANE,"H1 BISNABE SAM MAODA",5,7,18,12,30
SAINT-LOUIS,DAGANA,MBANE,MBANE,"H2 KEUR BAMBARA DIALLO",26,46,135,139,274
SAINT-LOUIS,DAGANA,MBANE,MBANE,"GANKETTE PENDA YAYAKE",15,37,85,97,182
SAINT-LOUIS,DAGANA,MBANE,MBANE,"H2 KALOME 2",12,16,84,73,157
SAINT-LOUIS,DAGANA,MBANE,MBANE,"WENDOU SENO 2",3,4,18,26,44
SAINT-LOUIS,DAGANA,MBANE,MBANE,"H3 KEUR SAMBA DINA SOW",4,11,51,61,112
SAINT-LOUIS,DAGANA,MBANE,MBANE,"H4 BAWEDJI DIARKA",10,15,34,55,89
SAINT-LOUIS,DAGANA,MBANE,MBANE,BOUCOULNABE,11,15,41,61,102
SAINT-LOUIS,DAGANA,MBANE,MBANE,DIAGLE,142,161,652,616,1268
SAINT-LOUIS,DAGANA,MBANE,MBANE,"NDIAKHAYE (KEBA)",112,151,864,618,1482
SAINT-LOUIS,DAGANA,MBANE,MBANE,POMO,42,48,218,222,440
SAINT-LOUIS,DAGANA,MBANE,MBANE,"LOUGHERE BAILA",15,27,86,79,165
SAINT-LOUIS,DAGANA,MBANE,MBANE,"H1 LOUGUERE II",11,14,60,74,134
SAINT-LOUIS,DAGANA,MBANE,MBANE,"DIABALNABE BELY NAMARY",50,70,237,277,514
SAINT-LOUIS,DAGANA,MBANE,MBANE,FOUNDONG,26,57,126,125,251
SAINT-LOUIS,DAGANA,MBANE,MBANE,"H2 KEUR AMADOU BAMBA SOW",1,5,9,22,31
SAINT-LOUIS,DAGANA,MBANE,MBANE,"DIASSARNABE NDIACK FALL",22,38,107,142,249
SAINT-LOUIS,DAGANA,MBANE,MBANE,"H2 SANDA 1",16,35,126,107,233
SAINT-LOUIS,DAGANA,MBANE,MBANE,"H4 KEUR BOUNENE SOW ( SANDA 2)",17,21,64,71,135
SAINT-LOUIS,DAGANA,MBANE,MBANE,"DIASSARNABE BALLANDE",11,20,53,59,112
SAINT-LOUIS,DAGANA,MBANE,MBANE,"H1 KEUR SOKOUNDOU A B SOW (MBELOGNE TOUFAM)",18,32,93,115,208
SAINT-LOUIS,DAGANA,MBANE,MBANE,"H2 KEUR OUSMANE DIALLO ( MBELOGNE TOUFAM)",4,10,40,35,75
SAINT-LOUIS,DAGANA,MBANE,MBANE,"GADE ABASS",15,20,74,71,145
SAINT-LOUIS,DAGANA,MBANE,MBANE,"SANEINTA TACK",54,73,345,334,679
SAINT-LOUIS,DAGANA,MBANE,MBANE,"FASS NDIAKHAYE 1",12,18,81,68,149
SAINT-LOUIS,DAGANA,MBANE,MBANE,"FASS NDIAKHAYE 2",19,21,130,118,248
SAINT-LOUIS,DAGANA,MBANE,MBANE,"H1 BELEL PATHE 2",8,8,26,23,49
SAINT-LOUIS,DAGANA,MBANE,MBANE,YELOUR,33,48,146,167,313
SAINT-LOUIS,DAGANA,MBANE,MBANE,"GADE ASSY SAMBA",74,103,379,356,735
SAINT-LOUIS,DAGANA,MBANE,MBANE,"H2 BOUNAMA YELOUR",18,23,47,77,124
SAINT-LOUIS,DAGANA,MBANE,MBANE,"GADE YELOUR",8,9,37,46,83
SAINT-LOUIS,DAGANA,MBANE,MBANE,"BISNABE PENDA YAYAKE PEUL",40,74,366,348,714
SAINT-LOUIS,DAGANA,MBANE,MBANE,"H2 ODALE PENDA YAYAKE",4,8,24,18,42
SAINT-LOUIS,DAGANA,MBANE,MBANE,"H3 KEUR ALPHA SOW",5,11,19,21,40
SAINT-LOUIS,DAGANA,MBANE,MBANE,"H1 KALOME 1",5,5,21,22,43
SAINT-LOUIS,DAGANA,MBANE,MBANE,KAOUNDIRAL,17,27,122,119,241
SAINT-LOUIS,DAGANA,MBANE,MBANE,"H1 KEUR EL HADJI LOUGUERE SOW",4,10,43,33,76
SAINT-LOUIS,DAGANA,MBANE,MBANE,"H1 KEUR NDIALA KA (BELELLE SENA WOURA NDIALA)",14,15,39,58,97
SAINT-LOUIS,DAGANA,MBANE,MBANE,"H3 KEUR MANIANG SOW",3,6,18,24,42
SAINT-LOUIS,DAGANA,MBANE,MBANE,"H3 KAOUNDIRAL 2",10,20,85,92,177
SAINT-LOUIS,DAGANA,MBANE,MBANE,"KOUEL NIASSANTE",23,26,46,104,150
SAINT-LOUIS,DAGANA,MBANE,MBANE,"TEMAYE LEWAH",62,69,356,325,681
SAINT-LOUIS,DAGANA,MBANE,MBANE,"H1 BELEL MASSOSE",25,33,132,154,286
SAINT-LOUIS,DAGANA,MBANE,MBANE,"SINGOU DIERY",75,207,761,745,1506
SAINT-LOUIS,DAGANA,MBANE,MBANE,"TEMEYE TOUCOULEUR",64,65,343,280,623
SAINT-LOUIS,DAGANA,MBANE,MBANE,"MALLA SANTHIE",14,14,93,66,159
SAINT-LOUIS,DAGANA,MBANE,MBANE,"BALLANDE WINDE MALAL",32,36,123,114,237
SAINT-LOUIS,DAGANA,MBANE,MBANE,"SENO NDAO (NDAWEDJI)",34,57,197,210,407
SAINT-LOUIS,DAGANA,MBANE,MBANE,MBANE,215,264,1499,1405,2904
SAINT-LOUIS,DAGANA,MBANE,MBANE,"H1 SOWONABE KOUEL BALLANDE",38,74,194,215,409
SAINT-LOUIS,DAGANA,MBANE,MBANE,"MEDINA BAIDY",34,48,197,198,395
SAINT-LOUIS,DAGANA,MBANE,MBANE,"H2 WODABE MOUSSEYNI",1,1,8,5,13
SAINT-LOUIS,DAGANA,MBANE,MBANE,NDOUMBOULENE,25,43,164,151,315
SAINT-LOUIS,DAGANA,MBANE,MBANE,"BELELE DIABY",52,83,267,328,595
SAINT-LOUIS,DAGANA,MBANE,MBANE,"H2 BOUGUEL NGALGOU",18,20,98,93,191
SAINT-LOUIS,DAGANA,MBANE,MBANE,"H1 SOVONABE BELEL DIABY 3",2,2,14,16,30
SAINT-LOUIS,DAGANA,MBANE,MBANE,NDIELEFOUL,37,43,199,148,347
SAINT-LOUIS,DAGANA,MBANE,MBANE,"H1 GADE SARE LAMOU",20,45,101,98,199
SAINT-LOUIS,DAGANA,MBANE,MBANE,"H2 BELEL YOURA",15,42,112,98,210
SAINT-LOUIS,DAGANA,MBANE,MBANE,"NIASSANTE 1",59,91,234,313,547
SAINT-LOUIS,DAGANA,MBANE,MBANE,"H3 KEUR GORIKA 1",8,15,50,59,109
SAINT-LOUIS,DAGANA,MBANE,MBANE,"H4 KEUR OUSMANE SECK SOW",12,15,59,68,127
SAINT-LOUIS,DAGANA,MBANE,MBANE,"BISNABE DIAMWELY",7,13,51,58,109
SAINT-LOUIS,DAGANA,MBANE,MBANE,"NIASSANTE 2",63,85,302,364,666
SAINT-LOUIS,DAGANA,MBANE,MBANE,"OUROUBE MEDINA I",13,15,67,61,128
SAINT-LOUIS,DAGANA,MBANE,MBANE,"PAMPENABE I",15,26,69,95,164
SAINT-LOUIS,DAGANA,MBANE,MBANE,"H1 BELI NDIATBE",6,8,42,38,80
SAINT-LOUIS,DAGANA,MBANE,MBANE,"H1 DIAMWELLY 1",4,6,20,39,59
SAINT-LOUIS,DAGANA,MBANE,MBANE,SAGOBE,26,34,132,138,270
SAINT-LOUIS,DAGANA,MBANE,MBANE,"H1 KEUR ELIMANE DIALLO",7,7,37,18,55
SAINT-LOUIS,DAGANA,MBANE,MBANE,"H2 KEUR AH YAKHYA DIAKHATE",3,5,11,15,26
SAINT-LOUIS,DAGANA,MBANE,MBANE,"BADJINCOBE WIDODJI",40,61,170,236,406
SAINT-LOUIS,DAGANA,MBANE,MBANE,"SARE LAMOU",36,39,171,140,311
SAINT-LOUIS,DAGANA,MBANE,MBANE,"H1 PATHE BADIO ALAHINDE",29,33,95,100,195
SAINT-LOUIS,DAGANA,MBANE,MBANE,"SOBOLNABE BELINAMARY 1",17,29,133,133,266
SAINT-LOUIS,DAGANA,MBANE,MBANE,"BELELLE PATHE",11,19,48,70,118
SAINT-LOUIS,DAGANA,MBANE,MBANE,"H2 KEUR ALASSANE NOEL DIA",7,12,38,35,73
SAINT-LOUIS,DAGANA,MBANE,MBANE,"H3 KEUR BALLA SOPHIE SOW",6,11,31,38,69
SAINT-LOUIS,DAGANA,MBANE,MBANE,"H4 KEUR CHEIKH ALARBA SOW",6,6,36,31,67
SAINT-LOUIS,DAGANA,MBANE,MBANE,"WODABE SOBOLNABE BELY NAMRY III",6,16,63,62,125
SAINT-LOUIS,DAGANA,MBANE,MBANE,"H1 WODABE MAR 1",7,15,44,57,101
SAINT-LOUIS,DAGANA,MBANE,MBANE,"SOWONABE I NARY",72,77,255,250,505
SAINT-LOUIS,DAGANA,MBANE,MBANE,"DIASSARNABE BARDIAL",15,20,95,76,171
SAINT-LOUIS,DAGANA,MBANE,MBANE,"H1 GUETOU ARDO",17,20,57,79,136
SAINT-LOUIS,DAGANA,MBANE,MBANE,"H3 KEUR SIDY COUMBAL SOW",31,49,138,134,272
SAINT-LOUIS,DAGANA,MBANE,MBANE,TEMEYE,152,167,938,806,1744
SAINT-LOUIS,DAGANA,MBANE,MBANE,"TETHIANE MALAL",12,19,40,80,120
SAINT-LOUIS,DAGANA,MBANE,MBANE,"H1 TETHIANE BAHDE",2,3,13,14,27
SAINT-LOUIS,DAGANA,MBANE,MBANE,"TETHIANE DIABY",8,12,48,48,96
SAINT-LOUIS,DAGANA,MBANE,MBANE,"H3 WOURY BATHIE DIALLO",6,6,14,26,40
SAINT-LOUIS,DAGANA,MBANE,MBANE,THIAGO,163,189,1040,1046,2086
SAINT-LOUIS,DAGANA,MBANE,MBANE,"WOYNDOU SAMBA",27,56,210,177,387
SAINT-LOUIS,DAGANA,MBANE,MBANE,"H1 GALLELE SOW",4,11,40,30,70
SAINT-LOUIS,DAGANA,MBANE,MBANE,"WENDOU SAMBA",37,68,216,207,423
SAINT-LOUIS,DAGANA,MBANE,MBANE,ALAYANA,12,18,88,77,165
SAINT-LOUIS,DAGANA,MBANE,MBANE,"H5 KEUR DIABEL DIALLO",8,15,77,87,164
SAINT-LOUIS,DAGANA,MBANE,MBANE,"H6 KEUR GALLO BAMBA DIALLO",2,3,17,14,31
SAINT-LOUIS,DAGANA,MBANE,MBANE,"SOBOLNABE LEWA",36,63,232,235,467
SAINT-LOUIS,DAGANA,MBANE,MBANE,"WODABE NIASSANTE",29,47,99,141,240
SAINT-LOUIS,DAGANA,MBANE,MBANE,MAPOUDJI,29,58,172,231,403
SAINT-LOUIS,DAGANA,MBANE,MBANE,"H3 KEUR AMETH SARR SY",7,7,11,21,32
SAINT-LOUIS,DAGANA,MBANE,MBANE,"YERY NDIAGA",2,2,6,9,15
SAINT-LOUIS,DAGANA,MBANE,MBANE,"H5 KEUR DIADJI NDOUMBE DIALLO",4,5,14,18,32
SAINT-LOUIS,DAGANA,MBANE,MBANE,"H6 AMETH BABOU",4,4,9,19,28
SAINT-LOUIS,DAGANA,MBANE,MBANE,"H7 SAMBALY BATHILY",8,15,37,59,96
SAINT-LOUIS,DAGANA,MBANE,MBANE,"H8 TETHIANE ODIO (TETHIANE NDIAMALA)",11,12,24,27,51
SAINT-LOUIS,DAGANA,MBANE,MBANE,"H9 ALTINE AMAR",5,5,18,20,38
SAINT-LOUIS,DAGANA,MBANE,MBANE,"H1 DANDGUE I",13,23,42,77,119
SAINT-LOUIS,DAGANA,MBANE,MBANE,"H2 MEDINA DAGDE",6,7,23,31,54
SAINT-LOUIS,DAGANA,MBANE,MBANE,"BARDIALE II",87,97,387,345,732
SAINT-LOUIS,DAGANA,MBANE,MBANE,"BELEL GODIOLY (KEUR MOMAR SARR)",3,16,16,23,39
SAINT-LOUIS,DAGANA,MBANE,MBANE,"BELEL MBEDO",3,6,18,21,39
SAINT-LOUIS,DAGANA,MBANE,MBANE,"BELEL SADIE",6,12,44,35,79
SAINT-LOUIS,DAGANA,MBANE,MBANE,"BELEL SADIEGUI",3,5,12,18,30
SAINT-LOUIS,DAGANA,MBANE,MBANE,"BISNABE KALOME 1",16,28,102,101,203
SAINT-LOUIS,DAGANA,MBANE,MBANE,"BISNABE YERO FELAH 1",4,7,42,37,79
SAINT-LOUIS,DAGANA,MBANE,MBANE,"BISNABE YERO FELAH 2",15,26,111,96,207
SAINT-LOUIS,DAGANA,MBANE,MBANE,DIAMDIAYRE,17,34,97,131,228
SAINT-LOUIS,DAGANA,MBANE,MBANE,"H1 DIADIARDE",2,5,13,24,37
SAINT-LOUIS,DAGANA,MBANE,MBANE,"DIASSARNABE DIACK FALL I",19,22,80,57,137
SAINT-LOUIS,DAGANA,MBANE,MBANE,"DIASSARNABE NDIACK FALL SIKERE",15,31,76,80,156
SAINT-LOUIS,DAGANA,MBANE,MBANE,DOBROU,5,6,26,23,49
SAINT-LOUIS,DAGANA,MBANE,MBANE,"DOKHALNABE PENDA YAYAKE",4,7,19,17,36
SAINT-LOUIS,DAGANA,MBANE,MBANE,"EL MARADINE",12,26,60,86,146
SAINT-LOUIS,DAGANA,MBANE,MBANE,"GADE NDIACK FALL",18,27,84,83,167
SAINT-LOUIS,DAGANA,MBANE,MBANE,"GADE PATHE BADIO",22,25,80,80,160
SAINT-LOUIS,DAGANA,MBANE,MBANE,HEWATHIATE,2,4,11,12,23
SAINT-LOUIS,DAGANA,MBANE,MBANE,"KOUEL ELHADJI KALIDOU",2,6,12,16,28
SAINT-LOUIS,DAGANA,MBANE,MBANE,"LOUMBI DIANE",7,9,21,31,52
SAINT-LOUIS,DAGANA,MBANE,MBANE,"MBELOGNE BOULBE",2,2,35,28,63
SAINT-LOUIS,DAGANA,MBANE,MBANE,"MBELOGNE GOUDY",12,27,74,101,175
SAINT-LOUIS,DAGANA,MBANE,MBANE,"OULAD BERRY",9,12,35,42,77
SAINT-LOUIS,DAGANA,MBANE,MBANE,OUROURBE,4,5,22,25,47
SAINT-LOUIS,DAGANA,MBANE,MBANE,"OUROURBE PATHE BADIO",31,39,207,291,498
SAINT-LOUIS,DAGANA,MBANE,MBANE,"PAMPINABE 3",4,13,37,46,83
SAINT-LOUIS,DAGANA,MBANE,MBANE,"PAMPINABE NIASSANTE",11,18,88,105,193
SAINT-LOUIS,DAGANA,MBANE,MBANE,"PATHE BADIO CARRIERE",22,26,92,67,159
SAINT-LOUIS,DAGANA,MBANE,MBANE,"H2 TETHIE NEDJI",12,18,55,54,109
SAINT-LOUIS,DAGANA,MBANE,MBANE,"PATHE BADIO D.THIADJI",19,30,121,114,235
SAINT-LOUIS,DAGANA,MBANE,MBANE,"SANEINTE DIERY",29,32,139,185,324
SAINT-LOUIS,DAGANA,MBANE,MBANE,"SOVOLNABE BELINAMARY II",5,7,23,29,52
SAINT-LOUIS,DAGANA,MBANE,MBANE,"H1 BISNABE BELY NAMARY",8,8,32,32,64
SAINT-LOUIS,DAGANA,MBANE,MBANE,"SOWONABE PATHE BADIO",22,36,133,193,326
SAINT-LOUIS,DAGANA,MBANE,MBANE,SYERE,4,4,29,25,54
SAINT-LOUIS,DAGANA,MBANE,MBANE,"TEMEYE PEULH",16,18,74,77,151
SAINT-LOUIS,DAGANA,MBANE,MBANE,"TEMAYE SALANE",12,17,125,61,186
SAINT-LOUIS,DAGANA,MBANE,MBANE,"TETHIAME NDIAMALA",1,1,7,3,10
SAINT-LOUIS,DAGANA,MBANE,MBANE,"WENDOU SENO 1",2,8,20,27,47
SAINT-LOUIS,DAGANA,MBANE,BOKHOL,ARRIWELE,95,112,495,552,1047
SAINT-LOUIS,DAGANA,MBANE,BOKHOL,BOKHOL,557,604,3064,2758,5822
SAINT-LOUIS,DAGANA,MBANE,BOKHOL,"GALLODJINA 1",23,24,103,148,251
SAINT-LOUIS,DAGANA,MBANE,BOKHOL,"GALLODJINA 2",22,22,111,124,235
SAINT-LOUIS,DAGANA,MBANE,BOKHOL,"H1 KOYLELE",53,61,421,366,787
SAINT-LOUIS,DAGANA,MBANE,BOKHOL,"GAMBOU THILLE",32,41,195,201,396
SAINT-LOUIS,DAGANA,MBANE,BOKHOL,"H1 DIERY GAE 2",6,8,43,45,88
SAINT-LOUIS,DAGANA,MBANE,BOKHOL,"H2 CARRIERE",22,25,98,107,205
SAINT-LOUIS,DAGANA,MBANE,BOKHOL,"H4 DIERY GAE 1",7,8,39,46,85
SAINT-LOUIS,DAGANA,MBANE,BOKHOL,"H5 DIALA WALY",27,39,155,190,345
SAINT-LOUIS,DAGANA,MBANE,BOKHOL,"H6 DARA SALAM",18,23,166,128,294
SAINT-LOUIS,DAGANA,MBANE,BOKHOL,"GUEUM YALLA",50,86,287,257,544
SAINT-LOUIS,DAGANA,MBANE,BOKHOL,"H3 KEUR ADIALE",23,37,122,105,227
SAINT-LOUIS,DAGANA,MBANE,BOKHOL,GUIDAKHAR,99,102,370,392,762
SAINT-LOUIS,DAGANA,MBANE,BOKHOL,"H1 MBILOR TACQUE",2,3,13,17,30
SAINT-LOUIS,DAGANA,MBANE,BOKHOL,"KEUR BIRAME KOBOR",34,39,211,195,406
SAINT-LOUIS,DAGANA,MBANE,BOKHOL,"KEUR MALAL TALABE",25,31,187,207,394
SAINT-LOUIS,DAGANA,MBANE,BOKHOL,"H1 BELEL HAMADY AISSE",3,8,26,21,47
SAINT-LOUIS,DAGANA,MBANE,BOKHOL,"H2 OBOK",6,6,32,46,78
SAINT-LOUIS,DAGANA,MBANE,BOKHOL,"H3 KEUR HAMIDOU NIANG",20,21,75,91,166
SAINT-LOUIS,DAGANA,MBANE,BOKHOL,"H4 SOUTOURA",15,17,80,57,137
SAINT-LOUIS,DAGANA,MBANE,BOKHOL,"H5 SOUTOURA",17,17,75,75,150
SAINT-LOUIS,DAGANA,MBANE,BOKHOL,"KEUR MBAYE",65,77,316,325,641
SAINT-LOUIS,DAGANA,MBANE,BOKHOL,"H1 KEUR MBAYE PEULH",49,51,228,226,454
SAINT-LOUIS,DAGANA,MBANE,BOKHOL,"H2 KEUR MBAYE SADIO",40,49,212,168,380
SAINT-LOUIS,DAGANA,MBANE,BOKHOL,"H3 KEUR MBAYE NDIOGOU",38,38,191,196,387
SAINT-LOUIS,DAGANA,MBANE,BOKHOL,"H4 KEUR DIAW FALL",20,21,85,79,164
SAINT-LOUIS,DAGANA,MBANE,BOKHOL,"KEUR MBAYE 2",60,60,185,168,353
SAINT-LOUIS,DAGANA,MBANE,BOKHOL,"H1 WENDOUFANOU SAM",1,1,2,3,5
SAINT-LOUIS,DAGANA,MBANE,BOKHOL,"KEUR MOR IBRA",10,18,69,77,146
SAINT-LOUIS,DAGANA,MBANE,BOKHOL,"H1 KEUR KALIDOU ALTINE",4,6,33,30,63
SAINT-LOUIS,DAGANA,MBANE,BOKHOL,"H2 SOWONABE 2",8,10,45,50,95
SAINT-LOUIS,DAGANA,MBANE,BOKHOL,"H3 BELEL HARAMNABE",3,4,16,16,32
SAINT-LOUIS,DAGANA,MBANE,BOKHOL,"H5 BELEL THILLE",8,17,49,57,106
SAINT-LOUIS,DAGANA,MBANE,BOKHOL,"H6 DIAKHASLENE",19,22,87,108,195
SAINT-LOUIS,DAGANA,MBANE,BOKHOL,KHARE,50,98,235,214,449
SAINT-LOUIS,DAGANA,MBANE,BOKHOL,"H1 TENE KHARE",11,19,57,57,114
SAINT-LOUIS,DAGANA,MBANE,BOKHOL,"H2 GAE",1,2,12,16,28
SAINT-LOUIS,DAGANA,MBANE,BOKHOL,"MBILOR DIERY",141,151,695,682,1377
SAINT-LOUIS,DAGANA,MBANE,BOKHOL,"MEDINA BELELE GAWDI",41,56,212,284,496
SAINT-LOUIS,DAGANA,MBANE,BOKHOL,MERY,39,46,184,226,410
SAINT-LOUIS,DAGANA,MBANE,BOKHOL,"SOUMANABE LOUMBEL",28,29,135,207,342
SAINT-LOUIS,DAGANA,MBANE,BOKHOL,"H1 DIOMEL BADY",16,29,122,139,261
SAINT-LOUIS,DAGANA,MBANE,BOKHOL,"H2 KEUR KALIDOU SOW",5,8,32,40,72
SAINT-LOUIS,DAGANA,MBANE,BOKHOL,"H3 KEUR THILAL KEDELE",5,6,21,25,46
SAINT-LOUIS,DAGANA,MBANE,BOKHOL,"SOWNABE WENDOU  FONDOU",81,174,549,562,1111
SAINT-LOUIS,DAGANA,MBANE,BOKHOL,"H1 KEUR AMADOU TOBO BA",8,8,41,44,85
SAINT-LOUIS,DAGANA,MBANE,BOKHOL,"H3 KEUR OUSMANE SARR",8,8,36,35,71
SAINT-LOUIS,DAGANA,MBANE,BOKHOL,"TOUCOULEUR DJIDIERY",79,89,498,418,916
SAINT-LOUIS,DAGANA,MBANE,BOKHOL,"BINGUEL DENE II",9,14,59,74,133
SAINT-LOUIS,DAGANA,MBANE,BOKHOL,"H1 ANDOU DINEMA",10,12,66,64,130
SAINT-LOUIS,DAGANA,MBANE,BOKHOL,NDIAWDOUNE,8,12,45,68,113
SAINT-LOUIS,DAGANA,MBANE,BOKHOL,"KEUR MESSOUD",7,12,60,48,108
SAINT-LOUIS,DAGANA,MBANE,BOKHOL,"ARRIWELL II",14,20,115,87,202
SAINT-LOUIS,DAGANA,MBANE,BOKHOL,"H1 GOUMEL DIERY",23,25,106,105,211
SAINT-LOUIS,DAGANA,MBANE,BOKHOL,"BELEL HARAMNABE",6,7,27,36,63
SAINT-LOUIS,DAGANA,MBANE,BOKHOL,"BINGUEL DENE",13,14,64,69,133
SAINT-LOUIS,DAGANA,MBANE,BOKHOL,"MBELOGNE BOULBE",17,17,90,76,166
SAINT-LOUIS,DAGANA,MBANE,BOKHOL,"H5 FARY MBAYE",9,13,48,49,97
SAINT-LOUIS,DAGANA,MBANE,GAE,BOULEYDI,145,151,778,756,1534
SAINT-LOUIS,DAGANA,MBANE,GAE,LAGDE,34,36,269,214,483
SAINT-LOUIS,DAGANA,MBANE,GAE,"NDIAREME NORD",102,139,857,720,1577
SAINT-LOUIS,DAGANA,MBANE,GAE,"NDIAREME SUD",96,125,769,679,1448
SAINT-LOUIS,DAGANA,MBANE,GAE,NDIORNA,144,150,967,864,1831
SAINT-LOUIS,DAGANA,MBANE,GAE,"PAL I",111,113,583,610,1193
SAINT-LOUIS,DAGANA,MBANE,GAE,"PAL II",125,137,619,620,1239
SAINT-LOUIS,DAGANA,MBANE,GAE,TIVAOUANE,180,194,1152,1054,2206
SAINT-LOUIS,DAGANA,MBANE,GAE,GOUMEL,45,56,308,265,573
SAINT-LOUIS,DAGANA,MBANE,GAE,"WOURO MINEL",27,28,98,114,212
SAINT-LOUIS,DAGANA,MBANE,"NDOMBO SANDJIRY",MATAMOULANA,68,68,331,240,571
SAINT-LOUIS,DAGANA,MBANE,"NDOMBO SANDJIRY","MEDINA I",35,66,258,212,470
SAINT-LOUIS,DAGANA,MBANE,"NDOMBO SANDJIRY",NDOMBO,294,339,1961,1667,3628
SAINT-LOUIS,DAGANA,MBANE,"NDOMBO SANDJIRY",DIAMAGEUNE,101,111,593,537,1130
SAINT-LOUIS,DAGANA,MBANE,"NDOMBO SANDJIRY","MEDINA II",37,53,200,181,381
SAINT-LOUIS,DAGANA,NDIAYE,DIAMA,AMOURA,27,32,110,124,234
SAINT-LOUIS,DAGANA,NDIAYE,DIAMA,ASSITOYE,50,85,289,279,568
SAINT-LOUIS,DAGANA,NDIAYE,DIAMA,"H1 KEUR DJIBY DIALLO",17,21,78,70,148
SAINT-LOUIS,DAGANA,NDIAYE,DIAMA,"H3 KEUR GAINTHE NDIAYE",23,26,157,152,309
SAINT-LOUIS,DAGANA,NDIAYE,DIAMA,"H1 KEUR DJIBY DIALLO IV",11,12,66,47,113
SAINT-LOUIS,DAGANA,NDIAYE,DIAMA,"BARI DIAM",88,100,570,554,1124
SAINT-LOUIS,DAGANA,NDIAYE,DIAMA,BIFFECHE,49,55,157,168,325
SAINT-LOUIS,DAGANA,NDIAYE,DIAMA,"BISSETTE I",31,40,144,155,299
SAINT-LOUIS,DAGANA,NDIAYE,DIAMA,"BISSETTE II",32,58,155,173,328
SAINT-LOUIS,DAGANA,NDIAYE,DIAMA,"H3 KEUR AMETH BA",10,15,41,45,86
SAINT-LOUIS,DAGANA,NDIAYE,DIAMA,"H4 KEUR ALIOUNE KA",8,9,40,38,78
SAINT-LOUIS,DAGANA,NDIAYE,DIAMA,"H6 ASSI NDIAWAYE",2,5,18,17,35
SAINT-LOUIS,DAGANA,NDIAYE,DIAMA,"H4 ASSY BISSETTE II",5,7,15,23,38
SAINT-LOUIS,DAGANA,NDIAYE,DIAMA,DEBY,210,243,1228,1191,2419
SAINT-LOUIS,DAGANA,NDIAYE,DIAMA,DEMIZINE,70,75,249,260,509
SAINT-LOUIS,DAGANA,NDIAYE,DIAMA,"H1 KEUR CHEIKH DAOUR HANN",10,12,65,65,130
SAINT-LOUIS,DAGANA,NDIAYE,DIAMA,"DIADIAM  I",72,82,298,323,621
SAINT-LOUIS,DAGANA,NDIAYE,DIAMA,"DIADIAM II",15,16,100,50,150
SAINT-LOUIS,DAGANA,NDIAYE,DIAMA,"H1 KEUR MAHMOUD DIOP",7,8,39,29,68
SAINT-LOUIS,DAGANA,NDIAYE,DIAMA,"DIADIAM III",62,63,281,285,566
SAINT-LOUIS,DAGANA,NDIAYE,DIAMA,"DIADJI FAKHA",62,83,304,286,590
SAINT-LOUIS,DAGANA,NDIAYE,DIAMA,"H1 DAARA S.MOUSSA M’BACKE",2,2,18,0,18
SAINT-LOUIS,DAGANA,NDIAYE,DIAMA,"H2 DAARA SERIGNE FALLOU",3,3,25,0,25
SAINT-LOUIS,DAGANA,NDIAYE,DIAMA,"H3 KEUR ASSANE MODY SOW",21,34,93,112,205
SAINT-LOUIS,DAGANA,NDIAYE,DIAMA,"H4 SITOU FOULBE",41,46,135,138,273
SAINT-LOUIS,DAGANA,NDIAYE,DIAMA,"DIAGAMBAL I",108,110,610,592,1202
SAINT-LOUIS,DAGANA,NDIAYE,DIAMA,"DIAMA YALAR",198,238,1029,873,1902
SAINT-LOUIS,DAGANA,NDIAYE,DIAMA,"H1 KEUR MAYE DIOP",31,34,188,137,325
SAINT-LOUIS,DAGANA,NDIAYE,DIAMA,"DIOSS PEULH",27,28,186,144,330
SAINT-LOUIS,DAGANA,NDIAYE,DIAMA,"H2 KEUR PATHE BA",4,5,26,33,59
SAINT-LOUIS,DAGANA,NDIAYE,DIAMA,"EL BETHIA 1",11,14,58,56,114
SAINT-LOUIS,DAGANA,NDIAYE,DIAMA,"EL BETHIA I",22,23,65,81,146
SAINT-LOUIS,DAGANA,NDIAYE,DIAMA,"H1 NDIOUGUETTE",13,13,38,35,73
SAINT-LOUIS,DAGANA,NDIAYE,DIAMA,"H2 NDIOUGUETTE II",5,9,37,31,68
SAINT-LOUIS,DAGANA,NDIAYE,DIAMA,"EL DEBIYAYE MARAYE II",84,98,267,341,608
SAINT-LOUIS,DAGANA,NDIAYE,DIAMA,"EL DELHAM MARAYE",6,7,24,27,51
SAINT-LOUIS,DAGANA,NDIAYE,DIAMA,"EL GORYA KOWRY",21,21,82,74,156
SAINT-LOUIS,DAGANA,NDIAYE,DIAMA,"EL MOHAMED AMAR",38,38,133,162,295
SAINT-LOUIS,DAGANA,NDIAYE,DIAMA,"EL NGOURANE 1",60,62,259,241,500
SAINT-LOUIS,DAGANA,NDIAYE,DIAMA,"EL NGOURANE 2",13,15,65,63,128
SAINT-LOUIS,DAGANA,NDIAYE,DIAMA,FOURARATE,37,49,207,201,408
SAINT-LOUIS,DAGANA,NDIAYE,DIAMA,"GADE TAMAKH",16,16,94,68,162
SAINT-LOUIS,DAGANA,NDIAYE,DIAMA,"MAKA DIAMA",61,72,331,356,687
SAINT-LOUIS,DAGANA,NDIAYE,DIAMA,"H1 MAKA PEULH",24,32,141,128,269
SAINT-LOUIS,DAGANA,NDIAYE,DIAMA,"H2 CAMPEMENT M.D CITE OMVS",6,6,31,25,56
SAINT-LOUIS,DAGANA,NDIAYE,DIAMA,MBERAYE,38,55,255,249,504
SAINT-LOUIS,DAGANA,NDIAYE,DIAMA,MBEURBEUF,35,41,183,167,350
SAINT-LOUIS,DAGANA,NDIAYE,DIAMA,"H1 KEUR ELHADJI AMETH SOW",4,4,20,13,33
SAINT-LOUIS,DAGANA,NDIAYE,DIAMA,"H2 BOLOUMBAL SAVOIGNE",11,13,22,25,47
SAINT-LOUIS,DAGANA,NDIAYE,DIAMA,"MBODJIENE (DIAGAMBAL)",97,105,527,444,971
SAINT-LOUIS,DAGANA,NDIAYE,DIAMA,MBOLTOGNE,137,170,619,582,1201
SAINT-LOUIS,DAGANA,NDIAYE,DIAMA,"MBOUBENE PEULH",55,56,164,189,353
SAINT-LOUIS,DAGANA,NDIAYE,DIAMA,"H1 KEUR  SAMBA HAMADY DIALLO",16,22,97,88,185
SAINT-LOUIS,DAGANA,NDIAYE,DIAMA,"MBOUNDOUM BARRAGE",340,376,1773,1617,3390
SAINT-LOUIS,DAGANA,NDIAYE,DIAMA,"H5 VILLAGE MALIEN MBOUNDOUM",12,12,51,42,93
SAINT-LOUIS,DAGANA,NDIAYE,DIAMA,NDELLE,144,168,1006,858,1864
SAINT-LOUIS,DAGANA,NDIAYE,DIAMA,"H1 KEUR OUSSEYNOU SOW",4,5,27,25,52
SAINT-LOUIS,DAGANA,NDIAYE,DIAMA,"H1 NDELLE PEULH",16,22,99,82,181
SAINT-LOUIS,DAGANA,NDIAYE,DIAMA,"NDIAYE MBERESSE (NDIAYE NGAINTHE)",235,306,1345,1290,2635
SAINT-LOUIS,DAGANA,NDIAYE,DIAMA,"H1 KEUR MAMADOU DADO SOW",9,9,51,35,86
SAINT-LOUIS,DAGANA,NDIAYE,DIAMA,"H8 AWALE",16,16,70,59,129
SAINT-LOUIS,DAGANA,NDIAYE,DIAMA,NDIGUE,45,47,176,160,336
SAINT-LOUIS,DAGANA,NDIAYE,DIAMA,"NDIOLE MAURE",107,134,485,493,978
SAINT-LOUIS,DAGANA,NDIAYE,DIAMA,"NDIOLE PEULH",9,12,98,56,154
SAINT-LOUIS,DAGANA,NDIAYE,DIAMA,"H1 KEUR PATHE TELELE SOW",22,26,126,134,260
SAINT-LOUIS,DAGANA,NDIAYE,DIAMA,"H2 BEGAYE",88,153,490,487,977
SAINT-LOUIS,DAGANA,NDIAYE,DIAMA,"NDIOUNG MBERESSE",124,140,643,615,1258
SAINT-LOUIS,DAGANA,NDIAYE,DIAMA,"H1 MBERESS",71,80,345,341,686
SAINT-LOUIS,DAGANA,NDIAYE,DIAMA,NGOMENE,63,71,407,391,798
SAINT-LOUIS,DAGANA,NDIAYE,DIAMA,"H1 K ALIOU ROKHAYA DIOP",13,19,72,61,133
SAINT-LOUIS,DAGANA,NDIAYE,DIAMA,"TABA EL YOULOUL",38,45,132,181,313
SAINT-LOUIS,DAGANA,NDIAYE,DIAMA,"ODABE NAVAR I",52,53,176,172,348
SAINT-LOUIS,DAGANA,NDIAYE,DIAMA,"H1 KEUR MODY KA",4,7,73,65,138
SAINT-LOUIS,DAGANA,NDIAYE,DIAMA,"H4 ODABE NAVAR 4",11,11,26,28,54
SAINT-LOUIS,DAGANA,NDIAYE,DIAMA,"PONT GENDARME",91,96,406,387,793
SAINT-LOUIS,DAGANA,NDIAYE,DIAMA,"H1 MASSARA GABOU",27,57,183,204,387
SAINT-LOUIS,DAGANA,NDIAYE,DIAMA,"H2 POLLO",56,100,373,342,715
SAINT-LOUIS,DAGANA,NDIAYE,DIAMA,"H3 YAYE FOUNDA",19,20,63,61,124
SAINT-LOUIS,DAGANA,NDIAYE,DIAMA,"RAYNABE 2",4,4,10,11,21
SAINT-LOUIS,DAGANA,NDIAYE,DIAMA,"H2 GANDIAYE PEULH II",65,82,426,372,798
SAINT-LOUIS,DAGANA,NDIAYE,DIAMA,"H2 KEUR ALIOU BELAL SOW",23,34,116,113,229
SAINT-LOUIS,DAGANA,NDIAYE,DIAMA,"RONE MARAYE",107,113,338,373,711
SAINT-LOUIS,DAGANA,NDIAYE,DIAMA,"SAVOIGNE PEULH",20,61,174,182,356
SAINT-LOUIS,DAGANA,NDIAYE,DIAMA,"H1 KEUR DJIBY DOLELE SOW",13,18,66,75,141
SAINT-LOUIS,DAGANA,NDIAYE,DIAMA,"H1 KEUR PATHE SOW",10,11,39,37,76
SAINT-LOUIS,DAGANA,NDIAYE,DIAMA,"H2 KEUR DEMBOUROU KA",5,9,22,30,52
SAINT-LOUIS,DAGANA,NDIAYE,DIAMA,"H2 KEUR PATHE SOW",18,26,96,85,181
SAINT-LOUIS,DAGANA,NDIAYE,DIAMA,"H5 GARRAGE SOCAS",11,12,40,29,69
SAINT-LOUIS,DAGANA,NDIAYE,DIAMA,"SAVOIGNE PIONNIERS",125,148,612,578,1190
SAINT-LOUIS,DAGANA,NDIAYE,DIAMA,"H2 MEDINA ISLAM",19,35,108,97,205
SAINT-LOUIS,DAGANA,NDIAYE,DIAMA,"TABA AHMETOU",61,60,176,249,425
SAINT-LOUIS,DAGANA,NDIAYE,DIAMA,"H1 EL BIRANE",20,20,57,76,133
SAINT-LOUIS,DAGANA,NDIAYE,DIAMA,"H1 EL HOUMEDI",55,55,182,250,432
SAINT-LOUIS,DAGANA,NDIAYE,DIAMA,"TABA DAROU SALAM  I",37,38,157,175,332
SAINT-LOUIS,DAGANA,NDIAYE,DIAMA,"H1 TOUBA NIMZATT",10,10,36,44,80
SAINT-LOUIS,DAGANA,NDIAYE,DIAMA,"TABA TACHE",27,27,96,128,224
SAINT-LOUIS,DAGANA,NDIAYE,DIAMA,"TABA TREICH",44,47,154,204,358
SAINT-LOUIS,DAGANA,NDIAYE,DIAMA,THILENE,126,140,601,628,1229
SAINT-LOUIS,DAGANA,NDIAYE,DIAMA,"H1 GANDIAYE WOLOF",32,35,137,148,285
SAINT-LOUIS,DAGANA,NDIAYE,DIAMA,TIGUETTE,163,174,886,760,1646
SAINT-LOUIS,DAGANA,NDIAYE,DIAMA,"TREICH PEULH",21,22,104,91,195
SAINT-LOUIS,DAGANA,NDIAYE,DIAMA,"H2 TREICH PEULH II",35,44,176,160,336
SAINT-LOUIS,DAGANA,NDIAYE,DIAMA,"DIAMA PEULH",16,21,67,54,121
SAINT-LOUIS,DAGANA,NDIAYE,DIAMA,"GONION WALO",1,1,4,3,7
SAINT-LOUIS,DAGANA,NDIAYE,DIAMA,"MÉDINA GANDIAYE",29,34,116,128,244
SAINT-LOUIS,DAGANA,NDIAYE,DIAMA,"H5 ODABE NDITTY BANDE",33,45,204,224,428
SAINT-LOUIS,DAGANA,NDIAYE,DIAMA,"NDIOL KEUR BIRESSY",38,45,160,155,315
SAINT-LOUIS,DAGANA,NDIAYE,DIAMA,NIMZATT,1,1,7,0,7
SAINT-LOUIS,DAGANA,NDIAYE,DIAMA,"OURO AMETH ABY",5,13,36,32,68
SAINT-LOUIS,DAGANA,NDIAYE,DIAMA,"H5 ASSY OUROU AMETH ABY",1,1,4,3,7
SAINT-LOUIS,DAGANA,NDIAYE,DIAMA,"POSTE DE CONTRÔLE DE NDOUTH (PARC DE DJOUDJ)",1,1,4,0,4
SAINT-LOUIS,DAGANA,NDIAYE,DIAMA,"TABA EL BIRANE",2,2,5,9,14
SAINT-LOUIS,DAGANA,NDIAYE,DIAMA,"GORYA EL KORY",25,26,139,116,255
SAINT-LOUIS,DAGANA,NDIAYE,NGNITH,"ALWA THIAM",39,43,265,242,507
SAINT-LOUIS,DAGANA,NDIAYE,NGNITH,"H1 KEUR COUMBA CISSE",4,5,44,33,77
SAINT-LOUIS,DAGANA,NDIAYE,NGNITH,"DAROU DIALANG",9,16,131,141,272
SAINT-LOUIS,DAGANA,NDIAYE,NGNITH,"H1 DIOKHOR 1",83,107,779,616,1395
SAINT-LOUIS,DAGANA,NDIAYE,NGNITH,"H2 KEUR BAIDY SOW",10,10,57,53,110
SAINT-LOUIS,DAGANA,NDIAYE,NGNITH,"DIASSARNABE DEGUELENE",29,35,132,120,252
SAINT-LOUIS,DAGANA,NDIAYE,NGNITH,"H1 TANAYE",37,53,180,179,359
SAINT-LOUIS,DAGANA,NDIAYE,NGNITH,"H3 NDIADIERNABE DIAGANE",21,58,115,112,227
SAINT-LOUIS,DAGANA,NDIAYE,NGNITH,"DIOKHOR 1",104,154,827,773,1600
SAINT-LOUIS,DAGANA,NDIAYE,NGNITH,"H1 NDIEMEULE 2",12,14,83,71,154
SAINT-LOUIS,DAGANA,NDIAYE,NGNITH,"DIOKHOR 2",18,31,180,185,365
SAINT-LOUIS,DAGANA,NDIAYE,NGNITH,"H3 NDIAYENE",46,103,350,237,587
SAINT-LOUIS,DAGANA,NDIAYE,NGNITH,"H4 KEUR HAMADY NDIAYE SOW",2,2,14,8,22
SAINT-LOUIS,DAGANA,NDIAYE,NGNITH,"GOGNO FALL (OUOLOF)",21,27,99,133,232
SAINT-LOUIS,DAGANA,NDIAYE,NGNITH,"H1 KEUR SAMBA DIEYE",8,27,47,41,88
SAINT-LOUIS,DAGANA,NDIAYE,NGNITH,"GOUYE NAR",7,9,67,66,133
SAINT-LOUIS,DAGANA,NDIAYE,NGNITH,"H1 KEUR MALICK SOW",3,4,24,17,41
SAINT-LOUIS,DAGANA,NDIAYE,NGNITH,"H2 BASSE FALL",10,12,33,62,95
SAINT-LOUIS,DAGANA,NDIAYE,NGNITH,"H1 BAITY",11,16,107,96,203
SAINT-LOUIS,DAGANA,NDIAYE,NGNITH,"H2 DIOKODOU",6,11,49,41,90
SAINT-LOUIS,DAGANA,NDIAYE,NGNITH,"KEUR BARKA",6,13,27,27,54
SAINT-LOUIS,DAGANA,NDIAYE,NGNITH,"KEUR SAMBA DIA",5,5,32,26,58
SAINT-LOUIS,DAGANA,NDIAYE,NGNITH,"KEUR SAMBA NIAKHOUR",12,14,56,54,110
SAINT-LOUIS,DAGANA,NDIAYE,NGNITH,"H1 DJILIME",34,42,222,189,411
SAINT-LOUIS,DAGANA,NDIAYE,NGNITH,"H2 THIEDAL NDOGAL",51,62,284,251,535
SAINT-LOUIS,DAGANA,NDIAYE,NGNITH,"H3 GADE",16,18,75,90,165
SAINT-LOUIS,DAGANA,NDIAYE,NGNITH,"H4 KEUR MAKA NIASSENE",31,35,137,138,275
SAINT-LOUIS,DAGANA,NDIAYE,NGNITH,"KEUR YERO GUEDAL",9,10,41,38,79
SAINT-LOUIS,DAGANA,NDIAYE,NGNITH,"H1 DIAKOUNDOU",21,44,155,130,285
SAINT-LOUIS,DAGANA,NDIAYE,NGNITH,"H3 KEUR KALIDOU DIA",5,5,24,23,47
SAINT-LOUIS,DAGANA,NDIAYE,NGNITH,"H5 KADOU DEFF",11,27,65,73,138
SAINT-LOUIS,DAGANA,NDIAYE,NGNITH,"H6 KEUR SONGO",9,9,35,26,61
SAINT-LOUIS,DAGANA,NDIAYE,NGNITH,MALLE,54,75,357,375,732
SAINT-LOUIS,DAGANA,NDIAYE,NGNITH,MBAYENE,134,152,772,754,1526
SAINT-LOUIS,DAGANA,NDIAYE,NGNITH,"H1 IBRAHIMA TABANE",7,9,76,57,133
SAINT-LOUIS,DAGANA,NDIAYE,NGNITH,"H2 NDEPPI",14,26,155,164,319
SAINT-LOUIS,DAGANA,NDIAYE,NGNITH,"H2 WANGUENE 1",14,15,70,74,144
SAINT-LOUIS,DAGANA,NDIAYE,NGNITH,NAERE,5,7,38,38,76
SAINT-LOUIS,DAGANA,NDIAYE,NGNITH,"H1 DAROU SALAM",51,67,443,292,735
SAINT-LOUIS,DAGANA,NDIAYE,NGNITH,"H2 KEUR ISSA DIOP",11,12,69,71,140
SAINT-LOUIS,DAGANA,NDIAYE,NGNITH,"H3 TEUSS",18,25,181,155,336
SAINT-LOUIS,DAGANA,NDIAYE,NGNITH,"H4 DIAMAGUENE",5,7,108,71,179
SAINT-LOUIS,DAGANA,NDIAYE,NGNITH,NDER,39,69,343,314,657
SAINT-LOUIS,DAGANA,NDIAYE,NGNITH,"H1 ROKHOU NDER",9,11,55,36,91
SAINT-LOUIS,DAGANA,NDIAYE,NGNITH,NDIAMAR,16,24,80,72,152
SAINT-LOUIS,DAGANA,NDIAYE,NGNITH,"NDIEMEULE SECKENE",20,36,229,205,434
SAINT-LOUIS,DAGANA,NDIAYE,NGNITH,NDIORNO,19,27,102,95,197
SAINT-LOUIS,DAGANA,NDIAYE,NGNITH,NDOGAL,55,61,425,426,851
SAINT-LOUIS,DAGANA,NDIAYE,NGNITH,"NDOUROUNABE DIAGANE",1,1,5,3,8
SAINT-LOUIS,DAGANA,NDIAYE,NGNITH,"H1 DIOURKY",32,61,176,169,345
SAINT-LOUIS,DAGANA,NDIAYE,NGNITH,"H2 NDOURNABE DIAGANE 4",7,9,26,34,60
SAINT-LOUIS,DAGANA,NDIAYE,NGNITH,"NDOUROUNABE DIAGNE 2",13,13,106,65,171
SAINT-LOUIS,DAGANA,NDIAYE,NGNITH,NGNITH,302,444,2319,2144,4463
SAINT-LOUIS,DAGANA,NDIAYE,NGNITH,"H1 DIOURKY 2",23,41,116,110,226
SAINT-LOUIS,DAGANA,NDIAYE,NGNITH,"H2 FEDERATION",11,11,77,72,149
SAINT-LOUIS,DAGANA,NDIAYE,NGNITH,"H3 WANGUENE 2",33,36,175,128,303
SAINT-LOUIS,DAGANA,NDIAYE,NGNITH,"H4 KAMBOUKI I",24,26,130,135,265
SAINT-LOUIS,DAGANA,NDIAYE,NGNITH,NIASSENE,83,92,415,413,828
SAINT-LOUIS,DAGANA,NDIAYE,NGNITH,"H1 TALBAKHLE PEULH NIASSENE (COMMUNE DE DIAMA)",8,10,45,42,87
SAINT-LOUIS,DAGANA,NDIAYE,NGNITH,"ODABE DIAGANE",27,49,169,155,324
SAINT-LOUIS,DAGANA,NDIAYE,NGNITH,"ODABE KAMBOUKI",7,7,40,24,64
SAINT-LOUIS,DAGANA,NDIAYE,NGNITH,"OUMARNABE NGUITH",21,29,117,94,211
SAINT-LOUIS,DAGANA,NDIAYE,NGNITH,"H1 KEUR SAMBA COUMBA SOW",7,11,39,45,84
SAINT-LOUIS,DAGANA,NDIAYE,NGNITH,"H3 BARI (COMMUNE DE DIAMA)",4,7,18,24,42
SAINT-LOUIS,DAGANA,NDIAYE,NGNITH,ROUMBATINE,37,54,183,198,381
SAINT-LOUIS,DAGANA,NDIAYE,NGNITH,TEMEYE,32,49,203,180,383
SAINT-LOUIS,DAGANA,NDIAYE,NGNITH,"H1 GADE TEMEYE",8,10,45,57,102
SAINT-LOUIS,DAGANA,NDIAYE,NGNITH,"THIEUDEME OUOLOF",4,8,20,28,48
SAINT-LOUIS,DAGANA,NDIAYE,NGNITH,"THIEUDEME PEULH",9,12,38,36,74
SAINT-LOUIS,DAGANA,NDIAYE,NGNITH,"TIDIEL TOUCOULEUR",39,43,374,321,695
SAINT-LOUIS,DAGANA,NDIAYE,NGNITH,"H1 MANGONE MBAYE",34,45,180,205,385
SAINT-LOUIS,DAGANA,NDIAYE,NGNITH,"H2 THIEPPE",12,14,59,58,117
SAINT-LOUIS,DAGANA,NDIAYE,NGNITH,"H3 YELETTE",41,44,205,186,391
SAINT-LOUIS,DAGANA,NDIAYE,NGNITH,"H5 KEUR ALY SOW",25,36,200,150,350
SAINT-LOUIS,DAGANA,NDIAYE,NGNITH,"H6 DOUNGUEL",7,13,80,70,150
SAINT-LOUIS,DAGANA,NDIAYE,NGNITH,"H7 YALATA PEULH",18,31,105,99,204
SAINT-LOUIS,DAGANA,NDIAYE,NGNITH,YAMAME,74,118,595,545,1140
SAINT-LOUIS,DAGANA,NDIAYE,NGNITH,DENTAL,35,95,200,180,380
SAINT-LOUIS,DAGANA,NDIAYE,NGNITH,HOWANDOU,48,68,242,238,480
SAINT-LOUIS,DAGANA,NDIAYE,NGNITH,"DEGUELEME 2",27,33,126,133,259
SAINT-LOUIS,DAGANA,NDIAYE,NGNITH,"H1 KEUR MAYOUCK NDIAYE",2,8,16,7,23
SAINT-LOUIS,DAGANA,NDIAYE,NGNITH,PENENE,25,35,252,231,483
SAINT-LOUIS,DAGANA,NDIAYE,NGNITH,TORDIONABE,33,35,130,134,264
SAINT-LOUIS,DAGANA,NDIAYE,NGNITH,"NDOURNABE DIAGANE 3",25,62,151,145,296
SAINT-LOUIS,DAGANA,NDIAYE,NGNITH,"DIALBENABE 2",19,36,126,93,219
SAINT-LOUIS,DAGANA,NDIAYE,NGNITH,"DIALBENABE 1",13,25,74,86,160
SAINT-LOUIS,DAGANA,NDIAYE,NGNITH,NDEYMANE,14,25,116,96,212
SAINT-LOUIS,DAGANA,NDIAYE,NGNITH,"BELEL MBAYE",29,54,134,128,262
SAINT-LOUIS,DAGANA,NDIAYE,NGNITH,KHONDENTAL,9,15,62,70,132
SAINT-LOUIS,DAGANA,NDIAYE,NGNITH,"H1 LOUGUE BAWANE",14,15,77,92,169
SAINT-LOUIS,DAGANA,NDIAYE,NGNITH,NGANDIEL,20,28,103,102,205
SAINT-LOUIS,DAGANA,NDIAYE,NGNITH,"ODABE POUROGNE",31,39,128,131,259
SAINT-LOUIS,DAGANA,NDIAYE,NGNITH,"ODABE ALWATHIAM",24,28,107,112,219
SAINT-LOUIS,DAGANA,NDIAYE,NGNITH,THIARENE,56,64,306,291,597
SAINT-LOUIS,DAGANA,NDIAYE,NGNITH,THIAMENE,24,32,128,112,240
SAINT-LOUIS,DAGANA,NDIAYE,NGNITH,"H4 SADIALE",8,12,41,30,71
SAINT-LOUIS,DAGANA,NDIAYE,RONKH,"BASSANG PEULH",32,33,104,111,215
SAINT-LOUIS,DAGANA,NDIAYE,RONKH,"BOUNTOU BACK",26,31,113,99,212
SAINT-LOUIS,DAGANA,NDIAYE,RONKH,"COLONAT (BALKY)",68,70,354,318,672
SAINT-LOUIS,DAGANA,NDIAYE,RONKH,"H2 LOUGUI DAYMISS II (TABLEAU)",35,45,172,153,325
SAINT-LOUIS,DAGANA,NDIAYE,RONKH,"H4 OUROULBE 1",43,53,194,174,368
SAINT-LOUIS,DAGANA,NDIAYE,RONKH,"H5 OUROULBE 2",48,59,179,181,360
SAINT-LOUIS,DAGANA,NDIAYE,RONKH,DIAWAR,308,334,1473,1361,2834
SAINT-LOUIS,DAGANA,NDIAYE,RONKH,"H1 DIAWAR GAE",12,14,69,68,137
SAINT-LOUIS,DAGANA,NDIAYE,RONKH,"KASSACK NORD",179,196,1149,918,2067
SAINT-LOUIS,DAGANA,NDIAYE,RONKH,"KASSACK SUD",125,138,605,491,1096
SAINT-LOUIS,DAGANA,NDIAYE,RONKH,"H1 KASSACK MALI",1,1,1,1,2
SAINT-LOUIS,DAGANA,NDIAYE,RONKH,KHEER,34,35,103,119,222
SAINT-LOUIS,DAGANA,NDIAYE,RONKH,"H1 FAURE",14,16,67,71,138
SAINT-LOUIS,DAGANA,NDIAYE,RONKH,KHEUNE,117,132,668,438,1106
SAINT-LOUIS,DAGANA,NDIAYE,RONKH,"H1 KEUR SERIGNE SOW",9,16,58,49,107
SAINT-LOUIS,DAGANA,NDIAYE,RONKH,KHOR,118,125,587,491,1078
SAINT-LOUIS,DAGANA,NDIAYE,RONKH,"MBEPAR GOROM",2,2,15,8,23
SAINT-LOUIS,DAGANA,NDIAYE,RONKH,"H4 GOWEYDI",14,16,48,47,95
SAINT-LOUIS,DAGANA,NDIAYE,RONKH,"H1 GAE KHOR",2,7,20,29,49
SAINT-LOUIS,DAGANA,NDIAYE,RONKH,"MBOUNDOUM EST",90,92,393,319,712
SAINT-LOUIS,DAGANA,NDIAYE,RONKH,"H2 GALLAKH",4,11,33,17,50
SAINT-LOUIS,DAGANA,NDIAYE,RONKH,"NADIEL I",25,25,71,76,147
SAINT-LOUIS,DAGANA,NDIAYE,RONKH,"H2 WOURO L'ISLAM 3",13,20,49,51,100
SAINT-LOUIS,DAGANA,NDIAYE,RONKH,"WOUROU L'ISLAM 4",19,30,50,65,115
SAINT-LOUIS,DAGANA,NDIAYE,RONKH,"NADIEL II",16,20,46,47,93
SAINT-LOUIS,DAGANA,NDIAYE,RONKH,"NADIEL IV",12,12,25,48,73
SAINT-LOUIS,DAGANA,NDIAYE,RONKH,"H1 GUILADO 1",18,18,56,63,119
SAINT-LOUIS,DAGANA,NDIAYE,RONKH,"H2 GUILADO II",6,12,44,42,86
SAINT-LOUIS,DAGANA,NDIAYE,RONKH,"H3 GUILADO III",5,5,17,19,36
SAINT-LOUIS,DAGANA,NDIAYE,RONKH,"H1 GUILADO IV",6,7,22,17,39
SAINT-LOUIS,DAGANA,NDIAYE,RONKH,NDIETENE,278,299,1178,1193,2371
SAINT-LOUIS,DAGANA,NDIAYE,RONKH,PAKH,83,92,397,367,764
SAINT-LOUIS,DAGANA,NDIAYE,RONKH,"H1 FEYEUROU",3,4,16,14,30
SAINT-LOUIS,DAGANA,NDIAYE,RONKH,RONKH,557,589,2413,2081,4494
SAINT-LOUIS,DAGANA,NDIAYE,RONKH,"H1 RONKH PEULH",6,11,55,35,90
SAINT-LOUIS,DAGANA,NDIAYE,RONKH,"H3 DAARA SERIGNE MOUSTAPHA",1,2,7,6,13
SAINT-LOUIS,DAGANA,NDIAYE,RONKH,THIAGAR,225,257,1161,1071,2232
SAINT-LOUIS,DAGANA,NDIAYE,RONKH,"H1 THIAGAR PEULH",3,4,27,25,52
SAINT-LOUIS,DAGANA,NDIAYE,RONKH,"THIENEL DOCKY",18,23,84,89,173
SAINT-LOUIS,DAGANA,NDIAYE,RONKH,"H1 KARA LAXAR",31,35,113,131,244
SAINT-LOUIS,DAGANA,NDIAYE,RONKH,WASSOUL,131,168,729,683,1412
SAINT-LOUIS,DAGANA,NDIAYE,RONKH,"YETTI YONE (BOUNTOU NDIEUGNE)",72,89,345,320,665
SAINT-LOUIS,DAGANA,NDIAYE,RONKH,"BOUNTOU BACK II",40,43,182,142,324
SAINT-LOUIS,DAGANA,NDIAYE,RONKH,CARRIERE,11,15,44,50,94
SAINT-LOUIS,DAGANA,NDIAYE,RONKH,FOYOROU,43,49,166,164,330
SAINT-LOUIS,DAGANA,NDIAYE,RONKH,"GAWDIYEL 2",20,26,109,94,203
SAINT-LOUIS,DAGANA,NDIAYE,RONKH,"GADA TOUMANI",18,18,42,39,81
SAINT-LOUIS,DAGANA,NDIAYE,RONKH,"KARALACK SARR 1",1,1,3,3,6
SAINT-LOUIS,DAGANA,NDIAYE,RONKH,"KEUR IDY",4,15,42,31,73
SAINT-LOUIS,DAGANA,NDIAYE,RONKH,"KEUR ADEER",11,12,42,43,85
SAINT-LOUIS,DAGANA,NDIAYE,RONKH,KOYLE,5,6,20,23,43
SAINT-LOUIS,DAGANA,NDIAYE,RONKH,TOLEU,22,34,130,89,219
SAINT-LOUIS,DAGANA,NDIAYE,RONKH,TONGOR,13,20,65,56,121
SAINT-LOUIS,DAGANA,NDIAYE,RONKH,TORDONABE,26,32,106,114,220
SAINT-LOUIS,DAGANA,NDIAYE,RONKH,"WOURO L'ISLAM I",19,42,99,122,221
SAINT-LOUIS,DAGANA,NDIAYE,RONKH,"WINDOU THIELY",22,40,102,113,215
SAINT-LOUIS,DAGANA,NDIAYE,RONKH,"WOURO L'ISLAM 2",13,16,44,39,83
SAINT-LOUIS,DAGANA,NDIAYE,RONKH,"THIONEL DICKO",2,2,13,10,23
SAINT-LOUIS,DAGANA,NDIAYE,RONKH,"NADIEL III",20,23,97,82,179
SAINT-LOUIS,DAGANA,NDIAYE,"ROSS BETHIO",DIOROSS,62,86,310,291,601
SAINT-LOUIS,DAGANA,NDIAYE,"ROSS BETHIO","OUROULBE BEGAYE",29,44,101,85,186
SAINT-LOUIS,DAGANA,NDIAYE,"ROSS BETHIO","RAYNABE I",127,161,516,473,989
SAINT-LOUIS,DAGANA,NDIAYE,"ROSS BETHIO","ODABE NAWAR II",74,90,320,319,639
SAINT-LOUIS,DAGANA,NDIAYE,"ROSS BETHIO",NDIORNO,151,204,1102,1015,2117
SAINT-LOUIS,DAGANA,NDIAYE,"ROSS BETHIO","ODABE NDITTI",29,46,198,154,352
SAINT-LOUIS,DAGANA,NDIAYE,"ROSS BETHIO","ROSS CENTRE",312,393,2007,1811,3818
SAINT-LOUIS,DAGANA,NDIAYE,"ROSS BETHIO","SANTHIABA I",347,399,2128,1716,3844
SAINT-LOUIS,DAGANA,NDIAYE,"ROSS BETHIO","SANTHIABA II",211,245,1147,929,2076
SAINT-LOUIS,DAGANA,NDIAYE,"ROSS BETHIO",THIEUDEM,169,191,897,706,1603
SAINT-LOUIS,DAGANA,NDIAYE,ROSSO,"CITE NIAKH",107,153,726,690,1416
SAINT-LOUIS,DAGANA,NDIAYE,ROSSO,CROISEMENT,62,86,329,313,642
SAINT-LOUIS,DAGANA,NDIAYE,ROSSO,DIAMAGUENE,176,204,1056,878,1934
SAINT-LOUIS,DAGANA,NDIAYE,ROSSO,MBAGAM,305,340,1902,1739,3641
SAINT-LOUIS,DAGANA,NDIAYE,ROSSO,MEDINE,408,497,2310,1902,4212
SAINT-LOUIS,DAGANA,NDIAYE,ROSSO,NDIANDIOU,17,22,128,103,231
SAINT-LOUIS,DAGANA,NDIAYE,ROSSO,"ROSSO PEULH",82,128,489,419,908
SAINT-LOUIS,DAGANA,NDIAYE,ROSSO,"SANTHIABA I",129,196,718,683,1401
SAINT-LOUIS,DAGANA,NDIAYE,ROSSO,"SANTHIABA II",117,160,735,755,1490
SAINT-LOUIS,DAGANA,NDIAYE,ROSSO,"SANTHIABA III",403,568,2639,2346,4985
SAINT-LOUIS,DAGANA,NDIAYE,ROSSO,"SANTHIABA IV",113,169,742,697,1439
SAINT-LOUIS,PODOR,PODOR,PODOR,"BIR PODOR",114,131,617,547,1164
SAINT-LOUIS,PODOR,PODOR,PODOR,"LAO DEMBA",279,419,1631,1524,3155
SAINT-LOUIS,PODOR,PODOR,PODOR,MBODIENE,169,222,797,807,1604
SAINT-LOUIS,PODOR,PODOR,PODOR,SINTHIANE,364,439,1833,1633,3466
SAINT-LOUIS,PODOR,PODOR,PODOR,SOUIMA,122,132,670,688,1358
SAINT-LOUIS,PODOR,PODOR,PODOR,THIOFFY,176,201,818,947,1765
SAINT-LOUIS,PODOR,NDIOUM,NDIOUM,"DAROU SALAM",139,191,1191,955,2146
SAINT-LOUIS,PODOR,NDIOUM,NDIOUM,DIEDHIOUBA,196,213,935,913,1848
SAINT-LOUIS,PODOR,NDIOUM,NDIOUM,"MEDINA NIANGA",122,141,668,572,1240
SAINT-LOUIS,PODOR,NDIOUM,NDIOUM,"NDIOUM DIERY",82,106,606,561,1167
SAINT-LOUIS,PODOR,NDIOUM,NDIOUM,"NDIOUM WALO",139,180,979,1010,1989
SAINT-LOUIS,PODOR,NDIOUM,NDIOUM,"OULAD BERY",294,351,1910,1700,3610
SAINT-LOUIS,PODOR,NDIOUM,NDIOUM,YAKAR,256,307,1589,1197,2786
SAINT-LOUIS,PODOR,NDIOUM,NDIOUM,BASE,125,170,877,804,1681
SAINT-LOUIS,PODOR,NDIOUM,NDIOUM,DIAMEL,122,149,857,762,1619
SAINT-LOUIS,PODOR,NDIOUM,NDIOUM,"NIANGA NDIOUM",133,225,1152,1032,2184
SAINT-LOUIS,PODOR,"CAS CAS","MADINA NDIATHBE",ARAM,172,225,1218,1158,2376
SAINT-LOUIS,PODOR,"CAS CAS","MADINA NDIATHBE","H1 DEMBA GAISSIRY SY",3,3,22,20,42
SAINT-LOUIS,PODOR,"CAS CAS","MADINA NDIATHBE","H2 DEMBA WASSA",32,38,256,223,479
SAINT-LOUIS,PODOR,"CAS CAS","MADINA NDIATHBE","BAWAMY (BAWAMY SAFALBE)",8,16,66,67,133
SAINT-LOUIS,PODOR,"CAS CAS","MADINA NDIATHBE","H1 DAKA",11,13,53,65,118
SAINT-LOUIS,PODOR,"CAS CAS","MADINA NDIATHBE","H2 FORAGE DE BANO",16,37,86,98,184
SAINT-LOUIS,PODOR,"CAS CAS","MADINA NDIATHBE","H3 WOBA",13,18,75,74,149
SAINT-LOUIS,PODOR,"CAS CAS","MADINA NDIATHBE","H4 LATOL",46,97,373,401,774
SAINT-LOUIS,PODOR,"CAS CAS","MADINA NDIATHBE","H5 LAO LAO TOROBES",11,15,57,57,114
SAINT-LOUIS,PODOR,"CAS CAS","MADINA NDIATHBE","H6 LAO LAO YOUF YOUF",16,21,121,112,233
SAINT-LOUIS,PODOR,"CAS CAS","MADINA NDIATHBE","H7 RINGANDE",6,7,34,38,72
SAINT-LOUIS,PODOR,"CAS CAS","MADINA NDIATHBE","H8 WENDO SADIO",24,35,124,143,267
SAINT-LOUIS,PODOR,"CAS CAS","MADINA NDIATHBE","H9 THIENGUELONE",28,48,196,214,410
SAINT-LOUIS,PODOR,"CAS CAS","MADINA NDIATHBE","H10 BELI BIRAME II",10,17,72,64,136
SAINT-LOUIS,PODOR,"CAS CAS","MADINA NDIATHBE","H11 RINGANDE SAMBA NGOUNO",24,55,195,152,347
SAINT-LOUIS,PODOR,"CAS CAS","MADINA NDIATHBE","H12 WOURO BOUYA",8,19,53,40,93
SAINT-LOUIS,PODOR,"CAS CAS","MADINA NDIATHBE","H13 OURO BOLOL",12,20,89,98,187
SAINT-LOUIS,PODOR,"CAS CAS","MADINA NDIATHBE","H14 LOUMBOL GOPADO",19,47,141,153,294
SAINT-LOUIS,PODOR,"CAS CAS","MADINA NDIATHBE","H15 OURO OUMAR DIERI BA",11,14,40,36,76
SAINT-LOUIS,PODOR,"CAS CAS","MADINA NDIATHBE","H16 LAO LOA WOURO OUSMANE",4,4,13,21,34
SAINT-LOUIS,PODOR,"CAS CAS","MADINA NDIATHBE","H17 GASSEL",9,20,118,107,225
SAINT-LOUIS,PODOR,"CAS CAS","MADINA NDIATHBE","H18 BELA BOUNABE",13,20,69,70,139
SAINT-LOUIS,PODOR,"CAS CAS","MADINA NDIATHBE",CAS-CAS,367,480,2796,2376,5172
SAINT-LOUIS,PODOR,"CAS CAS","MADINA NDIATHBE","H1 WOURO WOUNO",31,44,195,168,363
SAINT-LOUIS,PODOR,"CAS CAS","MADINA NDIATHBE","H2 WELDE BEYE",12,17,86,94,180
SAINT-LOUIS,PODOR,"CAS CAS","MADINA NDIATHBE","H3 TOULEL BOWDY",3,8,33,39,72
SAINT-LOUIS,PODOR,"CAS CAS","MADINA NDIATHBE","DOGUI DOMBY",62,68,217,313,530
SAINT-LOUIS,PODOR,"CAS CAS","MADINA NDIATHBE","H1 DIAMEL DIOBBE",33,35,137,150,287
SAINT-LOUIS,PODOR,"CAS CAS","MADINA NDIATHBE",DOUNGUEL,166,203,901,866,1767
SAINT-LOUIS,PODOR,"CAS CAS","MADINA NDIATHBE","H1 BOLELE BEY",7,18,74,87,161
SAINT-LOUIS,PODOR,"CAS CAS","MADINA NDIATHBE","H2 PELOL",7,10,64,50,114
SAINT-LOUIS,PODOR,"CAS CAS","MADINA NDIATHBE","H3 WOURO SARA",6,7,28,43,71
SAINT-LOUIS,PODOR,"CAS CAS","MADINA NDIATHBE","H4 PELOL",5,10,40,41,81
SAINT-LOUIS,PODOR,"CAS CAS","MADINA NDIATHBE","HOUDIABE (DOUNGUEL DADO)",50,87,304,335,639
SAINT-LOUIS,PODOR,"CAS CAS","MADINA NDIATHBE","H1 LANAROU",4,6,28,35,63
SAINT-LOUIS,PODOR,"CAS CAS","MADINA NDIATHBE","H2 WAWAW",75,168,562,544,1106
SAINT-LOUIS,PODOR,"CAS CAS","MADINA NDIATHBE","H3 KAWOBE",13,41,136,133,269
SAINT-LOUIS,PODOR,"CAS CAS","MADINA NDIATHBE","H4 OURO THIERNO DEMBA BARRY",7,15,46,48,94
SAINT-LOUIS,PODOR,"CAS CAS","MADINA NDIATHBE","H5 TELMADOU",9,14,35,33,68
SAINT-LOUIS,PODOR,"CAS CAS","MADINA NDIATHBE","H6 WOURO ADAMA DIA",1,2,18,21,39
SAINT-LOUIS,PODOR,"CAS CAS","MADINA NDIATHBE",KENENE,34,55,234,234,468
SAINT-LOUIS,PODOR,"CAS CAS","MADINA NDIATHBE","H1 PALE KENENE",6,6,30,22,52
SAINT-LOUIS,PODOR,"CAS CAS","MADINA NDIATHBE","H2 BALEL FRESBE",6,9,61,59,120
SAINT-LOUIS,PODOR,"CAS CAS","MADINA NDIATHBE","H3 OUSTI YOLDE",5,5,34,38,72
SAINT-LOUIS,PODOR,"CAS CAS","MADINA NDIATHBE","H4 WOURO DIALTABE",5,11,48,58,106
SAINT-LOUIS,PODOR,"CAS CAS","MADINA NDIATHBE","H5 MBAKHE",15,22,99,100,199
SAINT-LOUIS,PODOR,"CAS CAS","MADINA NDIATHBE","H6 OUSTI YOLDE",2,2,17,9,26
SAINT-LOUIS,PODOR,"CAS CAS","MADINA NDIATHBE","MEDINA NDIATHBE",431,558,2809,2790,5599
SAINT-LOUIS,PODOR,"CAS CAS","MADINA NDIATHBE","H1 SOLOR DE MADINA NDIATHBE",20,28,99,127,226
SAINT-LOUIS,PODOR,"CAS CAS","MADINA NDIATHBE","NANOYE PEULH (AIERE GAWDI)",7,20,46,38,84
SAINT-LOUIS,PODOR,"CAS CAS","MADINA NDIATHBE","H1 LOUMBOUL SIWRI",10,13,51,53,104
SAINT-LOUIS,PODOR,"CAS CAS","MADINA NDIATHBE","H2 BILIWILY",11,20,87,76,163
SAINT-LOUIS,PODOR,"CAS CAS","MADINA NDIATHBE","OLOL DIAOBE",32,56,212,276,488
SAINT-LOUIS,PODOR,"CAS CAS","MADINA NDIATHBE","H1 AWA BENDY BA",6,8,35,30,65
SAINT-LOUIS,PODOR,"CAS CAS","MADINA NDIATHBE","H2 SINTHIANE",5,9,30,36,66
SAINT-LOUIS,PODOR,"CAS CAS","MADINA NDIATHBE","H3 ARAM DIERY",10,18,88,93,181
SAINT-LOUIS,PODOR,"CAS CAS","MADINA NDIATHBE","H4 BELI BIROME",5,13,59,32,91
SAINT-LOUIS,PODOR,"CAS CAS","MADINA NDIATHBE","SARE SOUKI",34,48,225,266,491
SAINT-LOUIS,PODOR,"CAS CAS","MADINA NDIATHBE","H1 TOULDE THILLA",16,20,86,93,179
SAINT-LOUIS,PODOR,"CAS CAS","MADINA NDIATHBE","H2 DIAWELE",5,5,33,31,64
SAINT-LOUIS,PODOR,"CAS CAS","MADINA NDIATHBE","H3 TOULDE THILLA 2",30,41,192,150,342
SAINT-LOUIS,PODOR,"CAS CAS","MADINA NDIATHBE","SIOURE THIAMBE",102,141,790,808,1598
SAINT-LOUIS,PODOR,"CAS CAS","MADINA NDIATHBE","H1 GUIROU",61,82,454,409,863
SAINT-LOUIS,PODOR,"CAS CAS","MADINA NDIATHBE","SOUBALO MEDINA",87,106,654,628,1282
SAINT-LOUIS,PODOR,"CAS CAS","MADINA NDIATHBE",TAKOYEL,73,111,409,354,763
SAINT-LOUIS,PODOR,"CAS CAS","MADINA NDIATHBE","H1 BODO DE TAKOYEL",6,8,39,43,82
SAINT-LOUIS,PODOR,"CAS CAS","MADINA NDIATHBE","H2 MBOURLOGNE DE TAKOYEL",12,15,96,66,162
SAINT-LOUIS,PODOR,"CAS CAS","MADINA NDIATHBE","WENDOU BOKI (TANGO)",11,20,85,77,162
SAINT-LOUIS,PODOR,"CAS CAS","MADINA NDIATHBE","H1 DIOLOLE",28,36,134,154,288
SAINT-LOUIS,PODOR,"CAS CAS","MADINA NDIATHBE","H2 BELI BAMWAMY",11,25,102,83,185
SAINT-LOUIS,PODOR,"CAS CAS","MADINA NDIATHBE","H3 BINGUEL BOLO",46,71,247,280,527
SAINT-LOUIS,PODOR,"CAS CAS","MADINA NDIATHBE","H4 GNOURKADIE",37,82,300,299,599
SAINT-LOUIS,PODOR,"CAS CAS","MADINA NDIATHBE","H5 MAHAM DIAOBES",14,28,105,120,225
SAINT-LOUIS,PODOR,"CAS CAS","MADINA NDIATHBE","H6 MAHAM MABOUBES",23,35,175,189,364
SAINT-LOUIS,PODOR,"CAS CAS","MADINA NDIATHBE","H7 LEMKAR",5,21,45,51,96
SAINT-LOUIS,PODOR,"CAS CAS","MADINA NDIATHBE","H8 AERE WANDE",3,16,31,38,69
SAINT-LOUIS,PODOR,"CAS CAS","MADINA NDIATHBE","H9 FORAGE AERE BOULBE",27,44,187,157,344
SAINT-LOUIS,PODOR,"CAS CAS","MADINA NDIATHBE","H10 LOUMBEL THIAFADJI",12,19,99,112,211
SAINT-LOUIS,PODOR,"CAS CAS","MADINA NDIATHBE","H11 MAHAM",5,20,57,46,103
SAINT-LOUIS,PODOR,"CAS CAS","MADINA NDIATHBE","H12 MAHAM",5,14,25,33,58
SAINT-LOUIS,PODOR,"CAS CAS","MADINA NDIATHBE","H13 OUSSOUYOLDE SAMBOUDI",6,8,32,33,65
SAINT-LOUIS,PODOR,"CAS CAS","MADINA NDIATHBE","H14 RINGANE SIRENABE",15,24,113,119,232
SAINT-LOUIS,PODOR,"CAS CAS","MADINA NDIATHBE","H15 BRAYKATY",9,14,69,58,127
SAINT-LOUIS,PODOR,"CAS CAS","MADINA NDIATHBE","H16 BELY WELI BOUNABE",32,54,212,241,453
SAINT-LOUIS,PODOR,"CAS CAS","MADINA NDIATHBE","H17 LAO LAO SIRENABE",19,29,102,112,214
SAINT-LOUIS,PODOR,"CAS CAS","MADINA NDIATHBE","H18 BADIOL",24,30,137,129,266
SAINT-LOUIS,PODOR,"CAS CAS","MADINA NDIATHBE","YALALBE (BARHGOL)",40,86,161,164,325
SAINT-LOUIS,PODOR,"CAS CAS","MADINA NDIATHBE","H1 GANKI BARANGHOL",9,13,58,54,112
SAINT-LOUIS,PODOR,"CAS CAS","MADINA NDIATHBE","H2 PONGUEL BOYE",6,13,45,21,66
SAINT-LOUIS,PODOR,"CAS CAS","MADINA NDIATHBE","H3 HOTIERE",8,18,91,70,161
SAINT-LOUIS,PODOR,"CAS CAS","MADINA NDIATHBE","H4 HOLOUDOU",7,10,90,49,139
SAINT-LOUIS,PODOR,"CAS CAS","MADINA NDIATHBE","H5 OURO SAIDOU",1,2,5,9,14
SAINT-LOUIS,PODOR,"CAS CAS","MADINA NDIATHBE","H6 LOUGUEL",9,13,89,86,175
SAINT-LOUIS,PODOR,"CAS CAS","MADINA NDIATHBE","YOUF-YOUF TOGANE",22,28,109,121,230
SAINT-LOUIS,PODOR,"CAS CAS","MADINA NDIATHBE","H1 OURO THIAO",4,6,24,29,53
SAINT-LOUIS,PODOR,"CAS CAS","MADINA NDIATHBE","H2 CROISEMENT BELLY COILY",13,22,79,97,176
SAINT-LOUIS,PODOR,"CAS CAS","MADINA NDIATHBE","H3 OURO SAMBA KADIATA",17,18,123,87,210
SAINT-LOUIS,PODOR,"CAS CAS","MADINA NDIATHBE","H4 LANAROU AMADOU MIKA",4,5,32,27,59
SAINT-LOUIS,PODOR,"CAS CAS","MADINA NDIATHBE","H5 TOGANE YOUF YOUF",6,8,38,44,82
SAINT-LOUIS,PODOR,"CAS CAS","MADINA NDIATHBE","TOGANE YOUF YOUF",13,20,66,101,167
SAINT-LOUIS,PODOR,"CAS CAS","MADINA NDIATHBE","DIAMY GALA",49,65,236,250,486
SAINT-LOUIS,PODOR,"CAS CAS","MADINA NDIATHBE","H1 AERE THINGUI",9,26,50,58,108
SAINT-LOUIS,PODOR,"CAS CAS","MADINA NDIATHBE","H1 PARANGAL",15,22,98,117,215
SAINT-LOUIS,PODOR,"CAS CAS","MADINA NDIATHBE","H2 AERE WANDE",3,6,9,12,21
SAINT-LOUIS,PODOR,"CAS CAS","MADINA NDIATHBE","H3 BELI BIRAMA III (WOURO BOUBOU)",9,15,32,40,72
SAINT-LOUIS,PODOR,"CAS CAS","MADINA NDIATHBE","H4 LOUGUI THIANK",3,7,26,28,54
SAINT-LOUIS,PODOR,"CAS CAS","MADINA NDIATHBE","H5 NIOR KADE",3,4,17,13,30
SAINT-LOUIS,PODOR,"CAS CAS","MADINA NDIATHBE","H6 SIMBIRI 2 DE BANO",34,47,226,217,443
SAINT-LOUIS,PODOR,"CAS CAS","MADINA NDIATHBE","H7 WOURO BALI",1,2,8,8,16
SAINT-LOUIS,PODOR,"CAS CAS","MADINA NDIATHBE","H8 WOURO GORY",10,11,39,48,87
SAINT-LOUIS,PODOR,"CAS CAS","MADINA NDIATHBE","H9 WOURO LELE",4,9,35,31,66
SAINT-LOUIS,PODOR,"CAS CAS","MADINA NDIATHBE","H10 WOURO MOUSSA",4,5,18,17,35
SAINT-LOUIS,PODOR,"CAS CAS","MADINA NDIATHBE","H11 WOURO SILY",10,17,51,60,111
SAINT-LOUIS,PODOR,"CAS CAS","MADINA NDIATHBE","WAWAW (UNE PARTIE IN 09)",9,13,76,73,149
SAINT-LOUIS,PODOR,"CAS CAS","MADINA NDIATHBE",KELLELY,12,13,65,67,132
SAINT-LOUIS,PODOR,"CAS CAS","MADINA NDIATHBE",LOUGKADJI,5,8,33,23,56
SAINT-LOUIS,PODOR,"CAS CAS","MADINA NDIATHBE","GONKOL SAFALBE",18,96,447,425,872
SAINT-LOUIS,PODOR,"CAS CAS","MADINA NDIATHBE","WOURO KOYLEL",4,4,22,21,43
SAINT-LOUIS,PODOR,"CAS CAS","MADINA NDIATHBE","WOURO MBOYLELE",7,7,20,24,44
SAINT-LOUIS,PODOR,"CAS CAS","DOUMGA LAO","AERO POSTE",46,80,416,384,800
SAINT-LOUIS,PODOR,"CAS CAS","DOUMGA LAO","H1 WAYO",2,2,15,15,30
SAINT-LOUIS,PODOR,"CAS CAS","DOUMGA LAO","H2 NDOME",13,20,99,111,210
SAINT-LOUIS,PODOR,"CAS CAS","DOUMGA LAO","H4 NGABA",4,8,29,33,62
SAINT-LOUIS,PODOR,"CAS CAS","DOUMGA LAO","H5AERE POSTE (WAYO)",7,8,38,47,85
SAINT-LOUIS,PODOR,"CAS CAS","DOUMGA LAO",H6MBARALOU,2,2,15,7,22
SAINT-LOUIS,PODOR,"CAS CAS","DOUMGA LAO","AWQUALY (THIEWEL)",79,115,554,608,1162
SAINT-LOUIS,PODOR,"CAS CAS","DOUMGA LAO","H1 NDICKA",11,18,99,84,183
SAINT-LOUIS,PODOR,"CAS CAS","DOUMGA LAO","H2 KAOUEL",6,24,83,76,159
SAINT-LOUIS,PODOR,"CAS CAS","DOUMGA LAO","H3 MBARALOU",14,31,109,124,233
SAINT-LOUIS,PODOR,"CAS CAS","DOUMGA LAO","H4 FELMADE",8,16,68,73,141
SAINT-LOUIS,PODOR,"CAS CAS","DOUMGA LAO","H5 DIABALA",4,11,46,55,101
SAINT-LOUIS,PODOR,"CAS CAS","DOUMGA LAO","H6 DIAM KANI",21,36,163,190,353
SAINT-LOUIS,PODOR,"CAS CAS","DOUMGA LAO","H7 BOGUERE",43,81,294,341,635
SAINT-LOUIS,PODOR,"CAS CAS","DOUMGA LAO","H8 LOUMBOL",18,28,129,135,264
SAINT-LOUIS,PODOR,"CAS CAS","DOUMGA LAO","H9 DOUNGAL",3,3,16,8,24
SAINT-LOUIS,PODOR,"CAS CAS","DOUMGA LAO","H10 BOULY BOGUERÉ",6,8,21,26,47
SAINT-LOUIS,PODOR,"CAS CAS","DOUMGA LAO","H11 WOURO GAYADO SAMBA KHOURO",15,30,118,116,234
SAINT-LOUIS,PODOR,"CAS CAS","DOUMGA LAO","H12 NDJICKA (NDOUFFE)",6,17,63,65,128
SAINT-LOUIS,PODOR,"CAS CAS","DOUMGA LAO",BOKI,147,189,1236,1107,2343
SAINT-LOUIS,PODOR,"CAS CAS","DOUMGA LAO","H1 WOUSSALANG",32,46,339,336,675
SAINT-LOUIS,PODOR,"CAS CAS","DOUMGA LAO","H2 LEWE NGAYE",22,31,133,119,252
SAINT-LOUIS,PODOR,"CAS CAS","DOUMGA LAO","H3 ALWAR BOKI",7,7,51,37,88
SAINT-LOUIS,PODOR,"CAS CAS","DOUMGA LAO","H4 TOULDE DIAOBE (PALE BORNDE)",7,9,58,54,112
SAINT-LOUIS,PODOR,"CAS CAS","DOUMGA LAO","H5 TOULDE DIAOBE (THIWA)",8,14,76,62,138
SAINT-LOUIS,PODOR,"CAS CAS","DOUMGA LAO","H6 TOULDE ROUBOUNDE (PALAIS DIABAL)",5,5,36,30,66
SAINT-LOUIS,PODOR,"CAS CAS","DOUMGA LAO","H7 TOULDE ROUBOUNDE (PALAIS GANGUEL)",8,8,31,43,74
SAINT-LOUIS,PODOR,"CAS CAS","DOUMGA LAO","H8 DAROU SALAM BOKI",16,18,96,85,181
SAINT-LOUIS,PODOR,"CAS CAS","DOUMGA LAO","H9 THIOFFY",10,15,66,45,111
SAINT-LOUIS,PODOR,"CAS CAS","DOUMGA LAO","DIOUTH MELEL",24,116,185,201,386
SAINT-LOUIS,PODOR,"CAS CAS","DOUMGA LAO","H1 NDOKMAMI",27,58,220,241,461
SAINT-LOUIS,PODOR,"CAS CAS","DOUMGA LAO","H2 DIOUTH",14,25,117,112,229
SAINT-LOUIS,PODOR,"CAS CAS","DOUMGA LAO","H3 LOUGUERE DIABE",29,49,233,244,477
SAINT-LOUIS,PODOR,"CAS CAS","DOUMGA LAO","H4 ASRE",10,42,71,71,142
SAINT-LOUIS,PODOR,"CAS CAS","DOUMGA LAO","H5 LOUMBOL KODIOLELE",7,9,43,45,88
SAINT-LOUIS,PODOR,"CAS CAS","DOUMGA LAO","H6 BOULBONE",38,60,230,240,470
SAINT-LOUIS,PODOR,"CAS CAS","DOUMGA LAO","H7 LELO",11,66,67,97,164
SAINT-LOUIS,PODOR,"CAS CAS","DOUMGA LAO","H8 BOW BOW",14,37,146,113,259
SAINT-LOUIS,PODOR,"CAS CAS","DOUMGA LAO","H9 KODIOLI",7,13,28,41,69
SAINT-LOUIS,PODOR,"CAS CAS","DOUMGA LAO","H10 NGINTEME",9,19,93,97,190
SAINT-LOUIS,PODOR,"CAS CAS","DOUMGA LAO","H11 DIAKEL OURO WAYLOUBE",13,15,47,66,113
SAINT-LOUIS,PODOR,"CAS CAS","DOUMGA LAO","H12 OURO ADAMEL",3,11,49,51,100
SAINT-LOUIS,PODOR,"CAS CAS","DOUMGA LAO","H13 LOUMBOL DIALLO",14,36,139,122,261
SAINT-LOUIS,PODOR,"CAS CAS","DOUMGA LAO","H14 PATOUDE",14,21,57,83,140
SAINT-LOUIS,PODOR,"CAS CAS","DOUMGA LAO","H15 PETTEL AOUGADY",14,20,94,100,194
SAINT-LOUIS,PODOR,"CAS CAS","DOUMGA LAO","H16 LOTHIE GOPADJ",11,50,77,80,157
SAINT-LOUIS,PODOR,"CAS CAS","DOUMGA LAO","H17 LOUMBOUL DIAMI",21,41,183,185,368
SAINT-LOUIS,PODOR,"CAS CAS","DOUMGA LAO","H18 DIAKHEL WOURO SÉNO",13,58,68,76,144
SAINT-LOUIS,PODOR,"CAS CAS","DOUMGA LAO","DOUMGA LAO",137,178,811,931,1742
SAINT-LOUIS,PODOR,"CAS CAS","DOUMGA LAO","H1 DOUMGA DIAWANDOU",40,68,245,274,519
SAINT-LOUIS,PODOR,"CAS CAS","DOUMGA LAO","H2 WANDE DIERY",9,12,51,53,104
SAINT-LOUIS,PODOR,"CAS CAS","DOUMGA LAO","H3 OUDALAYE",41,65,148,224,372
SAINT-LOUIS,PODOR,"CAS CAS","DOUMGA LAO","H4 LOUMBOL DELBY",4,7,39,29,68
SAINT-LOUIS,PODOR,"CAS CAS","DOUMGA LAO","H5 DIAYNGA DIERY",6,12,48,64,112
SAINT-LOUIS,PODOR,"CAS CAS","DOUMGA LAO","H6 LOUMBOL DORO",9,22,68,98,166
SAINT-LOUIS,PODOR,"CAS CAS","DOUMGA LAO","H7 THIWDE OURO YORO SIDY",7,19,58,65,123
SAINT-LOUIS,PODOR,"CAS CAS","DOUMGA LAO",IDA,13,20,83,86,169
SAINT-LOUIS,PODOR,"CAS CAS","DOUMGA LAO","H1 KOYLI NDIAYE",13,20,90,102,192
SAINT-LOUIS,PODOR,"CAS CAS","DOUMGA LAO","H2 KARE BODEDIO",10,22,60,72,132
SAINT-LOUIS,PODOR,"CAS CAS","DOUMGA LAO","H3 DIALOUNGAL",31,51,190,197,387
SAINT-LOUIS,PODOR,"CAS CAS","DOUMGA LAO","H4 GUENOL",14,26,94,81,175
SAINT-LOUIS,PODOR,"CAS CAS","DOUMGA LAO","H5 GOUREL BRAHIM",7,9,39,58,97
SAINT-LOUIS,PODOR,"CAS CAS","DOUMGA LAO","H6 BADIAL",21,35,167,154,321
SAINT-LOUIS,PODOR,"CAS CAS","DOUMGA LAO","H7 POEDJI",21,29,132,119,251
SAINT-LOUIS,PODOR,"CAS CAS","DOUMGA LAO","H8 LOUFERBE",33,59,248,258,506
SAINT-LOUIS,PODOR,"CAS CAS","DOUMGA LAO","H9 ALANA",10,31,139,122,261
SAINT-LOUIS,PODOR,"CAS CAS","DOUMGA LAO","H10 BINGUEL TOROBE",5,7,34,44,78
SAINT-LOUIS,PODOR,"CAS CAS","DOUMGA LAO","H11 PETEL OUROUBE",10,14,68,71,139
SAINT-LOUIS,PODOR,"CAS CAS","DOUMGA LAO","H12 WOURO SILEYE",17,20,87,90,177
SAINT-LOUIS,PODOR,"CAS CAS","DOUMGA LAO","H13 GNEROUKI",3,4,20,23,43
SAINT-LOUIS,PODOR,"CAS CAS","DOUMGA LAO","H14 BEMBA AWQUALY",22,32,141,163,304
SAINT-LOUIS,PODOR,"CAS CAS","DOUMGA LAO","H15 BELY DIABY",17,25,120,95,215
SAINT-LOUIS,PODOR,"CAS CAS","DOUMGA LAO","H16 SINTHIANG AERE",24,28,143,162,305
SAINT-LOUIS,PODOR,"CAS CAS","DOUMGA LAO","H17 TOULDE DIAOBE (GANGUEL)",15,29,151,160,311
SAINT-LOUIS,PODOR,"CAS CAS","DOUMGA LAO",KOGGA,58,96,437,428,865
SAINT-LOUIS,PODOR,"CAS CAS","DOUMGA LAO","H1 KOGGA DIERY FULBE",8,11,41,68,109
SAINT-LOUIS,PODOR,"CAS CAS","DOUMGA LAO","H2 KOGGA DIERI",32,45,169,203,372
SAINT-LOUIS,PODOR,"CAS CAS","DOUMGA LAO","H3 SINTHIOU PENAKA",60,79,369,410,779
SAINT-LOUIS,PODOR,"CAS CAS","DOUMGA LAO",KOYLEL,51,99,504,536,1040
SAINT-LOUIS,PODOR,"CAS CAS","DOUMGA LAO","H1 BALEROU KOYLEL",3,10,57,51,108
SAINT-LOUIS,PODOR,"CAS CAS","DOUMGA LAO","H2 WOURO KALIDOU ALPHA",5,8,31,38,69
SAINT-LOUIS,PODOR,"CAS CAS","DOUMGA LAO","MABOUBE DIAOBE",12,14,68,80,148
SAINT-LOUIS,PODOR,"CAS CAS","DOUMGA LAO","H1 TOURGUENOL (H3 FOURGUENOL)",39,51,287,300,587
SAINT-LOUIS,PODOR,"CAS CAS","DOUMGA LAO","NDIAYNGA SOUBALO",115,179,868,983,1851
SAINT-LOUIS,PODOR,"CAS CAS","DOUMGA LAO","H1 CELE NDIAYNGA",29,49,247,251,498
SAINT-LOUIS,PODOR,"CAS CAS","DOUMGA LAO","OULD MBOYRICK (MBELCOUM)",16,26,110,111,221
SAINT-LOUIS,PODOR,"CAS CAS","DOUMGA LAO","H1 OURO SAMBA THIELOL DIA",23,58,232,223,455
SAINT-LOUIS,PODOR,"CAS CAS","DOUMGA LAO","H2 LAMBI FOUTOU",16,44,108,128,236
SAINT-LOUIS,PODOR,"CAS CAS","DOUMGA LAO","H3 GUINTOU THIELE",14,33,106,124,230
SAINT-LOUIS,PODOR,"CAS CAS","DOUMGA LAO","H4 GAZELLE",20,38,157,168,325
SAINT-LOUIS,PODOR,"CAS CAS","DOUMGA LAO","H5 REDINGO",4,4,16,13,29
SAINT-LOUIS,PODOR,"CAS CAS","DOUMGA LAO","H6 YARE LAO",131,187,651,769,1420
SAINT-LOUIS,PODOR,"CAS CAS","DOUMGA LAO","H7 GUINTOU AMADOU YERO MATEL SOW",9,16,55,64,119
SAINT-LOUIS,PODOR,"CAS CAS","DOUMGA LAO","H8 BINGAL COBY",2,8,25,31,56
SAINT-LOUIS,PODOR,"CAS CAS","DOUMGA LAO","H9 GONKOL GAOUDY",7,17,60,64,124
SAINT-LOUIS,PODOR,"CAS CAS","DOUMGA LAO","H10 LOUMBAL MBATMA",28,76,269,256,525
SAINT-LOUIS,PODOR,"CAS CAS","DOUMGA LAO","H11 RENDO",25,43,160,171,331
SAINT-LOUIS,PODOR,"CAS CAS","DOUMGA LAO","H12 SOUDOU OUTOUROU",21,44,145,173,318
SAINT-LOUIS,PODOR,"CAS CAS","DOUMGA LAO","H13 LOUMBOL THILLE",12,22,66,55,121
SAINT-LOUIS,PODOR,"CAS CAS","DOUMGA LAO","H14 BAGADOBE",13,29,77,109,186
SAINT-LOUIS,PODOR,"CAS CAS","DOUMGA LAO","H15 WOURO DEMBA NGADIO",25,73,175,192,367
SAINT-LOUIS,PODOR,"CAS CAS","DOUMGA LAO","H16 OURMA",8,12,49,53,102
SAINT-LOUIS,PODOR,"CAS CAS","DOUMGA LAO","H17 GUINTOU WAMBABE",5,16,56,58,114
SAINT-LOUIS,PODOR,"CAS CAS","DOUMGA LAO","H18 GAZELLE OURO SAMBA THIELO DIA",16,34,133,157,290
SAINT-LOUIS,PODOR,"CAS CAS","DOUMGA LAO","H19 DIAKHEL",8,20,44,45,89
SAINT-LOUIS,PODOR,"CAS CAS","DOUMGA LAO","H20 RENDO",6,7,19,26,45
SAINT-LOUIS,PODOR,"CAS CAS","DOUMGA LAO","H21 BOKKI TOUDOUNDE",25,57,253,266,519
SAINT-LOUIS,PODOR,"CAS CAS","DOUMGA LAO",SYWALBE,17,25,113,125,238
SAINT-LOUIS,PODOR,"CAS CAS","DOUMGA LAO","H1 OURO BELLOUI",21,34,157,154,311
SAINT-LOUIS,PODOR,"CAS CAS","DOUMGA LAO","H2 NOUFLE",14,31,92,109,201
SAINT-LOUIS,PODOR,"CAS CAS","DOUMGA LAO","H3 DIAYNGA DIERY",4,6,28,26,54
SAINT-LOUIS,PODOR,"CAS CAS","DOUMGA LAO","H4 WENDOU MBODJ",9,17,76,70,146
SAINT-LOUIS,PODOR,"CAS CAS","DOUMGA LAO","H5 WOURO THIERNO MAMADOU IBRAHIMA DIOP",11,20,89,99,188
SAINT-LOUIS,PODOR,"CAS CAS","DOUMGA LAO","H6 WOURO SOUSKA",34,61,347,308,655
SAINT-LOUIS,PODOR,"CAS CAS","DOUMGA LAO",WANDE,51,71,324,385,709
SAINT-LOUIS,PODOR,"CAS CAS","DOUMGA LAO","H1 THIASKY WANDE",18,28,171,181,352
SAINT-LOUIS,PODOR,"CAS CAS","DOUMGA LAO",WORDE,39,70,399,372,771
SAINT-LOUIS,PODOR,"CAS CAS","DOUMGA LAO","H1 DIAGA",47,82,322,385,707
SAINT-LOUIS,PODOR,"CAS CAS","DOUMGA LAO","H2 GODILE",25,44,208,229,437
SAINT-LOUIS,PODOR,"CAS CAS","DOUMGA LAO","H3 CROISEMENT DIAGA",71,106,493,647,1140
SAINT-LOUIS,PODOR,"CAS CAS","DOUMGA LAO","H4 WALIDIALA",8,21,98,97,195
SAINT-LOUIS,PODOR,"CAS CAS","DOUMGA LAO","WOURO ARDO",12,15,71,70,141
SAINT-LOUIS,PODOR,"CAS CAS","DOUMGA LAO","H1 GOUREL TIBADJI",9,12,40,44,84
SAINT-LOUIS,PODOR,"CAS CAS","DOUMGA LAO","H2 TABOUGHO",14,32,127,124,251
SAINT-LOUIS,PODOR,"CAS CAS","DOUMGA LAO","H3 SAMBA GOULLO",15,22,104,91,195
SAINT-LOUIS,PODOR,"CAS CAS","DOUMGA LAO","FETERE DIEME (WOURO EL HADJI SAMBA)",6,7,20,22,42
SAINT-LOUIS,PODOR,"CAS CAS","DOUMGA LAO","H1 TOULDE ROUBOUNDÉ LAO",25,34,171,164,335
SAINT-LOUIS,PODOR,"CAS CAS","DOUMGA LAO","FORAGE DE KORE",12,25,97,115,212
SAINT-LOUIS,PODOR,"CAS CAS","DOUMGA LAO","KORE II",14,38,140,157,297
SAINT-LOUIS,PODOR,"CAS CAS","DOUMGA LAO",DJOUBA,5,14,56,64,120
SAINT-LOUIS,PODOR,"CAS CAS","DOUMGA LAO",BOBORY,17,39,139,147,286
SAINT-LOUIS,PODOR,"CAS CAS","DOUMGA LAO","THILLI BABACAR",44,58,391,335,726
SAINT-LOUIS,PODOR,"CAS CAS","DOUMGA LAO","H1 WINDE HERY",11,14,100,70,170
SAINT-LOUIS,PODOR,"CAS CAS","DOUMGA LAO","H2 BARKEDJI HOUDIABE",18,50,223,183,406
SAINT-LOUIS,PODOR,"CAS CAS","DOUMGA LAO","H3 DIAMI DARTE (DARTO ABOU BA)",7,8,95,76,171
SAINT-LOUIS,PODOR,"CAS CAS","DOUMGA LAO","H4 KOKHA & FETHI",15,24,130,135,265
SAINT-LOUIS,PODOR,"CAS CAS","DOUMGA LAO","H5 BARKEDJI SIWALDE",25,49,225,213,438
SAINT-LOUIS,PODOR,"CAS CAS","DOUMGA LAO",KAWEL,10,18,57,69,126
SAINT-LOUIS,PODOR,"CAS CAS",MERY,ABDALLAH,105,135,708,657,1365
SAINT-LOUIS,PODOR,"CAS CAS",MERY,BITTO,64,68,331,393,724
SAINT-LOUIS,PODOR,"CAS CAS",MERY,"DIAOBE MBOUMBA",88,131,735,683,1418
SAINT-LOUIS,PODOR,"CAS CAS",MERY,"H1 WOURO NDOUDO",8,9,42,37,79
SAINT-LOUIS,PODOR,"CAS CAS",MERY,"H2 LOUGUERE NGARY",6,7,57,57,114
SAINT-LOUIS,PODOR,"CAS CAS",MERY,"H3 WOURO ARDO",9,16,75,78,153
SAINT-LOUIS,PODOR,"CAS CAS",MERY,"DIOUDE DIABE",230,282,1493,1311,2804
SAINT-LOUIS,PODOR,"CAS CAS",MERY,"FODE ELIMANE",69,86,397,363,760
SAINT-LOUIS,PODOR,"CAS CAS",MERY,"FONDE GANDE",86,112,460,531,991
SAINT-LOUIS,PODOR,"CAS CAS",MERY,"H1 GOUREL MOUROU",1,1,3,2,5
SAINT-LOUIS,PODOR,"CAS CAS",MERY,MERY,253,358,1745,1678,3423
SAINT-LOUIS,PODOR,"CAS CAS",MERY,"H1 WOURO DIGNE",4,8,43,29,72
SAINT-LOUIS,PODOR,"CAS CAS",MERY,"NDIOUGANABE MERY",76,92,412,407,819
SAINT-LOUIS,PODOR,"CAS CAS",MERY,"H1 THIORCKA",50,65,256,262,518
SAINT-LOUIS,PODOR,"CAS CAS",MERY,"NDIOUNGANABE PEULH (BOKI TEKOUM)",18,32,154,123,277
SAINT-LOUIS,PODOR,"CAS CAS",MERY,"H1 BOKI GAYELE",16,24,110,86,196
SAINT-LOUIS,PODOR,"CAS CAS",MERY,"H2 LOUMBI",71,89,338,356,694
SAINT-LOUIS,PODOR,"CAS CAS",MERY,"H3 GOUREL SENO",8,15,66,79,145
SAINT-LOUIS,PODOR,"CAS CAS",MERY,"H4 BOKE GOUME NOUMA",23,31,100,150,250
SAINT-LOUIS,PODOR,"CAS CAS",MERY,"H5 LOUMBY YERO",9,24,110,95,205
SAINT-LOUIS,PODOR,"CAS CAS",MERY,"H6 WOURO SAMBA THIAPATEL",4,7,28,22,50
SAINT-LOUIS,PODOR,"CAS CAS",MERY,"NOUMA ( WOURO BAILA)",17,28,132,143,275
SAINT-LOUIS,PODOR,"CAS CAS",MERY,"H1 GOUREL ARDO",4,11,50,49,99
SAINT-LOUIS,PODOR,"CAS CAS",MERY,"H2 LEWE THIELEL",18,26,145,100,245
SAINT-LOUIS,PODOR,"CAS CAS",MERY,"OURO ALPHALY (FONDE ALI)",40,55,291,302,593
SAINT-LOUIS,PODOR,"CAS CAS",MERY,"H1 WOURO POUNGUEL",21,32,143,173,316
SAINT-LOUIS,PODOR,"CAS CAS",MERY,"H2 WENDOU GAWDI GOTY",23,28,134,136,270
SAINT-LOUIS,PODOR,"CAS CAS",MERY,"PANIPINALI (GOTI GAOUDI)",10,16,70,51,121
SAINT-LOUIS,PODOR,"CAS CAS",MERY,"H1 GOUREL TOULDE",2,9,32,34,66
SAINT-LOUIS,PODOR,"CAS CAS",MERY,"H2 GOUREL DEUW",7,13,57,53,110
SAINT-LOUIS,PODOR,"CAS CAS",MERY,"H3 NDOUMBOUL",12,13,90,92,182
SAINT-LOUIS,PODOR,"CAS CAS",MERY,"H4 BINGUEL SENO",16,21,110,107,217
SAINT-LOUIS,PODOR,"CAS CAS",MERY,"SOBALO MBOUMA",57,77,339,368,707
SAINT-LOUIS,PODOR,"CAS CAS",MERY,"H1 SAVA GANDE MERY",15,24,95,113,208
SAINT-LOUIS,PODOR,"CAS CAS",MERY,SOURAYE,69,93,373,420,793
SAINT-LOUIS,PODOR,"CAS CAS",MERY,"THIENGLE (GALOU)",19,30,159,178,337
SAINT-LOUIS,PODOR,"CAS CAS",MERY,"H1 GOUREL MIKA",2,2,12,20,32
SAINT-LOUIS,PODOR,"CAS CAS",MERY,THIOUBALEL,232,292,1372,1480,2852
SAINT-LOUIS,PODOR,"CAS CAS",MERY,MBARKI,20,25,116,130,246
SAINT-LOUIS,PODOR,"CAS CAS","AERE LAO",BAROBE,328,486,1944,2001,3945
SAINT-LOUIS,PODOR,"CAS CAS","AERE LAO",HALAYBE,104,153,773,753,1526
SAINT-LOUIS,PODOR,"CAS CAS","AERE LAO",MBAYBE,185,293,1494,1397,2891
SAINT-LOUIS,PODOR,"CAS CAS","AERE LAO",MBISSANE,323,418,2205,1969,4174
SAINT-LOUIS,PODOR,"CAS CAS","AERE LAO","OURO DIERRY",88,166,881,967,1848
SAINT-LOUIS,PODOR,"CAS CAS",GOLLERE,BARANGOL,143,258,993,1115,2108
SAINT-LOUIS,PODOR,"CAS CAS",GOLLERE,BOUSSOBE,48,103,661,649,1310
SAINT-LOUIS,PODOR,"CAS CAS",GOLLERE,DARNDE,24,53,303,264,567
SAINT-LOUIS,PODOR,"CAS CAS",GOLLERE,NAANAYE,102,147,834,706,1540
SAINT-LOUIS,PODOR,"CAS CAS",GOLLERE,NDIACKA,38,85,504,442,946
SAINT-LOUIS,PODOR,"CAS CAS",GOLLERE,SONINKE,15,33,460,193,653
SAINT-LOUIS,PODOR,"CAS CAS",MBOUMBA,HOSSIRDE,116,167,998,703,1701
SAINT-LOUIS,PODOR,"CAS CAS",MBOUMBA,NDIAYBE,57,88,336,352,688
SAINT-LOUIS,PODOR,"CAS CAS",MBOUMBA,SINTHIANE,88,103,521,414,935
SAINT-LOUIS,PODOR,"CAS CAS",MBOUMBA,THIAMBE,108,163,655,665,1320
SAINT-LOUIS,PODOR,"CAS CAS",MBOUMBA,WORGO,77,96,412,401,813
SAINT-LOUIS,PODOR,"CAS CAS",WALALDE,BELALE,53,70,410,378,788
SAINT-LOUIS,PODOR,"CAS CAS",WALALDE,BOINGUEL,52,82,407,441,848
SAINT-LOUIS,PODOR,"CAS CAS",WALALDE,"H1 PALAIS NDIENGUERE",6,16,90,76,166
SAINT-LOUIS,PODOR,"CAS CAS",WALALDE,NAWDE,36,41,214,227,441
SAINT-LOUIS,PODOR,"CAS CAS",WALALDE,SALOUBE,72,105,527,506,1033
SAINT-LOUIS,PODOR,"CAS CAS",WALALDE,BELAL,46,63,350,343,693
SAINT-LOUIS,PODOR,"CAS CAS",WALALDE,DEMBADADO,37,39,205,213,418
SAINT-LOUIS,PODOR,SALDE,"BOKE DIALLOUBE",BAROBE,110,162,750,726,1476
SAINT-LOUIS,PODOR,SALDE,"BOKE DIALLOUBE",BOBEREL,47,60,369,433,802
SAINT-LOUIS,PODOR,SALDE,"BOKE DIALLOUBE","H1 GOUREL GONDJI",11,13,60,64,124
SAINT-LOUIS,PODOR,SALDE,"BOKE DIALLOUBE","BOKE DIALLOUBE",167,238,1105,1205,2310
SAINT-LOUIS,PODOR,SALDE,"BOKE DIALLOUBE","BOKE DIEGUESSE",31,51,270,234,504
SAINT-LOUIS,PODOR,SALDE,"BOKE DIALLOUBE","H1 GOUREL BAOREL",19,29,159,103,262
SAINT-LOUIS,PODOR,SALDE,"BOKE DIALLOUBE","H2 WOURO SAMBA DINGUE",9,9,54,34,88
SAINT-LOUIS,PODOR,SALDE,"BOKE DIALLOUBE","H1 BOKI FAFABE (GALOYOBE)",7,8,43,40,83
SAINT-LOUIS,PODOR,SALDE,"BOKE DIALLOUBE","H2 BOKE FAFABE",10,13,56,59,115
SAINT-LOUIS,PODOR,SALDE,"BOKE DIALLOUBE","H3 BOKI FAFABE (WOURO DIOUMO)",5,7,20,24,44
SAINT-LOUIS,PODOR,SALDE,"BOKE DIALLOUBE","BOKE FAFADE (MARIABE  III WOURO MODY)",39,48,183,164,347
SAINT-LOUIS,PODOR,SALDE,"BOKE DIALLOUBE","H1 NDEF",10,25,43,36,79
SAINT-LOUIS,PODOR,SALDE,"BOKE DIALLOUBE","BOKE LAOBE",6,12,38,59,97
SAINT-LOUIS,PODOR,SALDE,"BOKE DIALLOUBE","H1 PERLELE",19,24,94,108,202
SAINT-LOUIS,PODOR,SALDE,"BOKE DIALLOUBE","BOKE MBAYBE",75,90,504,449,953
SAINT-LOUIS,PODOR,SALDE,"BOKE DIALLOUBE","BOKE NAMARY",42,69,231,288,519
SAINT-LOUIS,PODOR,SALDE,"BOKE DIALLOUBE","H3 GOUREL THIOFFY",4,8,42,32,74
SAINT-LOUIS,PODOR,SALDE,"BOKE DIALLOUBE","H4 BOKE GOUME BIBE",15,21,103,87,190
SAINT-LOUIS,PODOR,SALDE,"BOKE DIALLOUBE","H5 DANTHIADY",23,33,161,161,322
SAINT-LOUIS,PODOR,SALDE,"BOKE DIALLOUBE","H6 LOUMBE DJAMGUELBE",15,23,107,131,238
SAINT-LOUIS,PODOR,SALDE,"BOKE DIALLOUBE","H8 WENDOU BOKE",6,11,60,54,114
SAINT-LOUIS,PODOR,SALDE,"BOKE DIALLOUBE","H9 BOKE NAMARY WOURO ALY",18,23,116,108,224
SAINT-LOUIS,PODOR,SALDE,"BOKE DIALLOUBE","H10 BOKE NAMARY WOURO SENO",8,9,46,49,95
SAINT-LOUIS,PODOR,SALDE,"BOKE DIALLOUBE","H11 BALDIEL",5,9,26,30,56
SAINT-LOUIS,PODOR,SALDE,"BOKE DIALLOUBE","BOKE SALSABE",66,81,463,440,903
SAINT-LOUIS,PODOR,SALDE,"BOKE DIALLOUBE","H1 BOULANE",13,21,108,61,169
SAINT-LOUIS,PODOR,SALDE,"BOKE DIALLOUBE","H2 BAALA",36,56,277,223,500
SAINT-LOUIS,PODOR,SALDE,"BOKE DIALLOUBE","H3 RIGANDE",11,20,96,73,169
SAINT-LOUIS,PODOR,SALDE,"BOKE DIALLOUBE",DIARANGUEL,59,71,268,277,545
SAINT-LOUIS,PODOR,SALDE,"BOKE DIALLOUBE","H1 FONDE DIARGUEL",3,3,22,32,54
SAINT-LOUIS,PODOR,SALDE,"BOKE DIALLOUBE","H2 GOUREL SAMBA DJIBY GAW",1,2,3,9,12
SAINT-LOUIS,PODOR,SALDE,"BOKE DIALLOUBE","H3 HOUNDAL SENEGAL",2,3,18,14,32
SAINT-LOUIS,PODOR,SALDE,"BOKE DIALLOUBE",DIONGUI,90,107,609,613,1222
SAINT-LOUIS,PODOR,SALDE,"BOKE DIALLOUBE","H2 DAROU SALAM YIRLABE",29,37,187,182,369
SAINT-LOUIS,PODOR,SALDE,"BOKE DIALLOUBE","DIOUGUEL SEMERABE",7,15,44,47,91
SAINT-LOUIS,PODOR,SALDE,"BOKE DIALLOUBE","H1 DIOUGUEL SANORABE MAURE",1,3,8,6,14
SAINT-LOUIS,PODOR,SALDE,"BOKE DIALLOUBE","H2 GUEYMERE",14,19,73,62,135
SAINT-LOUIS,PODOR,SALDE,"BOKE DIALLOUBE","FERLO THIKITE",23,32,192,187,379
SAINT-LOUIS,PODOR,SALDE,"BOKE DIALLOUBE","H1 BODIEDIE",13,19,122,117,239
SAINT-LOUIS,PODOR,SALDE,"BOKE DIALLOUBE","H3 BIBE",2,4,27,20,47
SAINT-LOUIS,PODOR,SALDE,"BOKE DIALLOUBE",GADIOBE,43,55,246,283,529
SAINT-LOUIS,PODOR,SALDE,"BOKE DIALLOUBE","H1 SINTHIANE NEMA TOULAYE",2,2,6,10,16
SAINT-LOUIS,PODOR,SALDE,"BOKE DIALLOUBE","GAYE KADAR DIALOUBE",17,35,133,144,277
SAINT-LOUIS,PODOR,SALDE,"BOKE DIALLOUBE","H1 BEYE MADJI SAFALBE",12,17,76,82,158
SAINT-LOUIS,PODOR,SALDE,"BOKE DIALLOUBE","H2 BEYE MADJI IRLABE",7,8,26,29,55
SAINT-LOUIS,PODOR,SALDE,"BOKE DIALLOUBE","H3 AERE NAMARY",23,36,155,144,299
SAINT-LOUIS,PODOR,SALDE,"BOKE DIALLOUBE","H4 OURO GADIEL BA",7,8,30,40,70
SAINT-LOUIS,PODOR,SALDE,"BOKE DIALLOUBE","H5 GUENTOU",17,23,101,101,202
SAINT-LOUIS,PODOR,SALDE,"BOKE DIALLOUBE","GAYE KADAR YIRLABE",53,64,251,279,530
SAINT-LOUIS,PODOR,SALDE,"BOKE DIALLOUBE","H1 BADAGOR BOKI",14,84,227,219,446
SAINT-LOUIS,PODOR,SALDE,"BOKE DIALLOUBE","H2 THIELBY",25,90,165,185,350
SAINT-LOUIS,PODOR,SALDE,"BOKE DIALLOUBE","H3 WOURO SAFALBE",13,14,58,62,120
SAINT-LOUIS,PODOR,SALDE,"BOKE DIALLOUBE","H4 SOUNATOU",10,12,73,48,121
SAINT-LOUIS,PODOR,SALDE,"BOKE DIALLOUBE","H5 WOURO AMADEL GUELADIO",3,5,23,29,52
SAINT-LOUIS,PODOR,SALDE,"BOKE DIALLOUBE","H6 AERE NAMARY (WOURO SEBE)",10,22,112,88,200
SAINT-LOUIS,PODOR,SALDE,"BOKE DIALLOUBE",GUELANGAL,43,77,292,275,567
SAINT-LOUIS,PODOR,SALDE,"BOKE DIALLOUBE","H1 DIOUGUEL YALABE",28,42,184,178,362
SAINT-LOUIS,PODOR,SALDE,"BOKE DIALLOUBE","H3 WENDOU MARE",5,13,42,55,97
SAINT-LOUIS,PODOR,SALDE,"BOKE DIALLOUBE","H4 MADINATOU CHEIKH OMAR",7,8,38,38,76
SAINT-LOUIS,PODOR,SALDE,"BOKE DIALLOUBE","H5 WENDOU DIABE",3,4,25,22,47
SAINT-LOUIS,PODOR,SALDE,"BOKE DIALLOUBE","H8 ADAMA GNILA",3,7,30,24,54
SAINT-LOUIS,PODOR,SALDE,"BOKE DIALLOUBE","H9 BELEL BOUCAR",26,31,124,112,236
SAINT-LOUIS,PODOR,SALDE,"BOKE DIALLOUBE","H10 KAHONE",10,14,51,58,109
SAINT-LOUIS,PODOR,SALDE,"BOKE DIALLOUBE","H11 KOUROUBOL",17,42,140,137,277
SAINT-LOUIS,PODOR,SALDE,"BOKE DIALLOUBE","H12 GADOU SAFALBE",13,18,63,71,134
SAINT-LOUIS,PODOR,SALDE,"BOKE DIALLOUBE","H13 BELEL DIARRA",3,4,14,18,32
SAINT-LOUIS,PODOR,SALDE,"BOKE DIALLOUBE","H14 FETE GUELANGAL",3,3,13,14,27
SAINT-LOUIS,PODOR,SALDE,"BOKE DIALLOUBE","H15 TATHIR DE GUELANGAL",6,8,35,27,62
SAINT-LOUIS,PODOR,SALDE,"BOKE DIALLOUBE","H16 THIALTOL WOURO SEYDI",4,6,37,30,67
SAINT-LOUIS,PODOR,SALDE,"BOKE DIALLOUBE","H17 FETE NARE",2,2,13,8,21
SAINT-LOUIS,PODOR,SALDE,"BOKE DIALLOUBE","H18 LOUMBI SADIO",4,7,24,29,53
SAINT-LOUIS,PODOR,SALDE,"BOKE DIALLOUBE",KARAWOYNDOU,148,228,1001,979,1980
SAINT-LOUIS,PODOR,SALDE,"BOKE DIALLOUBE","H1 LAYKI HIRNANGUE",27,43,130,161,291
SAINT-LOUIS,PODOR,SALDE,"BOKE DIALLOUBE","H2 DAHARATOUL S KETHIEL",9,10,70,62,132
SAINT-LOUIS,PODOR,SALDE,"BOKE DIALLOUBE","H3 KADIA",15,25,128,108,236
SAINT-LOUIS,PODOR,SALDE,"BOKE DIALLOUBE","H4 LAYKI FOUNANGUE",11,19,63,87,150
SAINT-LOUIS,PODOR,SALDE,"BOKE DIALLOUBE","H5 KOBEL",10,16,90,56,146
SAINT-LOUIS,PODOR,SALDE,"BOKE DIALLOUBE","H6 KANAMBIRDI",11,18,43,43,86
SAINT-LOUIS,PODOR,SALDE,"BOKE DIALLOUBE","H7 KARA WOYNDOU DIALLOUBE",12,27,97,95,192
SAINT-LOUIS,PODOR,SALDE,"BOKE DIALLOUBE","H8 BELEL MBONDI",23,41,131,198,329
SAINT-LOUIS,PODOR,SALDE,"BOKE DIALLOUBE","H9 THIADJI IRLABE",12,12,87,82,169
SAINT-LOUIS,PODOR,SALDE,"BOKE DIALLOUBE","H10 THIADJI DIALLOUBE",10,15,93,56,149
SAINT-LOUIS,PODOR,SALDE,"BOKE DIALLOUBE","H11 KADIA YIRLABE",5,7,51,27,78
SAINT-LOUIS,PODOR,SALDE,"BOKE DIALLOUBE","H12 KADIA SALFABE",10,15,80,82,162
SAINT-LOUIS,PODOR,SALDE,"BOKE DIALLOUBE","H13 LOUR DIALLOUBES",20,30,138,128,266
SAINT-LOUIS,PODOR,SALDE,"BOKE DIALLOUBE","H14 LOUR OUROURBES",13,21,107,106,213
SAINT-LOUIS,PODOR,SALDE,"BOKE DIALLOUBE","H15 LOUR HARAO (LOUR FAFABE)",20,28,151,129,280
SAINT-LOUIS,PODOR,SALDE,"BOKE DIALLOUBE","LOUGUERE MBABA",35,51,234,205,439
SAINT-LOUIS,PODOR,SALDE,"BOKE DIALLOUBE","H2 WOURO SALIF S DIALLO",2,4,17,15,32
SAINT-LOUIS,PODOR,SALDE,"BOKE DIALLOUBE","H3 WOURO MUDDAL",1,3,10,9,19
SAINT-LOUIS,PODOR,SALDE,"BOKE DIALLOUBE","H4 WOURO SENO",5,6,21,27,48
SAINT-LOUIS,PODOR,SALDE,"BOKE DIALLOUBE","NDIAYENE PEULH (REWAANE)",21,23,97,106,203
SAINT-LOUIS,PODOR,SALDE,"BOKE DIALLOUBE","H1 AISSE MBARE",13,18,86,82,168
SAINT-LOUIS,PODOR,SALDE,"BOKE DIALLOUBE","H2 MBILOGNE",1,2,5,5,10
SAINT-LOUIS,PODOR,SALDE,"BOKE DIALLOUBE","H4 WOURO MAMADOU BATHE",15,29,139,126,265
SAINT-LOUIS,PODOR,SALDE,"BOKE DIALLOUBE","H5 DIAWARAL",2,4,16,7,23
SAINT-LOUIS,PODOR,SALDE,"BOKE DIALLOUBE","H6 PETEL NDAARE",12,17,78,69,147
SAINT-LOUIS,PODOR,SALDE,"BOKE DIALLOUBE","H7 AISSE MBARE DOW",7,12,43,57,100
SAINT-LOUIS,PODOR,SALDE,"BOKE DIALLOUBE","H8 PETEL NELBY",5,6,20,21,41
SAINT-LOUIS,PODOR,SALDE,"BOKE DIALLOUBE","H9 TOUDOUNDOU WELY",7,8,28,37,65
SAINT-LOUIS,PODOR,SALDE,"BOKE DIALLOUBE","H11 KAALOOY",4,5,27,16,43
SAINT-LOUIS,PODOR,SALDE,"BOKE DIALLOUBE","H12 BELEL MBOMI (WOURO THIERNO OUMAR)",4,4,54,13,67
SAINT-LOUIS,PODOR,SALDE,"BOKE DIALLOUBE",NGARANE,2,2,12,16,28
SAINT-LOUIS,PODOR,SALDE,"BOKE DIALLOUBE","H1 KOWLY DIAWA",9,9,27,25,52
SAINT-LOUIS,PODOR,SALDE,"BOKE DIALLOUBE","H2 BELY DADIE",2,2,3,12,15
SAINT-LOUIS,PODOR,SALDE,"BOKE DIALLOUBE","H3 DIAMEL CIRE",7,7,27,28,55
SAINT-LOUIS,PODOR,SALDE,"BOKE DIALLOUBE","H4 DIORODOU",4,4,8,8,16
SAINT-LOUIS,PODOR,SALDE,"BOKE DIALLOUBE","H5 BELY DADIE",4,4,17,17,34
SAINT-LOUIS,PODOR,SALDE,"BOKE DIALLOUBE","H6 SOHIKO",1,1,2,4,6
SAINT-LOUIS,PODOR,SALDE,"BOKE DIALLOUBE",NGOUYE,92,142,605,599,1204
SAINT-LOUIS,PODOR,SALDE,"BOKE DIALLOUBE","H1 THIOYA",6,9,44,36,80
SAINT-LOUIS,PODOR,SALDE,"BOKE DIALLOUBE","H2 TOULEL NGOUYE",10,12,76,61,137
SAINT-LOUIS,PODOR,SALDE,"BOKE DIALLOUBE","OUACE TAKE (WASSETAKE)",107,140,728,676,1404
SAINT-LOUIS,PODOR,SALDE,"BOKE DIALLOUBE","SALDE (TEBEGOUDOU)",135,155,658,580,1238
SAINT-LOUIS,PODOR,SALDE,"BOKE DIALLOUBE","H1 GOUREL ABOU GAINACK",9,11,34,64,98
SAINT-LOUIS,PODOR,SALDE,"BOKE DIALLOUBE","H2 GALOYA",3,3,12,18,30
SAINT-LOUIS,PODOR,SALDE,"BOKE DIALLOUBE","SINTHIOU DIONGUI",49,70,371,371,742
SAINT-LOUIS,PODOR,SALDE,"BOKE DIALLOUBE",THIALAMBO,3,3,10,8,18
SAINT-LOUIS,PODOR,SALDE,"BOKE DIALLOUBE","H1 DIOUTH",20,24,82,89,171
SAINT-LOUIS,PODOR,SALDE,"BOKE DIALLOUBE","H2 SENO",9,9,22,33,55
SAINT-LOUIS,PODOR,SALDE,"BOKE DIALLOUBE","H3 HAKKUNDE MADJI",16,17,51,51,102
SAINT-LOUIS,PODOR,SALDE,"BOKE DIALLOUBE","H4 HAAWRE",6,7,25,28,53
SAINT-LOUIS,PODOR,SALDE,"BOKE DIALLOUBE","H5 PETEL",3,3,17,22,39
SAINT-LOUIS,PODOR,SALDE,"BOKE DIALLOUBE","H6 LOUMBI LOFI (WOURO ASSANE)",9,9,31,36,67
SAINT-LOUIS,PODOR,SALDE,"BOKE DIALLOUBE","H7 FETO MBILLONE",14,14,53,63,116
SAINT-LOUIS,PODOR,SALDE,"BOKE DIALLOUBE","H8 LOUMBI LOFI (WOURO ABDOULAYE DEMBA)",5,5,26,24,50
SAINT-LOUIS,PODOR,SALDE,"BOKE DIALLOUBE",THIKITELE,102,138,1055,736,1791
SAINT-LOUIS,PODOR,SALDE,"BOKE DIALLOUBE",WALLAH,62,105,441,430,871
SAINT-LOUIS,PODOR,SALDE,"BOKE DIALLOUBE","H1 SOUNATOU",21,24,111,159,270
SAINT-LOUIS,PODOR,SALDE,"BOKE DIALLOUBE","H2 FONDE WALLAH",4,5,36,23,59
SAINT-LOUIS,PODOR,SALDE,"BOKE DIALLOUBE","H3 YOKHANE",4,4,21,20,41
SAINT-LOUIS,PODOR,SALDE,"BOKE DIALLOUBE","H4 KOLENGUEL",2,3,9,13,22
SAINT-LOUIS,PODOR,SALDE,"BOKE DIALLOUBE","WENDOU THILLE",28,33,132,161,293
SAINT-LOUIS,PODOR,SALDE,"BOKE DIALLOUBE","H2 MELDIAM",21,32,145,184,329
SAINT-LOUIS,PODOR,SALDE,"BOKE DIALLOUBE","H3 WAAWI HODDA",11,11,64,36,100
SAINT-LOUIS,PODOR,SALDE,"BOKE DIALLOUBE","YAVALDE DIALLOUBE",15,27,113,120,233
SAINT-LOUIS,PODOR,SALDE,"BOKE DIALLOUBE","H1 YAVALDE SINTHIOU",11,18,81,94,175
SAINT-LOUIS,PODOR,SALDE,"BOKE DIALLOUBE","H2 YAVALDE KOBI MBARA",17,25,92,100,192
SAINT-LOUIS,PODOR,SALDE,"BOKE DIALLOUBE","H5 WOURO THIENGUEL",6,8,39,35,74
SAINT-LOUIS,PODOR,SALDE,"BOKE DIALLOUBE","H3 WOURO THIERNO DEMBA DIALLO",4,4,9,17,26
SAINT-LOUIS,PODOR,SALDE,"BOKE DIALLOUBE","YAVALDE IRLABE",46,64,244,255,499
SAINT-LOUIS,PODOR,SALDE,"BOKE DIALLOUBE","H1 LIYANABE",11,15,59,61,120
SAINT-LOUIS,PODOR,SALDE,"BOKE DIALLOUBE","H3 RIDOUANE",16,24,86,92,178
SAINT-LOUIS,PODOR,SALDE,"BOKE DIALLOUBE","H5 WOURO FREBE",16,26,71,101,172
SAINT-LOUIS,PODOR,SALDE,"BOKE DIALLOUBE","H6 RANEO OUROULBE",6,7,21,27,48
SAINT-LOUIS,PODOR,SALDE,"BOKE DIALLOUBE","H7 LEENDE",7,7,37,33,70
SAINT-LOUIS,PODOR,SALDE,"BOKE DIALLOUBE","H8 RANEO DIALLOUBE",8,14,64,51,115
SAINT-LOUIS,PODOR,SALDE,"BOKE DIALLOUBE","H9 RANEO YIRLABE",9,16,46,70,116
SAINT-LOUIS,PODOR,SALDE,"BOKE DIALLOUBE","H10 RANEO SIRANABE",5,10,32,35,67
SAINT-LOUIS,PODOR,SALDE,"BOKE DIALLOUBE","H11 KALIDOU BADEL",1,2,9,9,18
SAINT-LOUIS,PODOR,SALDE,"BOKE DIALLOUBE","H12 WOURO ABOU ALY",1,1,6,7,13
SAINT-LOUIS,PODOR,SALDE,"BOKE DIALLOUBE","H13 OLY DAMARY",8,9,27,32,59
SAINT-LOUIS,PODOR,SALDE,"BOKE DIALLOUBE","H14 LELNDE YIRLABE",8,9,58,36,94
SAINT-LOUIS,PODOR,SALDE,"BOKE DIALLOUBE","BOKÉ FAFABÉ FAYEMBÉ (THIAM THILLE )",21,46,101,104,205
SAINT-LOUIS,PODOR,SALDE,"BOKE DIALLOUBE","H1 BELEL SENO",12,42,65,60,125
SAINT-LOUIS,PODOR,SALDE,"BOKE DIALLOUBE","H2 GAINTH SENO",14,39,71,68,139
SAINT-LOUIS,PODOR,SALDE,"BOKE DIALLOUBE","H3 TAMPI DARO",24,58,145,129,274
SAINT-LOUIS,PODOR,SALDE,"BOKE DIALLOUBE","H4 THIASKY",14,26,70,61,131
SAINT-LOUIS,PODOR,SALDE,"BOKE DIALLOUBE",DIARAL,10,20,91,96,187
SAINT-LOUIS,PODOR,SALDE,"BOKE DIALLOUBE","GUIRWASS (HOUGA)",12,14,41,36,77
SAINT-LOUIS,PODOR,SALDE,"BOKE DIALLOUBE","WOURO FELKANDE",7,12,66,74,140
SAINT-LOUIS,PODOR,SALDE,"MBOLO BIRANE","BELEL THIEDO",33,69,141,121,262
SAINT-LOUIS,PODOR,SALDE,"MBOLO BIRANE","H1 VODI HARNO",3,3,22,23,45
SAINT-LOUIS,PODOR,SALDE,"MBOLO BIRANE","H2 DIAMEL ALI",13,18,59,59,118
SAINT-LOUIS,PODOR,SALDE,"MBOLO BIRANE","H3 TOUGOU",25,71,207,190,397
SAINT-LOUIS,PODOR,SALDE,"MBOLO BIRANE","H4 LOUNG KADJI",19,27,143,100,243
SAINT-LOUIS,PODOR,SALDE,"MBOLO BIRANE","BOGUEL (BELY EDY)",94,123,578,732,1310
SAINT-LOUIS,PODOR,SALDE,"MBOLO BIRANE","BOKI YALALBE (POUTI)",74,223,570,473,1043
SAINT-LOUIS,PODOR,SALDE,"MBOLO BIRANE","DIABA DEKELE",54,85,498,436,934
SAINT-LOUIS,PODOR,SALDE,"MBOLO BIRANE","DIABA HARLAO",5,8,44,57,101
SAINT-LOUIS,PODOR,SALDE,"MBOLO BIRANE","DIABA LIDOUBES",286,377,2118,1664,3782
SAINT-LOUIS,PODOR,SALDE,"MBOLO BIRANE","H1 WOURO SAMBA AMADOU MBEGNIGA",2,2,11,4,15
SAINT-LOUIS,PODOR,SALDE,"MBOLO BIRANE","GALOYA PEULH",42,59,278,279,557
SAINT-LOUIS,PODOR,SALDE,"MBOLO BIRANE","H1 THIABOURLE",60,90,345,452,797
SAINT-LOUIS,PODOR,SALDE,"MBOLO BIRANE","H2 THILIMBELY",4,5,12,18,30
SAINT-LOUIS,PODOR,SALDE,"MBOLO BIRANE","H3 FONDE THIEW",16,19,100,70,170
SAINT-LOUIS,PODOR,SALDE,"MBOLO BIRANE","H4 WOURO AMADOU DEMBA SALLA",1,1,19,13,32
SAINT-LOUIS,PODOR,SALDE,"MBOLO BIRANE",GANGUEL,28,60,259,262,521
SAINT-LOUIS,PODOR,SALDE,"MBOLO BIRANE","H1 VELINGARA",8,9,31,29,60
SAINT-LOUIS,PODOR,SALDE,"MBOLO BIRANE","H2 DIRMODIAL",8,13,67,63,130
SAINT-LOUIS,PODOR,SALDE,"MBOLO BIRANE","GUIRWASS (HOUGA)",54,81,359,272,631
SAINT-LOUIS,PODOR,SALDE,"MBOLO BIRANE",KOUNADJI,36,56,241,230,471
SAINT-LOUIS,PODOR,SALDE,"MBOLO BIRANE","LOUGUE PEULH",23,32,181,160,341
SAINT-LOUIS,PODOR,SALDE,"MBOLO BIRANE","H1 BILLE GALOYABE",40,81,377,382,759
SAINT-LOUIS,PODOR,SALDE,"MBOLO BIRANE","H2 GALDADJI",16,27,83,107,190
SAINT-LOUIS,PODOR,SALDE,"MBOLO BIRANE","H3LOBOUDOU WOURO LABA",24,39,139,147,286
SAINT-LOUIS,PODOR,SALDE,"MBOLO BIRANE","H4 BELEL",10,16,91,64,155
SAINT-LOUIS,PODOR,SALDE,"MBOLO BIRANE","H5 WOURO HAMADY KINKE",41,53,219,257,476
SAINT-LOUIS,PODOR,SALDE,"MBOLO BIRANE","LOUGUE SEBBE (LOUGUE WOLOF)",70,129,580,577,1157
SAINT-LOUIS,PODOR,SALDE,"MBOLO BIRANE","LOUGUE TOROBE",92,121,612,627,1239
SAINT-LOUIS,PODOR,SALDE,"MBOLO BIRANE","H1 LOBBOUDOU GOLDOU",11,18,75,90,165
SAINT-LOUIS,PODOR,SALDE,"MBOLO BIRANE","LOUR SEBE (LOUR WOLOF)",49,86,287,345,632
SAINT-LOUIS,PODOR,SALDE,"MBOLO BIRANE","H1 SINTHIANE LOUR",2,2,5,8,13
SAINT-LOUIS,PODOR,SALDE,"MBOLO BIRANE","MALOUM DIABA",33,36,255,178,433
SAINT-LOUIS,PODOR,SALDE,"MBOLO BIRANE","MALOUM DIAMEL",15,18,66,73,139
SAINT-LOUIS,PODOR,SALDE,"MBOLO BIRANE","MBOLO ALY SIDY",98,126,782,755,1537
SAINT-LOUIS,PODOR,SALDE,"MBOLO BIRANE","MBOLO BIRANE",219,306,1647,1597,3244
SAINT-LOUIS,PODOR,SALDE,"MBOLO BIRANE","H1 GOUREL AMADOU SAMBA",4,6,24,29,53
SAINT-LOUIS,PODOR,SALDE,"MBOLO BIRANE","H2 MBAGNE WORGO",15,20,102,82,184
SAINT-LOUIS,PODOR,SALDE,"MBOLO BIRANE","SINTHIOU AMADOU MAYRAM",89,133,595,594,1189
SAINT-LOUIS,PODOR,SALDE,"MBOLO BIRANE","H1 PALDI 1",8,8,28,27,55
SAINT-LOUIS,PODOR,SALDE,"MBOLO BIRANE","SINTHIOU BOGUEL (SINTHIOU BABABES)",41,45,155,267,422
SAINT-LOUIS,PODOR,SALDE,"MBOLO BIRANE","THILOUKI (SARE MAOUNDOU)",140,224,570,586,1156
SAINT-LOUIS,PODOR,SALDE,"MBOLO BIRANE","H1 BALDIOR",17,24,101,109,210
SAINT-LOUIS,PODOR,SALDE,"MBOLO BIRANE","H2 OGUERE 1",45,72,317,307,624
SAINT-LOUIS,PODOR,SALDE,"MBOLO BIRANE","H3 KODIOLELE",28,45,170,158,328
SAINT-LOUIS,PODOR,SALDE,"MBOLO BIRANE","H4 OGUERE II (REFUGIES)",6,11,54,47,101
SAINT-LOUIS,PODOR,SALDE,"MBOLO BIRANE","H5 WEDOU COULI",20,27,111,141,252
SAINT-LOUIS,PODOR,SALDE,"MBOLO BIRANE","H6 GOUREL ABOU DIA",4,4,19,22,41
SAINT-LOUIS,PODOR,SALDE,"MBOLO BIRANE","H7 BALDIOL 2",11,14,56,56,112
SAINT-LOUIS,PODOR,SALDE,"MBOLO BIRANE","H8 WOURO GOLLE",2,2,6,9,15
SAINT-LOUIS,PODOR,SALDE,"MBOLO BIRANE","H9 OGUERE 3",3,3,17,15,32
SAINT-LOUIS,PODOR,SALDE,"MBOLO BIRANE","THYLEMOL (DIANANCOBES)",45,59,226,329,555
SAINT-LOUIS,PODOR,SALDE,"MBOLO BIRANE","TOUFNDE GANDE",69,100,302,332,634
SAINT-LOUIS,PODOR,SALDE,"MBOLO BIRANE","H1 GOUREL BEYE",7,11,47,61,108
SAINT-LOUIS,PODOR,SALDE,"MBOLO BIRANE","H2 POUREL",9,18,53,65,118
SAINT-LOUIS,PODOR,SALDE,"MBOLO BIRANE","TYLEMOL (DIABANABE)",16,19,100,125,225
SAINT-LOUIS,PODOR,SALDE,"MBOLO BIRANE","H1 AYNOUMADY",14,18,72,97,169
SAINT-LOUIS,PODOR,SALDE,"MBOLO BIRANE",WINDING,5,13,49,58,107
SAINT-LOUIS,PODOR,SALDE,"MBOLO BIRANE","H1 SAMBA BOWELI",36,46,212,215,427
SAINT-LOUIS,PODOR,SALDE,"MBOLO BIRANE","H2 KOIKHOYAL 1",16,19,103,72,175
SAINT-LOUIS,PODOR,SALDE,"MBOLO BIRANE","H3 KOIKHOYAL 2 (FADY DIAM)",20,23,103,91,194
SAINT-LOUIS,PODOR,SALDE,"MBOLO BIRANE","H4 OLOL",18,20,102,103,205
SAINT-LOUIS,PODOR,SALDE,"MBOLO BIRANE","DOUGOU HEBIYABE",19,25,104,134,238
SAINT-LOUIS,PODOR,SALDE,"MBOLO BIRANE","H1 FONDE DAWALEL(WOURO CHEICK)",2,5,25,23,48
SAINT-LOUIS,PODOR,SALDE,"MBOLO BIRANE","H2 PALDI 2",8,9,48,42,90
SAINT-LOUIS,PODOR,SALDE,"MBOLO BIRANE","H3 WOURO GUELADIO",1,3,19,22,41
SAINT-LOUIS,PODOR,SALDE,"MBOLO BIRANE",DIAMBOURI,43,62,263,316,579
SAINT-LOUIS,PODOR,SALDE,"GALOYA TOUCOULEUR",MBAILA,14,27,91,95,186
SAINT-LOUIS,PODOR,SALDE,"GALOYA TOUCOULEUR",DEWODIA,65,83,424,411,835
SAINT-LOUIS,PODOR,SALDE,"GALOYA TOUCOULEUR",DIOCKY,31,51,250,251,501
SAINT-LOUIS,PODOR,SALDE,"GALOYA TOUCOULEUR",EGUEL,63,80,385,350,735
SAINT-LOUIS,PODOR,SALDE,"GALOYA TOUCOULEUR",KAABA,46,71,285,308,593
SAINT-LOUIS,PODOR,SALDE,"GALOYA TOUCOULEUR",LIDOUBE,23,37,188,226,414
SAINT-LOUIS,PODOR,SALDE,"GALOYA TOUCOULEUR",SINTHIOU,157,195,973,717,1690
SAINT-LOUIS,PODOR,SALDE,"GALOYA TOUCOULEUR","SOUDOU SADIO",21,28,166,141,307
SAINT-LOUIS,PODOR,SALDE,"GALOYA TOUCOULEUR","DAROU SALAM",90,118,686,554,1240
SAINT-LOUIS,PODOR,SALDE,PETE,"ANANBE BALEBE",15,22,113,122,235
SAINT-LOUIS,PODOR,SALDE,PETE,"ANANBE WODEBE",25,28,105,127,232
SAINT-LOUIS,PODOR,SALDE,PETE,LYDOUBE,9,20,71,89,160
SAINT-LOUIS,PODOR,SALDE,PETE,ROUMDE,85,113,567,521,1088
SAINT-LOUIS,PODOR,SALDE,PETE,SALSALBE,12,28,86,97,183
SAINT-LOUIS,PODOR,SALDE,PETE,"SINTHIANE I",114,146,722,668,1390
SAINT-LOUIS,PODOR,SALDE,PETE,"SINTHIANE II",76,89,377,357,734
SAINT-LOUIS,PODOR,SALDE,PETE,THIAMBE,50,80,480,333,813
SAINT-LOUIS,PODOR,"THILE BOUBACAR",FANAYE,"ALINGO GANINA",28,78,209,214,423
SAINT-LOUIS,PODOR,"THILE BOUBACAR",FANAYE,"H1 MBELOGNE KELLE",12,30,104,104,208
SAINT-LOUIS,PODOR,"THILE BOUBACAR",FANAYE,"H2 GANINA EROGNE",8,15,59,60,119
SAINT-LOUIS,PODOR,"THILE BOUBACAR",FANAYE,"H3 FETE DONDOU SENO",36,152,534,478,1012
SAINT-LOUIS,PODOR,"THILE BOUBACAR",FANAYE,"BELEL BOGGAL",6,32,46,48,94
SAINT-LOUIS,PODOR,"THILE BOUBACAR",FANAYE,"H1 NILAH",20,35,125,139,264
SAINT-LOUIS,PODOR,"THILE BOUBACAR",FANAYE,"BINGUEL SENO",9,24,74,71,145
SAINT-LOUIS,PODOR,"THILE BOUBACAR",FANAYE,"H1 WARKERE",12,54,71,47,118
SAINT-LOUIS,PODOR,"THILE BOUBACAR",FANAYE,"H2 MALAL BOUBOU",8,37,61,58,119
SAINT-LOUIS,PODOR,"THILE BOUBACAR",FANAYE,"H3 ANTHIANG",5,17,42,39,81
SAINT-LOUIS,PODOR,"THILE BOUBACAR",FANAYE,"H4 BELEL BOBORY",9,28,103,80,183
SAINT-LOUIS,PODOR,"THILE BOUBACAR",FANAYE,"H5 GNOUROUKADJI",17,30,174,159,333
SAINT-LOUIS,PODOR,"THILE BOUBACAR",FANAYE,"H6 NGANDA",13,22,76,78,154
SAINT-LOUIS,PODOR,"THILE BOUBACAR",FANAYE,"H7 HOULI HOTA",13,29,131,112,243
SAINT-LOUIS,PODOR,"THILE BOUBACAR",FANAYE,"H8 PETEL BOUDOUDI",8,23,106,116,222
SAINT-LOUIS,PODOR,"THILE BOUBACAR",FANAYE,"DARA SALAM",27,151,694,627,1321
SAINT-LOUIS,PODOR,"THILE BOUBACAR",FANAYE,"H1 WOURO SAYDOU SALL",8,10,35,36,71
SAINT-LOUIS,PODOR,"THILE BOUBACAR",FANAYE,"H2 THILLE",7,8,31,35,66
SAINT-LOUIS,PODOR,"THILE BOUBACAR",FANAYE,"H3 WOURO MOUSSA DJIBY LY",7,12,45,63,108
SAINT-LOUIS,PODOR,"THILE BOUBACAR",FANAYE,"DIAGNOUME DIAOBES",17,18,84,101,185
SAINT-LOUIS,PODOR,"THILE BOUBACAR",FANAYE,"H1 GOURE DIAOBES",5,5,20,15,35
SAINT-LOUIS,PODOR,"THILE BOUBACAR",FANAYE,"DIAGNOUME SARRE",87,105,440,495,935
SAINT-LOUIS,PODOR,"THILE BOUBACAR",FANAYE,DIALLY,27,105,305,304,609
SAINT-LOUIS,PODOR,"THILE BOUBACAR",FANAYE,"DIAMEL DIERY",29,73,214,308,522
SAINT-LOUIS,PODOR,"THILE BOUBACAR",FANAYE,"DIMAR DIERY",336,435,2182,2357,4539
SAINT-LOUIS,PODOR,"THILE BOUBACAR",FANAYE,"H1 DIMATH WALO",42,51,295,257,552
SAINT-LOUIS,PODOR,"THILE BOUBACAR",FANAYE,"H2 DIOLLI REFUGIES",48,56,312,343,655
SAINT-LOUIS,PODOR,"THILE BOUBACAR",FANAYE,"H3 DIOULKI",9,17,65,72,137
SAINT-LOUIS,PODOR,"THILE BOUBACAR",FANAYE,"H4 BARKELE",11,23,149,91,240
SAINT-LOUIS,PODOR,"THILE BOUBACAR",FANAYE,"H5 OURO MAMADOU NDIEME",1,1,6,6,12
SAINT-LOUIS,PODOR,"THILE BOUBACAR",FANAYE,"H6 BOUBOU LAMA",9,18,76,74,150
SAINT-LOUIS,PODOR,"THILE BOUBACAR",FANAYE,"H7 BELELE GAOUDI",6,18,55,61,116
SAINT-LOUIS,PODOR,"THILE BOUBACAR",FANAYE,"H8 RIMBAKH",9,66,98,90,188
SAINT-LOUIS,PODOR,"THILE BOUBACAR",FANAYE,"H9 WENDOU THIASKY",4,26,41,40,81
SAINT-LOUIS,PODOR,"THILE BOUBACAR",FANAYE,"H10 BELEL HAMADY DOCKA",7,20,73,42,115
SAINT-LOUIS,PODOR,"THILE BOUBACAR",FANAYE,"H11 WENDOU DIAMEDI",7,30,55,58,113
SAINT-LOUIS,PODOR,"THILE BOUBACAR",FANAYE,"H12 BERGUEL RACINE",13,17,87,69,156
SAINT-LOUIS,PODOR,"THILE BOUBACAR",FANAYE,"H13 TAYBACK",7,21,78,83,161
SAINT-LOUIS,PODOR,"THILE BOUBACAR",FANAYE,"H14 WOURO DORO BA",11,45,153,136,289
SAINT-LOUIS,PODOR,"THILE BOUBACAR",FANAYE,"H15 RIZIC",4,7,45,50,95
SAINT-LOUIS,PODOR,"THILE BOUBACAR",FANAYE,"H16 TODEL TOKOSEL",10,10,54,43,97
SAINT-LOUIS,PODOR,"THILE BOUBACAR",FANAYE,DOUNOBES,25,65,206,218,424
SAINT-LOUIS,PODOR,"THILE BOUBACAR",FANAYE,"H1 SAGUEBES NAEBES",17,38,161,173,334
SAINT-LOUIS,PODOR,"THILE BOUBACAR",FANAYE,"FANAYE DIERY",659,852,5046,4873,9919
SAINT-LOUIS,PODOR,"THILE BOUBACAR",FANAYE,"H2 THIOUKOUGUEL",9,18,63,74,137
SAINT-LOUIS,PODOR,"THILE BOUBACAR",FANAYE,"FANAYE WALO",110,139,778,721,1499
SAINT-LOUIS,PODOR,"THILE BOUBACAR",FANAYE,"H1 WOURO MAMADOU BAIDY",14,28,139,117,256
SAINT-LOUIS,PODOR,"THILE BOUBACAR",FANAYE,"FETE LAOBE",32,102,330,386,716
SAINT-LOUIS,PODOR,"THILE BOUBACAR",FANAYE,"FORAGE GANINA",16,32,125,93,218
SAINT-LOUIS,PODOR,"THILE BOUBACAR",FANAYE,"H1 BELEL SAMBA EGGOUDOU",13,39,109,105,214
SAINT-LOUIS,PODOR,"THILE BOUBACAR",FANAYE,"H2 THIAMLEDJI",19,45,144,139,283
SAINT-LOUIS,PODOR,"THILE BOUBACAR",FANAYE,"H3 NOUWEYDI",18,53,167,152,319
SAINT-LOUIS,PODOR,"THILE BOUBACAR",FANAYE,"H4 GANINA MAOUDOU",26,65,207,214,421
SAINT-LOUIS,PODOR,"THILE BOUBACAR",FANAYE,"H5 WENDOU SENO",19,42,133,133,266
SAINT-LOUIS,PODOR,"THILE BOUBACAR",FANAYE,"H6 DIOULARE",23,35,137,124,261
SAINT-LOUIS,PODOR,"THILE BOUBACAR",FANAYE,"H7 GANAREL",16,59,162,177,339
SAINT-LOUIS,PODOR,"THILE BOUBACAR",FANAYE,"H1 YILO",4,11,37,32,69
SAINT-LOUIS,PODOR,"THILE BOUBACAR",FANAYE,"GOREL AL SEYNI",24,29,186,227,413
SAINT-LOUIS,PODOR,"THILE BOUBACAR",FANAYE,"GOUMEL HAMADY CAMARA",97,126,607,583,1190
SAINT-LOUIS,PODOR,"THILE BOUBACAR",FANAYE,LERE,33,95,285,276,561
SAINT-LOUIS,PODOR,"THILE BOUBACAR",FANAYE,LODE,19,47,139,143,282
SAINT-LOUIS,PODOR,"THILE BOUBACAR",FANAYE,"LOUGOURE GOLOMBO",43,53,149,205,354
SAINT-LOUIS,PODOR,"THILE BOUBACAR",FANAYE,"LOUMBEL GALLE DOADO",2,3,6,11,17
SAINT-LOUIS,PODOR,"THILE BOUBACAR",FANAYE,"H1 WENDOU MOUTHIATEKI",25,51,143,142,285
SAINT-LOUIS,PODOR,"THILE BOUBACAR",FANAYE,"H2 FETE PATOUKI",25,60,175,208,383
SAINT-LOUIS,PODOR,"THILE BOUBACAR",FANAYE,"H3 LOUGGUE MOMI",8,18,50,58,108
SAINT-LOUIS,PODOR,"THILE BOUBACAR",FANAYE,"LOUMBOL BOKKI",12,37,113,110,223
SAINT-LOUIS,PODOR,"THILE BOUBACAR",FANAYE,"H1 DIELIA",2,11,29,28,57
SAINT-LOUIS,PODOR,"THILE BOUBACAR",FANAYE,"H2 FETE BOUDJI",10,40,65,81,146
SAINT-LOUIS,PODOR,"THILE BOUBACAR",FANAYE,"H3 AFO",9,13,41,53,94
SAINT-LOUIS,PODOR,"THILE BOUBACAR",FANAYE,"H4 LEREYEL",11,38,99,112,211
SAINT-LOUIS,PODOR,"THILE BOUBACAR",FANAYE,"H5 BELEL NDIAWDI",9,35,74,87,161
SAINT-LOUIS,PODOR,"THILE BOUBACAR",FANAYE,"MEDINA ABOU",16,28,111,118,229
SAINT-LOUIS,PODOR,"THILE BOUBACAR",FANAYE,"MEDINA CHERIF",12,26,97,84,181
SAINT-LOUIS,PODOR,"THILE BOUBACAR",FANAYE,NDIEURBEU,145,166,737,691,1428
SAINT-LOUIS,PODOR,"THILE BOUBACAR",FANAYE,"H1 OURO AMADOU SOW",9,15,56,53,109
SAINT-LOUIS,PODOR,"THILE BOUBACAR",FANAYE,"H2 GADE MAOULOUD",11,17,79,80,159
SAINT-LOUIS,PODOR,"THILE BOUBACAR",FANAYE,"SALNDE FANAYE",94,135,704,652,1356
SAINT-LOUIS,PODOR,"THILE BOUBACAR",FANAYE,SOUSSANE,19,138,275,286,561
SAINT-LOUIS,PODOR,"THILE BOUBACAR",FANAYE,TATQUI,54,108,359,364,723
SAINT-LOUIS,PODOR,"THILE BOUBACAR",FANAYE,"H1 OURO BAMBADO SY",43,73,246,288,534
SAINT-LOUIS,PODOR,"THILE BOUBACAR",FANAYE,"H2 TETIANE PATOUKI",13,40,120,131,251
SAINT-LOUIS,PODOR,"THILE BOUBACAR",FANAYE,"H3 ASNDE KADIOLI",10,31,80,103,183
SAINT-LOUIS,PODOR,"THILE BOUBACAR",FANAYE,THIANGAYE,277,389,1765,1690,3455
SAINT-LOUIS,PODOR,"THILE BOUBACAR",FANAYE,"H1 HALWAR",1,1,7,3,10
SAINT-LOUIS,PODOR,"THILE BOUBACAR",FANAYE,"H2 THIANGAYE",16,20,74,64,138
SAINT-LOUIS,PODOR,"THILE BOUBACAR",FANAYE,"WENDOU OLDOU",22,69,216,248,464
SAINT-LOUIS,PODOR,"THILE BOUBACAR",FANAYE,"H1 DIEUF DIEUFANE",13,36,104,100,204
SAINT-LOUIS,PODOR,"THILE BOUBACAR",FANAYE,"H2 DEGOUTADJI",4,10,40,28,68
SAINT-LOUIS,PODOR,"THILE BOUBACAR",FANAYE,"H3 NDARAW",6,17,54,49,103
SAINT-LOUIS,PODOR,"THILE BOUBACAR",FANAYE,"H4 NGARE MBATHIE",29,50,203,205,408
SAINT-LOUIS,PODOR,"THILE BOUBACAR",FANAYE,"H5 TETHI NEDJI",6,12,39,46,85
SAINT-LOUIS,PODOR,"THILE BOUBACAR",FANAYE,"H6 BOUMODI",5,8,20,24,44
SAINT-LOUIS,PODOR,"THILE BOUBACAR",FANAYE,"H7 BELEL NGATI BALA",3,8,34,61,95
SAINT-LOUIS,PODOR,"THILE BOUBACAR",FANAYE,"H8 KEUR GORY KA",4,5,21,24,45
SAINT-LOUIS,PODOR,"THILE BOUBACAR",FANAYE,"WOURO OUSMANE LY",35,54,196,210,406
SAINT-LOUIS,PODOR,"THILE BOUBACAR",FANAYE,"H1 WOURO BAYDY MBODJI",22,30,128,106,234
SAINT-LOUIS,PODOR,"THILE BOUBACAR",FANAYE,"WODABES WOURO SAMBA HAWA",24,77,226,232,458
SAINT-LOUIS,PODOR,"THILE BOUBACAR",FANAYE,"WENDOU HAJAL",17,27,178,134,312
SAINT-LOUIS,PODOR,"THILE BOUBACAR",FANAYE,"H1 TEKANE SENEGAL",7,8,64,63,127
SAINT-LOUIS,PODOR,"THILE BOUBACAR",FANAYE,"WOURO SAYDOU SALL",8,15,68,61,129
SAINT-LOUIS,PODOR,"THILE BOUBACAR",FANAYE,"WOURO MOUSSA PENDA BA",2,9,35,40,75
SAINT-LOUIS,PODOR,"THILE BOUBACAR",FANAYE,"SINTHIANE MEDINE",1,1,1,4,5
SAINT-LOUIS,PODOR,"THILE BOUBACAR",FANAYE,"WOURO MOURIDE",5,17,74,95,169
SAINT-LOUIS,PODOR,"THILE BOUBACAR","NDIAYENE PEINDAO","BELLY GOUADY",22,49,113,163,276
SAINT-LOUIS,PODOR,"THILE BOUBACAR","NDIAYENE PEINDAO","H1 HAMETH DOULO",16,32,74,95,169
SAINT-LOUIS,PODOR,"THILE BOUBACAR","NDIAYENE PEINDAO","H2 NOUWOYDOU",8,14,37,49,86
SAINT-LOUIS,PODOR,"THILE BOUBACAR","NDIAYENE PEINDAO","H3 SOUKOUNDOU SENO",12,13,36,38,74
SAINT-LOUIS,PODOR,"THILE BOUBACAR","NDIAYENE PEINDAO","H4 THIOUKOUNGEL",9,12,31,45,76
SAINT-LOUIS,PODOR,"THILE BOUBACAR","NDIAYENE PEINDAO","H5 DIARDE KOYLE",3,4,7,13,20
SAINT-LOUIS,PODOR,"THILE BOUBACAR","NDIAYENE PEINDAO","H6 PETE OLE 1 ET 2",13,20,43,76,119
SAINT-LOUIS,PODOR,"THILE BOUBACAR","NDIAYENE PEINDAO","H7 THIANBA LEDJI",19,29,142,127,269
SAINT-LOUIS,PODOR,"THILE BOUBACAR","NDIAYENE PEINDAO","H8 LOUMBOUL SOVOUABE",24,36,139,164,303
SAINT-LOUIS,PODOR,"THILE BOUBACAR","NDIAYENE PEINDAO","H9 POUAH DIAMY",11,21,53,68,121
SAINT-LOUIS,PODOR,"THILE BOUBACAR","NDIAYENE PEINDAO","H10 GONTHIE",1,1,3,1,4
SAINT-LOUIS,PODOR,"THILE BOUBACAR","NDIAYENE PEINDAO","H11 WINDI BOKI",5,18,65,71,136
SAINT-LOUIS,PODOR,"THILE BOUBACAR","NDIAYENE PEINDAO","H12 WINDI CIRE",27,58,266,251,517
SAINT-LOUIS,PODOR,"THILE BOUBACAR","NDIAYENE PEINDAO","H13 BELEL BALALA",12,28,109,107,216
SAINT-LOUIS,PODOR,"THILE BOUBACAR","NDIAYENE PEINDAO","H14 FETE DIANAL",7,12,26,37,63
SAINT-LOUIS,PODOR,"THILE BOUBACAR","NDIAYENE PEINDAO","H15 KAWEL AGADE",4,12,29,38,67
SAINT-LOUIS,PODOR,"THILE BOUBACAR","NDIAYENE PEINDAO","H16 LOURADJIE",6,17,34,49,83
SAINT-LOUIS,PODOR,"THILE BOUBACAR","NDIAYENE PEINDAO","H17 DISSIDIAM",13,23,67,83,150
SAINT-LOUIS,PODOR,"THILE BOUBACAR","NDIAYENE PEINDAO","H18 KAOUREL OURO ALTINE",4,10,26,36,62
SAINT-LOUIS,PODOR,"THILE BOUBACAR","NDIAYENE PEINDAO","H19 BINGUEL BOBORI",10,22,59,77,136
SAINT-LOUIS,PODOR,"THILE BOUBACAR","NDIAYENE PEINDAO","H20 BELLOLI COUMBA SOKHNA",17,24,67,92,159
SAINT-LOUIS,PODOR,"THILE BOUBACAR","NDIAYENE PEINDAO","H21 RIGANDE",3,6,19,29,48
SAINT-LOUIS,PODOR,"THILE BOUBACAR","NDIAYENE PEINDAO",DIABOBES,44,62,370,339,709
SAINT-LOUIS,PODOR,"THILE BOUBACAR","NDIAYENE PEINDAO","DIAMEL (DIAMEL DIERY)",29,50,136,191,327
SAINT-LOUIS,PODOR,"THILE BOUBACAR","NDIAYENE PEINDAO","H1 WOURO HAMAT FATOUMA",24,29,105,137,242
SAINT-LOUIS,PODOR,"THILE BOUBACAR","NDIAYENE PEINDAO","H2 MBAALA",39,50,206,204,410
SAINT-LOUIS,PODOR,"THILE BOUBACAR","NDIAYENE PEINDAO","H3 WOURO DIERY",32,36,122,160,282
SAINT-LOUIS,PODOR,"THILE BOUBACAR","NDIAYENE PEINDAO","H4 HARI VELLE",30,40,101,163,264
SAINT-LOUIS,PODOR,"THILE BOUBACAR","NDIAYENE PEINDAO","DIARDE KOYLE",3,5,21,24,45
SAINT-LOUIS,PODOR,"THILE BOUBACAR","NDIAYENE PEINDAO",FIGO,55,87,382,378,760
SAINT-LOUIS,PODOR,"THILE BOUBACAR","NDIAYENE PEINDAO",HIWIRIGA,34,57,166,202,368
SAINT-LOUIS,PODOR,"THILE BOUBACAR","NDIAYENE PEINDAO","H1 GNOUTE",48,163,240,268,508
SAINT-LOUIS,PODOR,"THILE BOUBACAR","NDIAYENE PEINDAO","H2 LOUMBOL",9,13,54,42,96
SAINT-LOUIS,PODOR,"THILE BOUBACAR","NDIAYENE PEINDAO","H3 THIEWGAL",8,8,26,43,69
SAINT-LOUIS,PODOR,"THILE BOUBACAR","NDIAYENE PEINDAO","H4 PATE COGNE",25,37,103,148,251
SAINT-LOUIS,PODOR,"THILE BOUBACAR","NDIAYENE PEINDAO","H5 KAWEL NGUENDAR",22,31,115,120,235
SAINT-LOUIS,PODOR,"THILE BOUBACAR","NDIAYENE PEINDAO","H6 TEKINGUEL NGUENDAR",13,42,66,80,146
SAINT-LOUIS,PODOR,"THILE BOUBACAR","NDIAYENE PEINDAO","H7 WOURO MBOUNA",27,89,173,159,332
SAINT-LOUIS,PODOR,"THILE BOUBACAR","NDIAYENE PEINDAO","H8 BELEL MOUNDI",2,8,11,14,25
SAINT-LOUIS,PODOR,"THILE BOUBACAR","NDIAYENE PEINDAO","H9 KOILY GOTTI",6,14,36,38,74
SAINT-LOUIS,PODOR,"THILE BOUBACAR","NDIAYENE PEINDAO","H10 NAMADI",3,4,23,16,39
SAINT-LOUIS,PODOR,"THILE BOUBACAR","NDIAYENE PEINDAO","H11 GNOURKADIE",7,8,22,34,56
SAINT-LOUIS,PODOR,"THILE BOUBACAR","NDIAYENE PEINDAO","H12 MAOUNDOU THIASKI",18,22,81,88,169
SAINT-LOUIS,PODOR,"THILE BOUBACAR","NDIAYENE PEINDAO","H13 BELEL SIVEKOU",11,30,81,71,152
SAINT-LOUIS,PODOR,"THILE BOUBACAR","NDIAYENE PEINDAO","KADIOGUE (DIABOBES II)",269,370,1472,1448,2920
SAINT-LOUIS,PODOR,"THILE BOUBACAR","NDIAYENE PEINDAO","LOBBOUDOU DOUE",167,243,1562,1286,2848
SAINT-LOUIS,PODOR,"THILE BOUBACAR","NDIAYENE PEINDAO","H1 THIELDATY",12,15,35,38,73
SAINT-LOUIS,PODOR,"THILE BOUBACAR","NDIAYENE PEINDAO","NDIAYENE PENDAO",142,252,1229,1210,2439
SAINT-LOUIS,PODOR,"THILE BOUBACAR","NDIAYENE PEINDAO","H1 BOUBE",15,33,157,144,301
SAINT-LOUIS,PODOR,"THILE BOUBACAR","NDIAYENE PEINDAO","NDIAYENE SARE",178,253,1213,1268,2481
SAINT-LOUIS,PODOR,"THILE BOUBACAR","NDIAYENE PEINDAO","NDIOFNDE DIALY",58,97,282,358,640
SAINT-LOUIS,PODOR,"THILE BOUBACAR","NDIAYENE PEINDAO","NGUENDAR (GARAGE NGUENDAR)",136,182,664,752,1416
SAINT-LOUIS,PODOR,"THILE BOUBACAR","NDIAYENE PEINDAO","H1 NIANGA DIERY",34,34,123,151,274
SAINT-LOUIS,PODOR,"THILE BOUBACAR","NDIAYENE PEINDAO","H2 WOURO BAIDY",33,34,108,124,232
SAINT-LOUIS,PODOR,"THILE BOUBACAR","NDIAYENE PEINDAO","H3 HARIFOUNDA 1",28,40,136,172,308
SAINT-LOUIS,PODOR,"THILE BOUBACAR","NDIAYENE PEINDAO","H4 FASS THIERNO",8,8,27,33,60
SAINT-LOUIS,PODOR,"THILE BOUBACAR","NDIAYENE PEINDAO","H5 HARIFOUNDA 3",21,39,185,209,394
SAINT-LOUIS,PODOR,"THILE BOUBACAR","NDIAYENE PEINDAO","H6 HARIFOUNDA 2",14,18,69,80,149
SAINT-LOUIS,PODOR,"THILE BOUBACAR","NDIAYENE PEINDAO","OURO KELLEO",42,75,314,312,626
SAINT-LOUIS,PODOR,"THILE BOUBACAR","NDIAYENE PEINDAO","H1 BAKHAO",43,57,323,342,665
SAINT-LOUIS,PODOR,"THILE BOUBACAR","NDIAYENE PEINDAO","H2 BOLDEME",7,9,27,24,51
SAINT-LOUIS,PODOR,"THILE BOUBACAR","NDIAYENE PEINDAO","H3 GOUMEL BARAYE",25,35,146,107,253
SAINT-LOUIS,PODOR,"THILE BOUBACAR","NDIAYENE PEINDAO","H4 TODEL MAOUDOU",7,11,54,41,95
SAINT-LOUIS,PODOR,"THILE BOUBACAR","NDIAYENE PEINDAO","H5 DIAMGUEL (OURO DJIBY MALA)",8,11,45,43,88
SAINT-LOUIS,PODOR,"THILE BOUBACAR","NDIAYENE PEINDAO","H6 FONDE",13,24,87,100,187
SAINT-LOUIS,PODOR,"THILE BOUBACAR","NDIAYENE PEINDAO","H7 GARAGE NOPEDJI",10,24,98,102,200
SAINT-LOUIS,PODOR,"THILE BOUBACAR","NDIAYENE PEINDAO","H8 SINTHIANE NOPEDJI",5,7,43,36,79
SAINT-LOUIS,PODOR,"THILE BOUBACAR","NDIAYENE PEINDAO","H9 HOUDALLAH",8,16,69,66,135
SAINT-LOUIS,PODOR,"THILE BOUBACAR","NDIAYENE PEINDAO","H10 MAYEL",4,7,13,10,23
SAINT-LOUIS,PODOR,"THILE BOUBACAR","NDIAYENE PEINDAO","H11 PENDAO SAED",26,30,129,101,230
SAINT-LOUIS,PODOR,"THILE BOUBACAR","NDIAYENE PEINDAO","H12 BALAKOS",8,16,39,30,69
SAINT-LOUIS,PODOR,"THILE BOUBACAR","NDIAYENE PEINDAO","H13 POUT GARI",17,19,81,65,146
SAINT-LOUIS,PODOR,"THILE BOUBACAR","NDIAYENE PEINDAO","H14 SEROUME",10,25,58,65,123
SAINT-LOUIS,PODOR,"THILE BOUBACAR","NDIAYENE PEINDAO","H15 WOURO MAODO SAMBOUROU",3,3,15,13,28
SAINT-LOUIS,PODOR,"THILE BOUBACAR","NDIAYENE PEINDAO","H16 NGAB",11,23,65,89,154
SAINT-LOUIS,PODOR,"THILE BOUBACAR","NDIAYENE PEINDAO","H17 FADA",10,25,81,81,162
SAINT-LOUIS,PODOR,"THILE BOUBACAR","NDIAYENE PEINDAO","H18 MOURABA",7,10,69,37,106
SAINT-LOUIS,PODOR,"THILE BOUBACAR","NDIAYENE PEINDAO","POUAH THILLEE",4,5,11,16,27
SAINT-LOUIS,PODOR,"THILE BOUBACAR","NDIAYENE PEINDAO",SENEBOVOL,61,90,352,342,694
SAINT-LOUIS,PODOR,"THILE BOUBACAR","NDIAYENE PEINDAO","H2 BELEL LASSOU",5,6,13,29,42
SAINT-LOUIS,PODOR,"THILE BOUBACAR","NDIAYENE PEINDAO","H3 TECKANGUEL WODAABE",4,5,13,22,35
SAINT-LOUIS,PODOR,"THILE BOUBACAR","NDIAYENE PEINDAO","H4 LOUMBI THIAIGRI",5,10,42,40,82
SAINT-LOUIS,PODOR,"THILE BOUBACAR","NDIAYENE PEINDAO","H5 WAL DE NDIAYENE PENDAO",10,16,45,50,95
SAINT-LOUIS,PODOR,"THILE BOUBACAR","NDIAYENE PEINDAO","H6 KOTI",21,34,123,125,248
SAINT-LOUIS,PODOR,"THILE BOUBACAR","NDIAYENE PEINDAO","H7 KOTI KODIOLEL",4,9,24,36,60
SAINT-LOUIS,PODOR,"THILE BOUBACAR","NDIAYENE PEINDAO","H8 GOUPPOULI",2,4,13,11,24
SAINT-LOUIS,PODOR,"THILE BOUBACAR","NDIAYENE PEINDAO","H9 NGAGAROU",7,7,19,36,55
SAINT-LOUIS,PODOR,"THILE BOUBACAR","NDIAYENE PEINDAO","H10 AWDERE",12,18,97,77,174
SAINT-LOUIS,PODOR,"THILE BOUBACAR","NDIAYENE PEINDAO","H11 PEULH SOGUI",5,8,22,36,58
SAINT-LOUIS,PODOR,"THILE BOUBACAR","NDIAYENE PEINDAO","H12 MINDIELE",3,5,23,29,52
SAINT-LOUIS,PODOR,"THILE BOUBACAR","NDIAYENE PEINDAO","H13 BINGUEL SENO",10,34,137,130,267
SAINT-LOUIS,PODOR,"THILE BOUBACAR","NDIAYENE PEINDAO",THIEWLE,75,118,582,605,1187
SAINT-LOUIS,PODOR,"THILE BOUBACAR","NDIAYENE PEINDAO","H1 WOURO SOULEYMANE DÉH",3,3,13,10,23
SAINT-LOUIS,PODOR,"THILE BOUBACAR","NDIAYENE PEINDAO","THILLE BOUBACAR",195,285,1506,1324,2830
SAINT-LOUIS,PODOR,"THILE BOUBACAR","NDIAYENE PEINDAO","H1 GOUMEL",34,47,245,222,467
SAINT-LOUIS,PODOR,"THILE BOUBACAR","NDIAYENE PEINDAO","H2 FÉTÉ KOBA DE THILLÉ BOUBACAR",6,6,21,25,46
SAINT-LOUIS,PODOR,"THILE BOUBACAR","NDIAYENE PEINDAO","TIVAOUANE II",29,31,92,103,195
SAINT-LOUIS,PODOR,"THILE BOUBACAR","NDIAYENE PEINDAO","H1 KIRAYE II",12,17,53,57,110
SAINT-LOUIS,PODOR,"THILE BOUBACAR","NDIAYENE PEINDAO","H2 MEDINA THIAWLE",2,4,15,18,33
SAINT-LOUIS,PODOR,"THILE BOUBACAR","NDIAYENE PEINDAO","WOURO DOUDEL MBARICK",23,37,116,136,252
SAINT-LOUIS,PODOR,"THILE BOUBACAR","NDIAYENE PEINDAO","WENDOU OLDOU KIRAYE II (COMMUNE NDIAYENE PENDA)",4,7,15,25,40
SAINT-LOUIS,PODOR,"THILE BOUBACAR","NDIAYENE PEINDAO",ARAFAT,21,25,104,140,244
SAINT-LOUIS,PODOR,"THILE BOUBACAR","NDIAYENE PEINDAO","DIARDE BOGEL",1,1,0,4,4
SAINT-LOUIS,PODOR,"THILE BOUBACAR",NIANDANE,AYNOUMADY,172,207,1158,1072,2230
SAINT-LOUIS,PODOR,"THILE BOUBACAR",NIANDANE,FASS,110,129,720,643,1363
SAINT-LOUIS,PODOR,"THILE BOUBACAR",NIANDANE,NDIORNO,100,129,597,561,1158
SAINT-LOUIS,PODOR,"THILE BOUBACAR",NIANDANE,THIALY,146,166,1000,882,1882
SAINT-LOUIS,PODOR,"THILE BOUBACAR",NIANDANE,"CITE SAED",30,37,78,58,136
SAINT-LOUIS,PODOR,"GAMADJI SARE",DODEL,"BELLY THIOWY",56,71,365,468,833
SAINT-LOUIS,PODOR,"GAMADJI SARE",DODEL,"H1 BALEROU",3,3,15,10,25
SAINT-LOUIS,PODOR,"GAMADJI SARE",DODEL,"DARA ALAYBE",263,334,1953,1964,3917
SAINT-LOUIS,PODOR,"GAMADJI SARE",DODEL,"H1 SAMBA THIAKA",4,5,36,36,72
SAINT-LOUIS,PODOR,"GAMADJI SARE",DODEL,"H2 THIORIGUEL",2,3,9,14,23
SAINT-LOUIS,PODOR,"GAMADJI SARE",DODEL,DIAMAL,24,44,202,228,430
SAINT-LOUIS,PODOR,"GAMADJI SARE",DODEL,"H1 NIORMI",9,12,54,48,102
SAINT-LOUIS,PODOR,"GAMADJI SARE",DODEL,"H2 BOME",4,6,21,23,44
SAINT-LOUIS,PODOR,"GAMADJI SARE",DODEL,"H3 TOULELE MAMA",28,42,160,189,349
SAINT-LOUIS,PODOR,"GAMADJI SARE",DODEL,"H4 DIOLBORTOL",14,22,79,116,195
SAINT-LOUIS,PODOR,"GAMADJI SARE",DODEL,"H5 KORKODIEL",9,10,49,34,83
SAINT-LOUIS,PODOR,"GAMADJI SARE",DODEL,"H6 AWDJI",7,7,28,33,61
SAINT-LOUIS,PODOR,"GAMADJI SARE",DODEL,"DIEDHIOUBA EDY",14,15,85,63,148
SAINT-LOUIS,PODOR,"GAMADJI SARE",DODEL,"H1 MARDA DIERY",44,59,261,319,580
SAINT-LOUIS,PODOR,"GAMADJI SARE",DODEL,"H2 DIAMY BAILA",22,27,97,114,211
SAINT-LOUIS,PODOR,"GAMADJI SARE",DODEL,"H3 DIOUWA",28,38,182,224,406
SAINT-LOUIS,PODOR,"GAMADJI SARE",DODEL,"DIEDIOUBA TAGANIT",19,25,100,98,198
SAINT-LOUIS,PODOR,"GAMADJI SARE",DODEL,"H1 KEUR NDIOBO DIOP",7,9,39,33,72
SAINT-LOUIS,PODOR,"GAMADJI SARE",DODEL,"H2 BINGUEL WALALNABE",17,23,108,105,213
SAINT-LOUIS,PODOR,"GAMADJI SARE",DODEL,"H3 WALE WALE",41,58,217,228,445
SAINT-LOUIS,PODOR,"GAMADJI SARE",DODEL,"H4 PETE THILEL",7,10,51,57,108
SAINT-LOUIS,PODOR,"GAMADJI SARE",DODEL,"H5 SABAK THIALAGA",9,15,64,71,135
SAINT-LOUIS,PODOR,"GAMADJI SARE",DODEL,"H6 SABAK MATHIOUBE",6,9,36,40,76
SAINT-LOUIS,PODOR,"GAMADJI SARE",DODEL,"H7 BELY KOYLI",13,27,79,93,172
SAINT-LOUIS,PODOR,"GAMADJI SARE",DODEL,"H8 GNAPANE (WOURO BOUBOU THIAPATO)",7,14,60,49,109
SAINT-LOUIS,PODOR,"GAMADJI SARE",DODEL,"H9 PETE OBAK",19,35,118,124,242
SAINT-LOUIS,PODOR,"GAMADJI SARE",DODEL,"H10 MADIALI",10,15,73,76,149
SAINT-LOUIS,PODOR,"GAMADJI SARE",DODEL,"H11 NDOUFE EDY",9,15,72,69,141
SAINT-LOUIS,PODOR,"GAMADJI SARE",DODEL,"H12 GOUREL ERE",9,14,49,49,98
SAINT-LOUIS,PODOR,"GAMADJI SARE",DODEL,"H13 DIOUBA DIOUWANABE",5,5,20,32,52
SAINT-LOUIS,PODOR,"GAMADJI SARE",DODEL,"H14 FORAGE DEMBA KEDADJI",5,13,49,39,88
SAINT-LOUIS,PODOR,"GAMADJI SARE",DODEL,"H15 LOUMBOL GUELODE",6,16,73,58,131
SAINT-LOUIS,PODOR,"GAMADJI SARE",DODEL,"H16 NGOURA",16,36,109,136,245
SAINT-LOUIS,PODOR,"GAMADJI SARE",DODEL,"H17 ATCH BALLY FORAGE",54,83,302,363,665
SAINT-LOUIS,PODOR,"GAMADJI SARE",DODEL,"H18 LOURENE MAWNDE",15,23,102,116,218
SAINT-LOUIS,PODOR,"GAMADJI SARE",DODEL,"H19 ATCH LANDJI",4,16,42,48,90
SAINT-LOUIS,PODOR,"GAMADJI SARE",DODEL,"H20 ATCH VANDE",20,29,126,139,265
SAINT-LOUIS,PODOR,"GAMADJI SARE",DODEL,"H21 FAMBAL EDY II",21,39,134,168,302
SAINT-LOUIS,PODOR,"GAMADJI SARE",DODEL,"H22 LOUMBOL HAMADY ALY",7,10,50,43,93
SAINT-LOUIS,PODOR,"GAMADJI SARE",DODEL,"H23 LOURENE TOCKSEL",15,24,96,112,208
SAINT-LOUIS,PODOR,"GAMADJI SARE",DODEL,"H24 BARADJI WODABE",20,32,149,133,282
SAINT-LOUIS,PODOR,"GAMADJI SARE",DODEL,"H25 THIEWDE",8,18,64,69,133
SAINT-LOUIS,PODOR,"GAMADJI SARE",DODEL,"H26 BELY KARADJI",21,30,131,167,298
SAINT-LOUIS,PODOR,"GAMADJI SARE",DODEL,"H27 FELDE",22,34,132,134,266
SAINT-LOUIS,PODOR,"GAMADJI SARE",DODEL,"H28 DOGNE",25,47,174,178,352
SAINT-LOUIS,PODOR,"GAMADJI SARE",DODEL,"H29 BINGUEL EDY",17,28,135,110,245
SAINT-LOUIS,PODOR,"GAMADJI SARE",DODEL,"H30 BELEL KOILY",2,3,21,15,36
SAINT-LOUIS,PODOR,"GAMADJI SARE",DODEL,"H31 THIOKATAL",3,5,22,23,45
SAINT-LOUIS,PODOR,"GAMADJI SARE",DODEL,"H32 WINDE MAOUNDE",16,55,136,164,300
SAINT-LOUIS,PODOR,"GAMADJI SARE",DODEL,"H33 WOURO SAMBA HAROUNA",17,26,93,94,187
SAINT-LOUIS,PODOR,"GAMADJI SARE",DODEL,"DIERY DIOUGA",93,127,505,667,1172
SAINT-LOUIS,PODOR,"GAMADJI SARE",DODEL,"H1 MBEEDO",4,8,32,41,73
SAINT-LOUIS,PODOR,"GAMADJI SARE",DODEL,"DIOBE EDY",42,49,158,191,349
SAINT-LOUIS,PODOR,"GAMADJI SARE",DODEL,"H1 SINTHIANE DONGO",25,35,117,169,286
SAINT-LOUIS,PODOR,"GAMADJI SARE",DODEL,DIOMANDOU,147,202,1173,1255,2428
SAINT-LOUIS,PODOR,"GAMADJI SARE",DODEL,"H1 THIGUIPOVE II",6,9,38,46,84
SAINT-LOUIS,PODOR,"GAMADJI SARE",DODEL,"H2 HARESADIO (COMMUNE DE DODEL)",9,10,30,37,67
SAINT-LOUIS,PODOR,"GAMADJI SARE",DODEL,DODEL,363,474,2007,2296,4303
SAINT-LOUIS,PODOR,"GAMADJI SARE",DODEL,"H1 DIAMANDOU WALO",15,22,116,145,261
SAINT-LOUIS,PODOR,"GAMADJI SARE",DODEL,"H2 PALEL BEYE",7,8,47,55,102
SAINT-LOUIS,PODOR,"GAMADJI SARE",DODEL,"H3 TOUFNDE DODEL",1,4,15,22,37
SAINT-LOUIS,PODOR,"GAMADJI SARE",DODEL,"H4 REEDE",18,29,139,158,297
SAINT-LOUIS,PODOR,"GAMADJI SARE",DODEL,"H5 RENE",2,4,23,23,46
SAINT-LOUIS,PODOR,"GAMADJI SARE",DODEL,"H6 TOUFNDE NGUENDY",1,2,9,13,22
SAINT-LOUIS,PODOR,"GAMADJI SARE",DODEL,"H7 PETE BAIDY",18,40,167,178,345
SAINT-LOUIS,PODOR,"GAMADJI SARE",DODEL,"H8 AMEL",10,14,56,82,138
SAINT-LOUIS,PODOR,"GAMADJI SARE",DODEL,"H9 WOURO MAMADOU BOYE",15,23,81,108,189
SAINT-LOUIS,PODOR,"GAMADJI SARE",DODEL,"H10 LOUMBOL DORO",6,47,32,67,99
SAINT-LOUIS,PODOR,"GAMADJI SARE",DODEL,DOUBANGHE,79,95,489,520,1009
SAINT-LOUIS,PODOR,"GAMADJI SARE",DODEL,"GAOUDY GOTTY",54,72,237,335,572
SAINT-LOUIS,PODOR,"GAMADJI SARE",DODEL,"H1 TOWQUI",22,30,143,151,294
SAINT-LOUIS,PODOR,"GAMADJI SARE",DODEL,"H2 OURO SOULEYMANE",21,24,122,130,252
SAINT-LOUIS,PODOR,"GAMADJI SARE",DODEL,"H3 ALWAR",16,18,92,59,151
SAINT-LOUIS,PODOR,"GAMADJI SARE",DODEL,"H4 TAIF",15,18,87,93,180
SAINT-LOUIS,PODOR,"GAMADJI SARE",DODEL,"H5 BALALE",9,11,75,47,122
SAINT-LOUIS,PODOR,"GAMADJI SARE",DODEL,"H6 THILEL TOWNGUEL",19,29,83,101,184
SAINT-LOUIS,PODOR,"GAMADJI SARE",DODEL,MARDA,119,149,626,782,1408
SAINT-LOUIS,PODOR,"GAMADJI SARE",DODEL,"H1 GOUREL MALIKEL",20,27,138,147,285
SAINT-LOUIS,PODOR,"GAMADJI SARE",DODEL,"H2 LEDE",16,20,118,98,216
SAINT-LOUIS,PODOR,"GAMADJI SARE",DODEL,"H3 DIANGA",8,10,36,42,78
SAINT-LOUIS,PODOR,"GAMADJI SARE",DODEL,"H4 TOUFNDE NDJINTHIOU",18,23,88,106,194
SAINT-LOUIS,PODOR,"GAMADJI SARE",DODEL,"H5 WOURO ABOU HAMADOU",2,7,30,31,61
SAINT-LOUIS,PODOR,"GAMADJI SARE",DODEL,"H6 LOBBOUDOU BOWEL",10,10,46,28,74
SAINT-LOUIS,PODOR,"GAMADJI SARE",DODEL,"H7 NDJINTHIOU DIOME",11,12,61,62,123
SAINT-LOUIS,PODOR,"GAMADJI SARE",DODEL,"H8 DANOUYEL",3,4,13,8,21
SAINT-LOUIS,PODOR,"GAMADJI SARE",DODEL,"H9 MBAFAAR",3,5,33,21,54
SAINT-LOUIS,PODOR,"GAMADJI SARE",DODEL,"H10 GOUREL MAHELE",1,1,4,8,12
SAINT-LOUIS,PODOR,"GAMADJI SARE",DODEL,"H11 COGAA MBOYNDOU (JARDIN)",2,2,13,5,18
SAINT-LOUIS,PODOR,"GAMADJI SARE",DODEL,"H12 GOUREL FONDE",14,24,104,101,205
SAINT-LOUIS,PODOR,"GAMADJI SARE",DODEL,"H13 WOURO NDIAWDY",1,2,14,9,23
SAINT-LOUIS,PODOR,"GAMADJI SARE",DODEL,"H14 BARI",1,3,23,13,36
SAINT-LOUIS,PODOR,"GAMADJI SARE",DODEL,"H15 GADADI DIOUVANABE",32,196,172,190,362
SAINT-LOUIS,PODOR,"GAMADJI SARE",DODEL,"H16 GADADI WADABÉ",8,50,34,54,88
SAINT-LOUIS,PODOR,"GAMADJI SARE",DODEL,NDORMBOSS,74,91,470,511,981
SAINT-LOUIS,PODOR,"GAMADJI SARE",DODEL,"NIANGA EDY",128,156,691,807,1498
SAINT-LOUIS,PODOR,"GAMADJI SARE",DODEL,"PATHE GALLO",95,115,574,612,1186
SAINT-LOUIS,PODOR,"GAMADJI SARE",DODEL,"H1 WOUA WOUA",27,40,216,217,433
SAINT-LOUIS,PODOR,"GAMADJI SARE",DODEL,"H2 SINTHIOU SILBE",21,29,116,144,260
SAINT-LOUIS,PODOR,"GAMADJI SARE",DODEL,"H3 SINTHIANE DEMBA HABY",4,10,39,31,70
SAINT-LOUIS,PODOR,"GAMADJI SARE",DODEL,POURY,9,18,95,92,187
SAINT-LOUIS,PODOR,"GAMADJI SARE",DODEL,"SASSEL TALBE",83,96,528,666,1194
SAINT-LOUIS,PODOR,"GAMADJI SARE",DODEL,"H1 KEUR LEBBOU GUI",1,1,6,5,11
SAINT-LOUIS,PODOR,"GAMADJI SARE",DODEL,"SINTHIOU DANGDE",170,205,1138,1148,2286
SAINT-LOUIS,PODOR,"GAMADJI SARE",DODEL,"H1 BONGADJI",7,13,47,30,77
SAINT-LOUIS,PODOR,"GAMADJI SARE",DODEL,"H2 SORY NGOUNGA",8,12,54,60,114
SAINT-LOUIS,PODOR,"GAMADJI SARE",DODEL,"H4 DIAMEL DIARALDOU",1,1,6,7,13
SAINT-LOUIS,PODOR,"GAMADJI SARE",DODEL,"H5 GOUREL MOUSSA",1,1,27,30,57
SAINT-LOUIS,PODOR,"GAMADJI SARE",DODEL,"SINTHIOU IFRA",25,30,151,142,293
SAINT-LOUIS,PODOR,"GAMADJI SARE",DODEL,"H1 THIENEL FOULBE",34,37,175,183,358
SAINT-LOUIS,PODOR,"GAMADJI SARE",DODEL,"H2 DJOUNDOU",1,2,11,1,12
SAINT-LOUIS,PODOR,"GAMADJI SARE",DODEL,"H3 KEDELE DAR SALAM",20,29,146,164,310
SAINT-LOUIS,PODOR,"GAMADJI SARE",DODEL,SOKOU,12,18,75,102,177
SAINT-LOUIS,PODOR,"GAMADJI SARE",DODEL,THIALAGA,138,195,865,934,1799
SAINT-LOUIS,PODOR,"GAMADJI SARE",DODEL,"H1 GNAPANE",2,4,13,10,23
SAINT-LOUIS,PODOR,"GAMADJI SARE",DODEL,"THIENEL SAKHOBES",45,71,282,302,584
SAINT-LOUIS,PODOR,"GAMADJI SARE",DODEL,"H1 OURO MAMADEL",9,14,54,37,91
SAINT-LOUIS,PODOR,"GAMADJI SARE",DODEL,"H2 GALLOU SOUSKA",6,18,73,82,155
SAINT-LOUIS,PODOR,"GAMADJI SARE",DODEL,"H3 BAWEL",15,28,114,125,239
SAINT-LOUIS,PODOR,"GAMADJI SARE",DODEL,"H4 OURO SAMBA GOBI",8,14,41,43,84
SAINT-LOUIS,PODOR,"GAMADJI SARE",DODEL,"H5 BOWEL BARI",10,13,41,51,92
SAINT-LOUIS,PODOR,"GAMADJI SARE",DODEL,"TOULDE GALLE",192,292,1161,1296,2457
SAINT-LOUIS,PODOR,"GAMADJI SARE",DODEL,"H1 LAGNE",6,8,22,28,50
SAINT-LOUIS,PODOR,"GAMADJI SARE",DODEL,YANANKE,24,35,139,141,280
SAINT-LOUIS,PODOR,"GAMADJI SARE",DODEL,"H1 BEPAR",10,16,93,82,175
SAINT-LOUIS,PODOR,"GAMADJI SARE",DODEL,"H2 NDOBANE",1,4,18,20,38
SAINT-LOUIS,PODOR,"GAMADJI SARE",DODEL,"PETE MAMADOU DIAMODY",14,15,49,64,113
SAINT-LOUIS,PODOR,"GAMADJI SARE",DODEL,"H1 GOUREL DEMBA BINTA",2,2,8,7,15
SAINT-LOUIS,PODOR,"GAMADJI SARE",DODEL,LOBOUDOU,4,4,15,13,28
SAINT-LOUIS,PODOR,"GAMADJI SARE",DODEL,"SAMBA GOREL",1,1,6,4,10
SAINT-LOUIS,PODOR,"GAMADJI SARE",DODEL,VELINGARA,1,1,4,5,9
SAINT-LOUIS,PODOR,"GAMADJI SARE",DODEL,THIAGUE,9,12,44,55,99
SAINT-LOUIS,PODOR,"GAMADJI SARE","GAMADJI SARE",ALWAR,60,71,393,404,797
SAINT-LOUIS,PODOR,"GAMADJI SARE","GAMADJI SARE","H1 TOUFNDE BALLY",20,22,88,103,191
SAINT-LOUIS,PODOR,"GAMADJI SARE","GAMADJI SARE","H2 PROJET BOUKA",4,8,25,19,44
SAINT-LOUIS,PODOR,"GAMADJI SARE","GAMADJI SARE","H3 DEMBA BOLO SOW",3,3,9,13,22
SAINT-LOUIS,PODOR,"GAMADJI SARE","GAMADJI SARE","H4 LAHEL GUELADJI KARADJI",9,16,63,72,135
SAINT-LOUIS,PODOR,"GAMADJI SARE","GAMADJI SARE","H5 DIAO",9,12,56,73,129
SAINT-LOUIS,PODOR,"GAMADJI SARE","GAMADJI SARE","H6 MOUNDOUWAYE",37,59,277,313,590
SAINT-LOUIS,PODOR,"GAMADJI SARE","GAMADJI SARE","H7 SAMBA DIALLO",2,2,6,16,22
SAINT-LOUIS,PODOR,"GAMADJI SARE","GAMADJI SARE","H8 WALY DIATTA",7,8,44,49,93
SAINT-LOUIS,PODOR,"GAMADJI SARE","GAMADJI SARE","H9 LOBOUDOU",1,1,5,8,13
SAINT-LOUIS,PODOR,"GAMADJI SARE","GAMADJI SARE","H10 FONDE ALWAR",11,21,84,64,148
SAINT-LOUIS,PODOR,"GAMADJI SARE","GAMADJI SARE","H11 ARRIWELE WALO",11,14,63,68,131
SAINT-LOUIS,PODOR,"GAMADJI SARE","GAMADJI SARE","H12 GOUREL MAMA LY",4,5,13,14,27
SAINT-LOUIS,PODOR,"GAMADJI SARE","GAMADJI SARE",DEMBE,43,46,224,230,454
SAINT-LOUIS,PODOR,"GAMADJI SARE","GAMADJI SARE",DIARRA,36,44,307,339,646
SAINT-LOUIS,PODOR,"GAMADJI SARE","GAMADJI SARE","H1 SINTHIOU FARBA",4,4,20,28,48
SAINT-LOUIS,PODOR,"GAMADJI SARE","GAMADJI SARE","H2 IBRAHIMA SY",4,4,30,31,61
SAINT-LOUIS,PODOR,"GAMADJI SARE","GAMADJI SARE","H3 THIALMA",29,34,155,162,317
SAINT-LOUIS,PODOR,"GAMADJI SARE","GAMADJI SARE","GAMADJI SARRE",198,252,1102,1219,2321
SAINT-LOUIS,PODOR,"GAMADJI SARE","GAMADJI SARE","H1 SINTHIOU GAMADJI",15,18,120,77,197
SAINT-LOUIS,PODOR,"GAMADJI SARE","GAMADJI SARE","H2 VELINGARA",15,15,75,67,142
SAINT-LOUIS,PODOR,"GAMADJI SARE","GAMADJI SARE","H3 HANDALOU",7,9,32,43,75
SAINT-LOUIS,PODOR,"GAMADJI SARE","GAMADJI SARE","H4 TAYLANE",16,18,67,60,127
SAINT-LOUIS,PODOR,"GAMADJI SARE","GAMADJI SARE","H5 FETE DJAYE TOROBE",5,8,53,51,104
SAINT-LOUIS,PODOR,"GAMADJI SARE","GAMADJI SARE","H6 BADIAGARA",6,7,39,51,90
SAINT-LOUIS,PODOR,"GAMADJI SARE","GAMADJI SARE","H7 BOULI DIABAL",16,20,88,83,171
SAINT-LOUIS,PODOR,"GAMADJI SARE","GAMADJI SARE","GOUREL BOLO",31,47,228,251,479
SAINT-LOUIS,PODOR,"GAMADJI SARE","GAMADJI SARE","H1 FAMBAL MOUSSA",16,23,60,91,151
SAINT-LOUIS,PODOR,"GAMADJI SARE","GAMADJI SARE","KAEL DIARRA",36,39,238,189,427
SAINT-LOUIS,PODOR,"GAMADJI SARE","GAMADJI SARE","KAEL THIERNO MAMADOU",55,63,305,373,678
SAINT-LOUIS,PODOR,"GAMADJI SARE","GAMADJI SARE","KOILY GOTTY",3,5,11,17,28
SAINT-LOUIS,PODOR,"GAMADJI SARE","GAMADJI SARE","H1 BOUKI NDOULA FORAGE",7,12,23,42,65
SAINT-LOUIS,PODOR,"GAMADJI SARE","GAMADJI SARE","H2 BINGUEL MODJI",7,12,40,38,78
SAINT-LOUIS,PODOR,"GAMADJI SARE","GAMADJI SARE","H3 OURO PETEL",18,23,87,93,180
SAINT-LOUIS,PODOR,"GAMADJI SARE","GAMADJI SARE","H4 BELGANE I",15,34,106,110,216
SAINT-LOUIS,PODOR,"GAMADJI SARE","GAMADJI SARE","H5 GOUREL BOKI",12,18,57,73,130
SAINT-LOUIS,PODOR,"GAMADJI SARE","GAMADJI SARE","H6 BELGANE II",5,18,30,56,86
SAINT-LOUIS,PODOR,"GAMADJI SARE","GAMADJI SARE","H7 LOUGUE POMEDIO",11,18,59,74,133
SAINT-LOUIS,PODOR,"GAMADJI SARE","GAMADJI SARE","H8 FETERE MOURTODJI",5,18,105,73,178
SAINT-LOUIS,PODOR,"GAMADJI SARE","GAMADJI SARE","H9 YOLI I",7,27,109,86,195
SAINT-LOUIS,PODOR,"GAMADJI SARE","GAMADJI SARE","H10 YOLI II",20,45,144,188,332
SAINT-LOUIS,PODOR,"GAMADJI SARE","GAMADJI SARE","H11 KAREL I",8,22,62,60,122
SAINT-LOUIS,PODOR,"GAMADJI SARE","GAMADJI SARE","H12 LOUBEL BARA",12,34,139,100,239
SAINT-LOUIS,PODOR,"GAMADJI SARE","GAMADJI SARE","H13 BOUKY NDOULA",16,28,76,105,181
SAINT-LOUIS,PODOR,"GAMADJI SARE","GAMADJI SARE","H14 LOUMBOL BOULBE",5,13,37,55,92
SAINT-LOUIS,PODOR,"GAMADJI SARE","GAMADJI SARE","H15 LOUMBOL DADO",4,7,20,20,40
SAINT-LOUIS,PODOR,"GAMADJI SARE","GAMADJI SARE","H16 BOMBODE (OURO DOUROU)",21,59,255,198,453
SAINT-LOUIS,PODOR,"GAMADJI SARE","GAMADJI SARE","H17 KAREL II",3,11,25,25,50
SAINT-LOUIS,PODOR,"GAMADJI SARE","GAMADJI SARE","H18 BOMBODE OURO DARRA",7,13,37,37,74
SAINT-LOUIS,PODOR,"GAMADJI SARE","GAMADJI SARE","H19 MBELOGNE II",4,10,39,35,74
SAINT-LOUIS,PODOR,"GAMADJI SARE","GAMADJI SARE","H20 MBELOGNE III",11,26,119,81,200
SAINT-LOUIS,PODOR,"GAMADJI SARE","GAMADJI SARE","H21 FORAGE BOMBODE",12,23,80,78,158
SAINT-LOUIS,PODOR,"GAMADJI SARE","GAMADJI SARE","H22 KADIOGNE II",8,22,84,105,189
SAINT-LOUIS,PODOR,"GAMADJI SARE","GAMADJI SARE","H23 KADIOGNE I",1,11,42,46,88
SAINT-LOUIS,PODOR,"GAMADJI SARE","GAMADJI SARE","H24 PELEL",9,19,87,76,163
SAINT-LOUIS,PODOR,"GAMADJI SARE","GAMADJI SARE","H25 HAMET KORGA I",10,24,111,102,213
SAINT-LOUIS,PODOR,"GAMADJI SARE","GAMADJI SARE","H26 LALOWI",17,45,214,210,424
SAINT-LOUIS,PODOR,"GAMADJI SARE","GAMADJI SARE","H27 BELONGNE GALLE DIARI",5,15,41,43,84
SAINT-LOUIS,PODOR,"GAMADJI SARE","GAMADJI SARE","H28 MBELOGNE I",9,51,174,179,353
SAINT-LOUIS,PODOR,"GAMADJI SARE","GAMADJI SARE","H29 GOUREL MEGOU",4,4,14,15,29
SAINT-LOUIS,PODOR,"GAMADJI SARE","GAMADJI SARE","H30 BALLA",5,8,20,37,57
SAINT-LOUIS,PODOR,"GAMADJI SARE","GAMADJI SARE","H31 BOUBOU NDIYAME",3,7,32,46,78
SAINT-LOUIS,PODOR,"GAMADJI SARE","GAMADJI SARE","H32 WINDOU DIAME",21,26,98,124,222
SAINT-LOUIS,PODOR,"GAMADJI SARE","GAMADJI SARE","H33 BEVEDJI II",19,22,73,104,177
SAINT-LOUIS,PODOR,"GAMADJI SARE","GAMADJI SARE","H34 BEVEDJI I",18,38,177,203,380
SAINT-LOUIS,PODOR,"GAMADJI SARE","GAMADJI SARE","H35 GASE THIKATAL",9,16,78,53,131
SAINT-LOUIS,PODOR,"GAMADJI SARE","GAMADJI SARE","H36 WOURO SAIDOROU",7,15,38,53,91
SAINT-LOUIS,PODOR,"GAMADJI SARE","GAMADJI SARE","H37 POGUÈL DIAMI",9,9,33,31,64
SAINT-LOUIS,PODOR,"GAMADJI SARE","GAMADJI SARE","H38 WOUROU SAMBA DIOUMEL",5,17,73,66,139
SAINT-LOUIS,PODOR,"GAMADJI SARE","GAMADJI SARE","H39 SINTHIANE BOUKI NDOULA",3,5,20,25,45
SAINT-LOUIS,PODOR,"GAMADJI SARE","GAMADJI SARE","KOPE MANGAYE",29,35,170,137,307
SAINT-LOUIS,PODOR,"GAMADJI SARE","GAMADJI SARE","H1 PALE KOPE",6,7,22,36,58
SAINT-LOUIS,PODOR,"GAMADJI SARE","GAMADJI SARE","H2 PALE MACHINE",7,7,50,28,78
SAINT-LOUIS,PODOR,"GAMADJI SARE","GAMADJI SARE","H3 SERPOLI",15,22,55,65,120
SAINT-LOUIS,PODOR,"GAMADJI SARE","GAMADJI SARE","KORKADIEL (LIDOUBE)",44,47,234,264,498
SAINT-LOUIS,PODOR,"GAMADJI SARE","GAMADJI SARE","MANGAYE (OURO MANGOY)",26,39,150,154,304
SAINT-LOUIS,PODOR,"GAMADJI SARE","GAMADJI SARE","H1 DEGUAYE MAKAGNE",10,17,56,78,134
SAINT-LOUIS,PODOR,"GAMADJI SARE","GAMADJI SARE","H2 ABA",25,50,162,210,372
SAINT-LOUIS,PODOR,"GAMADJI SARE","GAMADJI SARE","H3 OWANDO",18,28,77,103,180
SAINT-LOUIS,PODOR,"GAMADJI SARE","GAMADJI SARE","H4 PETONE",2,4,12,18,30
SAINT-LOUIS,PODOR,"GAMADJI SARE","GAMADJI SARE","H5 BIDA",26,57,180,225,405
SAINT-LOUIS,PODOR,"GAMADJI SARE","GAMADJI SARE","H6 BELEL BOUKI",9,13,63,76,139
SAINT-LOUIS,PODOR,"GAMADJI SARE","GAMADJI SARE",NAMAREL,44,67,365,383,748
SAINT-LOUIS,PODOR,"GAMADJI SARE","GAMADJI SARE","H1 HAME KORGA 2",21,48,185,173,358
SAINT-LOUIS,PODOR,"GAMADJI SARE","GAMADJI SARE","H2 BOVEDI LEDEME",17,37,157,150,307
SAINT-LOUIS,PODOR,"GAMADJI SARE","GAMADJI SARE","H3 DIALAMBANE",16,37,152,157,309
SAINT-LOUIS,PODOR,"GAMADJI SARE","GAMADJI SARE","H4 LOUMBOL SINKO",13,34,73,60,133
SAINT-LOUIS,PODOR,"GAMADJI SARE","GAMADJI SARE","H5 BELEL BALA",3,7,34,34,68
SAINT-LOUIS,PODOR,"GAMADJI SARE","GAMADJI SARE","H6 LOUMBOL KOBO",14,29,146,119,265
SAINT-LOUIS,PODOR,"GAMADJI SARE","GAMADJI SARE","H7 LOUMBOL DIAME",8,26,106,95,201
SAINT-LOUIS,PODOR,"GAMADJI SARE","GAMADJI SARE","H8 NAMARDE OURO THILLE",12,32,108,100,208
SAINT-LOUIS,PODOR,"GAMADJI SARE","GAMADJI SARE","H9 NAMARDE OURO GALLO",15,70,113,147,260
SAINT-LOUIS,PODOR,"GAMADJI SARE","GAMADJI SARE","H10 NAMARDE BONI",13,59,146,150,296
SAINT-LOUIS,PODOR,"GAMADJI SARE","GAMADJI SARE","H11 WOURO ABDOUL SIRÉ",5,9,64,60,124
SAINT-LOUIS,PODOR,"GAMADJI SARE","GAMADJI SARE","H12 YOLI III",10,31,107,118,225
SAINT-LOUIS,PODOR,"GAMADJI SARE","GAMADJI SARE","H13 WOURO AMADOU BOYE",2,4,14,7,21
SAINT-LOUIS,PODOR,"GAMADJI SARE","GAMADJI SARE","H14 WOURO DIAM BOUBOU",8,20,57,51,108
SAINT-LOUIS,PODOR,"GAMADJI SARE","GAMADJI SARE","H15 LOUMBOL THIOLY",6,12,39,41,80
SAINT-LOUIS,PODOR,"GAMADJI SARE","GAMADJI SARE","H16 KARA WOURO PATHÉ",4,7,37,23,60
SAINT-LOUIS,PODOR,"GAMADJI SARE","GAMADJI SARE","H17 NAYDÈ WOURO DADÉL",2,5,16,25,41
SAINT-LOUIS,PODOR,"GAMADJI SARE","GAMADJI SARE","H18 NAEDE WOURO SICK",4,20,72,66,138
SAINT-LOUIS,PODOR,"GAMADJI SARE","GAMADJI SARE","H19 NAEDE WOURO SAMBA LEWO",3,8,38,26,64
SAINT-LOUIS,PODOR,"GAMADJI SARE","GAMADJI SARE","H20 NAEDE WOURO DEMBA DIELO",9,18,80,79,159
SAINT-LOUIS,PODOR,"GAMADJI SARE","GAMADJI SARE","H21 NAEDE WOURO GANEL",6,13,29,43,72
SAINT-LOUIS,PODOR,"GAMADJI SARE","GAMADJI SARE","H22 WOURO ALIOU MAMADOU BILLO",8,24,122,122,244
SAINT-LOUIS,PODOR,"GAMADJI SARE","GAMADJI SARE","H23 WOUROU KALIDOU DIOYRÉ",5,14,62,60,122
SAINT-LOUIS,PODOR,"GAMADJI SARE","GAMADJI SARE","H24 NAMARDE WOURO THIOUB",5,24,46,51,97
SAINT-LOUIS,PODOR,"GAMADJI SARE","GAMADJI SARE","H25 WOURO SAYDOU MODY",5,6,21,20,41
SAINT-LOUIS,PODOR,"GAMADJI SARE","GAMADJI SARE","H26 LOUMBOUL THIOWI",10,19,63,80,143
SAINT-LOUIS,PODOR,"GAMADJI SARE","GAMADJI SARE","H27 FAMBAL NGADIACK",6,15,58,65,123
SAINT-LOUIS,PODOR,"GAMADJI SARE","GAMADJI SARE","H28 FAMBAL WODABE",19,35,134,153,287
SAINT-LOUIS,PODOR,"GAMADJI SARE","GAMADJI SARE","H29 WOURO MOUSSA DIAMODY",5,7,34,45,79
SAINT-LOUIS,PODOR,"GAMADJI SARE","GAMADJI SARE",NGADIACK,53,62,342,279,621
SAINT-LOUIS,PODOR,"GAMADJI SARE","GAMADJI SARE",NGANE,51,57,193,266,459
SAINT-LOUIS,PODOR,"GAMADJI SARE","GAMADJI SARE","H1 TIVAOUANE",3,5,20,12,32
SAINT-LOUIS,PODOR,"GAMADJI SARE","GAMADJI SARE","H2 GANKI BEYLA",8,9,28,34,62
SAINT-LOUIS,PODOR,"GAMADJI SARE","GAMADJI SARE","H3 BAYLA",19,26,130,120,250
SAINT-LOUIS,PODOR,"GAMADJI SARE","GAMADJI SARE","H4 BOCAR COUMBA",9,10,33,44,77
SAINT-LOUIS,PODOR,"GAMADJI SARE","GAMADJI SARE","H5 PATOUDE",36,50,144,191,335
SAINT-LOUIS,PODOR,"GAMADJI SARE","GAMADJI SARE","H6 SABOU ALLAH",34,39,139,168,307
SAINT-LOUIS,PODOR,"GAMADJI SARE","GAMADJI SARE","H7 HARY FOUNDA",23,30,132,151,283
SAINT-LOUIS,PODOR,"GAMADJI SARE","GAMADJI SARE","H8 GADJEL",1,1,3,2,5
SAINT-LOUIS,PODOR,"GAMADJI SARE","GAMADJI SARE","OURO MALEY",71,86,356,444,800
SAINT-LOUIS,PODOR,"GAMADJI SARE","GAMADJI SARE","H1 GOUREL KEBE",13,14,73,56,129
SAINT-LOUIS,PODOR,"GAMADJI SARE","GAMADJI SARE","OURO MBAYE",27,36,182,210,392
SAINT-LOUIS,PODOR,"GAMADJI SARE","GAMADJI SARE",THIELAO,154,179,949,970,1919
SAINT-LOUIS,PODOR,"GAMADJI SARE","GAMADJI SARE","H1 HOUDOU",14,15,88,77,165
SAINT-LOUIS,PODOR,"GAMADJI SARE","GAMADJI SARE","H2 DIOUKLY",1,1,1,2,3
SAINT-LOUIS,PODOR,"GAMADJI SARE","GAMADJI SARE","H3 BEKEWEKE",3,3,26,20,46
SAINT-LOUIS,PODOR,"GAMADJI SARE","GAMADJI SARE","NAEDE WOURO SALA (DE LABGAR)",12,29,81,103,184
SAINT-LOUIS,PODOR,"GAMADJI SARE","GAMADJI SARE","OURO BELO KETHIE",4,8,40,33,73
SAINT-LOUIS,PODOR,"GAMADJI SARE","GAMADJI SARE","H20 WIWANO",5,12,61,38,99
SAINT-LOUIS,PODOR,"GAMADJI SARE","GAMADJI SARE","H2 NDIONGUERE",5,19,86,65,151
SAINT-LOUIS,PODOR,"GAMADJI SARE","GAMADJI SARE","MADINA GAMADJI",13,34,73,132,205
SAINT-LOUIS,PODOR,"GAMADJI SARE","GAMADJI SARE","H19 DIABELE",2,2,14,8,22
SAINT-LOUIS,PODOR,"GAMADJI SARE","GAMADJI SARE","OURO SEYDOU BODIAN",4,5,73,64,137
SAINT-LOUIS,PODOR,"GAMADJI SARE","GAMADJI SARE","BELOGNE WOUROU SILEY",2,9,37,32,69
SAINT-LOUIS,PODOR,"GAMADJI SARE","GAMADJI SARE","MBELOGNE OURO KALIDEL",5,13,42,37,79
SAINT-LOUIS,PODOR,"GAMADJI SARE","GUEDE VILLAGE","AGNAM TONGUEL",123,140,715,742,1457
SAINT-LOUIS,PODOR,"GAMADJI SARE","GUEDE VILLAGE",ATIYA,13,22,80,81,161
SAINT-LOUIS,PODOR,"GAMADJI SARE","GUEDE VILLAGE","H2 MEDINA FASS",20,28,116,95,211
SAINT-LOUIS,PODOR,"GAMADJI SARE","GUEDE VILLAGE","H3 TEHENDE YALY",15,22,93,87,180
SAINT-LOUIS,PODOR,"GAMADJI SARE","GUEDE VILLAGE","BELELE KELLE",79,91,282,450,732
SAINT-LOUIS,PODOR,"GAMADJI SARE","GUEDE VILLAGE",DADO,39,67,361,332,693
SAINT-LOUIS,PODOR,"GAMADJI SARE","GUEDE VILLAGE","H2 DOUBEL",4,4,23,25,48
SAINT-LOUIS,PODOR,"GAMADJI SARE","GUEDE VILLAGE","H3 PODEL MADINA",8,16,87,93,180
SAINT-LOUIS,PODOR,"GAMADJI SARE","GUEDE VILLAGE",DEBOUNAZOL,5,10,22,30,52
SAINT-LOUIS,PODOR,"GAMADJI SARE","GUEDE VILLAGE","DIAMA ALWALY",77,95,424,439,863
SAINT-LOUIS,PODOR,"GAMADJI SARE","GUEDE VILLAGE","H1 SABAR",11,11,58,61,119
SAINT-LOUIS,PODOR,"GAMADJI SARE","GUEDE VILLAGE","H2 HARI FOUNDA",8,10,49,36,85
SAINT-LOUIS,PODOR,"GAMADJI SARE","GUEDE VILLAGE","H3 DIAMA WOURO",2,2,5,6,11
SAINT-LOUIS,PODOR,"GAMADJI SARE","GUEDE VILLAGE","H4 KORKADJI",42,46,210,200,410
SAINT-LOUIS,PODOR,"GAMADJI SARE","GUEDE VILLAGE","H5 OURO THIAMON",5,6,30,33,63
SAINT-LOUIS,PODOR,"GAMADJI SARE","GUEDE VILLAGE","H6 PALLE KELLY",19,21,98,98,196
SAINT-LOUIS,PODOR,"GAMADJI SARE","GUEDE VILLAGE","H7 OURO DORO",6,7,38,30,68
SAINT-LOUIS,PODOR,"GAMADJI SARE","GUEDE VILLAGE","DIAMBO DIAOBE",37,59,266,285,551
SAINT-LOUIS,PODOR,"GAMADJI SARE","GUEDE VILLAGE","H1 FONDE THILALE",4,5,18,16,34
SAINT-LOUIS,PODOR,"GAMADJI SARE","GUEDE VILLAGE","DIAMBO THIOUBALO",74,79,479,426,905
SAINT-LOUIS,PODOR,"GAMADJI SARE","GUEDE VILLAGE","H1 LOUMBOL SAMBANABE",11,33,163,132,295
SAINT-LOUIS,PODOR,"GAMADJI SARE","GUEDE VILLAGE","H2 DAL ALIOU",9,11,44,47,91
SAINT-LOUIS,PODOR,"GAMADJI SARE","GUEDE VILLAGE","H3 WOUROU ALY",4,8,40,40,80
SAINT-LOUIS,PODOR,"GAMADJI SARE","GUEDE VILLAGE",DIATAR,191,251,1198,1155,2353
SAINT-LOUIS,PODOR,"GAMADJI SARE","GUEDE VILLAGE","H1 REGUESS BOURSOUDOU",13,13,57,85,142
SAINT-LOUIS,PODOR,"GAMADJI SARE","GUEDE VILLAGE","H2 VANDE KADE",12,22,149,110,259
SAINT-LOUIS,PODOR,"GAMADJI SARE","GUEDE VILLAGE","DIEGUESS DAROU SALAM",40,50,184,251,435
SAINT-LOUIS,PODOR,"GAMADJI SARE","GUEDE VILLAGE","H1 LORTI",16,19,85,115,200
SAINT-LOUIS,PODOR,"GAMADJI SARE","GUEDE VILLAGE","H2 GUEDE DIERI",52,61,226,287,513
SAINT-LOUIS,PODOR,"GAMADJI SARE","GUEDE VILLAGE",DONAYE,15,16,87,83,170
SAINT-LOUIS,PODOR,"GAMADJI SARE","GUEDE VILLAGE","H1 TOGUEL",6,6,36,26,62
SAINT-LOUIS,PODOR,"GAMADJI SARE","GUEDE VILLAGE","H2 OURO HADY SALL",9,17,60,55,115
SAINT-LOUIS,PODOR,"GAMADJI SARE","GUEDE VILLAGE","H3 GAYO",9,15,54,48,102
SAINT-LOUIS,PODOR,"GAMADJI SARE","GUEDE VILLAGE","H5 MACINE",9,9,36,44,80
SAINT-LOUIS,PODOR,"GAMADJI SARE","GUEDE VILLAGE","DONAYE TAREDJI",378,423,2079,2135,4214
SAINT-LOUIS,PODOR,"GAMADJI SARE","GUEDE VILLAGE","H1 MAWNDOU",6,8,31,28,59
SAINT-LOUIS,PODOR,"GAMADJI SARE","GUEDE VILLAGE","H1 FASS TAREDJI",9,12,51,57,108
SAINT-LOUIS,PODOR,"GAMADJI SARE","GUEDE VILLAGE",DOUE,93,131,781,797,1578
SAINT-LOUIS,PODOR,"GAMADJI SARE","GUEDE VILLAGE","H1 KEUR MAMADOU BOUBOU DIA",2,4,23,18,41
SAINT-LOUIS,PODOR,"GAMADJI SARE","GUEDE VILLAGE","H2 BOYELE",2,2,8,7,15
SAINT-LOUIS,PODOR,"GAMADJI SARE","GUEDE VILLAGE","H3 NDIAGORE",2,4,16,15,31
SAINT-LOUIS,PODOR,"GAMADJI SARE","GUEDE VILLAGE","H4 MBARANE 1",3,8,59,26,85
SAINT-LOUIS,PODOR,"GAMADJI SARE","GUEDE VILLAGE","H5 ISSA SALL",1,4,19,22,41
SAINT-LOUIS,PODOR,"GAMADJI SARE","GUEDE VILLAGE","H6 MBARANE 2",6,6,42,30,72
SAINT-LOUIS,PODOR,"GAMADJI SARE","GUEDE VILLAGE","FONDE ASS",41,60,302,259,561
SAINT-LOUIS,PODOR,"GAMADJI SARE","GUEDE VILLAGE","H1 ANTENNE DABAYE",8,11,51,42,93
SAINT-LOUIS,PODOR,"GAMADJI SARE","GUEDE VILLAGE","H2 OURO SIDY",11,12,80,67,147
SAINT-LOUIS,PODOR,"GAMADJI SARE","GUEDE VILLAGE","H3 MEDINA MAMADOU",8,8,49,37,86
SAINT-LOUIS,PODOR,"GAMADJI SARE","GUEDE VILLAGE","H4 FALO SEWNGO",8,13,45,53,98
SAINT-LOUIS,PODOR,"GAMADJI SARE","GUEDE VILLAGE","GOUMEL GOULADJI",21,39,172,170,342
SAINT-LOUIS,PODOR,"GAMADJI SARE","GUEDE VILLAGE","GUEDE VILLAGE",188,236,1076,1021,2097
SAINT-LOUIS,PODOR,"GAMADJI SARE","GUEDE VILLAGE","H1 MBANTOU WALO",12,17,99,83,182
SAINT-LOUIS,PODOR,"GAMADJI SARE","GUEDE VILLAGE","H2 DIAM BERGUE",5,6,26,24,50
SAINT-LOUIS,PODOR,"GAMADJI SARE","GUEDE VILLAGE",GUIA,239,320,2041,1972,4013
SAINT-LOUIS,PODOR,"GAMADJI SARE","GUEDE VILLAGE","H1 DAROU WANLANG",15,40,186,145,331
SAINT-LOUIS,PODOR,"GAMADJI SARE","GUEDE VILLAGE","H2 GUIA 4",13,21,94,81,175
SAINT-LOUIS,PODOR,"GAMADJI SARE","GUEDE VILLAGE","H3 MEDINA CHEIKHOU OUMAR",8,8,59,54,113
SAINT-LOUIS,PODOR,"GAMADJI SARE","GUEDE VILLAGE",KODITH,58,69,368,357,725
SAINT-LOUIS,PODOR,"GAMADJI SARE","GUEDE VILLAGE","H1 THIAPATODJI",9,9,38,41,79
SAINT-LOUIS,PODOR,"GAMADJI SARE","GUEDE VILLAGE","H2 NAMARDI",18,22,124,106,230
SAINT-LOUIS,PODOR,"GAMADJI SARE","GUEDE VILLAGE","H4 DAROU SALAM",14,14,67,64,131
SAINT-LOUIS,PODOR,"GAMADJI SARE","GUEDE VILLAGE","H5 TEKHINDE",20,25,125,95,220
SAINT-LOUIS,PODOR,"GAMADJI SARE","GUEDE VILLAGE",LERABE,101,132,737,810,1547
SAINT-LOUIS,PODOR,"GAMADJI SARE","GUEDE VILLAGE","H1 THIAGLE",69,119,592,630,1222
SAINT-LOUIS,PODOR,"GAMADJI SARE","GUEDE VILLAGE","H2 BELEL NAEDE",1,1,5,10,15
SAINT-LOUIS,PODOR,"GAMADJI SARE","GUEDE VILLAGE",MAFRE,60,92,384,427,811
SAINT-LOUIS,PODOR,"GAMADJI SARE","GUEDE VILLAGE","H1 ALANA",5,13,44,43,87
SAINT-LOUIS,PODOR,"GAMADJI SARE","GUEDE VILLAGE","H2 LOUMBOL THIOLAM",4,6,31,43,74
SAINT-LOUIS,PODOR,"GAMADJI SARE","GUEDE VILLAGE","H3 BINGUEL SENO",6,12,38,46,84
SAINT-LOUIS,PODOR,"GAMADJI SARE","GUEDE VILLAGE","H4 OURO BATAYEL DIAKHATE",1,2,5,8,13
SAINT-LOUIS,PODOR,"GAMADJI SARE","GUEDE VILLAGE","H5 FORAGE KODIALELE",4,10,47,44,91
SAINT-LOUIS,PODOR,"GAMADJI SARE","GUEDE VILLAGE","H6 LENDE MBANA",9,11,55,59,114
SAINT-LOUIS,PODOR,"GAMADJI SARE","GUEDE VILLAGE","H7 OURO SAMBA BODEYELE BA",5,14,44,48,92
SAINT-LOUIS,PODOR,"GAMADJI SARE","GUEDE VILLAGE","H8 OURO GUISSE",5,5,26,27,53
SAINT-LOUIS,PODOR,"GAMADJI SARE","GUEDE VILLAGE","H9 NDIARNO",22,32,139,176,315
SAINT-LOUIS,PODOR,"GAMADJI SARE","GUEDE VILLAGE","H10 OURO OLO",2,4,12,12,24
SAINT-LOUIS,PODOR,"GAMADJI SARE","GUEDE VILLAGE","H11 BETER LO",14,23,92,101,193
SAINT-LOUIS,PODOR,"GAMADJI SARE","GUEDE VILLAGE","H12 YAWARA",4,6,29,16,45
SAINT-LOUIS,PODOR,"GAMADJI SARE","GUEDE VILLAGE","H13 LOUMBI NGUIDO DIÉGUESS",7,9,59,28,87
SAINT-LOUIS,PODOR,"GAMADJI SARE","GUEDE VILLAGE","H14 OLOLE",5,6,22,26,48
SAINT-LOUIS,PODOR,"GAMADJI SARE","GUEDE VILLAGE","H15 LOUMBERE",1,3,9,8,17
SAINT-LOUIS,PODOR,"GAMADJI SARE","GUEDE VILLAGE","H16 FETE DJOYE FOULBE 7",5,12,36,61,97
SAINT-LOUIS,PODOR,"GAMADJI SARE","GUEDE VILLAGE",MBANTOU,71,80,355,376,731
SAINT-LOUIS,PODOR,"GAMADJI SARE","GUEDE VILLAGE","H1 OURO AMADOU GALAT",9,9,38,47,85
SAINT-LOUIS,PODOR,"GAMADJI SARE","GUEDE VILLAGE","H2 GOUREL KOMI",12,12,37,38,75
SAINT-LOUIS,PODOR,"GAMADJI SARE","GUEDE VILLAGE",MBIDDI,76,99,444,416,860
SAINT-LOUIS,PODOR,"GAMADJI SARE","GUEDE VILLAGE","H1 OURO MAMADOU DEMBAYEL SY",4,4,19,16,35
SAINT-LOUIS,PODOR,"GAMADJI SARE","GUEDE VILLAGE","H2 RIGANDE",2,3,7,11,18
SAINT-LOUIS,PODOR,"GAMADJI SARE","GUEDE VILLAGE","H3 HAME KORGA III",11,18,73,55,128
SAINT-LOUIS,PODOR,"GAMADJI SARE","GUEDE VILLAGE","H4 MOURLENE",5,6,29,28,57
SAINT-LOUIS,PODOR,"GAMADJI SARE","GUEDE VILLAGE","H5 LOUMBI LAOBE I",13,26,106,114,220
SAINT-LOUIS,PODOR,"GAMADJI SARE","GUEDE VILLAGE","H6 THIEWDE SAMANABE",13,29,100,110,210
SAINT-LOUIS,PODOR,"GAMADJI SARE","GUEDE VILLAGE","H7 LOUMBAGNE BAROBE",13,25,87,84,171
SAINT-LOUIS,PODOR,"GAMADJI SARE","GUEDE VILLAGE","H8 WENDOU DOKI",9,11,38,46,84
SAINT-LOUIS,PODOR,"GAMADJI SARE","GUEDE VILLAGE","H9 WINDE BOKI",29,43,121,139,260
SAINT-LOUIS,PODOR,"GAMADJI SARE","GUEDE VILLAGE",MBOYO,154,217,1102,1164,2266
SAINT-LOUIS,PODOR,"GAMADJI SARE","GUEDE VILLAGE","H1 MEDINA MBOYO",22,35,117,95,212
SAINT-LOUIS,PODOR,"GAMADJI SARE","GUEDE VILLAGE","H2 TIVAOUANE MBOYO",4,13,67,41,108
SAINT-LOUIS,PODOR,"GAMADJI SARE","GUEDE VILLAGE","H3 GUEDE OURO",17,22,126,134,260
SAINT-LOUIS,PODOR,"GAMADJI SARE","GUEDE VILLAGE","H4 DALLE SIDDY",16,28,133,109,242
SAINT-LOUIS,PODOR,"GAMADJI SARE","GUEDE VILLAGE","MBOYO DIERY",34,46,180,200,380
SAINT-LOUIS,PODOR,"GAMADJI SARE","GUEDE VILLAGE","H1 MBOYO AMADOU CIRE DIA",21,29,103,114,217
SAINT-LOUIS,PODOR,"GAMADJI SARE","GUEDE VILLAGE","MEDINA FRESBE",75,91,382,438,820
SAINT-LOUIS,PODOR,"GAMADJI SARE","GUEDE VILLAGE","H1 BELELE GAWDI",16,18,78,86,164
SAINT-LOUIS,PODOR,"GAMADJI SARE","GUEDE VILLAGE",NDIAWARA,166,183,1099,1038,2137
SAINT-LOUIS,PODOR,"GAMADJI SARE","GUEDE VILLAGE","H1 MBAFAN",3,7,23,23,46
SAINT-LOUIS,PODOR,"GAMADJI SARE","GUEDE VILLAGE","H2 OURO HAMADOU BOGA",19,31,133,132,265
SAINT-LOUIS,PODOR,"GAMADJI SARE","GUEDE VILLAGE","H3 NGANEGA",10,18,86,85,171
SAINT-LOUIS,PODOR,"GAMADJI SARE","GUEDE VILLAGE","H4 BIDIEYMA",6,6,30,18,48
SAINT-LOUIS,PODOR,"GAMADJI SARE","GUEDE VILLAGE","H5 MBAFAN 2",6,6,29,29,58
SAINT-LOUIS,PODOR,"GAMADJI SARE","GUEDE VILLAGE",NGAOULE,96,114,708,689,1397
SAINT-LOUIS,PODOR,"GAMADJI SARE","GUEDE VILLAGE","H1 YAMANA",1,2,20,12,32
SAINT-LOUIS,PODOR,"GAMADJI SARE","GUEDE VILLAGE","OURO MADIHOU",81,119,556,511,1067
SAINT-LOUIS,PODOR,"GAMADJI SARE","GUEDE VILLAGE","H1 DIANDOU",13,18,89,101,190
SAINT-LOUIS,PODOR,"GAMADJI SARE","GUEDE VILLAGE","H2 DIANDOU REFUGIES",10,21,80,77,157
SAINT-LOUIS,PODOR,"GAMADJI SARE","GUEDE VILLAGE","OUROURBE NENETTE",83,109,501,494,995
SAINT-LOUIS,PODOR,"GAMADJI SARE","GUEDE VILLAGE","H1 TOGANE",25,30,165,151,316
SAINT-LOUIS,PODOR,"GAMADJI SARE","GUEDE VILLAGE","SAMANABE DOUNDE",18,23,72,93,165
SAINT-LOUIS,PODOR,"GAMADJI SARE","GUEDE VILLAGE","H1 GNOULKADJE",6,9,47,38,85
SAINT-LOUIS,PODOR,"GAMADJI SARE","GUEDE VILLAGE","H2 DOUNDE",10,13,40,49,89
SAINT-LOUIS,PODOR,"GAMADJI SARE","GUEDE VILLAGE","H3 DIAYA",11,11,82,67,149
SAINT-LOUIS,PODOR,"GAMADJI SARE","GUEDE VILLAGE",TAGANIT,23,27,125,121,246
SAINT-LOUIS,PODOR,"GAMADJI SARE","GUEDE VILLAGE","H1 CROISEMENT MBANTOU",24,36,178,173,351
SAINT-LOUIS,PODOR,"GAMADJI SARE","GUEDE VILLAGE","TAREDJI DECOLLE",165,196,816,1006,1822
SAINT-LOUIS,PODOR,"GAMADJI SARE","GUEDE VILLAGE","H1 DOUNDOUL",5,5,14,8,22
SAINT-LOUIS,PODOR,"GAMADJI SARE","GUEDE VILLAGE",ZOGA,24,37,159,174,333
SAINT-LOUIS,PODOR,"GAMADJI SARE","GUEDE VILLAGE","BOWEDI THIOYELE BISSNABÉ",18,41,96,116,212
SAINT-LOUIS,PODOR,"GAMADJI SARE","GUEDE VILLAGE",DECOLLE,53,92,413,416,829
SAINT-LOUIS,PODOR,"GAMADJI SARE","GUEDE VILLAGE","PETEL DIEGUESS",45,55,377,358,735
SAINT-LOUIS,PODOR,"GAMADJI SARE","GUEDE VILLAGE","OUROUBE NENETTE",8,8,54,51,105
SAINT-LOUIS,PODOR,"GAMADJI SARE","GUEDE VILLAGE",FETERE,1,1,1,1,2
SAINT-LOUIS,PODOR,"GAMADJI SARE","GUEDE VILLAGE","SINTHIOU DIAMBO",14,15,99,90,189
SAINT-LOUIS,PODOR,"GAMADJI SARE","BODE LAO","DAROU SALAM",72,100,591,611,1202
SAINT-LOUIS,PODOR,"GAMADJI SARE","BODE LAO",DIARNGUEL,53,68,351,385,736
SAINT-LOUIS,PODOR,"GAMADJI SARE","BODE LAO",HALWAR,25,50,237,294,531
SAINT-LOUIS,PODOR,"GAMADJI SARE","BODE LAO","MEDINA BODE",72,108,663,628,1291
SAINT-LOUIS,PODOR,"GAMADJI SARE",DEMETTE,BALABE,50,79,280,297,577
SAINT-LOUIS,PODOR,"GAMADJI SARE",DEMETTE,BOGA,20,28,109,97,206
SAINT-LOUIS,PODOR,"GAMADJI SARE",DEMETTE,DIAKE,29,34,160,166,326
SAINT-LOUIS,PODOR,"GAMADJI SARE",DEMETTE,DJIGOBE,38,52,284,308,592
SAINT-LOUIS,PODOR,"GAMADJI SARE",DEMETTE,"GOUBE (BABABE)",8,8,32,30,62
SAINT-LOUIS,PODOR,"GAMADJI SARE",DEMETTE,"SENY DIOWOL (HALEYEBE LAMBE)",20,24,111,121,232
SAINT-LOUIS,PODOR,"GAMADJI SARE",DEMETTE,"HALEYBE LAMBE",32,40,260,255,515
SAINT-LOUIS,PODOR,"GAMADJI SARE",DEMETTE,NGAÏDEMBE,32,43,227,230,457
SAINT-LOUIS,PODOR,"GAMADJI SARE",DEMETTE,SOUBALO,29,46,212,235,447
SAINT-LOUIS,PODOR,"GAMADJI SARE","GUEDE CHANTIER",BRIGALE,67,96,586,595,1181
SAINT-LOUIS,PODOR,"GAMADJI SARE","GUEDE CHANTIER",DJIERY,109,126,604,659,1263
SAINT-LOUIS,PODOR,"GAMADJI SARE","GUEDE CHANTIER",FOUNANGUE,63,75,644,642,1286
SAINT-LOUIS,PODOR,"GAMADJI SARE","GUEDE CHANTIER",FRESBE,21,27,175,190,365
SAINT-LOUIS,PODOR,"GAMADJI SARE","GUEDE CHANTIER",GUEDE,70,107,601,616,1217
SAINT-LOUIS,PODOR,"GAMADJI SARE","GUEDE CHANTIER",TIVAOUANE,124,143,858,832,1690
SAINT-LOUIS,"SAINT LOUIS","SAINT LOUIS","SAINT LOUIS",BALACOS,493,640,2234,2223,4457
SAINT-LOUIS,"SAINT LOUIS","SAINT LOUIS","SAINT LOUIS","BANGO NORD",208,271,1099,1192,2291
SAINT-LOUIS,"SAINT LOUIS","SAINT LOUIS","SAINT LOUIS","BANGO SUD",935,1023,3749,3568,7317
SAINT-LOUIS,"SAINT LOUIS","SAINT LOUIS","SAINT LOUIS","BAS NDAR TOUTE",246,413,1661,1694,3355
SAINT-LOUIS,"SAINT LOUIS","SAINT LOUIS","SAINT LOUIS","CITE NIAKH",766,998,3681,3327,7008
SAINT-LOUIS,"SAINT LOUIS","SAINT LOUIS","SAINT LOUIS","DAKK GUET NDAR",521,1077,5157,5195,10352
SAINT-LOUIS,"SAINT LOUIS","SAINT LOUIS","SAINT LOUIS","DAROU MEDINA MARMYAL",562,735,3691,3020,6711
SAINT-LOUIS,"SAINT LOUIS","SAINT LOUIS","SAINT LOUIS","DAROU ROUTE DE KHOR",979,1578,5800,4613,10413
SAINT-LOUIS,"SAINT LOUIS","SAINT LOUIS","SAINT LOUIS",DIAMAGUENE,915,1274,5094,4730,9824
SAINT-LOUIS,"SAINT LOUIS","SAINT LOUIS","SAINT LOUIS",DIAMINAR,637,780,3770,3685,7455
SAINT-LOUIS,"SAINT LOUIS","SAINT LOUIS","SAINT LOUIS","EAUX CLAIRES",636,811,3283,3214,6497
SAINT-LOUIS,"SAINT LOUIS","SAINT LOUIS","SAINT LOUIS","GOXU MBACC",1521,2132,10944,11231,22175
SAINT-LOUIS,"SAINT LOUIS","SAINT LOUIS","SAINT LOUIS","GUINAW RAIL",1729,2110,9218,8658,17876
SAINT-LOUIS,"SAINT LOUIS","SAINT LOUIS","SAINT LOUIS","HAUT NDAR TOUTE",457,724,3251,3046,6297
SAINT-LOUIS,"SAINT LOUIS","SAINT LOUIS","SAINT LOUIS","HAUT NORD",219,306,925,865,1790
SAINT-LOUIS,"SAINT LOUIS","SAINT LOUIS","SAINT LOUIS",HLM,385,459,1469,1462,2931
SAINT-LOUIS,"SAINT LOUIS","SAINT LOUIS","SAINT LOUIS",HYDROBASE,495,666,3159,3016,6175
SAINT-LOUIS,"SAINT LOUIS","SAINT LOUIS","SAINT LOUIS","KHOR MISSION",146,167,537,520,1057
SAINT-LOUIS,"SAINT LOUIS","SAINT LOUIS","SAINT LOUIS","KHOR USINE",968,1120,5012,4143,9155
SAINT-LOUIS,"SAINT LOUIS","SAINT LOUIS","SAINT LOUIS",LEONA,661,930,3802,3864,7666
SAINT-LOUIS,"SAINT LOUIS","SAINT LOUIS","SAINT LOUIS","LODO GUET NDAR",401,779,3475,3896,7371
SAINT-LOUIS,"SAINT LOUIS","SAINT LOUIS","SAINT LOUIS","MEDINA COURSE PETHIEULY",444,579,2468,2243,4711
SAINT-LOUIS,"SAINT LOUIS","SAINT LOUIS","SAINT LOUIS","NDIOLOFENE NORD",621,819,3263,2931,6194
SAINT-LOUIS,"SAINT LOUIS","SAINT LOUIS","SAINT LOUIS","NDIOLOFENE SUD",347,583,1713,1540,3253
SAINT-LOUIS,"SAINT LOUIS","SAINT LOUIS","SAINT LOUIS","NGALLELE NORD",415,526,1719,1882,3601
SAINT-LOUIS,"SAINT LOUIS","SAINT LOUIS","SAINT LOUIS","NGALLELE SUD",206,220,651,739,1390
SAINT-LOUIS,"SAINT LOUIS","SAINT LOUIS","SAINT LOUIS","PIKINE BAS SENEGAL",1376,1592,7549,7327,14876
SAINT-LOUIS,"SAINT LOUIS","SAINT LOUIS","SAINT LOUIS","PIKINE SOR DAGA",1118,1314,5808,5745,11553
SAINT-LOUIS,"SAINT LOUIS","SAINT LOUIS","SAINT LOUIS","PIKINE SOR DIAGNE",1543,1950,8068,7502,15570
SAINT-LOUIS,"SAINT LOUIS","SAINT LOUIS","SAINT LOUIS","PIKINE TABLEAU WALO",2200,2756,12220,11939,24159
SAINT-LOUIS,"SAINT LOUIS","SAINT LOUIS","SAINT LOUIS",SUD,288,353,1055,1041,2096
SAINT-LOUIS,"SAINT LOUIS","SAINT LOUIS","SAINT LOUIS",TENDJIGUENE,608,787,2880,2678,5558
SAINT-LOUIS,"SAINT LOUIS","SAINT LOUIS","SAINT LOUIS","NORD CENTRE",309,393,1852,1185,3037
SAINT-LOUIS,"SAINT LOUIS",RAO,GANDON,"BAITY DIEYE",6,8,43,47,90
SAINT-LOUIS,"SAINT LOUIS",RAO,GANDON,"H1 KEUR SAMBA DIALLO",7,8,42,53,95
SAINT-LOUIS,"SAINT LOUIS",RAO,GANDON,"H2 FASS NDIAYE",1,1,10,16,26
SAINT-LOUIS,"SAINT LOUIS",RAO,GANDON,"H3 BAITY DIEYE",1,1,1,1,2
SAINT-LOUIS,"SAINT LOUIS",RAO,GANDON,BEKHAR,66,70,332,414,746
SAINT-LOUIS,"SAINT LOUIS",RAO,GANDON,"BOP THIOR",20,22,96,131,227
SAINT-LOUIS,"SAINT LOUIS",RAO,GANDON,BOUDIOUCK,1154,1272,4037,4028,8065
SAINT-LOUIS,"SAINT LOUIS",RAO,GANDON,"H1 ALI DIAGNE NAR",31,31,99,94,193
SAINT-LOUIS,"SAINT LOUIS",RAO,GANDON,"DIAMA THIAGUEL",39,49,257,239,496
SAINT-LOUIS,"SAINT LOUIS",RAO,GANDON,"H1 NGAYE NGAYE",15,17,84,65,149
SAINT-LOUIS,"SAINT LOUIS",RAO,GANDON,"DIAMA TOUBE",13,17,96,108,204
SAINT-LOUIS,"SAINT LOUIS",RAO,GANDON,"DIOUGOB PEULH (SANAR PEULH)",667,995,2815,2414,5229
SAINT-LOUIS,"SAINT LOUIS",RAO,GANDON,"H2 DIOUGOB BAMBARA",70,90,385,305,690
SAINT-LOUIS,"SAINT LOUIS",RAO,GANDON,"FASS DIEYE",40,47,179,273,452
SAINT-LOUIS,"SAINT LOUIS",RAO,GANDON,GANDON,209,234,1163,1092,2255
SAINT-LOUIS,"SAINT LOUIS",RAO,GANDON,GOBAG,16,19,110,91,201
SAINT-LOUIS,"SAINT LOUIS",RAO,GANDON,"GOUYE TOURE",24,28,109,122,231
SAINT-LOUIS,"SAINT LOUIS",RAO,GANDON,"H1 GOUYE TOURE PEULH",34,37,168,130,298
SAINT-LOUIS,"SAINT LOUIS",RAO,GANDON,"H2 YEULEUME",22,39,147,128,275
SAINT-LOUIS,"SAINT LOUIS",RAO,GANDON,"IBA BALLA",13,17,60,83,143
SAINT-LOUIS,"SAINT LOUIS",RAO,GANDON,"H1 MBONDJI PEULH",10,13,43,47,90
SAINT-LOUIS,"SAINT LOUIS",RAO,GANDON,"IBA PEULH",2,5,15,12,27
SAINT-LOUIS,"SAINT LOUIS",RAO,GANDON,"H1 KEUR EL H YOUSSOU SOW",2,2,7,10,17
SAINT-LOUIS,"SAINT LOUIS",RAO,GANDON,"H3 MBARAR SOW",10,11,36,40,76
SAINT-LOUIS,"SAINT LOUIS",RAO,GANDON,"KEUR MADIOP BASSINE",17,17,108,68,176
SAINT-LOUIS,"SAINT LOUIS",RAO,GANDON,"H1 KEUR SAMBA KA",23,24,128,115,243
SAINT-LOUIS,"SAINT LOUIS",RAO,GANDON,"KEUR MARTIN",131,134,538,541,1079
SAINT-LOUIS,"SAINT LOUIS",RAO,GANDON,"KHATALI II",11,11,46,57,103
SAINT-LOUIS,"SAINT LOUIS",RAO,GANDON,"H1 MAMADOU BESSE SOW",3,9,29,27,56
SAINT-LOUIS,"SAINT LOUIS",RAO,GANDON,"KHELCOM DIAO",24,26,174,150,324
SAINT-LOUIS,"SAINT LOUIS",RAO,GANDON,"H1 KOMAL DIAW",11,14,95,88,183
SAINT-LOUIS,"SAINT LOUIS",RAO,GANDON,LAMPSAR,173,198,729,833,1562
SAINT-LOUIS,"SAINT LOUIS",RAO,GANDON,"LEYBAR BOYE",145,151,688,568,1256
SAINT-LOUIS,"SAINT LOUIS",RAO,GANDON,"H1 PONT LEYBAR",1,1,4,1,5
SAINT-LOUIS,"SAINT LOUIS",RAO,GANDON,"MAKA TOUBE",164,211,913,938,1851
SAINT-LOUIS,"SAINT LOUIS",RAO,GANDON,MAKHANA,100,115,462,421,883
SAINT-LOUIS,"SAINT LOUIS",RAO,GANDON,"H2 KEUR MACTAR SAMBA BA",14,15,93,98,191
SAINT-LOUIS,"SAINT LOUIS",RAO,GANDON,"H3 BEYSSOUS",43,53,228,205,433
SAINT-LOUIS,"SAINT LOUIS",RAO,GANDON,MBARIGO,98,105,634,589,1223
SAINT-LOUIS,"SAINT LOUIS",RAO,GANDON,"H1 NEUFEUR",23,25,121,109,230
SAINT-LOUIS,"SAINT LOUIS",RAO,GANDON,"H2 KEUR MAR",37,40,176,153,329
SAINT-LOUIS,"SAINT LOUIS",RAO,GANDON,"H3 KEUR MOUSSA DIOR SOW",21,22,112,117,229
SAINT-LOUIS,"SAINT LOUIS",RAO,GANDON,"H4 MBAYE LAR",74,80,354,310,664
SAINT-LOUIS,"SAINT LOUIS",RAO,GANDON,"MBENGUENE BOYE",83,100,522,463,985
SAINT-LOUIS,"SAINT LOUIS",RAO,GANDON,"H1 MBENGUENE NARE",6,8,42,26,68
SAINT-LOUIS,"SAINT LOUIS",RAO,GANDON,"MERINA BARA",15,15,92,85,177
SAINT-LOUIS,"SAINT LOUIS",RAO,GANDON,"MERINA SALL",38,43,233,221,454
SAINT-LOUIS,"SAINT LOUIS",RAO,GANDON,NDIAKHER,67,112,487,439,926
SAINT-LOUIS,"SAINT LOUIS",RAO,GANDON,"H1 KEUR AMADOU SIDY SOW",2,2,6,4,10
SAINT-LOUIS,"SAINT LOUIS",RAO,GANDON,"NDIAKHIP I",31,32,109,93,202
SAINT-LOUIS,"SAINT LOUIS",RAO,GANDON,"H1 KEUR NDIAGA SOW",5,6,26,28,54
SAINT-LOUIS,"SAINT LOUIS",RAO,GANDON,"H2 KEUR MOUSSA SOW",9,10,32,47,79
SAINT-LOUIS,"SAINT LOUIS",RAO,GANDON,"NDIAKHIP II",55,67,276,414,690
SAINT-LOUIS,"SAINT LOUIS",RAO,GANDON,"NDIALAKHAR OUOLOF",30,38,210,148,358
SAINT-LOUIS,"SAINT LOUIS",RAO,GANDON,"H1 KEUR MALICK DIOUMA KA",8,8,55,39,94
SAINT-LOUIS,"SAINT LOUIS",RAO,GANDON,"H2 BOTI",6,6,20,30,50
SAINT-LOUIS,"SAINT LOUIS",RAO,GANDON,"H3 BOUH",11,12,66,70,136
SAINT-LOUIS,"SAINT LOUIS",RAO,GANDON,"H5 KEUR SIDY FALL",5,5,21,16,37
SAINT-LOUIS,"SAINT LOUIS",RAO,GANDON,"NDIALAKHAR PEULH",37,50,276,240,516
SAINT-LOUIS,"SAINT LOUIS",RAO,GANDON,"NDIALAME BAMBARA",19,19,70,66,136
SAINT-LOUIS,"SAINT LOUIS",RAO,GANDON,"H1 TOUGOR",13,13,61,49,110
SAINT-LOUIS,"SAINT LOUIS",RAO,GANDON,"H2 KEUR ABDOU NDENE SOW",70,77,325,316,641
SAINT-LOUIS,"SAINT LOUIS",RAO,GANDON,"H3 KEUR GALLO SAMBA SOW",9,10,30,35,65
SAINT-LOUIS,"SAINT LOUIS",RAO,GANDON,"H5 LAMPSAR PEULH",10,10,38,39,77
SAINT-LOUIS,"SAINT LOUIS",RAO,GANDON,NDIAOUDOUNE,161,174,731,824,1555
SAINT-LOUIS,"SAINT LOUIS",RAO,GANDON,"H1 NDIAOUDOUNE PONT",45,47,272,213,485
SAINT-LOUIS,"SAINT LOUIS",RAO,GANDON,"H2 KEUR MAME DIOP FALL",6,7,26,23,49
SAINT-LOUIS,"SAINT LOUIS",RAO,GANDON,"H3 NDIAOUDOUNE NAR",18,19,88,86,174
SAINT-LOUIS,"SAINT LOUIS",RAO,GANDON,"H4 KEUR ADAMA BA",10,11,40,38,78
SAINT-LOUIS,"SAINT LOUIS",RAO,GANDON,"H6 MBAYE LAR 1",28,31,172,160,332
SAINT-LOUIS,"SAINT LOUIS",RAO,GANDON,"NDIAOUSSIR LEBOU",462,481,2029,1738,3767
SAINT-LOUIS,"SAINT LOUIS",RAO,GANDON,"NDIEBENE TOUBE PEULH",39,53,326,333,659
SAINT-LOUIS,"SAINT LOUIS",RAO,GANDON,"NDIEBENE TOUBE WOLOF",263,297,1458,1450,2908
SAINT-LOUIS,"SAINT LOUIS",RAO,GANDON,NGAYE,80,88,637,508,1145
SAINT-LOUIS,"SAINT LOUIS",RAO,GANDON,"H1 KEUR ABDOUL KA",4,4,25,24,49
SAINT-LOUIS,"SAINT LOUIS",RAO,GANDON,"NGAYE NGAYE",136,199,1183,1135,2318
SAINT-LOUIS,"SAINT LOUIS",RAO,GANDON,"NGAYNA WOLOF",148,153,748,629,1377
SAINT-LOUIS,"SAINT LOUIS",RAO,GANDON,"NGUIGALAKH OUOLOF",39,40,210,217,427
SAINT-LOUIS,"SAINT LOUIS",RAO,GANDON,"H1 KEUR MAGUETTE DIOP",2,3,15,20,35
SAINT-LOUIS,"SAINT LOUIS",RAO,GANDON,"H2 KEUR ALIOU SOW",7,7,80,64,144
SAINT-LOUIS,"SAINT LOUIS",RAO,GANDON,"H3 KEUR MALICK SOW YADOUROU",1,1,3,6,9
SAINT-LOUIS,"SAINT LOUIS",RAO,GANDON,"H4 NDIOP PEULH I",5,10,33,35,68
SAINT-LOUIS,"SAINT LOUIS",RAO,GANDON,"H5 NDIOP FALL",1,1,8,10,18
SAINT-LOUIS,"SAINT LOUIS",RAO,GANDON,"H6 NDIOP PEULH II",11,12,44,56,100
SAINT-LOUIS,"SAINT LOUIS",RAO,GANDON,"NGUIGALAKH PEULH",29,35,175,159,334
SAINT-LOUIS,"SAINT LOUIS",RAO,GANDON,"H1 KEUR IDY SENE",1,2,10,11,21
SAINT-LOUIS,"SAINT LOUIS",RAO,GANDON,"PANKET SARR",25,28,194,155,349
SAINT-LOUIS,"SAINT LOUIS",RAO,GANDON,POUNDIOUM,46,47,284,288,572
SAINT-LOUIS,"SAINT LOUIS",RAO,GANDON,"RAHMANE SALL",2,2,9,20,29
SAINT-LOUIS,"SAINT LOUIS",RAO,GANDON,"H1 KHEMASSOU",11,13,86,68,154
SAINT-LOUIS,"SAINT LOUIS",RAO,GANDON,RAO,294,355,1200,1297,2497
SAINT-LOUIS,"SAINT LOUIS",RAO,GANDON,"RAO GARE",90,90,278,291,569
SAINT-LOUIS,"SAINT LOUIS",RAO,GANDON,"H1 WOURO ABDOU DIA",21,29,134,108,242
SAINT-LOUIS,"SAINT LOUIS",RAO,GANDON,"RAO PEULH",40,53,232,232,464
SAINT-LOUIS,"SAINT LOUIS",RAO,GANDON,"H1 RAO PEULH GOKE",25,33,228,174,402
SAINT-LOUIS,"SAINT LOUIS",RAO,GANDON,"H2 KEUR ALASSANE",20,45,251,259,510
SAINT-LOUIS,"SAINT LOUIS",RAO,GANDON,"H3 KEUR MADAME DIA",4,6,30,21,51
SAINT-LOUIS,"SAINT LOUIS",RAO,GANDON,"H4 KEUR AMETH DIENG",11,15,69,65,134
SAINT-LOUIS,"SAINT LOUIS",RAO,GANDON,"H5 KEUR MAMADOU BA",12,12,61,44,105
SAINT-LOUIS,"SAINT LOUIS",RAO,GANDON,"H6 MBAQUE",25,27,165,136,301
SAINT-LOUIS,"SAINT LOUIS",RAO,GANDON,"H7 KEUR DAOUDA SY",21,25,141,139,280
SAINT-LOUIS,"SAINT LOUIS",RAO,GANDON,"H8 KEUR ISSA SOW",8,8,49,34,83
SAINT-LOUIS,"SAINT LOUIS",RAO,GANDON,"H9 KEUR ALE KA",14,14,111,66,177
SAINT-LOUIS,"SAINT LOUIS",RAO,GANDON,"H10 RAO DALLA",54,70,473,420,893
SAINT-LOUIS,"SAINT LOUIS",RAO,GANDON,"H11 KEUR ALASSANE DIENG",2,2,13,10,23
SAINT-LOUIS,"SAINT LOUIS",RAO,GANDON,"H12 KEUR OUMAR BA",7,7,35,18,53
SAINT-LOUIS,"SAINT LOUIS",RAO,GANDON,"H13 KEUR DIAM YORO SOW",1,1,22,13,35
SAINT-LOUIS,"SAINT LOUIS",RAO,GANDON,"H14 KEUR DIAM YORO SOW",1,1,7,3,10
SAINT-LOUIS,"SAINT LOUIS",RAO,GANDON,"SANAR WOLOF",210,248,3629,2866,6495
SAINT-LOUIS,"SAINT LOUIS",RAO,GANDON,"SELGUIRE (THILLA 2)",34,35,147,131,278
SAINT-LOUIS,"SAINT LOUIS",RAO,GANDON,"SINTHIOU RAHMANE",12,13,67,100,167
SAINT-LOUIS,"SAINT LOUIS",RAO,GANDON,"H1 MBAYE MBAYE PEULH",5,7,42,29,71
SAINT-LOUIS,"SAINT LOUIS",RAO,GANDON,"THIAR MOUSSE DIOP",5,6,41,31,72
SAINT-LOUIS,"SAINT LOUIS",RAO,GANDON,THIERIGNE,2,4,12,14,26
SAINT-LOUIS,"SAINT LOUIS",RAO,GANDON,"H1 NDIAWTANE",8,11,49,44,93
SAINT-LOUIS,"SAINT LOUIS",RAO,GANDON,"THILLA I",50,64,388,380,768
SAINT-LOUIS,"SAINT LOUIS",RAO,GANDON,TODDE,34,47,191,190,381
SAINT-LOUIS,"SAINT LOUIS",RAO,GANDON,"TOUBA GUENE",47,51,283,329,612
SAINT-LOUIS,"SAINT LOUIS",RAO,GANDON,"YAMANE SOGUE",50,51,257,294,551
SAINT-LOUIS,"SAINT LOUIS",RAO,GANDON,"H1 YAMANE PEULH",17,32,131,139,270
SAINT-LOUIS,"SAINT LOUIS",RAO,GANDON,"H6 NDIALAKHAR NARE",6,8,29,33,62
SAINT-LOUIS,"SAINT LOUIS",RAO,GANDON,"H2 DIABAYE (COMMUNE DE DIAMA)",5,7,29,32,61
SAINT-LOUIS,"SAINT LOUIS",RAO,GANDON,"NDIOUSS PEULH (COMMUNE DE FASS)",2,3,11,15,26
SAINT-LOUIS,"SAINT LOUIS",RAO,"FASS NGOM","BIDIAME MOURIDE",27,34,175,161,336
SAINT-LOUIS,"SAINT LOUIS",RAO,"FASS NGOM","H1 NDEYE WADE",24,32,164,171,335
SAINT-LOUIS,"SAINT LOUIS",RAO,"FASS NGOM","H2 NDIOUSSE SARR",3,5,18,13,31
SAINT-LOUIS,"SAINT LOUIS",RAO,"FASS NGOM","H4 THIELLE PEULH",13,15,58,55,113
SAINT-LOUIS,"SAINT LOUIS",RAO,"FASS NGOM","MBIRANE GAYE MBABOU",26,26,124,99,223
SAINT-LOUIS,"SAINT LOUIS",RAO,"FASS NGOM","FASS NGOM",209,340,1265,1255,2520
SAINT-LOUIS,"SAINT LOUIS",RAO,"FASS NGOM","FASS PEULH",23,37,191,135,326
SAINT-LOUIS,"SAINT LOUIS",RAO,"FASS NGOM","GATY TEFF",2,2,17,9,26
SAINT-LOUIS,"SAINT LOUIS",RAO,"FASS NGOM","GOGNO CADIOR PEULH",33,59,194,169,363
SAINT-LOUIS,"SAINT LOUIS",RAO,"FASS NGOM",KABDOU,123,145,671,688,1359
SAINT-LOUIS,"SAINT LOUIS",RAO,"FASS NGOM","KEUR AMADOU NDIAYE 1",25,25,221,207,428
SAINT-LOUIS,"SAINT LOUIS",RAO,"FASS NGOM","KEUR GORA DIAGNE NAR",8,9,40,47,87
SAINT-LOUIS,"SAINT LOUIS",RAO,"FASS NGOM","H1 KEUR ALIOU KA",2,3,14,14,28
SAINT-LOUIS,"SAINT LOUIS",RAO,"FASS NGOM","H2 KEUR ALDIOUMA SOW",2,2,13,13,26
SAINT-LOUIS,"SAINT LOUIS",RAO,"FASS NGOM","H3 KEUR GORA DIAGNE NAAR",4,4,19,11,30
SAINT-LOUIS,"SAINT LOUIS",RAO,"FASS NGOM","KEUR GORA DIAGNE WOLOF",11,13,91,81,172
SAINT-LOUIS,"SAINT LOUIS",RAO,"FASS NGOM","KEUR MBAYE MBAYE OUOLOF (MBAYE MBAYE FALL)",26,31,177,136,313
SAINT-LOUIS,"SAINT LOUIS",RAO,"FASS NGOM","KEUR SEA",47,151,398,433,831
SAINT-LOUIS,"SAINT LOUIS",RAO,"FASS NGOM","KHATALY 1",59,59,352,352,704
SAINT-LOUIS,"SAINT LOUIS",RAO,"FASS NGOM","KHATETE GAYE",50,55,291,259,550
SAINT-LOUIS,"SAINT LOUIS",RAO,"FASS NGOM","H1 KHATETE PEULH",9,9,51,70,121
SAINT-LOUIS,"SAINT LOUIS",RAO,"FASS NGOM","KHELCOM DIOP",31,37,172,193,365
SAINT-LOUIS,"SAINT LOUIS",RAO,"FASS NGOM","H1 KEUR GORY NDIAYE",6,6,27,37,64
SAINT-LOUIS,"SAINT LOUIS",RAO,"FASS NGOM","H2 KEUR DEMBA",4,4,33,31,64
SAINT-LOUIS,"SAINT LOUIS",RAO,"FASS NGOM","MBAKHASS PEULH",5,5,40,29,69
SAINT-LOUIS,"SAINT LOUIS",RAO,"FASS NGOM","MBAKHASS WOLOF",23,29,113,120,233
SAINT-LOUIS,"SAINT LOUIS",RAO,"FASS NGOM","MBATHIASS DIEYE",35,38,214,248,462
SAINT-LOUIS,"SAINT LOUIS",RAO,"FASS NGOM","MBAYE MBAYE PEULH",24,34,111,108,219
SAINT-LOUIS,"SAINT LOUIS",RAO,"FASS NGOM","H1 TEUMB PEULH",14,15,78,74,152
SAINT-LOUIS,"SAINT LOUIS",RAO,"FASS NGOM","H2 NGUIGUI PEULH",13,14,61,74,135
SAINT-LOUIS,"SAINT LOUIS",RAO,"FASS NGOM","MBAYE MBAYE SARR",64,70,336,253,589
SAINT-LOUIS,"SAINT LOUIS",RAO,"FASS NGOM",MBENDJIE,8,10,56,54,110
SAINT-LOUIS,"SAINT LOUIS",RAO,"FASS NGOM",MBOOY,32,49,241,250,491
SAINT-LOUIS,"SAINT LOUIS",RAO,"FASS NGOM",MBOULOUCK,20,35,151,132,283
SAINT-LOUIS,"SAINT LOUIS",RAO,"FASS NGOM","MEDINA BAYE (THIOKERE)",131,139,657,649,1306
SAINT-LOUIS,"SAINT LOUIS",RAO,"FASS NGOM","MPAL DIOUNGO",21,27,129,157,286
SAINT-LOUIS,"SAINT LOUIS",RAO,"FASS NGOM","H2 MPAL DIOUNGA PEULH",6,7,44,51,95
SAINT-LOUIS,"SAINT LOUIS",RAO,"FASS NGOM",MPAYE,46,56,207,195,402
SAINT-LOUIS,"SAINT LOUIS",RAO,"FASS NGOM","NDABE SOW",30,35,206,217,423
SAINT-LOUIS,"SAINT LOUIS",RAO,"FASS NGOM","NDAKHAR 2",37,65,375,343,718
SAINT-LOUIS,"SAINT LOUIS",RAO,"FASS NGOM","H1 KEUR ABOU DIALLO de NDAKHAR 2",5,6,38,43,81
SAINT-LOUIS,"SAINT LOUIS",RAO,"FASS NGOM","NDAKHAR PEULH",27,33,186,168,354
SAINT-LOUIS,"SAINT LOUIS",RAO,"FASS NGOM","H1 KEUR ABOU BA",8,9,88,60,148
SAINT-LOUIS,"SAINT LOUIS",RAO,"FASS NGOM","H1 KEUR ABOU DIALLO de NDAKHAR PEULH",3,8,35,49,84
SAINT-LOUIS,"SAINT LOUIS",RAO,"FASS NGOM","H3 KEUR OUMAR DIARY SOW",11,12,83,81,164
SAINT-LOUIS,"SAINT LOUIS",RAO,"FASS NGOM","NDIOBENE TAKHMBEUTH",2,2,15,18,33
SAINT-LOUIS,"SAINT LOUIS",RAO,"FASS NGOM",NDIOUMBNANE,13,32,102,86,188
SAINT-LOUIS,"SAINT LOUIS",RAO,"FASS NGOM","H1 KEUR ASSANE DJIBY RACKY BA",11,25,72,68,140
SAINT-LOUIS,"SAINT LOUIS",RAO,"FASS NGOM","H1 KEUR DJIBY DIABEL DIA",10,11,41,48,89
SAINT-LOUIS,"SAINT LOUIS",RAO,"FASS NGOM","RIMBAKH GORA FAYE",9,11,74,64,138
SAINT-LOUIS,"SAINT LOUIS",RAO,"FASS NGOM",SEMELLE,42,62,343,326,669
SAINT-LOUIS,"SAINT LOUIS",RAO,"FASS NGOM","SINTHIOU ALY NGOM",8,9,54,36,90
SAINT-LOUIS,"SAINT LOUIS",RAO,"FASS NGOM","SINTHIOU THIRMOYE",45,62,247,229,476
SAINT-LOUIS,"SAINT LOUIS",RAO,"FASS NGOM","TAKHMBEUTH PEULH",39,42,178,127,305
SAINT-LOUIS,"SAINT LOUIS",RAO,"FASS NGOM","TAKHMBEUTH WOLOF",41,59,273,243,516
SAINT-LOUIS,"SAINT LOUIS",RAO,"FASS NGOM","H4 KEUR OUSMANE SOW (AL DIEUL SOW)",10,22,86,66,152
SAINT-LOUIS,"SAINT LOUIS",RAO,"FASS NGOM","TALBAKHLE PEULH",23,23,76,76,152
SAINT-LOUIS,"SAINT LOUIS",RAO,"FASS NGOM","TALBAKHLE WOLOF",6,8,34,25,59
SAINT-LOUIS,"SAINT LOUIS",RAO,"FASS NGOM","TEUD BITTY",72,86,493,538,1031
SAINT-LOUIS,"SAINT LOUIS",RAO,"FASS NGOM","H1 KEUR MBODJI GNINGUE",8,8,38,39,77
SAINT-LOUIS,"SAINT LOUIS",RAO,"FASS NGOM","TEUMB WOLOF",4,6,31,25,56
SAINT-LOUIS,"SAINT LOUIS",RAO,"FASS NGOM",THISSE,38,41,273,193,466
SAINT-LOUIS,"SAINT LOUIS",RAO,"FASS NGOM","YADE WOLOF",13,13,63,38,101
SAINT-LOUIS,"SAINT LOUIS",RAO,"FASS NGOM",YASSAGNE,12,13,124,92,216
SAINT-LOUIS,"SAINT LOUIS",RAO,"FASS NGOM","H1 KEUR LAWEL KA",4,4,15,12,27
SAINT-LOUIS,"SAINT LOUIS",RAO,"FASS NGOM","H2 KEUR MODY KA",8,13,38,40,78
SAINT-LOUIS,"SAINT LOUIS",RAO,"FASS NGOM","H3 GADE YASSAGNE",5,6,23,17,40
SAINT-LOUIS,"SAINT LOUIS",RAO,"FASS NGOM","H5 KEUR SADIO DIALLO",9,14,75,41,116
SAINT-LOUIS,"SAINT LOUIS",RAO,"FASS NGOM",YOUKHOULENE,4,9,45,39,84
SAINT-LOUIS,"SAINT LOUIS",RAO,"FASS NGOM","H2 KEUR ABDOULAYE SOW",2,2,16,20,36
SAINT-LOUIS,"SAINT LOUIS",RAO,"FASS NGOM","GONIO BAMBARA",57,81,293,263,556
SAINT-LOUIS,"SAINT LOUIS",RAO,"FASS NGOM","NDIOUSS DIEYE",31,40,230,268,498
SAINT-LOUIS,"SAINT LOUIS",RAO,"FASS NGOM","KEUR AMADOU NDIAYE 2",8,10,58,48,106
SAINT-LOUIS,"SAINT LOUIS",RAO,"FASS NGOM","BIDIAM PEULH",9,12,53,65,118
SAINT-LOUIS,"SAINT LOUIS",RAO,"FASS NGOM",MBABOU,24,24,171,136,307
SAINT-LOUIS,"SAINT LOUIS",RAO,"FASS NGOM","TAL DIOP",1,1,6,9,15
SAINT-LOUIS,"SAINT LOUIS",RAO,"NDIEBENE GANDIOLE","DAROU BOU MBAYE",106,143,498,632,1130
SAINT-LOUIS,"SAINT LOUIS",RAO,"NDIEBENE GANDIOLE","DEGOU NIAYES",73,94,406,517,923
SAINT-LOUIS,"SAINT LOUIS",RAO,"NDIEBENE GANDIOLE","H1 KEUR ABDOU KA",17,24,85,83,168
SAINT-LOUIS,"SAINT LOUIS",RAO,"NDIEBENE GANDIOLE","H2 DIEFEL",4,6,19,20,39
SAINT-LOUIS,"SAINT LOUIS",RAO,"NDIEBENE GANDIOLE","H3 KEUR IFRA BA",7,9,54,36,90
SAINT-LOUIS,"SAINT LOUIS",RAO,"NDIEBENE GANDIOLE","DIEL MBAME",119,155,549,818,1367
SAINT-LOUIS,"SAINT LOUIS",RAO,"NDIEBENE GANDIOLE","H1 MBAMBARA",17,22,117,110,227
SAINT-LOUIS,"SAINT LOUIS",RAO,"NDIEBENE GANDIOLE",GANTOUR,74,99,588,603,1191
SAINT-LOUIS,"SAINT LOUIS",RAO,"NDIEBENE GANDIOLE","H1 FOFE GUEYE",2,6,44,38,82
SAINT-LOUIS,"SAINT LOUIS",RAO,"NDIEBENE GANDIOLE","GEUMBEUL I (NGAINA LEBOU)",61,64,240,274,514
SAINT-LOUIS,"SAINT LOUIS",RAO,"NDIEBENE GANDIOLE","H1 PARC GUEUBEUL",7,7,42,61,103
SAINT-LOUIS,"SAINT LOUIS",RAO,"NDIEBENE GANDIOLE",GOUYEREINE,63,72,434,369,803
SAINT-LOUIS,"SAINT LOUIS",RAO,"NDIEBENE GANDIOLE","H1 GOUYE REINE 2",17,27,131,136,267
SAINT-LOUIS,"SAINT LOUIS",RAO,"NDIEBENE GANDIOLE","GUIELING MBOW",25,37,128,190,318
SAINT-LOUIS,"SAINT LOUIS",RAO,"NDIEBENE GANDIOLE","H2 SAWENE MBAO",15,19,79,132,211
SAINT-LOUIS,"SAINT LOUIS",RAO,"NDIEBENE GANDIOLE","H1 SAWENE",14,22,105,119,224
SAINT-LOUIS,"SAINT LOUIS",RAO,"NDIEBENE GANDIOLE","KEUR BARKA",267,293,1415,1438,2853
SAINT-LOUIS,"SAINT LOUIS",RAO,"NDIEBENE GANDIOLE","LAKHRAR 2",33,38,133,180,313
SAINT-LOUIS,"SAINT LOUIS",RAO,"NDIEBENE GANDIOLE","H1 KEUR NIANGUENE MBAO",14,17,71,92,163
SAINT-LOUIS,"SAINT LOUIS",RAO,"NDIEBENE GANDIOLE","H2 NDEGOU",43,86,345,334,679
SAINT-LOUIS,"SAINT LOUIS",RAO,"NDIEBENE GANDIOLE","H4 THIGNOR",10,14,53,57,110
SAINT-LOUIS,"SAINT LOUIS",RAO,"NDIEBENE GANDIOLE","MBOUMBAYE I (GADE)",43,54,269,289,558
SAINT-LOUIS,"SAINT LOUIS",RAO,"NDIEBENE GANDIOLE",MOUIT,200,250,968,1191,2159
SAINT-LOUIS,"SAINT LOUIS",RAO,"NDIEBENE GANDIOLE",NDEUGUETTE,9,9,76,62,138
SAINT-LOUIS,"SAINT LOUIS",RAO,"NDIEBENE GANDIOLE","H3 TEPPE",7,7,27,39,66
SAINT-LOUIS,"SAINT LOUIS",RAO,"NDIEBENE GANDIOLE","NDIEBENE GANDIOLE",361,442,2159,2573,4732
SAINT-LOUIS,"SAINT LOUIS",RAO,"NDIEBENE GANDIOLE","NDIOL GANDIOLE",46,56,248,282,530
SAINT-LOUIS,"SAINT LOUIS",RAO,"NDIEBENE GANDIOLE","H1 KEUR DJIBY DIA",11,11,65,51,116
SAINT-LOUIS,"SAINT LOUIS",RAO,"NDIEBENE GANDIOLE","H2 KEUR SEYDOU SOW",12,15,64,82,146
SAINT-LOUIS,"SAINT LOUIS",RAO,"NDIEBENE GANDIOLE","NDOYE OUOLOF",19,24,144,114,258
SAINT-LOUIS,"SAINT LOUIS",RAO,"NDIEBENE GANDIOLE","H1 NDOYE FEDIOR",1,7,30,25,55
SAINT-LOUIS,"SAINT LOUIS",RAO,"NDIEBENE GANDIOLE","H2 NDOYE DIA",7,15,78,61,139
SAINT-LOUIS,"SAINT LOUIS",RAO,"NDIEBENE GANDIOLE","H3 NDOYE SOW",4,4,31,21,52
SAINT-LOUIS,"SAINT LOUIS",RAO,"NDIEBENE GANDIOLE","NDOYE PEULH",15,16,63,61,124
SAINT-LOUIS,"SAINT LOUIS",RAO,"NDIEBENE GANDIOLE",GUINGUE,15,16,60,57,117
SAINT-LOUIS,"SAINT LOUIS",RAO,"NDIEBENE GANDIOLE","PELOUR 1 (MBOULTINE)",51,66,422,363,785
SAINT-LOUIS,"SAINT LOUIS",RAO,"NDIEBENE GANDIOLE","H2 KEUR ASSANE BA",4,12,53,42,95
SAINT-LOUIS,"SAINT LOUIS",RAO,"NDIEBENE GANDIOLE","H3 KEUR IDY DIOULDE BA",13,15,57,47,104
SAINT-LOUIS,"SAINT LOUIS",RAO,"NDIEBENE GANDIOLE","H4 KEUR DAOUDA SOW",7,7,37,24,61
SAINT-LOUIS,"SAINT LOUIS",RAO,"NDIEBENE GANDIOLE","PELOUR 2",12,15,66,51,117
SAINT-LOUIS,"SAINT LOUIS",RAO,"NDIEBENE GANDIOLE","H1 KEUR OUMAR MALADO SOW",3,12,95,67,162
SAINT-LOUIS,"SAINT LOUIS",RAO,"NDIEBENE GANDIOLE","PILOTE LA BARI",154,198,757,1109,1866
SAINT-LOUIS,"SAINT LOUIS",RAO,"NDIEBENE GANDIOLE","RIMBAKH GANDIOLE",11,31,111,133,244
SAINT-LOUIS,"SAINT LOUIS",RAO,"NDIEBENE GANDIOLE","H1 DAROU SALAM",25,32,150,194,344
SAINT-LOUIS,"SAINT LOUIS",RAO,"NDIEBENE GANDIOLE","ROCOTTE (KHEKHE)",33,45,196,193,389
SAINT-LOUIS,"SAINT LOUIS",RAO,"NDIEBENE GANDIOLE","H1 BOULEL",11,15,66,68,134
SAINT-LOUIS,"SAINT LOUIS",RAO,"NDIEBENE GANDIOLE","H2 RICOTTE 2",1,1,2,0,2
SAINT-LOUIS,"SAINT LOUIS",RAO,"NDIEBENE GANDIOLE","H4 BENIA",11,22,110,101,211
SAINT-LOUIS,"SAINT LOUIS",RAO,"NDIEBENE GANDIOLE","H5 BENIA NIAYES",13,19,99,85,184
SAINT-LOUIS,"SAINT LOUIS",RAO,"NDIEBENE GANDIOLE",TASSINERE,161,215,672,885,1557
SAINT-LOUIS,"SAINT LOUIS",RAO,"NDIEBENE GANDIOLE","TOUGUE PEULH",16,23,115,103,218
SAINT-LOUIS,"SAINT LOUIS",RAO,"NDIEBENE GANDIOLE","H1 KEUR AIMEROU",3,8,26,21,47
SAINT-LOUIS,"SAINT LOUIS",RAO,"NDIEBENE GANDIOLE","H2 KEUR ISSA DIA",15,16,56,40,96
SAINT-LOUIS,"SAINT LOUIS",RAO,"NDIEBENE GANDIOLE","H3 KEUR DEMBA DIA",2,2,7,12,19
SAINT-LOUIS,"SAINT LOUIS",RAO,"NDIEBENE GANDIOLE","TOUGUE OUOLOF",7,11,73,62,135
SAINT-LOUIS,"SAINT LOUIS",RAO,"NDIEBENE GANDIOLE","TOURE BANDE",17,21,105,98,203
SAINT-LOUIS,"SAINT LOUIS",RAO,MPAL,"GUINAW RAIL",229,292,846,961,1807
SAINT-LOUIS,"SAINT LOUIS",RAO,MPAL,MEDINA,53,58,250,248,498
SAINT-LOUIS,"SAINT LOUIS",RAO,MPAL,SANTHIABA,126,163,824,894,1718
SAINT-LOUIS,"SAINT LOUIS",RAO,MPAL,DAROU,95,125,612,701,1313
SAINT-LOUIS,"SAINT LOUIS",RAO,MPAL,"GRAND MPAL",147,184,822,865,1687
SAINT-LOUIS,"SAINT LOUIS",RAO,MPAL,KIPP,104,124,558,571,1129
SAINT-LOUIS,"SAINT LOUIS",RAO,MPAL,MBALLA,46,51,195,204,399
SAINT-LOUIS,"SAINT LOUIS",RAO,MPAL,NDER,94,127,493,578,1071
SAINT-LOUIS,"SAINT LOUIS",RAO,MPAL,TAK,45,51,233,277,510
SAINT-LOUIS,"SAINT LOUIS",RAO,MPAL,THIALENE,78,88,449,444,893
TAMBACOUNDA,BAKEL,BAKEL,BAKEL,"BAKEL COURA",152,232,1320,1014,2334
TAMBACOUNDA,BAKEL,BAKEL,BAKEL,"DARE SALAM",353,467,2372,1848,4220
TAMBACOUNDA,BAKEL,BAKEL,BAKEL,GRIMPALE,58,83,570,482,1052
TAMBACOUNDA,BAKEL,BAKEL,BAKEL,MODINKANE,61,86,562,551,1113
TAMBACOUNDA,BAKEL,BAKEL,BAKEL,MONTAGNE,147,230,997,911,1908
TAMBACOUNDA,BAKEL,BAKEL,BAKEL,YAGUINE,54,94,542,496,1038
TAMBACOUNDA,BAKEL,BAKEL,BAKEL,HLM,347,579,2061,1404,3465
TAMBACOUNDA,BAKEL,BAKEL,BAKEL,"NDIAYEGA 1",43,74,433,386,819
TAMBACOUNDA,BAKEL,BAKEL,BAKEL,"NDIAYEGA 2",96,146,811,831,1642
TAMBACOUNDA,BAKEL,BAKEL,BAKEL,"NDIAYEGA 3",84,136,682,666,1348
TAMBACOUNDA,BAKEL,KENIEBA,GATHIARY,"BOUNDOU DIOYE",36,42,363,238,601
TAMBACOUNDA,BAKEL,KENIEBA,GATHIARY,"BOUNTOUNG LOGHO",9,10,68,59,127
TAMBACOUNDA,BAKEL,KENIEBA,GATHIARY,"DEBOU DIAOUBE",3,3,40,14,54
TAMBACOUNDA,BAKEL,KENIEBA,GATHIARY,"DEBOU FADILA",4,4,32,13,45
TAMBACOUNDA,BAKEL,KENIEBA,GATHIARY,"DIYALA HAMADOU",7,8,143,163,306
TAMBACOUNDA,BAKEL,KENIEBA,GATHIARY,"H1 KOULDE SORY KANOUTE",1,1,15,0,15
TAMBACOUNDA,BAKEL,KENIEBA,GATHIARY,GATHIARY,44,44,598,599,1197
TAMBACOUNDA,BAKEL,KENIEBA,GATHIARY,"H1 KHOULDE",1,1,14,0,14
TAMBACOUNDA,BAKEL,KENIEBA,GATHIARY,"SABOUCIRE GATHIARY",14,14,175,216,391
TAMBACOUNDA,BAKEL,KENIEBA,GATHIARY,SANOUKHOL,10,14,165,171,336
TAMBACOUNDA,BAKEL,KENIEBA,GATHIARY,"TAKOUTALA II (HEREMAKONO)",6,6,100,65,165
TAMBACOUNDA,BAKEL,KENIEBA,GATHIARY,TAME,22,22,343,379,722
TAMBACOUNDA,BAKEL,KENIEBA,"MADINA FOULBE",DALAOULE,16,21,142,121,263
TAMBACOUNDA,BAKEL,KENIEBA,"MADINA FOULBE",DIOMBALLOU,12,32,123,146,269
TAMBACOUNDA,BAKEL,KENIEBA,"MADINA FOULBE",DIOUBEBA,4,15,68,50,118
TAMBACOUNDA,BAKEL,KENIEBA,"MADINA FOULBE","DIOUBOYE TRONGA",67,82,286,158,444
TAMBACOUNDA,BAKEL,KENIEBA,"MADINA FOULBE",KENIEBA,24,46,281,132,413
TAMBACOUNDA,BAKEL,KENIEBA,"MADINA FOULBE","KOBA SANSANGHOTO",5,27,101,90,191
TAMBACOUNDA,BAKEL,KENIEBA,"MADINA FOULBE",KOBATO,4,6,71,63,134
TAMBACOUNDA,BAKEL,KENIEBA,"MADINA FOULBE",LALI,28,56,354,382,736
TAMBACOUNDA,BAKEL,KENIEBA,"MADINA FOULBE","MADINA FOULBE",20,60,285,245,530
TAMBACOUNDA,BAKEL,KENIEBA,"MADINA FOULBE","H1 CARE",1,4,22,24,46
TAMBACOUNDA,BAKEL,KENIEBA,"MADINA FOULBE","SAMBA YAYE",26,30,143,114,257
TAMBACOUNDA,BAKEL,KENIEBA,"MADINA FOULBE",SEKONDJI,1,8,59,28,87
TAMBACOUNDA,BAKEL,KENIEBA,"MADINA FOULBE","TOMBORO MADJI",13,21,161,110,271
TAMBACOUNDA,BAKEL,KENIEBA,"MADINA FOULBE","H1 DINGUELOU",1,2,9,8,17
TAMBACOUNDA,BAKEL,KENIEBA,"MADINA FOULBE","H2 GOUREL BANY",2,3,13,14,27
TAMBACOUNDA,BAKEL,KENIEBA,SADATOU,BALLEDJI,5,11,47,23,70
TAMBACOUNDA,BAKEL,KENIEBA,SADATOU,"H1 TONKOUTOU",10,24,117,56,173
TAMBACOUNDA,BAKEL,KENIEBA,SADATOU,"H2 SENO CARE",23,43,370,301,671
TAMBACOUNDA,BAKEL,KENIEBA,SADATOU,"H3 WETHIE",14,18,81,20,101
TAMBACOUNDA,BAKEL,KENIEBA,SADATOU,DIAMBOURDALLA,20,35,178,204,382
TAMBACOUNDA,BAKEL,KENIEBA,SADATOU,"H2 BOUNTOUMDIAN 2",2,2,5,2,7
TAMBACOUNDA,BAKEL,KENIEBA,SADATOU,"H3 SINDIAN KANKOU (HI SINDIAN KONKOU)",8,9,42,40,82
TAMBACOUNDA,BAKEL,KENIEBA,SADATOU,DIYABOUGOU,618,720,2252,1419,3671
TAMBACOUNDA,BAKEL,KENIEBA,SADATOU,"DIYALLA BACARY",31,36,173,173,346
TAMBACOUNDA,BAKEL,KENIEBA,SADATOU,ELIMALO,20,21,134,108,242
TAMBACOUNDA,BAKEL,KENIEBA,SADATOU,HEREMAKONO,29,33,376,379,755
TAMBACOUNDA,BAKEL,KENIEBA,SADATOU,"H1 SAMBOUKHOU",3,4,38,36,74
TAMBACOUNDA,BAKEL,KENIEBA,SADATOU,KAOUROU,7,9,66,58,124
TAMBACOUNDA,BAKEL,KENIEBA,SADATOU,LAMINIA,43,63,436,318,754
TAMBACOUNDA,BAKEL,KENIEBA,SADATOU,MANSAKODJI,21,73,462,525,987
TAMBACOUNDA,BAKEL,KENIEBA,SADATOU,MOUSSALA,40,69,340,267,607
TAMBACOUNDA,BAKEL,KENIEBA,SADATOU,"NIENIEKO SARA",30,31,257,240,497
TAMBACOUNDA,BAKEL,KENIEBA,SADATOU,"H1 BAROKHOTO",1,1,5,10,15
TAMBACOUNDA,BAKEL,KENIEBA,SADATOU,"H2 MANSACOUNDA",1,1,2,3,5
TAMBACOUNDA,BAKEL,KENIEBA,SADATOU,"SABOU SIRE SORETTO",185,201,1117,570,1687
TAMBACOUNDA,BAKEL,KENIEBA,SADATOU,SADATOU,190,239,1865,1811,3676
TAMBACOUNDA,BAKEL,KENIEBA,SADATOU,"H1 FALALA",6,9,59,66,125
TAMBACOUNDA,BAKEL,KENIEBA,SADATOU,"H2 GOUREL MAKA",12,16,132,131,263
TAMBACOUNDA,BAKEL,KENIEBA,SADATOU,"H5 DIOUBE BA DAOUDA",2,2,17,22,39
TAMBACOUNDA,BAKEL,KENIEBA,SADATOU,"H4 SANDIANCO",5,10,59,40,99
TAMBACOUNDA,BAKEL,KENIEBA,SADATOU,SANDICOUNDA,20,43,228,201,429
TAMBACOUNDA,BAKEL,KENIEBA,SADATOU,SEKHOTO,8,9,55,46,101
TAMBACOUNDA,BAKEL,KENIEBA,SADATOU,"SINTHIOU MAKA",11,20,109,142,251
TAMBACOUNDA,BAKEL,KENIEBA,SADATOU,SONFARA,4,4,28,22,50
TAMBACOUNDA,BAKEL,KENIEBA,SADATOU,SONKONKOU,64,69,336,258,594
TAMBACOUNDA,BAKEL,KENIEBA,SADATOU,"H1 BOUROUM BOUROUM",10,12,83,76,159
TAMBACOUNDA,BAKEL,KENIEBA,SADATOU,"TOURE KOUNDA",6,8,53,66,119
TAMBACOUNDA,BAKEL,KENIEBA,SADATOU,"H1 GOULOUNGA",1,7,41,32,73
TAMBACOUNDA,BAKEL,KENIEBA,SADATOU,"H2 DAR SALAM",2,2,20,11,31
TAMBACOUNDA,BAKEL,KENIEBA,TOUMBOURA,ALINGUEL,5,17,99,133,232
TAMBACOUNDA,BAKEL,KENIEBA,TOUMBOURA,"BANKOUBA (BAMBAKO)",15,18,123,113,236
TAMBACOUNDA,BAKEL,KENIEBA,TOUMBOURA,"DIDIE GASSAMA",39,45,390,314,704
TAMBACOUNDA,BAKEL,KENIEBA,TOUMBOURA,GOUNDAFFA,11,16,180,187,367
TAMBACOUNDA,BAKEL,KENIEBA,TOUMBOURA,"MEDINA TRACOLE",43,47,449,465,914
TAMBACOUNDA,BAKEL,KENIEBA,TOUMBOURA,"SANSANDING (SANSANDEL)",52,75,626,673,1299
TAMBACOUNDA,BAKEL,KENIEBA,TOUMBOURA,TOUMBOURA,91,97,590,686,1276
TAMBACOUNDA,BAKEL,BELE,BELE,ARIGABOU,46,49,418,459,877
TAMBACOUNDA,BAKEL,BELE,BELE,ARRYHARRA,31,35,275,268,543
TAMBACOUNDA,BAKEL,BELE,BELE,"BELE (SENO DIAGUI)",20,23,227,249,476
TAMBACOUNDA,BAKEL,BELE,BELE,"H1 WINDE BELE",5,5,44,45,89
TAMBACOUNDA,BAKEL,BELE,BELE,BIRFAL,23,23,228,246,474
TAMBACOUNDA,BAKEL,BELE,BELE,BOUBOUYA,6,8,92,94,186
TAMBACOUNDA,BAKEL,BELE,BELE,DAHARATOU,340,443,3200,2837,6037
TAMBACOUNDA,BAKEL,BELE,BELE,DARESALAM,4,6,54,57,111
TAMBACOUNDA,BAKEL,BELE,BELE,"DIYABOUGOU MOSSI (KIP SOULEYE)",17,23,172,189,361
TAMBACOUNDA,BAKEL,BELE,BELE,DIALIGUEL,61,75,487,531,1018
TAMBACOUNDA,BAKEL,BELE,BELE,DOUNDE,17,22,148,102,250
TAMBACOUNDA,BAKEL,BELE,BELE,"FETE GOLOMBI",14,25,172,157,329
TAMBACOUNDA,BAKEL,BELE,BELE,"GAMBI DIAOUBE",16,16,158,159,317
TAMBACOUNDA,BAKEL,BELE,BELE,"GOUREL ABDOULAYE DIAW",24,26,268,247,515
TAMBACOUNDA,BAKEL,BELE,BELE,"GOUREL BOULI",16,21,158,119,277
TAMBACOUNDA,BAKEL,BELE,BELE,"GOUREL MAMADOU BARA",15,22,193,207,400
TAMBACOUNDA,BAKEL,BELE,BELE,"GOUREL MAMADOU CIRE",4,4,10,21,31
TAMBACOUNDA,BAKEL,BELE,BELE,"GOUREL SORY LAMINE",29,30,214,188,402
TAMBACOUNDA,BAKEL,BELE,BELE,GUIROBE,26,34,282,137,419
TAMBACOUNDA,BAKEL,BELE,BELE,GUITA,57,70,521,536,1057
TAMBACOUNDA,BAKEL,BELE,BELE,"LOBBO BA",7,12,94,82,176
TAMBACOUNDA,BAKEL,BELE,BELE,"H1 OURO BOLDY",2,2,8,11,19
TAMBACOUNDA,BAKEL,BELE,BELE,"MAMA NDAO",8,11,133,56,189
TAMBACOUNDA,BAKEL,BELE,BELE,NAYES,86,100,768,773,1541
TAMBACOUNDA,BAKEL,BELE,BELE,"OURO HIMADOU",73,85,746,773,1519
TAMBACOUNDA,BAKEL,BELE,BELE,"OURO SOULEYE",27,30,298,285,583
TAMBACOUNDA,BAKEL,BELE,BELE,"H1 WANDALI",2,4,32,28,60
TAMBACOUNDA,BAKEL,BELE,BELE,"SELING (CELINGUE)",46,51,476,442,918
TAMBACOUNDA,BAKEL,BELE,BELE,"H1 BOUSSOURA",13,14,77,89,166
TAMBACOUNDA,BAKEL,BELE,BELE,"SENO ISSAGA (SENO SAGA)",31,31,234,193,427
TAMBACOUNDA,BAKEL,BELE,BELE,"H1 GOUREL DEMBA KONKON",4,4,26,28,54
TAMBACOUNDA,BAKEL,BELE,BELE,"SENO SAMBA COULIBALI (GOUREL SAMBA COULIBALI)",6,7,57,50,107
TAMBACOUNDA,BAKEL,BELE,BELE,"SENO YOUPE",27,31,321,316,637
TAMBACOUNDA,BAKEL,BELE,BELE,SENOUDEBOU,137,159,1036,998,2034
TAMBACOUNDA,BAKEL,BELE,BELE,"SINTHIOU DIALIGUEL",64,74,653,716,1369
TAMBACOUNDA,BAKEL,BELE,BELE,"SINTHIOU SEYDOU NDOULO",12,12,175,192,367
TAMBACOUNDA,BAKEL,BELE,BELE,VOUBAVOL,44,57,573,505,1078
TAMBACOUNDA,BAKEL,BELE,BELE,WALIDIALA,21,26,228,220,448
TAMBACOUNDA,BAKEL,BELE,"SINTHIOU FISSA",BABABE,13,16,160,119,279
TAMBACOUNDA,BAKEL,BELE,"SINTHIOU FISSA",BANIPELLY,44,50,528,531,1059
TAMBACOUNDA,BAKEL,BELE,"SINTHIOU FISSA","BELLY DJIMBARA",45,56,500,553,1053
TAMBACOUNDA,BAKEL,BELE,"SINTHIOU FISSA",BOHE,12,14,106,112,218
TAMBACOUNDA,BAKEL,BELE,"SINTHIOU FISSA","DIAM WELLY PATHE MBAYE",12,12,108,104,212
TAMBACOUNDA,BAKEL,BELE,"SINTHIOU FISSA","H1 BOHE YALABE",2,10,83,108,191
TAMBACOUNDA,BAKEL,BELE,"SINTHIOU FISSA",FANIRA,27,33,238,239,477
TAMBACOUNDA,BAKEL,BELE,"SINTHIOU FISSA",FIDJIBIDJI,24,26,240,242,482
TAMBACOUNDA,BAKEL,BELE,"SINTHIOU FISSA","GOUNDIOUROU (DIAMEKOUNDA)",25,26,303,249,552
TAMBACOUNDA,BAKEL,BELE,"SINTHIOU FISSA",GUEDEKOU,5,10,61,57,118
TAMBACOUNDA,BAKEL,BELE,"SINTHIOU FISSA","HAMDALAYE BOCAR SADA",7,14,86,71,157
TAMBACOUNDA,BAKEL,BELE,"SINTHIOU FISSA",KOUNDEL,15,16,172,161,333
TAMBACOUNDA,BAKEL,BELE,"SINTHIOU FISSA","H1 KOUNDEL",1,2,16,7,23
TAMBACOUNDA,BAKEL,BELE,"SINTHIOU FISSA",SAKHOCOUNDA,48,59,417,404,821
TAMBACOUNDA,BAKEL,BELE,"SINTHIOU FISSA","SAMBA COLO",41,44,450,436,886
TAMBACOUNDA,BAKEL,BELE,"SINTHIOU FISSA","SENO DIARAL",10,12,97,78,175
TAMBACOUNDA,BAKEL,BELE,"SINTHIOU FISSA",SEOUDJI,67,74,585,625,1210
TAMBACOUNDA,BAKEL,BELE,"SINTHIOU FISSA","SINTHIOU FISSA",62,68,400,408,808
TAMBACOUNDA,BAKEL,BELE,"SINTHIOU FISSA","H1 FISSA DAROU",1,1,6,7,13
TAMBACOUNDA,BAKEL,BELE,"SINTHIOU FISSA","H2 GOUREL FADJIGUI",3,4,35,38,73
TAMBACOUNDA,BAKEL,BELE,"SINTHIOU FISSA","SINTHIOU SAMBA NDIARNDE (DIAMVELY)",36,39,313,325,638
TAMBACOUNDA,BAKEL,BELE,"SINTHIOU FISSA","SINTHIOU YORO MBAYE",7,7,97,97,194
TAMBACOUNDA,BAKEL,BELE,"SINTHIOU FISSA",SITABANTA,15,15,130,133,263
TAMBACOUNDA,BAKEL,BELE,"SINTHIOU FISSA",SOMBOURDAKA,3,3,49,49,98
TAMBACOUNDA,BAKEL,BELE,"SINTHIOU FISSA","H1 GOUREL NIBA",1,1,24,24,48
TAMBACOUNDA,BAKEL,BELE,"SINTHIOU FISSA",TAKOUTALA,26,27,302,339,641
TAMBACOUNDA,BAKEL,BELE,"SINTHIOU FISSA",YERIMALE,36,44,269,393,662
TAMBACOUNDA,BAKEL,BELE,"SINTHIOU FISSA","YOUPE HAMADY",50,56,347,370,717
TAMBACOUNDA,BAKEL,BELE,"SINTHIOU FISSA","YOUPE PATHE",22,29,268,231,499
TAMBACOUNDA,BAKEL,BELE,KIDIRA,ABATTOIRS,279,405,1633,1548,3181
TAMBACOUNDA,BAKEL,BELE,KIDIRA,"ALAHINA BOCAR",107,123,840,575,1415
TAMBACOUNDA,BAKEL,BELE,KIDIRA,"DIBOLY FOULBE",58,67,585,605,1190
TAMBACOUNDA,BAKEL,BELE,KIDIRA,LIBERTE,83,128,776,730,1506
TAMBACOUNDA,BAKEL,BELE,KIDIRA,MEDINE,169,244,1043,983,2026
TAMBACOUNDA,BAKEL,BELE,KIDIRA,PLATEAU,138,199,843,675,1518
TAMBACOUNDA,BAKEL,BELE,KIDIRA,PONT,92,170,814,678,1492
TAMBACOUNDA,BAKEL,BELE,KIDIRA,"SINTHIOU DIOHE",47,68,569,654,1223
TAMBACOUNDA,BAKEL,MOUDERY,BALLOU,AROUNDOU,155,174,1596,1575,3171
TAMBACOUNDA,BAKEL,MOUDERY,BALLOU,BALLOU,181,213,1831,2079,3910
TAMBACOUNDA,BAKEL,MOUDERY,BALLOU,DEBEKHOULE,58,70,534,518,1052
TAMBACOUNDA,BAKEL,MOUDERY,BALLOU,DEDJI,47,58,496,442,938
TAMBACOUNDA,BAKEL,MOUDERY,BALLOU,DJIMBE,46,61,526,657,1183
TAMBACOUNDA,BAKEL,MOUDERY,BALLOU,GANGALA,20,27,147,144,291
TAMBACOUNDA,BAKEL,MOUDERY,BALLOU,GOLMY,183,229,2864,2659,5523
TAMBACOUNDA,BAKEL,MOUDERY,BALLOU,AMADJI,46,56,637,602,1239
TAMBACOUNDA,BAKEL,MOUDERY,BALLOU,"KOUNGANY (GOUREL HAI)",149,173,1666,1863,3529
TAMBACOUNDA,BAKEL,MOUDERY,BALLOU,SEBOU,63,69,470,475,945
TAMBACOUNDA,BAKEL,MOUDERY,BALLOU,YAFERA,102,110,1084,1093,2177
TAMBACOUNDA,BAKEL,MOUDERY,GABOU,"ALAHINA BAMBARA",25,28,244,298,542
TAMBACOUNDA,BAKEL,MOUDERY,GABOU,"ALAHINA MAURE",2,3,18,31,49
TAMBACOUNDA,BAKEL,MOUDERY,GABOU,ALALEVI,15,25,254,222,476
TAMBACOUNDA,BAKEL,MOUDERY,GABOU,BEMA,46,48,296,344,640
TAMBACOUNDA,BAKEL,MOUDERY,GABOU,"BORDE FOULBE",7,12,64,63,127
TAMBACOUNDA,BAKEL,MOUDERY,GABOU,DIABAL,59,67,665,565,1230
TAMBACOUNDA,BAKEL,MOUDERY,GABOU,FALOBOULA,14,16,93,111,204
TAMBACOUNDA,BAKEL,MOUDERY,GABOU,GABOU,224,309,2252,2044,4296
TAMBACOUNDA,BAKEL,MOUDERY,GABOU,"H2 BILE BOBORE",8,16,128,119,247
TAMBACOUNDA,BAKEL,MOUDERY,GABOU,GOUNIANG,72,76,590,570,1160
TAMBACOUNDA,BAKEL,MOUDERY,GABOU,"GOUREL DIALOUBE",24,31,254,249,503
TAMBACOUNDA,BAKEL,MOUDERY,GABOU,"GOUREL MANDIOU",48,61,666,518,1184
TAMBACOUNDA,BAKEL,MOUDERY,GABOU,GUETHIE,32,50,423,408,831
TAMBACOUNDA,BAKEL,MOUDERY,GABOU,"KADIEL SAMBOUBOU",44,62,632,520,1152
TAMBACOUNDA,BAKEL,MOUDERY,GABOU,"KADIEL SEOUDOU",2,8,46,41,87
TAMBACOUNDA,BAKEL,MOUDERY,GABOU,KAHE,47,67,537,593,1130
TAMBACOUNDA,BAKEL,MOUDERY,GABOU,"H1 BILE FOULBE",3,5,28,26,54
TAMBACOUNDA,BAKEL,MOUDERY,GABOU,"KANDA BORSA",13,15,92,93,185
TAMBACOUNDA,BAKEL,MOUDERY,GABOU,"LOMBOL TOBITO",14,17,157,225,382
TAMBACOUNDA,BAKEL,MOUDERY,GABOU,MARSA,126,159,1473,1476,2949
TAMBACOUNDA,BAKEL,MOUDERY,GABOU,"MAYEL AMATH",3,4,31,37,68
TAMBACOUNDA,BAKEL,MOUDERY,GABOU,"H1 MAYEL NDAMARDY",4,9,48,46,94
TAMBACOUNDA,BAKEL,MOUDERY,GABOU,"MAYEL FILY",25,30,235,206,441
TAMBACOUNDA,BAKEL,MOUDERY,GABOU,"MEDINA ABDOUL",15,17,194,229,423
TAMBACOUNDA,BAKEL,MOUDERY,GABOU,"MEDINA CARREFOUR",7,8,72,66,138
TAMBACOUNDA,BAKEL,MOUDERY,GABOU,"MISSIRAH SAMBA YIDE",89,138,848,913,1761
TAMBACOUNDA,BAKEL,MOUDERY,GABOU,MORIBOUGOU,7,7,93,99,192
TAMBACOUNDA,BAKEL,MOUDERY,GABOU,"OLOLDOU ESCALE",18,21,172,141,313
TAMBACOUNDA,BAKEL,MOUDERY,GABOU,"SAMBA GOURO",10,12,147,167,314
TAMBACOUNDA,BAKEL,MOUDERY,GABOU,"SAMBA KONTAYE",34,46,361,322,683
TAMBACOUNDA,BAKEL,MOUDERY,GABOU,"SAMBA NIAME (SAMBA DIAME)",69,119,885,841,1726
TAMBACOUNDA,BAKEL,MOUDERY,GABOU,"SARE FADOUBE",36,40,208,220,428
TAMBACOUNDA,BAKEL,MOUDERY,GABOU,"SENO SIMBING",13,19,226,223,449
TAMBACOUNDA,BAKEL,MOUDERY,GABOU,"SINTHIOU MADINA",11,19,185,172,357
TAMBACOUNDA,BAKEL,MOUDERY,GABOU,"SINTHIOU SEYDOU DORO",15,21,287,313,600
TAMBACOUNDA,BAKEL,MOUDERY,GABOU,"SINTHIOU THINGOLEL",9,15,124,138,262
TAMBACOUNDA,BAKEL,MOUDERY,GABOU,"SIRA BAIDY (GOUREL BAIDY)",7,9,76,98,174
TAMBACOUNDA,BAKEL,MOUDERY,GABOU,"SIRA DOUNDOU",24,32,283,326,609
TAMBACOUNDA,BAKEL,MOUDERY,GABOU,"SIRA KALIDOU (SIRA DEMBOYE)",16,19,126,138,264
TAMBACOUNDA,BAKEL,MOUDERY,GABOU,"SIRA MAMADOU BOCAR",33,38,312,376,688
TAMBACOUNDA,BAKEL,MOUDERY,GABOU,"SIRA NGADA",6,7,30,48,78
TAMBACOUNDA,BAKEL,MOUDERY,GABOU,"SIRA SIMBING",3,3,21,20,41
TAMBACOUNDA,BAKEL,MOUDERY,GABOU,"SIRA SISSIBE",7,7,49,62,111
TAMBACOUNDA,BAKEL,MOUDERY,GABOU,"ALAHINA PEULH",8,14,110,96,206
TAMBACOUNDA,BAKEL,MOUDERY,GABOU,"BORDE DIAWARA",30,34,251,231,482
TAMBACOUNDA,BAKEL,MOUDERY,GABOU,"H1 GOUREL OUROULBE",2,3,22,34,56
TAMBACOUNDA,BAKEL,MOUDERY,GABOU,"LOMBOL GANDJI",10,15,114,112,226
TAMBACOUNDA,BAKEL,MOUDERY,MOUDERY,"BONDJI FOULABE",28,44,257,287,544
TAMBACOUNDA,BAKEL,MOUDERY,MOUDERY,"BONDJI SINTHIANE",22,43,406,404,810
TAMBACOUNDA,BAKEL,MOUDERY,MOUDERY,"CARREFOUR SARE HAMADI",6,22,119,97,216
TAMBACOUNDA,BAKEL,MOUDERY,MOUDERY,DIAMWELY,16,21,209,246,455
TAMBACOUNDA,BAKEL,MOUDERY,MOUDERY,"DIAMWELY GARAGE",15,21,113,163,276
TAMBACOUNDA,BAKEL,MOUDERY,MOUDERY,DIEKOULANE,6,12,55,66,121
TAMBACOUNDA,BAKEL,MOUDERY,MOUDERY,GALLADE,56,63,585,744,1329
TAMBACOUNDA,BAKEL,MOUDERY,MOUDERY,GANDE,77,90,744,872,1616
TAMBACOUNDA,BAKEL,MOUDERY,MOUDERY,MANAEL,109,129,872,905,1777
TAMBACOUNDA,BAKEL,MOUDERY,MOUDERY,MANTHIABOU,14,17,126,112,238
TAMBACOUNDA,BAKEL,MOUDERY,MOUDERY,"H1 BANDIAGARA",18,37,228,207,435
TAMBACOUNDA,BAKEL,MOUDERY,MOUDERY,"H2 BELI",14,17,98,111,209
TAMBACOUNDA,BAKEL,MOUDERY,MOUDERY,"H3 GOUREL DAO",10,27,105,119,224
TAMBACOUNDA,BAKEL,MOUDERY,MOUDERY,"H4 LOUBOUGAL",6,11,69,47,116
TAMBACOUNDA,BAKEL,MOUDERY,MOUDERY,MOUDERY,330,471,3258,3513,6771
TAMBACOUNDA,BAKEL,MOUDERY,MOUDERY,"H1 DIEYBABA",6,6,31,42,73
TAMBACOUNDA,BAKEL,MOUDERY,MOUDERY,"H2 GOUREL SAMBA SOW",1,1,10,12,22
TAMBACOUNDA,BAKEL,MOUDERY,MOUDERY,NAMANDY,37,42,422,486,908
TAMBACOUNDA,BAKEL,MOUDERY,MOUDERY,"H1 MBOMOYABE",8,19,63,91,154
TAMBACOUNDA,BAKEL,MOUDERY,MOUDERY,"OUNDOUM BABA",21,23,190,159,349
TAMBACOUNDA,BAKEL,MOUDERY,MOUDERY,"SABOUCIRE FOULBE",6,7,34,61,95
TAMBACOUNDA,BAKEL,MOUDERY,MOUDERY,"H1 SABOU SIRE SONINKE",3,3,16,18,34
TAMBACOUNDA,BAKEL,MOUDERY,MOUDERY,TOURIME,118,145,1089,1351,2440
TAMBACOUNDA,BAKEL,MOUDERY,MOUDERY,"H1 SALAMATOU",18,23,137,178,315
TAMBACOUNDA,BAKEL,MOUDERY,MOUDERY,TUABOU,161,182,1679,1723,3402
TAMBACOUNDA,BAKEL,MOUDERY,MOUDERY,YELINGARA,61,71,444,533,977
TAMBACOUNDA,BAKEL,MOUDERY,DIAWARA,"KOITALA 2",161,269,1643,1530,3173
TAMBACOUNDA,BAKEL,MOUDERY,DIAWARA,BANGASSY,43,60,871,879,1750
TAMBACOUNDA,BAKEL,MOUDERY,DIAWARA,"WADOUGA 1",73,119,880,935,1815
TAMBACOUNDA,BAKEL,MOUDERY,DIAWARA,"KOITALA 1",24,30,176,173,349
TAMBACOUNDA,BAKEL,MOUDERY,DIAWARA,SAKHOLA,43,64,464,578,1042
TAMBACOUNDA,BAKEL,MOUDERY,DIAWARA,"SAMBA DIELY",62,77,759,894,1653
TAMBACOUNDA,BAKEL,MOUDERY,DIAWARA,"WADOUGA 2",106,260,1088,1277,2365
TAMBACOUNDA,TAMBACOUNDA,TAMBACOUNDA,TAMBACOUNDA,ABATTOIRS,388,566,2167,1978,4145
TAMBACOUNDA,TAMBACOUNDA,TAMBACOUNDA,TAMBACOUNDA,"ABATTOIRS COMPLEMENT",1101,1296,4966,4876,9842
TAMBACOUNDA,TAMBACOUNDA,TAMBACOUNDA,TAMBACOUNDA,AFFIA,814,1040,4568,4330,8898
TAMBACOUNDA,TAMBACOUNDA,TAMBACOUNDA,TAMBACOUNDA,"BOUCAR COUNDA",62,64,317,311,628
TAMBACOUNDA,TAMBACOUNDA,TAMBACOUNDA,TAMBACOUNDA,"CAMP NAVETANE",574,813,3458,3167,6625
TAMBACOUNDA,TAMBACOUNDA,TAMBACOUNDA,TAMBACOUNDA,"DAROU SALAM",181,185,889,665,1554
TAMBACOUNDA,TAMBACOUNDA,TAMBACOUNDA,TAMBACOUNDA,DAROULAYE,20,28,217,254,471
TAMBACOUNDA,TAMBACOUNDA,TAMBACOUNDA,TAMBACOUNDA,DAYBATOU,201,227,924,925,1849
TAMBACOUNDA,TAMBACOUNDA,TAMBACOUNDA,TAMBACOUNDA,DEPOT,458,821,2859,2972,5831
TAMBACOUNDA,TAMBACOUNDA,TAMBACOUNDA,TAMBACOUNDA,"DIALLO BOUGOU",351,443,1694,1781,3475
TAMBACOUNDA,TAMBACOUNDA,TAMBACOUNDA,TAMBACOUNDA,"DIAMWELI 1 (SARE SILLY)",89,96,435,410,845
TAMBACOUNDA,TAMBACOUNDA,TAMBACOUNDA,TAMBACOUNDA,"DIAMWELI 2",403,442,1965,1932,3897
TAMBACOUNDA,TAMBACOUNDA,TAMBACOUNDA,TAMBACOUNDA,"GOUREL AMATH SOW",393,429,1971,1787,3758
TAMBACOUNDA,TAMBACOUNDA,TAMBACOUNDA,TAMBACOUNDA,"GOUREL BARRY",294,308,1128,1057,2185
TAMBACOUNDA,TAMBACOUNDA,TAMBACOUNDA,TAMBACOUNDA,"GOUREL DIADIE",2133,2512,10020,9611,19631
TAMBACOUNDA,TAMBACOUNDA,TAMBACOUNDA,TAMBACOUNDA,GOUYE,216,287,1176,1120,2296
TAMBACOUNDA,TAMBACOUNDA,TAMBACOUNDA,TAMBACOUNDA,KANDECOUNDA,30,33,139,142,281
TAMBACOUNDA,TAMBACOUNDA,TAMBACOUNDA,TAMBACOUNDA,KANDERY,92,99,673,645,1318
TAMBACOUNDA,TAMBACOUNDA,TAMBACOUNDA,TAMBACOUNDA,KOTHIARINDING,58,68,373,346,719
TAMBACOUNDA,TAMBACOUNDA,TAMBACOUNDA,TAMBACOUNDA,"LABA BOUGOU",13,14,58,61,119
TAMBACOUNDA,TAMBACOUNDA,TAMBACOUNDA,TAMBACOUNDA,LIBERTE,435,523,1948,1607,3555
TAMBACOUNDA,TAMBACOUNDA,TAMBACOUNDA,TAMBACOUNDA,"LIBERTE EST",416,520,1805,1552,3357
TAMBACOUNDA,TAMBACOUNDA,TAMBACOUNDA,TAMBACOUNDA,"MEDINA COURA OUEST",520,771,3394,3157,6551
TAMBACOUNDA,TAMBACOUNDA,TAMBACOUNDA,TAMBACOUNDA,PLATEAU,959,1232,5203,5133,10336
TAMBACOUNDA,TAMBACOUNDA,TAMBACOUNDA,TAMBACOUNDA,"PONT 1",567,823,3308,3509,6817
TAMBACOUNDA,TAMBACOUNDA,TAMBACOUNDA,TAMBACOUNDA,"PONT 2",348,491,2153,2160,4313
TAMBACOUNDA,TAMBACOUNDA,TAMBACOUNDA,TAMBACOUNDA,QUINZAMBOUGOU,739,1003,3598,3817,7415
TAMBACOUNDA,TAMBACOUNDA,TAMBACOUNDA,TAMBACOUNDA,"SARE GUILEL",1653,1842,7274,6759,14033
TAMBACOUNDA,TAMBACOUNDA,TAMBACOUNDA,TAMBACOUNDA,"SARE ISSA",679,728,3001,3085,6086
TAMBACOUNDA,TAMBACOUNDA,TAMBACOUNDA,TAMBACOUNDA,"SARE MOUDOU (GOUREL MODOU)",161,174,755,676,1431
TAMBACOUNDA,TAMBACOUNDA,TAMBACOUNDA,TAMBACOUNDA,"TAMBA SOCE 1",187,204,988,984,1972
TAMBACOUNDA,TAMBACOUNDA,TAMBACOUNDA,TAMBACOUNDA,"PONT 3",393,549,2311,2527,4838
TAMBACOUNDA,TAMBACOUNDA,KOUSSANAR,KOUSSANAR,"BOKIE LOTHIE (WOURO HAMA)",23,58,242,248,490
TAMBACOUNDA,TAMBACOUNDA,KOUSSANAR,KOUSSANAR,"BOULEL (SINTHIOU BOULEL)",19,27,136,124,260
TAMBACOUNDA,TAMBACOUNDA,KOUSSANAR,KOUSSANAR,"SINTHIOU DAWADY KOTO",4,4,31,33,64
TAMBACOUNDA,TAMBACOUNDA,KOUSSANAR,KOUSSANAR,"DAWADY MEISSA PATHE",160,264,1393,1533,2926
TAMBACOUNDA,TAMBACOUNDA,KOUSSANAR,KOUSSANAR,"DIARABOGUEL (FOULBES)",5,11,65,41,106
TAMBACOUNDA,TAMBACOUNDA,KOUSSANAR,KOUSSANAR,"DIAREL ASSANE",5,14,65,64,129
TAMBACOUNDA,TAMBACOUNDA,KOUSSANAR,KOUSSANAR,GADAFARA,87,91,483,451,934
TAMBACOUNDA,TAMBACOUNDA,KOUSSANAR,KOUSSANAR,"GAYE PARADJI (WOURO GELLADIO)",11,20,81,83,164
TAMBACOUNDA,TAMBACOUNDA,KOUSSANAR,KOUSSANAR,KALBIROM,58,88,514,542,1056
TAMBACOUNDA,TAMBACOUNDA,KOUSSANAR,KOUSSANAR,"KEUR DEMBA AWA",20,20,110,140,250
TAMBACOUNDA,TAMBACOUNDA,KOUSSANAR,KOUSSANAR,"KEUR OUSMANE",21,26,105,122,227
TAMBACOUNDA,TAMBACOUNDA,KOUSSANAR,KOUSSANAR,KOLOMBA,23,50,361,370,731
TAMBACOUNDA,TAMBACOUNDA,KOUSSANAR,KOUSSANAR,KOUMBIDIA,19,21,114,99,213
TAMBACOUNDA,TAMBACOUNDA,KOUSSANAR,KOUSSANAR,"KOUSSANAR ESCALE",638,752,3752,3643,7395
TAMBACOUNDA,TAMBACOUNDA,KOUSSANAR,KOUSSANAR,"KOUSSANAR SOCE",463,545,2455,2354,4809
TAMBACOUNDA,TAMBACOUNDA,KOUSSANAR,KOUSSANAR,"KOUTHIA KOTO FARINDALA MANDINGUE",37,37,246,226,472
TAMBACOUNDA,TAMBACOUNDA,KOUSSANAR,KOUSSANAR,"KOUTHIA KOTO FARINDALA PEULH",17,36,246,190,436
TAMBACOUNDA,TAMBACOUNDA,KOUSSANAR,KOUSSANAR,"KOUTHIAKOTO NDENE (KOUTHIA)",32,40,281,316,597
TAMBACOUNDA,TAMBACOUNDA,KOUSSANAR,KOUSSANAR,"LAMA KELA",9,25,127,113,240
TAMBACOUNDA,TAMBACOUNDA,KOUSSANAR,KOUSSANAR,"H1 AINOUMADY (OURO DOUNDOU)",1,5,30,19,49
TAMBACOUNDA,TAMBACOUNDA,KOUSSANAR,KOUSSANAR,"MADINA TINKOLY",14,16,96,121,217
TAMBACOUNDA,TAMBACOUNDA,KOUSSANAR,KOUSSANAR,"MALEME WOG (WOG)",20,28,162,143,305
TAMBACOUNDA,TAMBACOUNDA,KOUSSANAR,KOUSSANAR,"MBOULE (DIMBO)",34,42,358,302,660
TAMBACOUNDA,TAMBACOUNDA,KOUSSANAR,KOUSSANAR,"MEDINA NIANA 2",6,7,31,35,66
TAMBACOUNDA,TAMBACOUNDA,KOUSSANAR,KOUSSANAR,"NGALLA BOURDE",12,15,73,53,126
TAMBACOUNDA,TAMBACOUNDA,KOUSSANAR,KOUSSANAR,"OURO MOUDERY",4,6,30,25,55
TAMBACOUNDA,TAMBACOUNDA,KOUSSANAR,KOUSSANAR,"H1 DIAMSOYE",1,1,13,11,24
TAMBACOUNDA,TAMBACOUNDA,KOUSSANAR,KOUSSANAR,"H2 GOUREL MAMOUDOU",3,7,20,25,45
TAMBACOUNDA,TAMBACOUNDA,KOUSSANAR,KOUSSANAR,PAKIRANE,16,22,66,90,156
TAMBACOUNDA,TAMBACOUNDA,KOUSSANAR,KOUSSANAR,"PASS KELIMANE",18,31,182,149,331
TAMBACOUNDA,TAMBACOUNDA,KOUSSANAR,KOUSSANAR,"PASS OUMAR",13,22,142,120,262
TAMBACOUNDA,TAMBACOUNDA,KOUSSANAR,KOUSSANAR,"SAM (SAM GOUNASS SALIM)",25,49,211,231,442
TAMBACOUNDA,TAMBACOUNDA,KOUSSANAR,KOUSSANAR,"H1 GOUREL BOCAR",2,4,22,15,37
TAMBACOUNDA,TAMBACOUNDA,KOUSSANAR,KOUSSANAR,"SARE BAMOL FAMARA",8,8,46,51,97
TAMBACOUNDA,TAMBACOUNDA,KOUSSANAR,KOUSSANAR,"SARE BIROME",21,28,218,209,427
TAMBACOUNDA,TAMBACOUNDA,KOUSSANAR,KOUSSANAR,"SARE DADY",14,17,113,100,213
TAMBACOUNDA,TAMBACOUNDA,KOUSSANAR,KOUSSANAR,"H1 GOUYDI",7,7,81,80,161
TAMBACOUNDA,TAMBACOUNDA,KOUSSANAR,KOUSSANAR,"SARE DERAL (SINTHIOU DARAL)",10,12,72,72,144
TAMBACOUNDA,TAMBACOUNDA,KOUSSANAR,KOUSSANAR,"SARE DIOULDE (OURO SAMODIAL)",4,9,44,30,74
TAMBACOUNDA,TAMBACOUNDA,KOUSSANAR,KOUSSANAR,"SARE FODE",14,19,84,98,182
TAMBACOUNDA,TAMBACOUNDA,KOUSSANAR,KOUSSANAR,"SARE GOUBOU 2",10,12,63,60,123
TAMBACOUNDA,TAMBACOUNDA,KOUSSANAR,KOUSSANAR,"SARE NGAYE SAMBA",13,17,173,163,336
TAMBACOUNDA,TAMBACOUNDA,KOUSSANAR,KOUSSANAR,"SARE NIAMBA",5,5,49,35,84
TAMBACOUNDA,TAMBACOUNDA,KOUSSANAR,KOUSSANAR,"SARE SAMBAROU (SARE TAMOU)",19,28,172,157,329
TAMBACOUNDA,TAMBACOUNDA,KOUSSANAR,KOUSSANAR,"SENO SAMBA YABE",12,25,147,122,269
TAMBACOUNDA,TAMBACOUNDA,KOUSSANAR,KOUSSANAR,"SINTHIOU HAMADY ( OURO WALY)",9,26,117,108,225
TAMBACOUNDA,TAMBACOUNDA,KOUSSANAR,KOUSSANAR,"H1 SARE BARKATOUL",5,11,59,61,120
TAMBACOUNDA,TAMBACOUNDA,KOUSSANAR,KOUSSANAR,"H2 GOUREL GAEL",4,4,12,21,33
TAMBACOUNDA,TAMBACOUNDA,KOUSSANAR,KOUSSANAR,"SINTHIOU BALLA MALESINE ( MALESINE)",29,49,234,237,471
TAMBACOUNDA,TAMBACOUNDA,KOUSSANAR,KOUSSANAR,"H1 GALLE OUSMANE DIENG",2,2,21,26,47
TAMBACOUNDA,TAMBACOUNDA,KOUSSANAR,KOUSSANAR,"H2 GALLE ABASS SOW",1,1,9,17,26
TAMBACOUNDA,TAMBACOUNDA,KOUSSANAR,KOUSSANAR,"H3 GALLE MAMADOU CAMARA",1,1,18,8,26
TAMBACOUNDA,TAMBACOUNDA,KOUSSANAR,KOUSSANAR,"H4 SINTHIANE ABDOULAYE",1,2,10,17,27
TAMBACOUNDA,TAMBACOUNDA,KOUSSANAR,KOUSSANAR,"SINTHIOU BARINABE (BARINABE TOUMBOUNG)",14,19,157,162,319
TAMBACOUNDA,TAMBACOUNDA,KOUSSANAR,KOUSSANAR,"SINTHIOU BOUBOU (GOUREL HAMA BOUBOU)",9,19,58,49,107
TAMBACOUNDA,TAMBACOUNDA,KOUSSANAR,KOUSSANAR,"SINTHIOU DAWADY",24,44,233,199,432
TAMBACOUNDA,TAMBACOUNDA,KOUSSANAR,KOUSSANAR,"SINTHIOU DEMBA (DORO FOUNDOUROU)",10,24,115,115,230
TAMBACOUNDA,TAMBACOUNDA,KOUSSANAR,KOUSSANAR,"SINTHIOU DEMBA DEME",20,48,224,282,506
TAMBACOUNDA,TAMBACOUNDA,KOUSSANAR,KOUSSANAR,"SINTHIOU DEMBA NIAMBA (DEBE)",8,28,134,117,251
TAMBACOUNDA,TAMBACOUNDA,KOUSSANAR,KOUSSANAR,"SINTHIOU DIALIGUE (BOHE BALEDJI)",52,78,507,465,972
TAMBACOUNDA,TAMBACOUNDA,KOUSSANAR,KOUSSANAR,"H2 MADINA SARAYEL (MEDINA OMAR BA)",4,10,45,71,116
TAMBACOUNDA,TAMBACOUNDA,KOUSSANAR,KOUSSANAR,"H3 MADINA SALIOU",2,2,16,13,29
TAMBACOUNDA,TAMBACOUNDA,KOUSSANAR,KOUSSANAR,"SINTHIOU DOUBEL (PARAVOL)",18,41,183,165,348
TAMBACOUNDA,TAMBACOUNDA,KOUSSANAR,KOUSSANAR,"H2 HAMDALLAYE",2,5,15,19,34
TAMBACOUNDA,TAMBACOUNDA,KOUSSANAR,KOUSSANAR,"SINTHIOU DOUNGOUROU",3,4,23,11,34
TAMBACOUNDA,TAMBACOUNDA,KOUSSANAR,KOUSSANAR,"SINTHIOU GUEDA MODIBO",16,18,89,91,180
TAMBACOUNDA,TAMBACOUNDA,KOUSSANAR,KOUSSANAR,"SINTHIOU GUEDY DIALLO (GOUREL GUEDOU)",3,15,71,63,134
TAMBACOUNDA,TAMBACOUNDA,KOUSSANAR,KOUSSANAR,"H1 SINTHIOU DEMBA DIALLO",2,4,18,31,49
TAMBACOUNDA,TAMBACOUNDA,KOUSSANAR,KOUSSANAR,"SINTHIOU HAMADY  HAMA (OURO DIALOUBES)",9,27,129,167,296
TAMBACOUNDA,TAMBACOUNDA,KOUSSANAR,KOUSSANAR,"SINTHIOU KADY (SARE THIOBORY)",34,41,244,224,468
TAMBACOUNDA,TAMBACOUNDA,KOUSSANAR,KOUSSANAR,"SINTHIOU KAHE (OURO SENO 1)",5,16,138,111,249
TAMBACOUNDA,TAMBACOUNDA,KOUSSANAR,KOUSSANAR,"SINTHIOU KAHE (OURO SENO 2)",8,19,144,140,284
TAMBACOUNDA,TAMBACOUNDA,KOUSSANAR,KOUSSANAR,"SINTHIOU KOUMBIDIA (KOBOTO)",7,9,38,34,72
TAMBACOUNDA,TAMBACOUNDA,KOUSSANAR,KOUSSANAR,"SINTHIOU LAMA",1,2,5,13,18
TAMBACOUNDA,TAMBACOUNDA,KOUSSANAR,KOUSSANAR,"SINTHIOU MABOUBES (BALLA BANE)",9,23,107,128,235
TAMBACOUNDA,TAMBACOUNDA,KOUSSANAR,KOUSSANAR,"SINTHIOU MALAO DIAO",1,6,23,19,42
TAMBACOUNDA,TAMBACOUNDA,KOUSSANAR,KOUSSANAR,"SINTHIOU MALEDE DEME",6,18,67,55,122
TAMBACOUNDA,TAMBACOUNDA,KOUSSANAR,KOUSSANAR,"SINTHIOU MAMOUDOU (OURO SORY)",15,32,178,223,401
TAMBACOUNDA,TAMBACOUNDA,KOUSSANAR,KOUSSANAR,"SINTHIOU MANSALY DIAO",6,8,28,44,72
TAMBACOUNDA,TAMBACOUNDA,KOUSSANAR,KOUSSANAR,"H1 SINTHIANE NDIENGOUDOU BA",2,2,12,9,21
TAMBACOUNDA,TAMBACOUNDA,KOUSSANAR,KOUSSANAR,"SINTHIOU WOPA BA",9,25,119,112,231
TAMBACOUNDA,TAMBACOUNDA,KOUSSANAR,KOUSSANAR,"SINTHIOU PAGNATE",15,29,128,96,224
TAMBACOUNDA,TAMBACOUNDA,KOUSSANAR,KOUSSANAR,"SINTHIOU PAGNATE DEMBA DJIBEL (PAGNATE MBALBE)",14,20,163,147,310
TAMBACOUNDA,TAMBACOUNDA,KOUSSANAR,KOUSSANAR,"SINTHIOU PAGNATE GOUNDO (SARE SYLLI)",7,7,64,55,119
TAMBACOUNDA,TAMBACOUNDA,KOUSSANAR,KOUSSANAR,"SINTHIOU PAGNATE MOUNDJI",3,3,29,28,57
TAMBACOUNDA,TAMBACOUNDA,KOUSSANAR,KOUSSANAR,"SINTHIOU PASS (PASS GAINTHE)",23,27,126,130,256
TAMBACOUNDA,TAMBACOUNDA,KOUSSANAR,KOUSSANAR,"SINTHIOU SADIO ALIOU DIALLO",16,18,70,53,123
TAMBACOUNDA,TAMBACOUNDA,KOUSSANAR,KOUSSANAR,"SINTHIOU SAMBA NIEBE (SARE NIEBE)",8,8,65,46,111
TAMBACOUNDA,TAMBACOUNDA,KOUSSANAR,KOUSSANAR,"SINTHIOU SAMBA THIOULOU (LEWA)",17,20,132,135,267
TAMBACOUNDA,TAMBACOUNDA,KOUSSANAR,KOUSSANAR,"H1 GOUREL ALY",1,2,11,9,20
TAMBACOUNDA,TAMBACOUNDA,KOUSSANAR,KOUSSANAR,"SINTHIOU SAMBOUROU",32,49,326,301,627
TAMBACOUNDA,TAMBACOUNDA,KOUSSANAR,KOUSSANAR,"SINTHIOU SAMBOUROU DEME",14,19,177,180,357
TAMBACOUNDA,TAMBACOUNDA,KOUSSANAR,KOUSSANAR,"H1 BOUSSOURA",1,2,6,11,17
TAMBACOUNDA,TAMBACOUNDA,KOUSSANAR,KOUSSANAR,"SINTHIOU SIRE KANE (KAHIP) (KAIPONGUEL)",11,16,85,73,158
TAMBACOUNDA,TAMBACOUNDA,KOUSSANAR,KOUSSANAR,"SINTHIOU SYLLA MAKHA",9,19,96,103,199
TAMBACOUNDA,TAMBACOUNDA,KOUSSANAR,KOUSSANAR,"SINTHIOU THIEKEDE",7,9,78,75,153
TAMBACOUNDA,TAMBACOUNDA,KOUSSANAR,KOUSSANAR,"SINTHIOU TOUMANY (OURO MOLLO)",15,25,174,148,322
TAMBACOUNDA,TAMBACOUNDA,KOUSSANAR,KOUSSANAR,"SINTHIOU WOURO",13,16,81,101,182
TAMBACOUNDA,TAMBACOUNDA,KOUSSANAR,KOUSSANAR,"TINKOLY PEULH",6,9,72,56,128
TAMBACOUNDA,TAMBACOUNDA,KOUSSANAR,KOUSSANAR,"TOUBA TIAPATO (TOUBA 2)",10,12,74,86,160
TAMBACOUNDA,TAMBACOUNDA,KOUSSANAR,KOUSSANAR,"TOUBERE BAFALL (TOUBERE GONGHEDJI)",3,4,31,23,54
TAMBACOUNDA,TAMBACOUNDA,KOUSSANAR,KOUSSANAR,"TOUBERE DIAOUBE",14,33,164,128,292
TAMBACOUNDA,TAMBACOUNDA,KOUSSANAR,KOUSSANAR,"TOUBERE SODORKHO (TOUBERE DEMBAILA)",14,44,114,123,237
TAMBACOUNDA,TAMBACOUNDA,KOUSSANAR,KOUSSANAR,"TOULDE THIEKOYE",1,14,68,90,158
TAMBACOUNDA,TAMBACOUNDA,KOUSSANAR,KOUSSANAR,"VELINGARA BOUNDOU (SINTHIOU GAGNADO)",5,11,55,41,96
TAMBACOUNDA,TAMBACOUNDA,KOUSSANAR,KOUSSANAR,"VELINGARA DIALLOUBE",5,13,43,74,117
TAMBACOUNDA,TAMBACOUNDA,KOUSSANAR,KOUSSANAR,"VELINGARA FERLO (OURO SEKOUROU)",7,11,41,62,103
TAMBACOUNDA,TAMBACOUNDA,KOUSSANAR,KOUSSANAR,YALALBE,11,18,79,79,158
TAMBACOUNDA,TAMBACOUNDA,KOUSSANAR,KOUSSANAR,"BELEL KODIOLY",5,13,33,55,88
TAMBACOUNDA,TAMBACOUNDA,KOUSSANAR,KOUSSANAR,"DAR SALAM (WOURO HAMA BA)",1,4,35,22,57
TAMBACOUNDA,TAMBACOUNDA,KOUSSANAR,KOUSSANAR,DENDOUDJI,5,14,64,61,125
TAMBACOUNDA,TAMBACOUNDA,KOUSSANAR,KOUSSANAR,DIAMWELI,6,8,34,30,64
TAMBACOUNDA,TAMBACOUNDA,KOUSSANAR,KOUSSANAR,GUIRY,1,3,15,16,31
TAMBACOUNDA,TAMBACOUNDA,KOUSSANAR,KOUSSANAR,"HAÏNY MADY DIALALOU",1,3,21,15,36
TAMBACOUNDA,TAMBACOUNDA,KOUSSANAR,KOUSSANAR,"KOUTHIA BOURE",9,12,69,69,138
TAMBACOUNDA,TAMBACOUNDA,KOUSSANAR,KOUSSANAR,KOUTOUMANG,6,7,26,28,54
TAMBACOUNDA,TAMBACOUNDA,KOUSSANAR,KOUSSANAR,"MADINA MOLLO BA",2,9,59,48,107
TAMBACOUNDA,TAMBACOUNDA,KOUSSANAR,KOUSSANAR,"SARE BOUBOU",10,15,81,79,160
TAMBACOUNDA,TAMBACOUNDA,KOUSSANAR,KOUSSANAR,"SARE DEMBA",8,9,50,55,105
TAMBACOUNDA,TAMBACOUNDA,KOUSSANAR,KOUSSANAR,"SARE HAMADY",10,10,76,81,157
TAMBACOUNDA,TAMBACOUNDA,KOUSSANAR,KOUSSANAR,"SARE NIAKEL",5,16,82,100,182
TAMBACOUNDA,TAMBACOUNDA,KOUSSANAR,KOUSSANAR,"SINTHIANE GALLO DIALLO",6,6,53,38,91
TAMBACOUNDA,TAMBACOUNDA,KOUSSANAR,KOUSSANAR,"SINTHIOU BANY",1,4,18,12,30
TAMBACOUNDA,TAMBACOUNDA,KOUSSANAR,KOUSSANAR,"SINTHIOU BOCAR BA",3,3,7,5,12
TAMBACOUNDA,TAMBACOUNDA,KOUSSANAR,KOUSSANAR,"SINTHIOU BORA BA",3,3,31,27,58
TAMBACOUNDA,TAMBACOUNDA,KOUSSANAR,KOUSSANAR,"SINTHIOU DIAMAYELLE",1,17,58,64,122
TAMBACOUNDA,TAMBACOUNDA,KOUSSANAR,KOUSSANAR,"SINTHIOU GATA",2,4,23,28,51
TAMBACOUNDA,TAMBACOUNDA,KOUSSANAR,KOUSSANAR,"SINTHIOU HAMADY BA",2,5,27,22,49
TAMBACOUNDA,TAMBACOUNDA,KOUSSANAR,KOUSSANAR,"SINTHIOU KADY DEME",4,6,49,32,81
TAMBACOUNDA,TAMBACOUNDA,KOUSSANAR,KOUSSANAR,"SINTHIOU NETE SOW",2,2,9,7,16
TAMBACOUNDA,TAMBACOUNDA,KOUSSANAR,KOUSSANAR,"SINTHIOU SADIO NIANG",4,8,38,54,92
TAMBACOUNDA,TAMBACOUNDA,KOUSSANAR,KOUSSANAR,"TINKOLY MANDINGUE",10,11,75,79,154
TAMBACOUNDA,TAMBACOUNDA,KOUSSANAR,KOUSSANAR,"VELINGARA DEMBA TALL",1,1,6,6,12
TAMBACOUNDA,TAMBACOUNDA,KOUSSANAR,KOUSSANAR,"WENDOU KOLLE",6,10,39,48,87
TAMBACOUNDA,TAMBACOUNDA,KOUSSANAR,"SINTHIOU MALEME",BOTOU,67,81,467,453,920
TAMBACOUNDA,TAMBACOUNDA,KOUSSANAR,"SINTHIOU MALEME","BOUDOU BOUDOU (SINTHIOU WALIFARA)",22,30,145,168,313
TAMBACOUNDA,TAMBACOUNDA,KOUSSANAR,"SINTHIOU MALEME","BOUKARIKOUNDA DIALLO",6,11,97,83,180
TAMBACOUNDA,TAMBACOUNDA,KOUSSANAR,"SINTHIOU MALEME","BOUKARIKOUNDA PEULH",10,10,82,68,150
TAMBACOUNDA,TAMBACOUNDA,KOUSSANAR,"SINTHIOU MALEME",BOUSSOURA,10,10,58,70,128
TAMBACOUNDA,TAMBACOUNDA,KOUSSANAR,"SINTHIOU MALEME","DAMBA MISSIRA",17,22,190,172,362
TAMBACOUNDA,TAMBACOUNDA,KOUSSANAR,"SINTHIOU MALEME","H1 SINTHIOU DAMBA",11,11,78,75,153
TAMBACOUNDA,TAMBACOUNDA,KOUSSANAR,"SINTHIOU MALEME",DIALACORO,68,70,379,342,721
TAMBACOUNDA,TAMBACOUNDA,KOUSSANAR,"SINTHIOU MALEME","H1 SINTHIOU BOUBOU DEME COUNDA",5,5,28,19,47
TAMBACOUNDA,TAMBACOUNDA,KOUSSANAR,"SINTHIOU MALEME","DIAM DIAM NDAWENE (MALEME KOTO)",4,4,77,67,144
TAMBACOUNDA,TAMBACOUNDA,KOUSSANAR,"SINTHIOU MALEME","DIAMBODINA MANDINGUE",13,14,102,96,198
TAMBACOUNDA,TAMBACOUNDA,KOUSSANAR,"SINTHIOU MALEME",GUIRIGARA,14,17,101,86,187
TAMBACOUNDA,TAMBACOUNDA,KOUSSANAR,"SINTHIOU MALEME",IDAKOTO,29,30,199,153,352
TAMBACOUNDA,TAMBACOUNDA,KOUSSANAR,"SINTHIOU MALEME","IDAKOTO PONT (PONDALLA)",5,5,47,42,89
TAMBACOUNDA,TAMBACOUNDA,KOUSSANAR,"SINTHIOU MALEME","SINTHIOU INADINA",7,11,70,89,159
TAMBACOUNDA,TAMBACOUNDA,KOUSSANAR,"SINTHIOU MALEME","KEREWANE TAMBA SANGHARE",3,3,24,13,37
TAMBACOUNDA,TAMBACOUNDA,KOUSSANAR,"SINTHIOU MALEME",KOROMADJI,19,22,160,107,267
TAMBACOUNDA,TAMBACOUNDA,KOUSSANAR,"SINTHIOU MALEME","KOUTHIA KOUROUMA",22,23,196,197,393
TAMBACOUNDA,TAMBACOUNDA,KOUSSANAR,"SINTHIOU MALEME","LYCOUNDA MANDINGUE",69,72,368,353,721
TAMBACOUNDA,TAMBACOUNDA,KOUSSANAR,"SINTHIOU MALEME","LYCOUNDA PEULH",21,30,167,176,343
TAMBACOUNDA,TAMBACOUNDA,KOUSSANAR,"SINTHIOU MALEME","LYCOUNDA SIDY",25,27,86,80,166
TAMBACOUNDA,TAMBACOUNDA,KOUSSANAR,"SINTHIOU MALEME","MADINA DIAM DIAM",7,9,62,50,112
TAMBACOUNDA,TAMBACOUNDA,KOUSSANAR,"SINTHIOU MALEME","MADINA NIANA 1",44,48,419,358,777
TAMBACOUNDA,TAMBACOUNDA,KOUSSANAR,"SINTHIOU MALEME","H2 TOUMBOUN  THIANA",2,2,12,14,26
TAMBACOUNDA,TAMBACOUNDA,KOUSSANAR,"SINTHIOU MALEME","MADINA SARAKHOLE",23,25,290,305,595
TAMBACOUNDA,TAMBACOUNDA,KOUSSANAR,"SINTHIOU MALEME",MARIBOUGOU,10,10,99,91,190
TAMBACOUNDA,TAMBACOUNDA,KOUSSANAR,"SINTHIOU MALEME","MAYEL DIBY",20,22,128,116,244
TAMBACOUNDA,TAMBACOUNDA,KOUSSANAR,"SINTHIOU MALEME","MEDINA DIAKHA",36,41,272,300,572
TAMBACOUNDA,TAMBACOUNDA,KOUSSANAR,"SINTHIOU MALEME","MEDINA MABOUBE (MEDINA BAMBARA)",41,47,247,257,504
TAMBACOUNDA,TAMBACOUNDA,KOUSSANAR,"SINTHIOU MALEME","MEDINA MAMOUDOU",11,15,69,59,128
TAMBACOUNDA,TAMBACOUNDA,KOUSSANAR,"SINTHIOU MALEME","MEDINA MOUSSA (SARE MOUSSA)",15,16,121,119,240
TAMBACOUNDA,TAMBACOUNDA,KOUSSANAR,"SINTHIOU MALEME","H1 GALLE ALASSANE BA",1,1,8,7,15
TAMBACOUNDA,TAMBACOUNDA,KOUSSANAR,"SINTHIOU MALEME",MISSIRAH,10,10,43,50,93
TAMBACOUNDA,TAMBACOUNDA,KOUSSANAR,"SINTHIOU MALEME","PADA PEULH (SARE MBAYE)",28,29,182,155,337
TAMBACOUNDA,TAMBACOUNDA,KOUSSANAR,"SINTHIOU MALEME","HI KARAMATOU",13,16,83,80,163
TAMBACOUNDA,TAMBACOUNDA,KOUSSANAR,"SINTHIOU MALEME","SADIO BOULOU PEUL",3,3,23,12,35
TAMBACOUNDA,TAMBACOUNDA,KOUSSANAR,"SINTHIOU MALEME","SADIO BOULOU THIOMBEL",4,4,29,31,60
TAMBACOUNDA,TAMBACOUNDA,KOUSSANAR,"SINTHIOU MALEME","SAMBADIANG COUNDA",5,5,73,44,117
TAMBACOUNDA,TAMBACOUNDA,KOUSSANAR,"SINTHIOU MALEME","SAMEKOUTA MANDINGUE",17,18,158,138,296
TAMBACOUNDA,TAMBACOUNDA,KOUSSANAR,"SINTHIOU MALEME","SAMEKOUTA PEULH (SINTHIOU DIALLO)",37,40,307,270,577
TAMBACOUNDA,TAMBACOUNDA,KOUSSANAR,"SINTHIOU MALEME","H1 SARE NIANA",9,10,41,37,78
TAMBACOUNDA,TAMBACOUNDA,KOUSSANAR,"SINTHIOU MALEME","SARE DOUNGUEL",10,11,63,34,97
TAMBACOUNDA,TAMBACOUNDA,KOUSSANAR,"SINTHIOU MALEME","SARE FARING (FARIKOUNDA)",55,62,326,251,577
TAMBACOUNDA,TAMBACOUNDA,KOUSSANAR,"SINTHIOU MALEME","SARE NGAYE SAMBA",13,22,92,97,189
TAMBACOUNDA,TAMBACOUNDA,KOUSSANAR,"SINTHIOU MALEME","SARE SABAKE THIEWAL",18,23,103,118,221
TAMBACOUNDA,TAMBACOUNDA,KOUSSANAR,"SINTHIOU MALEME","H1 DIALAKORO",6,11,72,68,140
TAMBACOUNDA,TAMBACOUNDA,KOUSSANAR,"SINTHIOU MALEME","SINTHIOU BALLA",27,30,189,204,393
TAMBACOUNDA,TAMBACOUNDA,KOUSSANAR,"SINTHIOU MALEME","SINTHIOU DIADIE",10,12,105,90,195
TAMBACOUNDA,TAMBACOUNDA,KOUSSANAR,"SINTHIOU MALEME","SINTHIOU DIALIGUEL",13,13,102,63,165
TAMBACOUNDA,TAMBACOUNDA,KOUSSANAR,"SINTHIOU MALEME","SINTHIOU DIAOULI",15,23,113,91,204
TAMBACOUNDA,TAMBACOUNDA,KOUSSANAR,"SINTHIOU MALEME","SINTHIOU DIAM SOW",8,11,115,113,228
TAMBACOUNDA,TAMBACOUNDA,KOUSSANAR,"SINTHIOU MALEME","SINTHIOU FARING",31,38,226,196,422
TAMBACOUNDA,TAMBACOUNDA,KOUSSANAR,"SINTHIOU MALEME","H1 TAIBATOU",14,22,168,146,314
TAMBACOUNDA,TAMBACOUNDA,KOUSSANAR,"SINTHIOU MALEME","SINTHIOU GAYO",54,87,486,495,981
TAMBACOUNDA,TAMBACOUNDA,KOUSSANAR,"SINTHIOU MALEME","H1 GALLE ALPHA SOW",2,2,10,10,20
TAMBACOUNDA,TAMBACOUNDA,KOUSSANAR,"SINTHIOU MALEME","H2 GALLE BODEL BA",1,1,19,14,33
TAMBACOUNDA,TAMBACOUNDA,KOUSSANAR,"SINTHIOU MALEME","H3 SARE NDIOBA SOW",6,6,36,44,80
TAMBACOUNDA,TAMBACOUNDA,KOUSSANAR,"SINTHIOU MALEME","SINTHIOU KOUNA",11,14,77,79,156
TAMBACOUNDA,TAMBACOUNDA,KOUSSANAR,"SINTHIOU MALEME","SINTHIOU MALEME",867,969,4496,4322,8818
TAMBACOUNDA,TAMBACOUNDA,KOUSSANAR,"SINTHIOU MALEME","H1 SINTHIOU FODE",7,7,40,37,77
TAMBACOUNDA,TAMBACOUNDA,KOUSSANAR,"SINTHIOU MALEME","SINTHIOU MAYEL (SINTHIOU THIAPATO)",21,30,116,70,186
TAMBACOUNDA,TAMBACOUNDA,KOUSSANAR,"SINTHIOU MALEME","SINTHIOU NOPPY (SARE MOUDOU)",23,25,119,76,195
TAMBACOUNDA,TAMBACOUNDA,KOUSSANAR,"SINTHIOU MALEME","SINTHIOU OUSMANE DIALLO",18,22,122,145,267
TAMBACOUNDA,TAMBACOUNDA,KOUSSANAR,"SINTHIOU MALEME","H1 SINTHIOU HAROUNA",1,1,9,6,15
TAMBACOUNDA,TAMBACOUNDA,KOUSSANAR,"SINTHIOU MALEME","H2 SINTHIOU YORO DIALLO",1,1,11,10,21
TAMBACOUNDA,TAMBACOUNDA,KOUSSANAR,"SINTHIOU MALEME","SINTHIOU SAKHO (TAWFEKH)",9,9,68,70,138
TAMBACOUNDA,TAMBACOUNDA,KOUSSANAR,"SINTHIOU MALEME","SINTHIOU SOUNA (SIRAMANDIALA SOUNA)",10,13,89,47,136
TAMBACOUNDA,TAMBACOUNDA,KOUSSANAR,"SINTHIOU MALEME","SIRAMANDIALA BOYE",17,23,153,97,250
TAMBACOUNDA,TAMBACOUNDA,KOUSSANAR,"SINTHIOU MALEME","SIRAMANDIALA FODE",7,9,59,57,116
TAMBACOUNDA,TAMBACOUNDA,KOUSSANAR,"SINTHIOU MALEME",SITADIANG,8,9,54,47,101
TAMBACOUNDA,TAMBACOUNDA,KOUSSANAR,"SINTHIOU MALEME",THIAOR,31,36,157,184,341
TAMBACOUNDA,TAMBACOUNDA,KOUSSANAR,"SINTHIOU MALEME","THIORO BOUGOU BAMBARA",10,11,59,54,113
TAMBACOUNDA,TAMBACOUNDA,KOUSSANAR,"SINTHIOU MALEME","THIORO GALLO (SINTHIOU SABAKE)",7,9,60,41,101
TAMBACOUNDA,TAMBACOUNDA,KOUSSANAR,"SINTHIOU MALEME","HI SINTHIOU PADA",8,9,39,43,82
TAMBACOUNDA,TAMBACOUNDA,KOUSSANAR,"SINTHIOU MALEME","THIOROBOUGOU PEULH",10,10,95,98,193
TAMBACOUNDA,TAMBACOUNDA,KOUSSANAR,"SINTHIOU MALEME","TOUBA FALL",81,88,396,350,746
TAMBACOUNDA,TAMBACOUNDA,KOUSSANAR,"SINTHIOU MALEME","TOUBA NDAWENE",4,6,23,19,42
TAMBACOUNDA,TAMBACOUNDA,KOUSSANAR,"SINTHIOU MALEME","VELINGARA SABAKE",14,16,98,101,199
TAMBACOUNDA,TAMBACOUNDA,KOUSSANAR,"SINTHIOU MALEME","VELINGARA SAMBA",8,12,96,42,138
TAMBACOUNDA,TAMBACOUNDA,KOUSSANAR,"SINTHIOU MALEME","GALLO BOUGOU",34,36,236,196,432
TAMBACOUNDA,TAMBACOUNDA,KOUSSANAR,"SINTHIOU MALEME","HAMDALAYE DIOUHE",2,11,23,18,41
TAMBACOUNDA,TAMBACOUNDA,KOUSSANAR,"SINTHIOU MALEME","HAMDALLAH FARY",9,9,57,56,113
TAMBACOUNDA,TAMBACOUNDA,KOUSSANAR,"SINTHIOU MALEME","MEDINA SILY",5,5,35,38,73
TAMBACOUNDA,TAMBACOUNDA,KOUSSANAR,"SINTHIOU MALEME","SINTHIANE SAMBA BA",1,3,12,11,23
TAMBACOUNDA,TAMBACOUNDA,KOUSSANAR,"SINTHIOU MALEME",LAMBABOUGOUII,49,49,179,169,348
TAMBACOUNDA,TAMBACOUNDA,KOUSSANAR,"SINTHIOU MALEME","NEMA 1",5,5,41,34,75
TAMBACOUNDA,TAMBACOUNDA,KOUSSANAR,"SINTHIOU MALEME","SARE OUSMANE",31,32,109,100,209
TAMBACOUNDA,TAMBACOUNDA,KOUSSANAR,"SINTHIOU MALEME","SINTHIOU ADAMA",4,4,19,12,31
TAMBACOUNDA,TAMBACOUNDA,KOUSSANAR,"SINTHIOU MALEME","SINTHIOU DEMBA",10,19,124,119,243
TAMBACOUNDA,TAMBACOUNDA,KOUSSANAR,"SINTHIOU MALEME","SINTHIOU DIKO",2,2,15,12,27
TAMBACOUNDA,TAMBACOUNDA,KOUSSANAR,"SINTHIOU MALEME","SINTHIOU TIDIANE",2,4,20,18,38
TAMBACOUNDA,TAMBACOUNDA,MAKACOLIBANTANG,MAKACOLIBANTANG,"BARKAYEL (KASSEDI BARKAYEL)",16,16,197,213,410
TAMBACOUNDA,TAMBACOUNDA,MAKACOLIBANTANG,MAKACOLIBANTANG,BAROCOUNDA,33,38,385,271,656
TAMBACOUNDA,TAMBACOUNDA,MAKACOLIBANTANG,MAKACOLIBANTANG,BOULEMBOU,56,73,788,945,1733
TAMBACOUNDA,TAMBACOUNDA,MAKACOLIBANTANG,MAKACOLIBANTANG,"BOYNGUEL NGHABA",5,6,39,35,74
TAMBACOUNDA,TAMBACOUNDA,MAKACOLIBANTANG,MAKACOLIBANTANG,COULIBANTANG,205,243,1909,1604,3513
TAMBACOUNDA,TAMBACOUNDA,MAKACOLIBANTANG,MAKACOLIBANTANG,DEMBARING,18,23,120,120,240
TAMBACOUNDA,TAMBACOUNDA,MAKACOLIBANTANG,MAKACOLIBANTANG,DEMBOULE,10,18,135,155,290
TAMBACOUNDA,TAMBACOUNDA,MAKACOLIBANTANG,MAKACOLIBANTANG,"H1 KERECOUNDA",8,8,64,61,125
TAMBACOUNDA,TAMBACOUNDA,MAKACOLIBANTANG,MAKACOLIBANTANG,"DIAKABA (SARE MAMADOU)",6,9,80,65,145
TAMBACOUNDA,TAMBACOUNDA,MAKACOLIBANTANG,MAKACOLIBANTANG,"DIALASSABA DIOUTE",8,13,121,94,215
TAMBACOUNDA,TAMBACOUNDA,MAKACOLIBANTANG,MAKACOLIBANTANG,"DIALASSABA PEULH (DIALASSABA DIATTA)",11,12,115,110,225
TAMBACOUNDA,TAMBACOUNDA,MAKACOLIBANTANG,MAKACOLIBANTANG,"DIALASSABA SARACOLLE",12,30,285,326,611
TAMBACOUNDA,TAMBACOUNDA,MAKACOLIBANTANG,MAKACOLIBANTANG,DIAMGOULOR,67,89,659,589,1248
TAMBACOUNDA,TAMBACOUNDA,MAKACOLIBANTANG,MAKACOLIBANTANG,DIENDER,47,59,922,727,1649
TAMBACOUNDA,TAMBACOUNDA,MAKACOLIBANTANG,MAKACOLIBANTANG,DIYABOUGOU,24,27,201,210,411
TAMBACOUNDA,TAMBACOUNDA,MAKACOLIBANTANG,MAKACOLIBANTANG,FADIYACOUNDA,48,50,308,390,698
TAMBACOUNDA,TAMBACOUNDA,MAKACOLIBANTANG,MAKACOLIBANTANG,"H1 SINTHIOU DEMBARING (SINTHIOU KAKA)",5,7,33,25,58
TAMBACOUNDA,TAMBACOUNDA,MAKACOLIBANTANG,MAKACOLIBANTANG,FATYCOUNDA,9,14,79,87,166
TAMBACOUNDA,TAMBACOUNDA,MAKACOLIBANTANG,MAKACOLIBANTANG,GANGALI,19,21,91,104,195
TAMBACOUNDA,TAMBACOUNDA,MAKACOLIBANTANG,MAKACOLIBANTANG,"H1 SINTHIOU DAOUDA",2,2,12,9,21
TAMBACOUNDA,TAMBACOUNDA,MAKACOLIBANTANG,MAKACOLIBANTANG,"HAMDALAYE TALEBE",5,12,69,67,136
TAMBACOUNDA,TAMBACOUNDA,MAKACOLIBANTANG,MAKACOLIBANTANG,"KASSEDI BOUREMA SY",14,21,164,155,319
TAMBACOUNDA,TAMBACOUNDA,MAKACOLIBANTANG,MAKACOLIBANTANG,"MADINA BOURANG",1,2,17,17,34
TAMBACOUNDA,TAMBACOUNDA,MAKACOLIBANTANG,MAKACOLIBANTANG,"MADINA SANDOU (SARE MOUSSA)",18,29,295,304,599
TAMBACOUNDA,TAMBACOUNDA,MAKACOLIBANTANG,MAKACOLIBANTANG,"MAKA CISSE (DIENOUME)",12,20,132,136,268
TAMBACOUNDA,TAMBACOUNDA,MAKACOLIBANTANG,MAKACOLIBANTANG,"H1 SINTHIANE BOURE DIALLO",3,3,25,26,51
TAMBACOUNDA,TAMBACOUNDA,MAKACOLIBANTANG,MAKACOLIBANTANG,"H2 SINTHIANE NAMORY SOW",4,5,22,18,40
TAMBACOUNDA,TAMBACOUNDA,MAKACOLIBANTANG,MAKACOLIBANTANG,"MAKA ESCALE (MAKACOULIBANTATANG)",381,466,3220,2526,5746
TAMBACOUNDA,TAMBACOUNDA,MAKACOLIBANTANG,MAKACOLIBANTANG,"H1 BOUCHRA",3,4,156,40,196
TAMBACOUNDA,TAMBACOUNDA,MAKACOLIBANTANG,MAKACOLIBANTANG,"MAKA VILLAGE",45,49,299,279,578
TAMBACOUNDA,TAMBACOUNDA,MAKACOLIBANTANG,MAKACOLIBANTANG,MAKADING,40,46,289,278,567
TAMBACOUNDA,TAMBACOUNDA,MAKACOLIBANTANG,MAKACOLIBANTANG,"MANIGUI AROUNA",9,10,97,99,196
TAMBACOUNDA,TAMBACOUNDA,MAKACOLIBANTANG,MAKACOLIBANTANG,"MANIGUI KOLI KASSA",20,34,210,232,442
TAMBACOUNDA,TAMBACOUNDA,MAKACOLIBANTANG,MAKACOLIBANTANG,"MANIGUI THIERNO",7,7,31,39,70
TAMBACOUNDA,TAMBACOUNDA,MAKACOLIBANTANG,MAKACOLIBANTANG,"MBANE KALIDOU",33,48,299,252,551
TAMBACOUNDA,TAMBACOUNDA,MAKACOLIBANTANG,MAKACOLIBANTANG,"MBOURO DAR SALAM",9,10,73,48,121
TAMBACOUNDA,TAMBACOUNDA,MAKACOLIBANTANG,MAKACOLIBANTANG,"H1 MBOURO BOGUE",4,9,50,43,93
TAMBACOUNDA,TAMBACOUNDA,MAKACOLIBANTANG,MAKACOLIBANTANG,"MBOURO GNOUKARY",13,16,102,118,220
TAMBACOUNDA,TAMBACOUNDA,MAKACOLIBANTANG,MAKACOLIBANTANG,"MBOURO KALDING",15,22,106,97,203
TAMBACOUNDA,TAMBACOUNDA,MAKACOLIBANTANG,MAKACOLIBANTANG,"MEDINA DIAKHA SANDOUGOU",13,24,342,239,581
TAMBACOUNDA,TAMBACOUNDA,MAKACOLIBANTANG,MAKACOLIBANTANG,"MEDINA WOULY",11,12,120,144,264
TAMBACOUNDA,TAMBACOUNDA,MAKACOLIBANTANG,MAKACOLIBANTANG,"MISSIRAH SEYDOU",15,16,229,242,471
TAMBACOUNDA,TAMBACOUNDA,MAKACOLIBANTANG,MAKACOLIBANTANG,"H1 MEDINALAN( SINTHIOU MBAYE SANE)",1,1,19,21,40
TAMBACOUNDA,TAMBACOUNDA,MAKACOLIBANTANG,MAKACOLIBANTANG,"NDOUSSOUA KIBA",11,11,61,65,126
TAMBACOUNDA,TAMBACOUNDA,MAKACOLIBANTANG,MAKACOLIBANTANG,"NDOUSSOUA YORO",14,14,59,60,119
TAMBACOUNDA,TAMBACOUNDA,MAKACOLIBANTANG,MAKACOLIBANTANG,"H1 NEMA (EL HADJI CHEIKH KANE)",2,2,21,19,40
TAMBACOUNDA,TAMBACOUNDA,MAKACOLIBANTANG,MAKACOLIBANTANG,"NEMATABA KOBANG",8,11,47,53,100
TAMBACOUNDA,TAMBACOUNDA,MAKACOLIBANTANG,MAKACOLIBANTANG,"NGHASSING PEULH (SARE BALLA)",10,10,42,33,75
TAMBACOUNDA,TAMBACOUNDA,MAKACOLIBANTANG,MAKACOLIBANTANG,"NGOLOL KEBA SANE",5,8,77,67,144
TAMBACOUNDA,TAMBACOUNDA,MAKACOLIBANTANG,MAKACOLIBANTANG,PAKEBA,29,43,346,411,757
TAMBACOUNDA,TAMBACOUNDA,MAKACOLIBANTANG,MAKACOLIBANTANG,"SAMBA NGAYE",10,11,100,90,190
TAMBACOUNDA,TAMBACOUNDA,MAKACOLIBANTANG,MAKACOLIBANTANG,"SANACOUNDA (SARE SIRGUERE)",20,28,189,173,362
TAMBACOUNDA,TAMBACOUNDA,MAKACOLIBANTANG,MAKACOLIBANTANG,"SANDING KERE (SANDING KERING)",4,6,40,20,60
TAMBACOUNDA,TAMBACOUNDA,MAKACOLIBANTANG,MAKACOLIBANTANG,"SANDOUGOU MANA",48,60,511,472,983
TAMBACOUNDA,TAMBACOUNDA,MAKACOLIBANTANG,MAKACOLIBANTANG,"SANKABARY BAKARY (SARABAKOUNDA)",28,38,245,241,486
TAMBACOUNDA,TAMBACOUNDA,MAKACOLIBANTANG,MAKACOLIBANTANG,"SANKABARY MANDINGUE",9,12,75,51,126
TAMBACOUNDA,TAMBACOUNDA,MAKACOLIBANTANG,MAKACOLIBANTANG,"SAO SOUCOUTA",58,82,716,618,1334
TAMBACOUNDA,TAMBACOUNDA,MAKACOLIBANTANG,MAKACOLIBANTANG,"SAO SOUKOTO",26,37,394,436,830
TAMBACOUNDA,TAMBACOUNDA,MAKACOLIBANTANG,MAKACOLIBANTANG,"SARE ALI",4,4,54,54,108
TAMBACOUNDA,TAMBACOUNDA,MAKACOLIBANTANG,MAKACOLIBANTANG,"SARE BATHIE",11,17,109,107,216
TAMBACOUNDA,TAMBACOUNDA,MAKACOLIBANTANG,MAKACOLIBANTANG,"SARE BOURE BALDE",15,21,114,121,235
TAMBACOUNDA,TAMBACOUNDA,MAKACOLIBANTANG,MAKACOLIBANTANG,"SARE BOYE (SARE MOUDELE)",10,15,110,89,199
TAMBACOUNDA,TAMBACOUNDA,MAKACOLIBANTANG,MAKACOLIBANTANG,"SARE COLY MANDINGUE",8,11,53,56,109
TAMBACOUNDA,TAMBACOUNDA,MAKACOLIBANTANG,MAKACOLIBANTANG,"SARE COLY PEULH (SARE NIANE)",19,30,216,218,434
TAMBACOUNDA,TAMBACOUNDA,MAKACOLIBANTANG,MAKACOLIBANTANG,"SARE DADI DAOUDA",9,9,40,28,68
TAMBACOUNDA,TAMBACOUNDA,MAKACOLIBANTANG,MAKACOLIBANTANG,"SARE DIAME (PETEL)",27,36,168,189,357
TAMBACOUNDA,TAMBACOUNDA,MAKACOLIBANTANG,MAKACOLIBANTANG,"SARE DIENOUN",31,39,337,344,681
TAMBACOUNDA,TAMBACOUNDA,MAKACOLIBANTANG,MAKACOLIBANTANG,"SARE DOULAYE (SINTHIOU DOULAYE)",19,31,219,170,389
TAMBACOUNDA,TAMBACOUNDA,MAKACOLIBANTANG,MAKACOLIBANTANG,"SARE ELI",40,41,329,334,663
TAMBACOUNDA,TAMBACOUNDA,MAKACOLIBANTANG,MAKACOLIBANTANG,"SARE ELI DIEDJI (SARE SARDY)",13,16,122,127,249
TAMBACOUNDA,TAMBACOUNDA,MAKACOLIBANTANG,MAKACOLIBANTANG,"SARE GALLO",5,6,45,62,107
TAMBACOUNDA,TAMBACOUNDA,MAKACOLIBANTANG,MAKACOLIBANTANG,"SARE GUIDADO",8,8,54,47,101
TAMBACOUNDA,TAMBACOUNDA,MAKACOLIBANTANG,MAKACOLIBANTANG,"SARE GUILIGA KANDE",14,34,216,195,411
TAMBACOUNDA,TAMBACOUNDA,MAKACOLIBANTANG,MAKACOLIBANTANG,"SARE HAMADY SOW",11,18,171,204,375
TAMBACOUNDA,TAMBACOUNDA,MAKACOLIBANTANG,MAKACOLIBANTANG,"H1 SINTHIOU NIANA BA",2,3,33,41,74
TAMBACOUNDA,TAMBACOUNDA,MAKACOLIBANTANG,MAKACOLIBANTANG,"SARE ILO SOW",10,12,108,128,236
TAMBACOUNDA,TAMBACOUNDA,MAKACOLIBANTANG,MAKACOLIBANTANG,"SARE MADY DIALLO (KOMO MBOURO MADY)",13,13,87,81,168
TAMBACOUNDA,TAMBACOUNDA,MAKACOLIBANTANG,MAKACOLIBANTANG,"SARE MALLA",11,13,73,96,169
TAMBACOUNDA,TAMBACOUNDA,MAKACOLIBANTANG,MAKACOLIBANTANG,"SARE MOLA KANDE",7,8,46,41,87
TAMBACOUNDA,TAMBACOUNDA,MAKACOLIBANTANG,MAKACOLIBANTANG,"SARE MOUDOU",6,7,38,44,82
TAMBACOUNDA,TAMBACOUNDA,MAKACOLIBANTANG,MAKACOLIBANTANG,"SARE MOUSSA BA (ARIMALE)",7,15,81,131,212
TAMBACOUNDA,TAMBACOUNDA,MAKACOLIBANTANG,MAKACOLIBANTANG,"SARE NGABA (WOURO NGABA)",15,19,168,177,345
TAMBACOUNDA,TAMBACOUNDA,MAKACOLIBANTANG,MAKACOLIBANTANG,"SARE OURO SOW (MAKADABA)",12,12,98,95,193
TAMBACOUNDA,TAMBACOUNDA,MAKACOLIBANTANG,MAKACOLIBANTANG,"SARE SAGA",3,14,163,150,313
TAMBACOUNDA,TAMBACOUNDA,MAKACOLIBANTANG,MAKACOLIBANTANG,"SARE SILLERE",6,16,118,129,247
TAMBACOUNDA,TAMBACOUNDA,MAKACOLIBANTANG,MAKACOLIBANTANG,"SARE VALOME",9,11,55,92,147
TAMBACOUNDA,TAMBACOUNDA,MAKACOLIBANTANG,MAKACOLIBANTANG,"SINTHIOU BOCAR DIALLO",13,15,93,75,168
TAMBACOUNDA,TAMBACOUNDA,MAKACOLIBANTANG,MAKACOLIBANTANG,"SINTHIOU BOURE BANA NDAO (SINSSANKOTO)",37,46,348,328,676
TAMBACOUNDA,TAMBACOUNDA,MAKACOLIBANTANG,MAKACOLIBANTANG,"SINTHIOU DIAME",8,12,117,96,213
TAMBACOUNDA,TAMBACOUNDA,MAKACOLIBANTANG,MAKACOLIBANTANG,"SINTHIOU DIAMON BA ( SARE DIAMON)",10,15,124,110,234
TAMBACOUNDA,TAMBACOUNDA,MAKACOLIBANTANG,MAKACOLIBANTANG,"SINTHIOU DIATTA BA",6,12,75,81,156
TAMBACOUNDA,TAMBACOUNDA,MAKACOLIBANTANG,MAKACOLIBANTANG,"SINTHIOU DIOKA (SARE DEMBAYE)",15,22,222,229,451
TAMBACOUNDA,TAMBACOUNDA,MAKACOLIBANTANG,MAKACOLIBANTANG,"SINTHIOU EGOUDOU",4,4,47,46,93
TAMBACOUNDA,TAMBACOUNDA,MAKACOLIBANTANG,MAKACOLIBANTANG,"SINTHIOU EL HADJI YERO BA",9,14,162,131,293
TAMBACOUNDA,TAMBACOUNDA,MAKACOLIBANTANG,MAKACOLIBANTANG,"SINTHIOU FARING BA",12,17,132,117,249
TAMBACOUNDA,TAMBACOUNDA,MAKACOLIBANTANG,MAKACOLIBANTANG,"SINTHIOU FODERING",14,16,128,147,275
TAMBACOUNDA,TAMBACOUNDA,MAKACOLIBANTANG,MAKACOLIBANTANG,"SINTHIOU GAROUME (DIACOUNDA)",8,9,70,69,139
TAMBACOUNDA,TAMBACOUNDA,MAKACOLIBANTANG,MAKACOLIBANTANG,"SINTHIOU GAYO SOW",6,7,33,45,78
TAMBACOUNDA,TAMBACOUNDA,MAKACOLIBANTANG,MAKACOLIBANTANG,"SINTHIOU KALDING (MAKOTO)",45,63,620,615,1235
TAMBACOUNDA,TAMBACOUNDA,MAKACOLIBANTANG,MAKACOLIBANTANG,"SINTHIOU KOLIKAN I (SARE AMADY)",9,9,61,49,110
TAMBACOUNDA,TAMBACOUNDA,MAKACOLIBANTANG,MAKACOLIBANTANG,"SINTHIOU MADY BA",10,12,123,110,233
TAMBACOUNDA,TAMBACOUNDA,MAKACOLIBANTANG,MAKACOLIBANTANG,"SINTHIOU PATHE BALDE",4,4,26,44,70
TAMBACOUNDA,TAMBACOUNDA,MAKACOLIBANTANG,MAKACOLIBANTANG,"SINTHIOU SAMBA CIRA",35,63,445,425,870
TAMBACOUNDA,TAMBACOUNDA,MAKACOLIBANTANG,MAKACOLIBANTANG,"SINTHIOU SAMBA DIAWO",4,5,34,24,58
TAMBACOUNDA,TAMBACOUNDA,MAKACOLIBANTANG,MAKACOLIBANTANG,"SINTHIOU SAMBA NDAO",8,8,63,58,121
TAMBACOUNDA,TAMBACOUNDA,MAKACOLIBANTANG,MAKACOLIBANTANG,"SINTHIOU SAMBAROU BA",10,14,84,84,168
TAMBACOUNDA,TAMBACOUNDA,MAKACOLIBANTANG,MAKACOLIBANTANG,"SINTHIOU SAMBAROU DJIBA SOW",19,21,117,95,212
TAMBACOUNDA,TAMBACOUNDA,MAKACOLIBANTANG,MAKACOLIBANTANG,"H1 KOLINKA",4,6,26,26,52
TAMBACOUNDA,TAMBACOUNDA,MAKACOLIBANTANG,MAKACOLIBANTANG,"H2 KOLINKA2",4,4,21,18,39
TAMBACOUNDA,TAMBACOUNDA,MAKACOLIBANTANG,MAKACOLIBANTANG,"SINTHIOU SILLY BA",12,13,100,72,172
TAMBACOUNDA,TAMBACOUNDA,MAKACOLIBANTANG,MAKACOLIBANTANG,"SINTHIOU SILLY SANE",6,8,99,94,193
TAMBACOUNDA,TAMBACOUNDA,MAKACOLIBANTANG,MAKACOLIBANTANG,"SINTHIOU SOUBACOUNDA",22,33,281,271,552
TAMBACOUNDA,TAMBACOUNDA,MAKACOLIBANTANG,MAKACOLIBANTANG,"SINTHIOU SOUNA DIALLO (MBOURO SOUNA)",8,15,119,109,228
TAMBACOUNDA,TAMBACOUNDA,MAKACOLIBANTANG,MAKACOLIBANTANG,"SINTHIOU SOURA BA",12,14,142,102,244
TAMBACOUNDA,TAMBACOUNDA,MAKACOLIBANTANG,MAKACOLIBANTANG,"H1 DAROU SALAM DIALIBA",6,8,49,28,77
TAMBACOUNDA,TAMBACOUNDA,MAKACOLIBANTANG,MAKACOLIBANTANG,"SITACOUROU MANDINGUE",100,117,1072,1125,2197
TAMBACOUNDA,TAMBACOUNDA,MAKACOLIBANTANG,MAKACOLIBANTANG,"SITACOUROU SARA (DIALASSEBA)",16,22,144,154,298
TAMBACOUNDA,TAMBACOUNDA,MAKACOLIBANTANG,MAKACOLIBANTANG,"SOTOCOTO HAMADY",14,20,111,118,229
TAMBACOUNDA,TAMBACOUNDA,MAKACOLIBANTANG,MAKACOLIBANTANG,"TABADIANG SOUNA",57,60,609,597,1206
TAMBACOUNDA,TAMBACOUNDA,MAKACOLIBANTANG,MAKACOLIBANTANG,"TABADING MOSSI",11,14,88,78,166
TAMBACOUNDA,TAMBACOUNDA,MAKACOLIBANTANG,MAKACOLIBANTANG,"TABADING OUOLOF",24,35,265,231,496
TAMBACOUNDA,TAMBACOUNDA,MAKACOLIBANTANG,MAKACOLIBANTANG,TALEBE,13,15,130,128,258
TAMBACOUNDA,TAMBACOUNDA,MAKACOLIBANTANG,MAKACOLIBANTANG,"TEMENTO GADIA SOW",26,29,258,280,538
TAMBACOUNDA,TAMBACOUNDA,MAKACOLIBANTANG,MAKACOLIBANTANG,"TEMENTO GUIDADO",10,10,112,126,238
TAMBACOUNDA,TAMBACOUNDA,MAKACOLIBANTANG,MAKACOLIBANTANG,THIANGALY,12,19,162,152,314
TAMBACOUNDA,TAMBACOUNDA,MAKACOLIBANTANG,MAKACOLIBANTANG,"THIARA OUMAR DIAO",13,16,117,139,256
TAMBACOUNDA,TAMBACOUNDA,MAKACOLIBANTANG,MAKACOLIBANTANG,"TIMBING FARA",11,11,84,90,174
TAMBACOUNDA,TAMBACOUNDA,MAKACOLIBANTANG,MAKACOLIBANTANG,"H1 SINTHIOU DEMBANE MODOU",7,8,65,60,125
TAMBACOUNDA,TAMBACOUNDA,MAKACOLIBANTANG,MAKACOLIBANTANG,"TINCOLY GAOULEL",11,11,84,72,156
TAMBACOUNDA,TAMBACOUNDA,MAKACOLIBANTANG,MAKACOLIBANTANG,"H1 SINTHIOU SAM PENDA",3,5,24,22,46
TAMBACOUNDA,TAMBACOUNDA,MAKACOLIBANTANG,MAKACOLIBANTANG,TOMBORONG,9,11,81,69,150
TAMBACOUNDA,TAMBACOUNDA,MAKACOLIBANTANG,MAKACOLIBANTANG,"VELINGARA SOTOCOTO",5,6,26,30,56
TAMBACOUNDA,TAMBACOUNDA,MAKACOLIBANTANG,MAKACOLIBANTANG,"WALIYA KANDE",5,10,39,51,90
TAMBACOUNDA,TAMBACOUNDA,MAKACOLIBANTANG,MAKACOLIBANTANG,"WALIYA SAMBA DEME",19,32,123,126,249
TAMBACOUNDA,TAMBACOUNDA,MAKACOLIBANTANG,MAKACOLIBANTANG,"YOLI BOUBOU",22,25,119,111,230
TAMBACOUNDA,TAMBACOUNDA,MAKACOLIBANTANG,MAKACOLIBANTANG,YOLISOUMA,4,4,79,56,135
TAMBACOUNDA,TAMBACOUNDA,MAKACOLIBANTANG,MAKACOLIBANTANG,YORODONDE,34,41,275,267,542
TAMBACOUNDA,TAMBACOUNDA,MAKACOLIBANTANG,"NDOGA BABACAR",BAMBAKO,22,24,167,198,365
TAMBACOUNDA,TAMBACOUNDA,MAKACOLIBANTANG,"NDOGA BABACAR",BANTANDIENKE,6,7,64,68,132
TAMBACOUNDA,TAMBACOUNDA,MAKACOLIBANTANG,"NDOGA BABACAR","H1 SINTHIOU BOYE",7,8,54,56,110
TAMBACOUNDA,TAMBACOUNDA,MAKACOLIBANTANG,"NDOGA BABACAR","BANY PELLY SISAO",10,12,104,107,211
TAMBACOUNDA,TAMBACOUNDA,MAKACOLIBANTANG,"NDOGA BABACAR","BOBA (BOBA MANDING)",14,19,114,102,216
TAMBACOUNDA,TAMBACOUNDA,MAKACOLIBANTANG,"NDOGA BABACAR","H1 NDOGA DIAM DIAM",3,4,37,34,71
TAMBACOUNDA,TAMBACOUNDA,MAKACOLIBANTANG,"NDOGA BABACAR",BOUROUKOU,9,12,56,57,113
TAMBACOUNDA,TAMBACOUNDA,MAKACOLIBANTANG,"NDOGA BABACAR","BOUSTANE MOURIDE",9,11,76,90,166
TAMBACOUNDA,TAMBACOUNDA,MAKACOLIBANTANG,"NDOGA BABACAR","DANE NIAKO",30,44,313,289,602
TAMBACOUNDA,TAMBACOUNDA,MAKACOLIBANTANG,"NDOGA BABACAR","DIRME PEULH",21,27,322,323,645
TAMBACOUNDA,TAMBACOUNDA,MAKACOLIBANTANG,"NDOGA BABACAR","DJIMESSOUTOU (SARE NO)",3,6,63,50,113
TAMBACOUNDA,TAMBACOUNDA,MAKACOLIBANTANG,"NDOGA BABACAR","DOUTA BASSY",27,33,225,223,448
TAMBACOUNDA,TAMBACOUNDA,MAKACOLIBANTANG,"NDOGA BABACAR","DOUTOTO MANDINGUE",5,8,39,41,80
TAMBACOUNDA,TAMBACOUNDA,MAKACOLIBANTANG,"NDOGA BABACAR","GOUBOU KOUNDA",21,24,205,230,435
TAMBACOUNDA,TAMBACOUNDA,MAKACOLIBANTANG,"NDOGA BABACAR","KANAPEKOTO (KANAPEKOTO MANDINGUE)",7,7,64,65,129
TAMBACOUNDA,TAMBACOUNDA,MAKACOLIBANTANG,"NDOGA BABACAR","KANDE KOUNDA 2",17,20,115,130,245
TAMBACOUNDA,TAMBACOUNDA,MAKACOLIBANTANG,"NDOGA BABACAR","HI SINTHIOU DIADIE BA",3,7,59,54,113
TAMBACOUNDA,TAMBACOUNDA,MAKACOLIBANTANG,"NDOGA BABACAR","H2 SINTHIOU DIOULDE BA",2,2,16,10,26
TAMBACOUNDA,TAMBACOUNDA,MAKACOLIBANTANG,"NDOGA BABACAR","H3 SINTHIOU SADIORY BA",3,3,16,12,28
TAMBACOUNDA,TAMBACOUNDA,MAKACOLIBANTANG,"NDOGA BABACAR",KATOB,30,39,209,230,439
TAMBACOUNDA,TAMBACOUNDA,MAKACOLIBANTANG,"NDOGA BABACAR","KAYAN KOUSSAN",15,18,139,128,267
TAMBACOUNDA,TAMBACOUNDA,MAKACOLIBANTANG,"NDOGA BABACAR","KEREWANE NGOYE",11,13,65,59,124
TAMBACOUNDA,TAMBACOUNDA,MAKACOLIBANTANG,"NDOGA BABACAR",KOLIKOUNDA,11,17,113,95,208
TAMBACOUNDA,TAMBACOUNDA,MAKACOLIBANTANG,"NDOGA BABACAR",KOLONDING,18,21,179,150,329
TAMBACOUNDA,TAMBACOUNDA,MAKACOLIBANTANG,"NDOGA BABACAR","H1 SINTHIOU DIOULDE DIALLO",1,1,12,11,23
TAMBACOUNDA,TAMBACOUNDA,MAKACOLIBANTANG,"NDOGA BABACAR","H2 SINTHIOU MOUSSA DIALLO",7,8,62,53,115
TAMBACOUNDA,TAMBACOUNDA,MAKACOLIBANTANG,"NDOGA BABACAR","KOUKOUKOLONG MANDINGUE",12,14,143,123,266
TAMBACOUNDA,TAMBACOUNDA,MAKACOLIBANTANG,"NDOGA BABACAR","H1 SINTHIOU WALY SOW 2",5,5,34,26,60
TAMBACOUNDA,TAMBACOUNDA,MAKACOLIBANTANG,"NDOGA BABACAR","KOUKOUKOLONG PEULH (SARE OURO)",16,19,202,173,375
TAMBACOUNDA,TAMBACOUNDA,MAKACOLIBANTANG,"NDOGA BABACAR","KOUTHIAKOTO DASSARA",7,7,60,61,121
TAMBACOUNDA,TAMBACOUNDA,MAKACOLIBANTANG,"NDOGA BABACAR","KOUTHIAKOTO SAMBA NDIAYE (SINTHIOU SAMBA)",8,9,57,47,104
TAMBACOUNDA,TAMBACOUNDA,MAKACOLIBANTANG,"NDOGA BABACAR","MADINA DIAKHA OULI",19,20,209,228,437
TAMBACOUNDA,TAMBACOUNDA,MAKACOLIBANTANG,"NDOGA BABACAR","MANDIAN KOUNDA",19,23,159,126,285
TAMBACOUNDA,TAMBACOUNDA,MAKACOLIBANTANG,"NDOGA BABACAR","MARKOUNDA (SARE DIAMO)",20,21,178,136,314
TAMBACOUNDA,TAMBACOUNDA,MAKACOLIBANTANG,"NDOGA BABACAR","MEDINA ABDOURAHMANE",12,14,110,107,217
TAMBACOUNDA,TAMBACOUNDA,MAKACOLIBANTANG,"NDOGA BABACAR","MEDINA COLY",10,10,97,80,177
TAMBACOUNDA,TAMBACOUNDA,MAKACOLIBANTANG,"NDOGA BABACAR","H1 SINTHIOU WOURA",17,23,180,173,353
TAMBACOUNDA,TAMBACOUNDA,MAKACOLIBANTANG,"NDOGA BABACAR","H2 BILAMANE",1,1,9,19,28
TAMBACOUNDA,TAMBACOUNDA,MAKACOLIBANTANG,"NDOGA BABACAR","MEDINA THIOYENE",20,23,158,137,295
TAMBACOUNDA,TAMBACOUNDA,MAKACOLIBANTANG,"NDOGA BABACAR","MEDINA TOMBON",5,8,51,45,96
TAMBACOUNDA,TAMBACOUNDA,MAKACOLIBANTANG,"NDOGA BABACAR","NDEMOU GAYO",40,46,201,179,380
TAMBACOUNDA,TAMBACOUNDA,MAKACOLIBANTANG,"NDOGA BABACAR","NDEMOU GORDIOUBE",15,20,113,133,246
TAMBACOUNDA,TAMBACOUNDA,MAKACOLIBANTANG,"NDOGA BABACAR","NDEMOU MAMADOU",30,35,168,161,329
TAMBACOUNDA,TAMBACOUNDA,MAKACOLIBANTANG,"NDOGA BABACAR","NDIABACK (NDIABACK SAMBA)",9,10,53,53,106
TAMBACOUNDA,TAMBACOUNDA,MAKACOLIBANTANG,"NDOGA BABACAR","H1 SINTHIOU THIERNO WOURY",3,3,16,12,28
TAMBACOUNDA,TAMBACOUNDA,MAKACOLIBANTANG,"NDOGA BABACAR","NDOGA BABACAR",98,113,566,593,1159
TAMBACOUNDA,TAMBACOUNDA,MAKACOLIBANTANG,"NDOGA BABACAR","NDOGA MBEULEUP",14,15,119,112,231
TAMBACOUNDA,TAMBACOUNDA,MAKACOLIBANTANG,"NDOGA BABACAR","NDOGA SAMBA",45,55,324,300,624
TAMBACOUNDA,TAMBACOUNDA,MAKACOLIBANTANG,"NDOGA BABACAR","NGOLEL MANDING (BOUNTOUNKO)",24,26,164,160,324
TAMBACOUNDA,TAMBACOUNDA,MAKACOLIBANTANG,"NDOGA BABACAR","PASS NDONGO",12,12,56,61,117
TAMBACOUNDA,TAMBACOUNDA,MAKACOLIBANTANG,"NDOGA BABACAR","PASS SIDY (DEMBA FAYE)",7,10,49,49,98
TAMBACOUNDA,TAMBACOUNDA,MAKACOLIBANTANG,"NDOGA BABACAR",PATHIAP,31,42,275,273,548
TAMBACOUNDA,TAMBACOUNDA,MAKACOLIBANTANG,"NDOGA BABACAR","PENDAKARE PEULH",16,18,159,204,363
TAMBACOUNDA,TAMBACOUNDA,MAKACOLIBANTANG,"NDOGA BABACAR","H1 MEDINA DIAWARA",4,4,19,22,41
TAMBACOUNDA,TAMBACOUNDA,MAKACOLIBANTANG,"NDOGA BABACAR","SAMBA KHOREDIA OUOLOF",12,14,73,49,122
TAMBACOUNDA,TAMBACOUNDA,MAKACOLIBANTANG,"NDOGA BABACAR","SAMBA KHOUREDIA PEULH",18,19,193,154,347
TAMBACOUNDA,TAMBACOUNDA,MAKACOLIBANTANG,"NDOGA BABACAR","SARE BAMOUL",26,30,238,254,492
TAMBACOUNDA,TAMBACOUNDA,MAKACOLIBANTANG,"NDOGA BABACAR","H1 SINTHIOU OUSMANE DIALLO",1,1,21,13,34
TAMBACOUNDA,TAMBACOUNDA,MAKACOLIBANTANG,"NDOGA BABACAR","SARE DADY THIOCKE",25,28,189,190,379
TAMBACOUNDA,TAMBACOUNDA,MAKACOLIBANTANG,"NDOGA BABACAR","H1 NDIAYENE ILLO DIALLO",11,11,62,63,125
TAMBACOUNDA,TAMBACOUNDA,MAKACOLIBANTANG,"NDOGA BABACAR","SARE DOUNDOU",19,28,151,167,318
TAMBACOUNDA,TAMBACOUNDA,MAKACOLIBANTANG,"NDOGA BABACAR","SARE GUEDA",10,10,61,60,121
TAMBACOUNDA,TAMBACOUNDA,MAKACOLIBANTANG,"NDOGA BABACAR","SARE NIANA BA",15,17,129,87,216
TAMBACOUNDA,TAMBACOUNDA,MAKACOLIBANTANG,"NDOGA BABACAR","SARE PATHE GOUBEL",12,13,51,54,105
TAMBACOUNDA,TAMBACOUNDA,MAKACOLIBANTANG,"NDOGA BABACAR","SARE SAMBA DIALLO (SARE GAYE)",13,22,172,172,344
TAMBACOUNDA,TAMBACOUNDA,MAKACOLIBANTANG,"NDOGA BABACAR","SARE SIDY",13,21,97,127,224
TAMBACOUNDA,TAMBACOUNDA,MAKACOLIBANTANG,"NDOGA BABACAR","H1 EL HADJI MODY BA SARA SIDY",4,5,40,21,61
TAMBACOUNDA,TAMBACOUNDA,MAKACOLIBANTANG,"NDOGA BABACAR","SARE SOUNA 2 (SINTHIOU SOUNA)",54,63,592,571,1163
TAMBACOUNDA,TAMBACOUNDA,MAKACOLIBANTANG,"NDOGA BABACAR","H1 SINTHIOU SEYDOU SOW",5,6,54,48,102
TAMBACOUNDA,TAMBACOUNDA,MAKACOLIBANTANG,"NDOGA BABACAR","SARE THILEL",32,41,222,213,435
TAMBACOUNDA,TAMBACOUNDA,MAKACOLIBANTANG,"NDOGA BABACAR","H1 BANDIAGARA SANE",11,12,72,74,146
TAMBACOUNDA,TAMBACOUNDA,MAKACOLIBANTANG,"NDOGA BABACAR","SARE WOURO DOUNGUEL",21,23,199,164,363
TAMBACOUNDA,TAMBACOUNDA,MAKACOLIBANTANG,"NDOGA BABACAR",SEWORO,29,31,230,274,504
TAMBACOUNDA,TAMBACOUNDA,MAKACOLIBANTANG,"NDOGA BABACAR","H1 SINTHIOU SANDY",2,2,42,58,100
TAMBACOUNDA,TAMBACOUNDA,MAKACOLIBANTANG,"NDOGA BABACAR","SEWORO KOTO PEULH",10,13,111,91,202
TAMBACOUNDA,TAMBACOUNDA,MAKACOLIBANTANG,"NDOGA BABACAR","SINE OULY",41,41,245,216,461
TAMBACOUNDA,TAMBACOUNDA,MAKACOLIBANTANG,"NDOGA BABACAR","SINTHIOU DAWA DIALLO",16,16,114,101,215
TAMBACOUNDA,TAMBACOUNDA,MAKACOLIBANTANG,"NDOGA BABACAR","H1 SINTHIOU WALY SOW 1",1,1,5,2,7
TAMBACOUNDA,TAMBACOUNDA,MAKACOLIBANTANG,"NDOGA BABACAR","SINTHIOU DIA",4,6,32,31,63
TAMBACOUNDA,TAMBACOUNDA,MAKACOLIBANTANG,"NDOGA BABACAR","SINTHIOU DIAM POULO",5,6,38,45,83
TAMBACOUNDA,TAMBACOUNDA,MAKACOLIBANTANG,"NDOGA BABACAR","SINTHIOU DIAMERY",27,39,305,321,626
TAMBACOUNDA,TAMBACOUNDA,MAKACOLIBANTANG,"NDOGA BABACAR","H1 TOMBONG SOUKA",8,8,54,75,129
TAMBACOUNDA,TAMBACOUNDA,MAKACOLIBANTANG,"NDOGA BABACAR","SINTHIOU EL HADJI MODY BA 1 (SINTHIOU ELHADJI)",18,24,241,242,483
TAMBACOUNDA,TAMBACOUNDA,MAKACOLIBANTANG,"NDOGA BABACAR","SINTHIOU IBRAHIMA DOUMBOUYA",16,16,88,87,175
TAMBACOUNDA,TAMBACOUNDA,MAKACOLIBANTANG,"NDOGA BABACAR","SINTHIOU KOLIBANA",6,6,37,38,75
TAMBACOUNDA,TAMBACOUNDA,MAKACOLIBANTANG,"NDOGA BABACAR","H1 SINTHIOU NGHABA BA",6,6,48,33,81
TAMBACOUNDA,TAMBACOUNDA,MAKACOLIBANTANG,"NDOGA BABACAR","SINTHIOU KOLINKA 2",38,46,296,317,613
TAMBACOUNDA,TAMBACOUNDA,MAKACOLIBANTANG,"NDOGA BABACAR","SINTHIOU KOUNA",5,12,58,59,117
TAMBACOUNDA,TAMBACOUNDA,MAKACOLIBANTANG,"NDOGA BABACAR","SINTHIOU NDIABACK (MBADANE)",6,6,34,33,67
TAMBACOUNDA,TAMBACOUNDA,MAKACOLIBANTANG,"NDOGA BABACAR","SINTHIOU NDIOBA SANE (BOBO FOULBES)",23,27,117,123,240
TAMBACOUNDA,TAMBACOUNDA,MAKACOLIBANTANG,"NDOGA BABACAR","SINTHIOU NIANA DEME",13,13,81,73,154
TAMBACOUNDA,TAMBACOUNDA,MAKACOLIBANTANG,"NDOGA BABACAR","SINTHIOU OURO SOW",13,13,97,90,187
TAMBACOUNDA,TAMBACOUNDA,MAKACOLIBANTANG,"NDOGA BABACAR","H1 SINTHIOU DIAMERY",1,2,17,26,43
TAMBACOUNDA,TAMBACOUNDA,MAKACOLIBANTANG,"NDOGA BABACAR","SINTHIOU SAMBA DIOUKA",39,47,225,230,455
TAMBACOUNDA,TAMBACOUNDA,MAKACOLIBANTANG,"NDOGA BABACAR","SINTHIOU SAMBAROU",7,7,64,73,137
TAMBACOUNDA,TAMBACOUNDA,MAKACOLIBANTANG,"NDOGA BABACAR","SINTHIOU SOUFA (SOUARE SOUFA)",19,19,144,129,273
TAMBACOUNDA,TAMBACOUNDA,MAKACOLIBANTANG,"NDOGA BABACAR","H1 SARE KAKARE",7,15,120,89,209
TAMBACOUNDA,TAMBACOUNDA,MAKACOLIBANTANG,"NDOGA BABACAR","SINTHIOU SOUKA 1 (SINTHIOU KHATA)",8,8,73,73,146
TAMBACOUNDA,TAMBACOUNDA,MAKACOLIBANTANG,"NDOGA BABACAR","SINTHIOU SOUKA 2",16,25,183,157,340
TAMBACOUNDA,TAMBACOUNDA,MAKACOLIBANTANG,"NDOGA BABACAR","H1 VELINGARA DIATTA",5,7,37,38,75
TAMBACOUNDA,TAMBACOUNDA,MAKACOLIBANTANG,"NDOGA BABACAR","SINTHIOU TALEBE",6,7,38,39,77
TAMBACOUNDA,TAMBACOUNDA,MAKACOLIBANTANG,"NDOGA BABACAR","H1 BOUNTOUNKO WOURA",7,10,97,62,159
TAMBACOUNDA,TAMBACOUNDA,MAKACOLIBANTANG,"NDOGA BABACAR","SINTHIOU THIDY",25,30,238,220,458
TAMBACOUNDA,TAMBACOUNDA,MAKACOLIBANTANG,"NDOGA BABACAR","SINTHIOU TINKOLY",10,20,154,185,339
TAMBACOUNDA,TAMBACOUNDA,MAKACOLIBANTANG,"NDOGA BABACAR","SOTOKOTO BOULOU",16,18,184,168,352
TAMBACOUNDA,TAMBACOUNDA,MAKACOLIBANTANG,"NDOGA BABACAR","SOUARE KOUNDA (SOUFA)",45,58,387,446,833
TAMBACOUNDA,TAMBACOUNDA,MAKACOLIBANTANG,"NDOGA BABACAR","H1 SINTHIOU YAMADOU BA",6,6,44,48,92
TAMBACOUNDA,TAMBACOUNDA,MAKACOLIBANTANG,"NDOGA BABACAR","SOUTOUBA PEULH",32,44,337,308,645
TAMBACOUNDA,TAMBACOUNDA,MAKACOLIBANTANG,"NDOGA BABACAR","TEMANSOU (SARE KEDIN)",8,16,111,150,261
TAMBACOUNDA,TAMBACOUNDA,MAKACOLIBANTANG,"NDOGA BABACAR",THIEVAL,21,28,129,109,238
TAMBACOUNDA,TAMBACOUNDA,MAKACOLIBANTANG,"NDOGA BABACAR","VELINGARA DJOUTE",8,16,93,82,175
TAMBACOUNDA,TAMBACOUNDA,MAKACOLIBANTANG,"NDOGA BABACAR",NDATTOU,1,2,26,23,49
TAMBACOUNDA,TAMBACOUNDA,MAKACOLIBANTANG,"NDOGA BABACAR","SINTHIOU SEYDOU",7,7,30,28,58
TAMBACOUNDA,TAMBACOUNDA,MAKACOLIBANTANG,"NIANI TOUCOULEUR",BARSAFO,41,50,325,336,661
TAMBACOUNDA,TAMBACOUNDA,MAKACOLIBANTANG,"NIANI TOUCOULEUR","CISSE KOUNDA",75,82,789,741,1530
TAMBACOUNDA,TAMBACOUNDA,MAKACOLIBANTANG,"NIANI TOUCOULEUR","DIAMAGUENE SINE",81,88,554,532,1086
TAMBACOUNDA,TAMBACOUNDA,MAKACOLIBANTANG,"NIANI TOUCOULEUR","DIANE KOUNDA",20,27,115,143,258
TAMBACOUNDA,TAMBACOUNDA,MAKACOLIBANTANG,"NIANI TOUCOULEUR","DJIDA MOURIDE (KOUKOU)",61,71,522,477,999
TAMBACOUNDA,TAMBACOUNDA,MAKACOLIBANTANG,"NIANI TOUCOULEUR","FELANE SINE",60,73,474,377,851
TAMBACOUNDA,TAMBACOUNDA,MAKACOLIBANTANG,"NIANI TOUCOULEUR","H1 DAROU FALL FELANE",9,9,52,16,68
TAMBACOUNDA,TAMBACOUNDA,MAKACOLIBANTANG,"NIANI TOUCOULEUR","FODE THIAM (KOUNTHIAW TEUGUE)",15,19,143,139,282
TAMBACOUNDA,TAMBACOUNDA,MAKACOLIBANTANG,"NIANI TOUCOULEUR","HAMDALAYE MALICK",19,26,205,158,363
TAMBACOUNDA,TAMBACOUNDA,MAKACOLIBANTANG,"NIANI TOUCOULEUR","KAHAO ABDOULAYE THIAM",14,20,83,59,142
TAMBACOUNDA,TAMBACOUNDA,MAKACOLIBANTANG,"NIANI TOUCOULEUR","KAHAO FALLY (SARE FALLY)",10,14,90,81,171
TAMBACOUNDA,TAMBACOUNDA,MAKACOLIBANTANG,"NIANI TOUCOULEUR","KAHAO MOUSSA SY",29,46,307,298,605
TAMBACOUNDA,TAMBACOUNDA,MAKACOLIBANTANG,"NIANI TOUCOULEUR","KAHAO TABANE (SARE FADY)",65,93,626,570,1196
TAMBACOUNDA,TAMBACOUNDA,MAKACOLIBANTANG,"NIANI TOUCOULEUR",KALELA,38,43,287,259,546
TAMBACOUNDA,TAMBACOUNDA,MAKACOLIBANTANG,"NIANI TOUCOULEUR",KOUSSALANG,17,22,172,155,327
TAMBACOUNDA,TAMBACOUNDA,MAKACOLIBANTANG,"NIANI TOUCOULEUR","LAMA SAMBA",27,44,325,291,616
TAMBACOUNDA,TAMBACOUNDA,MAKACOLIBANTANG,"NIANI TOUCOULEUR","H1 SINTHIOU ALADJI MARY ( LAMA BAIDY)",2,3,28,14,42
TAMBACOUNDA,TAMBACOUNDA,MAKACOLIBANTANG,"NIANI TOUCOULEUR",LEBA,15,18,228,196,424
TAMBACOUNDA,TAMBACOUNDA,MAKACOLIBANTANG,"NIANI TOUCOULEUR","MODY NDIAYE (SINTHIOUYEL)",28,32,204,211,415
TAMBACOUNDA,TAMBACOUNDA,MAKACOLIBANTANG,"NIANI TOUCOULEUR","MORY SAMBA MBAYE",12,13,76,73,149
TAMBACOUNDA,TAMBACOUNDA,MAKACOLIBANTANG,"NIANI TOUCOULEUR","NDIAYENE (NDIAYENE KALELA)",34,56,385,370,755
TAMBACOUNDA,TAMBACOUNDA,MAKACOLIBANTANG,"NIANI TOUCOULEUR",NGOUDO,15,21,124,120,244
TAMBACOUNDA,TAMBACOUNDA,MAKACOLIBANTANG,"NIANI TOUCOULEUR","NIANI TOUCOULEUR (SILAME)",67,81,603,514,1117
TAMBACOUNDA,TAMBACOUNDA,MAKACOLIBANTANG,"NIANI TOUCOULEUR","PETEL BODY DIALOUBE",10,13,119,119,238
TAMBACOUNDA,TAMBACOUNDA,MAKACOLIBANTANG,"NIANI TOUCOULEUR","PETEL BODY GOUNDOUROU (PETEL BODY FOULBES)",10,32,209,192,401
TAMBACOUNDA,TAMBACOUNDA,MAKACOLIBANTANG,"NIANI TOUCOULEUR","SARE GUELEL (SARE SEYDOU MAPAGNE)",4,14,67,74,141
TAMBACOUNDA,TAMBACOUNDA,MAKACOLIBANTANG,"NIANI TOUCOULEUR","H1 SINTHIANG BOURANG",1,2,19,26,45
TAMBACOUNDA,TAMBACOUNDA,MAKACOLIBANTANG,"NIANI TOUCOULEUR","H2 DAROU OUMAR NDAO",1,1,13,12,25
TAMBACOUNDA,TAMBACOUNDA,MAKACOLIBANTANG,"NIANI TOUCOULEUR","H3 SINTHIAN DIALLA BA",1,2,28,26,54
TAMBACOUNDA,TAMBACOUNDA,MAKACOLIBANTANG,"NIANI TOUCOULEUR","SINTHIOU BAMBA KOUNDIAW",26,30,184,196,380
TAMBACOUNDA,TAMBACOUNDA,MAKACOLIBANTANG,"NIANI TOUCOULEUR","SINTHIOU DEMBA DIAW (SARE DEMBA)",1,2,10,12,22
TAMBACOUNDA,TAMBACOUNDA,MAKACOLIBANTANG,"NIANI TOUCOULEUR","SINTHIOU GUEDE (SARE BABOU)",25,34,274,240,514
TAMBACOUNDA,TAMBACOUNDA,MAKACOLIBANTANG,"NIANI TOUCOULEUR","SINTHIOU ISMAILA",15,31,225,233,458
TAMBACOUNDA,TAMBACOUNDA,MAKACOLIBANTANG,"NIANI TOUCOULEUR","SOUNATOU GOUNASS",14,18,120,89,209
TAMBACOUNDA,TAMBACOUNDA,MAKACOLIBANTANG,"NIANI TOUCOULEUR","TOUBA BELEL (VILLAGE 9)",89,97,616,537,1153
TAMBACOUNDA,TAMBACOUNDA,MAKACOLIBANTANG,"NIANI TOUCOULEUR","TOUBA KAOUSSARA (VILLAGE 10)",58,66,390,416,806
TAMBACOUNDA,TAMBACOUNDA,MAKACOLIBANTANG,"NIANI TOUCOULEUR","TOUBA TERRES NEUVES (VILLAGE 8)",62,66,390,386,776
TAMBACOUNDA,TAMBACOUNDA,MISSIRAH,DIALACOTO,"AFIA THIERNO DOURA",18,20,118,105,223
TAMBACOUNDA,TAMBACOUNDA,MISSIRAH,DIALACOTO,AINOUMADY,20,25,191,151,342
TAMBACOUNDA,TAMBACOUNDA,MISSIRAH,DIALACOTO,"H1 SOUCOUTO",3,4,23,33,56
TAMBACOUNDA,TAMBACOUNDA,MISSIRAH,DIALACOTO,BADY,43,47,314,336,650
TAMBACOUNDA,TAMBACOUNDA,MISSIRAH,DIALACOTO,"H1 TOUBA BADY (PROJET BADY)",5,10,21,11,32
TAMBACOUNDA,TAMBACOUNDA,MISSIRAH,DIALACOTO,"H2 BASADIO COUNDA (CR BALA)",1,3,21,13,34
TAMBACOUNDA,TAMBACOUNDA,MISSIRAH,DIALACOTO,BANTANCOLY,10,17,104,112,216
TAMBACOUNDA,TAMBACOUNDA,MISSIRAH,DIALACOTO,"H1 BARKATOU THIERNO CAMARA",4,4,33,36,69
TAMBACOUNDA,TAMBACOUNDA,MISSIRAH,DIALACOTO,"H2 DIAOCOUNDA",1,1,7,4,11
TAMBACOUNDA,TAMBACOUNDA,MISSIRAH,DIALACOTO,BANTANKOUNTOU,61,82,473,262,735
TAMBACOUNDA,TAMBACOUNDA,MISSIRAH,DIALACOTO,"DAMANTAN 2",15,20,152,91,243
TAMBACOUNDA,TAMBACOUNDA,MISSIRAH,DIALACOTO,"DAROU IDJIRAROU",5,10,64,35,99
TAMBACOUNDA,TAMBACOUNDA,MISSIRAH,DIALACOTO,"DARSALAM FODE",13,27,151,153,304
TAMBACOUNDA,TAMBACOUNDA,MISSIRAH,DIALACOTO,"DARSALAM NIEMENIKE",32,40,221,149,370
TAMBACOUNDA,TAMBACOUNDA,MISSIRAH,DIALACOTO,"DIAKHABA PEULH",11,15,108,80,188
TAMBACOUNDA,TAMBACOUNDA,MISSIRAH,DIALACOTO,DIALACOTO,241,309,1471,1510,2981
TAMBACOUNDA,TAMBACOUNDA,MISSIRAH,DIALACOTO,"H1 BALLACOUNDA",15,19,99,80,179
TAMBACOUNDA,TAMBACOUNDA,MISSIRAH,DIALACOTO,"H2 KOLINKA",18,21,87,71,158
TAMBACOUNDA,TAMBACOUNDA,MISSIRAH,DIALACOTO,"H3 KOLINE",24,30,150,147,297
TAMBACOUNDA,TAMBACOUNDA,MISSIRAH,DIALACOTO,"H4 DIOP KOUNDA",12,12,106,95,201
TAMBACOUNDA,TAMBACOUNDA,MISSIRAH,DIALACOTO,"H5 SINTHIOU PATHE",9,11,61,50,111
TAMBACOUNDA,TAMBACOUNDA,MISSIRAH,DIALACOTO,"H6 GASSAMA KOUNDA",1,1,9,6,15
TAMBACOUNDA,TAMBACOUNDA,MISSIRAH,DIALACOTO,"H7  KOUNDAN",2,2,11,9,20
TAMBACOUNDA,TAMBACOUNDA,MISSIRAH,DIALACOTO,"H8  BABAYA",1,1,4,2,6
TAMBACOUNDA,TAMBACOUNDA,MISSIRAH,DIALACOTO,DIALAMAKHAN,32,46,401,295,696
TAMBACOUNDA,TAMBACOUNDA,MISSIRAH,DIALACOTO,DIENOUDIALA,95,101,596,561,1157
TAMBACOUNDA,TAMBACOUNDA,MISSIRAH,DIALACOTO,"H1 KABACOTO",13,15,93,53,146
TAMBACOUNDA,TAMBACOUNDA,MISSIRAH,DIALACOTO,"H2 MAREVA",17,20,118,89,207
TAMBACOUNDA,TAMBACOUNDA,MISSIRAH,DIALACOTO,"H3 MADINA  MAKA",11,16,97,79,176
TAMBACOUNDA,TAMBACOUNDA,MISSIRAH,DIALACOTO,GAMON,17,22,117,107,224
TAMBACOUNDA,TAMBACOUNDA,MISSIRAH,DIALACOTO,"H1 DIYALA",1,2,15,12,27
TAMBACOUNDA,TAMBACOUNDA,MISSIRAH,DIALACOTO,"H2 VELINGARA",3,7,45,47,92
TAMBACOUNDA,TAMBACOUNDA,MISSIRAH,DIALACOTO,GNOUFAYE,17,32,174,165,339
TAMBACOUNDA,TAMBACOUNDA,MISSIRAH,DIALACOTO,KABOUDIARA,12,23,156,102,258
TAMBACOUNDA,TAMBACOUNDA,MISSIRAH,DIALACOTO,"H1 SINTHIOU DIANKE MAKHA",1,4,23,14,37
TAMBACOUNDA,TAMBACOUNDA,MISSIRAH,DIALACOTO,"LABOYA (MEDINA COUTA 2)",225,245,1121,916,2037
TAMBACOUNDA,TAMBACOUNDA,MISSIRAH,DIALACOTO,"MADINA BAOUSSOU (MADINA MISSIRAH)",25,34,292,297,589
TAMBACOUNDA,TAMBACOUNDA,MISSIRAH,DIALACOTO,"MADINA FOUGA",27,32,394,269,663
TAMBACOUNDA,TAMBACOUNDA,MISSIRAH,DIALACOTO,"MADINA NIEMENIKE",31,37,290,191,481
TAMBACOUNDA,TAMBACOUNDA,MISSIRAH,DIALACOTO,"H1 SINTHIOU  SAMADI",2,2,9,8,17
TAMBACOUNDA,TAMBACOUNDA,MISSIRAH,DIALACOTO,"MADINA SOKO",19,20,94,90,184
TAMBACOUNDA,TAMBACOUNDA,MISSIRAH,DIALACOTO,"MAMBOYA DIALIKO",8,9,48,50,98
TAMBACOUNDA,TAMBACOUNDA,MISSIRAH,DIALACOTO,"H1 TOUBA NIERY",11,12,58,36,94
TAMBACOUNDA,TAMBACOUNDA,MISSIRAH,DIALACOTO,"H3 MAYO SAFE BA",6,7,17,15,32
TAMBACOUNDA,TAMBACOUNDA,MISSIRAH,DIALACOTO,MANSADALA,37,38,224,211,435
TAMBACOUNDA,TAMBACOUNDA,MISSIRAH,DIALACOTO,"MEDINA COUTA",44,81,654,607,1261
TAMBACOUNDA,TAMBACOUNDA,MISSIRAH,DIALACOTO,"MEDINA TOUNTY (MEDINA DEPOT)",39,49,223,181,404
TAMBACOUNDA,TAMBACOUNDA,MISSIRAH,DIALACOTO,"H1 BOKE NIONGHANI",1,1,5,6,11
TAMBACOUNDA,TAMBACOUNDA,MISSIRAH,DIALACOTO,"H2 GOUREL MAMADOU BA",1,1,4,3,7
TAMBACOUNDA,TAMBACOUNDA,MISSIRAH,DIALACOTO,"MISSIRAH DAMANTAN",18,20,75,63,138
TAMBACOUNDA,TAMBACOUNDA,MISSIRAH,DIALACOTO,"MISSIRAH TABADIAN",16,24,160,199,359
TAMBACOUNDA,TAMBACOUNDA,MISSIRAH,DIALACOTO,NIONGHANI,26,33,160,126,286
TAMBACOUNDA,TAMBACOUNDA,MISSIRAH,DIALACOTO,"OUASSADOU DEPOT",238,258,957,949,1906
TAMBACOUNDA,TAMBACOUNDA,MISSIRAH,DIALACOTO,"H1 SINTHIOU SAMBA",5,7,73,47,120
TAMBACOUNDA,TAMBACOUNDA,MISSIRAH,DIALACOTO,"H2 SAINT PESNINING BOUBANE",3,3,6,3,9
TAMBACOUNDA,TAMBACOUNDA,MISSIRAH,DIALACOTO,"H3 VELINGARA MOUSSA",2,2,11,22,33
TAMBACOUNDA,TAMBACOUNDA,MISSIRAH,DIALACOTO,"OUASSADOU VILLAGE",23,24,133,85,218
TAMBACOUNDA,TAMBACOUNDA,MISSIRAH,DIALACOTO,"H1 BABACO",16,18,195,140,335
TAMBACOUNDA,TAMBACOUNDA,MISSIRAH,DIALACOTO,"SENO (DALABA )",10,20,111,127,238
TAMBACOUNDA,TAMBACOUNDA,MISSIRAH,DIALACOTO,"SINTHIOU MADINA (DIANACOUTA)",63,72,326,295,621
TAMBACOUNDA,TAMBACOUNDA,MISSIRAH,DIALACOTO,"H1 MAYO MODY IBRAHIMA",9,9,45,61,106
TAMBACOUNDA,TAMBACOUNDA,MISSIRAH,DIALACOTO,"H3 GAYDAFAROU",6,8,37,33,70
TAMBACOUNDA,TAMBACOUNDA,MISSIRAH,DIALACOTO,"H4 MAYO SAMOUSSA BA",3,3,25,25,50
TAMBACOUNDA,TAMBACOUNDA,MISSIRAH,DIALACOTO,"H5 MEDINA DARSALAM",2,2,22,20,42
TAMBACOUNDA,TAMBACOUNDA,MISSIRAH,DIALACOTO,"H6 GOUREL BOULANGER",1,1,11,8,19
TAMBACOUNDA,TAMBACOUNDA,MISSIRAH,DIALACOTO,"H7 GOUREL SADIO CISSOKHO 10",4,4,26,28,54
TAMBACOUNDA,TAMBACOUNDA,MISSIRAH,DIALACOTO,"SINTHIOU NGABA",9,9,74,63,137
TAMBACOUNDA,TAMBACOUNDA,MISSIRAH,DIALACOTO,"H1 SARE NGABA",1,2,30,26,56
TAMBACOUNDA,TAMBACOUNDA,MISSIRAH,DIALACOTO,"H2 MOUSSA FORÊT",7,9,39,34,73
TAMBACOUNDA,TAMBACOUNDA,MISSIRAH,DIALACOTO,"H3 BOKE  THIERNO AMADOU",9,9,37,29,66
TAMBACOUNDA,TAMBACOUNDA,MISSIRAH,DIALACOTO,"H5 BOKE BOUKARIOU",6,6,21,27,48
TAMBACOUNDA,TAMBACOUNDA,MISSIRAH,DIALACOTO,"H6 SINTHIOU HAMIDOU BA",3,3,6,2,8
TAMBACOUNDA,TAMBACOUNDA,MISSIRAH,DIALACOTO,SITAOUMA,10,13,142,89,231
TAMBACOUNDA,TAMBACOUNDA,MISSIRAH,DIALACOTO,"H1 TANDA MADINA",3,6,42,26,68
TAMBACOUNDA,TAMBACOUNDA,MISSIRAH,DIALACOTO,"H2 GOUREL HAROUNA",1,2,8,4,12
TAMBACOUNDA,TAMBACOUNDA,MISSIRAH,DIALACOTO,"H3 TIMBING MADINA",6,10,82,48,130
TAMBACOUNDA,TAMBACOUNDA,MISSIRAH,DIALACOTO,"H4 MAYEL ISSA",8,12,61,51,112
TAMBACOUNDA,TAMBACOUNDA,MISSIRAH,DIALACOTO,"H5 SANTANFARA",2,2,13,15,28
TAMBACOUNDA,TAMBACOUNDA,MISSIRAH,DIALACOTO,SOUNATOU,16,32,203,166,369
TAMBACOUNDA,TAMBACOUNDA,MISSIRAH,DIALACOTO,TAIBATOU,38,43,271,263,534
TAMBACOUNDA,TAMBACOUNDA,MISSIRAH,DIALACOTO,TALIKORIN,6,9,68,78,146
TAMBACOUNDA,TAMBACOUNDA,MISSIRAH,DIALACOTO,"H1 MANSONKOUNDA",3,6,20,20,40
TAMBACOUNDA,TAMBACOUNDA,MISSIRAH,DIALACOTO,"TAMBACOUNDA BOULOU",13,21,110,116,226
TAMBACOUNDA,TAMBACOUNDA,MISSIRAH,DIALACOTO,"H1 BANDIAGARA",2,2,17,23,40
TAMBACOUNDA,TAMBACOUNDA,MISSIRAH,DIALACOTO,TENGHOTO,22,24,116,113,229
TAMBACOUNDA,TAMBACOUNDA,MISSIRAH,DIALACOTO,"H1 BARKATOU",6,6,37,43,80
TAMBACOUNDA,TAMBACOUNDA,MISSIRAH,DIALACOTO,"WAKILARE DAMANTAN",4,7,34,36,70
TAMBACOUNDA,TAMBACOUNDA,MISSIRAH,MISSIRAH,ALLABOUGOU,26,29,301,228,529
TAMBACOUNDA,TAMBACOUNDA,MISSIRAH,MISSIRAH,"ARDOULAYE WASSIHATOU",17,29,141,121,262
TAMBACOUNDA,TAMBACOUNDA,MISSIRAH,MISSIRAH,"BAGADADJI (BOUNKILING)",8,8,48,55,103
TAMBACOUNDA,TAMBACOUNDA,MISSIRAH,MISSIRAH,BAMBADINKA,55,58,877,752,1629
TAMBACOUNDA,TAMBACOUNDA,MISSIRAH,MISSIRAH,"H1 DJIDA (CR BALA)",2,4,22,22,44
TAMBACOUNDA,TAMBACOUNDA,MISSIRAH,MISSIRAH,"H2 HAFIA",4,10,80,32,112
TAMBACOUNDA,TAMBACOUNDA,MISSIRAH,MISSIRAH,"BIRA (BIRA TABA)",79,95,795,932,1727
TAMBACOUNDA,TAMBACOUNDA,MISSIRAH,MISSIRAH,"H1 GABON",4,5,50,26,76
TAMBACOUNDA,TAMBACOUNDA,MISSIRAH,MISSIRAH,"BOULACOUNDA BOLOL (BOULACOUNDA PEULH)",6,12,112,86,198
TAMBACOUNDA,TAMBACOUNDA,MISSIRAH,MISSIRAH,"DAROU SALAM (BOUBOU BA)",13,24,235,194,429
TAMBACOUNDA,TAMBACOUNDA,MISSIRAH,MISSIRAH,"DIAWOCOUNDA (LAREDJI PEULH)",11,12,106,121,227
TAMBACOUNDA,TAMBACOUNDA,MISSIRAH,MISSIRAH,"H1 BAGADADJI",14,22,169,167,336
TAMBACOUNDA,TAMBACOUNDA,MISSIRAH,MISSIRAH,"DIYABOUGOU 2",24,29,242,279,521
TAMBACOUNDA,TAMBACOUNDA,MISSIRAH,MISSIRAH,GADAPARA,8,11,74,79,153
TAMBACOUNDA,TAMBACOUNDA,MISSIRAH,MISSIRAH,GOULOUMBOU,227,292,1209,1271,2480
TAMBACOUNDA,TAMBACOUNDA,MISSIRAH,MISSIRAH,"GUINGUINEO (MEDINA BAMBARA)",42,63,376,384,760
TAMBACOUNDA,TAMBACOUNDA,MISSIRAH,MISSIRAH,"H1 KANTHIALA",8,17,121,106,227
TAMBACOUNDA,TAMBACOUNDA,MISSIRAH,MISSIRAH,"H2 SARE NDOUGUE",4,4,48,41,89
TAMBACOUNDA,TAMBACOUNDA,MISSIRAH,MISSIRAH,"H3 SIKASSO",2,2,11,11,22
TAMBACOUNDA,TAMBACOUNDA,MISSIRAH,MISSIRAH,"HAMDALAYE SEYNI (SARE SEYNI)",36,43,226,262,488
TAMBACOUNDA,TAMBACOUNDA,MISSIRAH,MISSIRAH,"H1 GOUREL SEKOUDIA",2,2,8,11,19
TAMBACOUNDA,TAMBACOUNDA,MISSIRAH,MISSIRAH,"H2 GALLE TOUNKO SOW",6,6,60,79,139
TAMBACOUNDA,TAMBACOUNDA,MISSIRAH,MISSIRAH,"HAMDALLAYE (NDIAPALDE)",51,65,363,333,696
TAMBACOUNDA,TAMBACOUNDA,MISSIRAH,MISSIRAH,"H1 SINTHIOU NDIAPALDE",7,11,71,58,129
TAMBACOUNDA,TAMBACOUNDA,MISSIRAH,MISSIRAH,"HAMDALLAYE PONT (MONTOUGOU)",83,93,409,411,820
TAMBACOUNDA,TAMBACOUNDA,MISSIRAH,MISSIRAH,"H1 SINTHIOU KABADA",9,11,116,108,224
TAMBACOUNDA,TAMBACOUNDA,MISSIRAH,MISSIRAH,"HAMDALLAYE SALOUM SEYDI",18,22,197,227,424
TAMBACOUNDA,TAMBACOUNDA,MISSIRAH,MISSIRAH,"HAMDALLAYE TESSANG",133,152,1025,1009,2034
TAMBACOUNDA,TAMBACOUNDA,MISSIRAH,MISSIRAH,KELECOUNDA,5,7,50,31,81
TAMBACOUNDA,TAMBACOUNDA,MISSIRAH,MISSIRAH,"KOAR 1 (KOAR MBAYLARY)",48,50,274,231,505
TAMBACOUNDA,TAMBACOUNDA,MISSIRAH,MISSIRAH,"KOAR 2(SINTHIOU SAMBA KOUROU)",16,18,114,81,195
TAMBACOUNDA,TAMBACOUNDA,MISSIRAH,MISSIRAH,"KOAR 3(KOAR PROJET)",189,200,924,829,1753
TAMBACOUNDA,TAMBACOUNDA,MISSIRAH,MISSIRAH,"KOAR YERO DIALLO",10,10,57,49,106
TAMBACOUNDA,TAMBACOUNDA,MISSIRAH,MISSIRAH,KODIAM,15,23,168,114,282
TAMBACOUNDA,TAMBACOUNDA,MISSIRAH,MISSIRAH,"KOLONDIARA (GOUREL BOCAR)",36,56,407,419,826
TAMBACOUNDA,TAMBACOUNDA,MISSIRAH,MISSIRAH,"LAREDJI MANDINGUE",12,21,119,111,230
TAMBACOUNDA,TAMBACOUNDA,MISSIRAH,MISSIRAH,MADIALY,45,45,348,366,714
TAMBACOUNDA,TAMBACOUNDA,MISSIRAH,MISSIRAH,"MADINA BOULACOUNDA (GOUREL YOBA)",46,57,399,313,712
TAMBACOUNDA,TAMBACOUNDA,MISSIRAH,MISSIRAH,"MADINA YERO (SITAOULE YERO DIATTA)",26,30,164,167,331
TAMBACOUNDA,TAMBACOUNDA,MISSIRAH,MISSIRAH,"MAHINA COURA",18,18,126,108,234
TAMBACOUNDA,TAMBACOUNDA,MISSIRAH,MISSIRAH,"MEDINA ALY (SARE ALY)",16,19,108,85,193
TAMBACOUNDA,TAMBACOUNDA,MISSIRAH,MISSIRAH,"MEDINA DIAKHA",63,77,578,620,1198
TAMBACOUNDA,TAMBACOUNDA,MISSIRAH,MISSIRAH,"H1 SINTHIOU NDIOBO",9,9,60,56,116
TAMBACOUNDA,TAMBACOUNDA,MISSIRAH,MISSIRAH,"MEDINA DIAM",50,54,275,267,542
TAMBACOUNDA,TAMBACOUNDA,MISSIRAH,MISSIRAH,"H1 FASS",30,35,181,193,374
TAMBACOUNDA,TAMBACOUNDA,MISSIRAH,MISSIRAH,"MEDINA MAMOUDOU (BARKAYEL)",23,27,182,178,360
TAMBACOUNDA,TAMBACOUNDA,MISSIRAH,MISSIRAH,MISSIRAH,586,736,3997,4586,8583
TAMBACOUNDA,TAMBACOUNDA,MISSIRAH,MISSIRAH,"MISSIRAH TABADIAN (B. SOUCOUTO) (B. TABADIANG)",57,70,563,611,1174
TAMBACOUNDA,TAMBACOUNDA,MISSIRAH,MISSIRAH,"MISSIRAH TONGOUDE (SINTHIAN TONGOUDE)",82,91,464,468,932
TAMBACOUNDA,TAMBACOUNDA,MISSIRAH,MISSIRAH,"H1 MAMPATODIE",3,4,13,16,29
TAMBACOUNDA,TAMBACOUNDA,MISSIRAH,MISSIRAH,"H2 PROJET ELEVAGE SOPELA",1,1,2,4,6
TAMBACOUNDA,TAMBACOUNDA,MISSIRAH,MISSIRAH,MOUKOUTY,5,6,57,46,103
TAMBACOUNDA,TAMBACOUNDA,MISSIRAH,MISSIRAH,"H1 BARADJICOUNDA",3,5,51,42,93
TAMBACOUNDA,TAMBACOUNDA,MISSIRAH,MISSIRAH,"MOUNTOBOU (MOUNTOB)",8,8,80,88,168
TAMBACOUNDA,TAMBACOUNDA,MISSIRAH,MISSIRAH,"NEMA HAMADY (SARE HAMADY)",13,17,115,107,222
TAMBACOUNDA,TAMBACOUNDA,MISSIRAH,MISSIRAH,"NEMA 1 (NEMA SAMBOU)",15,15,95,95,190
TAMBACOUNDA,TAMBACOUNDA,MISSIRAH,MISSIRAH,"NGUENE 1 (NGUENE SERERE)",122,124,420,391,811
TAMBACOUNDA,TAMBACOUNDA,MISSIRAH,MISSIRAH,"NGUENE PEUL",114,114,446,413,859
TAMBACOUNDA,TAMBACOUNDA,MISSIRAH,MISSIRAH,"NIAOULE MBAYGOU",39,63,408,388,796
TAMBACOUNDA,TAMBACOUNDA,MISSIRAH,MISSIRAH,"NIAOULE TANOU",64,84,448,462,910
TAMBACOUNDA,TAMBACOUNDA,MISSIRAH,MISSIRAH,"H1 SARE NIANA",7,12,78,95,173
TAMBACOUNDA,TAMBACOUNDA,MISSIRAH,MISSIRAH,"OUNDOUNDOU AMEROU",11,16,114,118,232
TAMBACOUNDA,TAMBACOUNDA,MISSIRAH,MISSIRAH,PAKALY,4,5,32,24,56
TAMBACOUNDA,TAMBACOUNDA,MISSIRAH,MISSIRAH,PATHIOU,17,21,177,153,330
TAMBACOUNDA,TAMBACOUNDA,MISSIRAH,MISSIRAH,"H1 PATHIOU TOUMBOU",8,8,79,59,138
TAMBACOUNDA,TAMBACOUNDA,MISSIRAH,MISSIRAH,"RAMATOULAYE (SARE BOUNE)",8,10,121,87,208
TAMBACOUNDA,TAMBACOUNDA,MISSIRAH,MISSIRAH,SAAL,114,117,457,314,771
TAMBACOUNDA,TAMBACOUNDA,MISSIRAH,MISSIRAH,"SABY MOULESSY",30,37,299,315,614
TAMBACOUNDA,TAMBACOUNDA,MISSIRAH,MISSIRAH,"H1 DIMANDING",6,7,49,59,108
TAMBACOUNDA,TAMBACOUNDA,MISSIRAH,MISSIRAH,"SAFALOU 1",25,44,446,429,875
TAMBACOUNDA,TAMBACOUNDA,MISSIRAH,MISSIRAH,"SAFALOU 2",25,28,330,384,714
TAMBACOUNDA,TAMBACOUNDA,MISSIRAH,MISSIRAH,"SANKAGNE 1",151,155,640,567,1207
TAMBACOUNDA,TAMBACOUNDA,MISSIRAH,MISSIRAH,"SANKAGNE 2",84,95,374,356,730
TAMBACOUNDA,TAMBACOUNDA,MISSIRAH,MISSIRAH,"H1 KENIEKENIEBA",2,2,8,4,12
TAMBACOUNDA,TAMBACOUNDA,MISSIRAH,MISSIRAH,"SARE ILO DEME",14,14,124,121,245
TAMBACOUNDA,TAMBACOUNDA,MISSIRAH,MISSIRAH,"SARE OUMAR LY (GOUMALOU)",16,21,215,235,450
TAMBACOUNDA,TAMBACOUNDA,MISSIRAH,MISSIRAH,"SARE PATHE",9,14,109,106,215
TAMBACOUNDA,TAMBACOUNDA,MISSIRAH,MISSIRAH,"H1 MADINA NIAGOU",3,3,35,33,68
TAMBACOUNDA,TAMBACOUNDA,MISSIRAH,MISSIRAH,"SARE PATHE FOUGOULOU",45,51,320,300,620
TAMBACOUNDA,TAMBACOUNDA,MISSIRAH,MISSIRAH,"SARE THIDY (MAKABE SIDY)",33,39,330,356,686
TAMBACOUNDA,TAMBACOUNDA,MISSIRAH,MISSIRAH,"H1 SINTHIOU SAMBA",8,10,44,53,97
TAMBACOUNDA,TAMBACOUNDA,MISSIRAH,MISSIRAH,SAROUDIA,15,17,148,169,317
TAMBACOUNDA,TAMBACOUNDA,MISSIRAH,MISSIRAH,"SINTHIOU BARA",5,8,76,53,129
TAMBACOUNDA,TAMBACOUNDA,MISSIRAH,MISSIRAH,"SINTHIOU KOLONDING",3,4,40,36,76
TAMBACOUNDA,TAMBACOUNDA,MISSIRAH,MISSIRAH,"SINTHIOU THIERNO",22,27,295,235,530
TAMBACOUNDA,TAMBACOUNDA,MISSIRAH,MISSIRAH,"SITAOULE ISSAC",39,45,239,223,462
TAMBACOUNDA,TAMBACOUNDA,MISSIRAH,MISSIRAH,"SOCOUNDA ADIAAF",148,154,640,580,1220
TAMBACOUNDA,TAMBACOUNDA,MISSIRAH,MISSIRAH,"TABADIAN DIALIKO",116,126,707,609,1316
TAMBACOUNDA,TAMBACOUNDA,MISSIRAH,MISSIRAH,"H1 SINTHIOUROU BOYE",8,10,91,68,159
TAMBACOUNDA,TAMBACOUNDA,MISSIRAH,MISSIRAH,"TALIBOULOU FINANKE",30,54,293,264,557
TAMBACOUNDA,TAMBACOUNDA,MISSIRAH,MISSIRAH,"TAYE DIABY",21,23,152,193,345
TAMBACOUNDA,TAMBACOUNDA,MISSIRAH,MISSIRAH,TIMBAFOULOU,8,10,44,53,97
TAMBACOUNDA,TAMBACOUNDA,MISSIRAH,MISSIRAH,TOUBA,47,57,478,576,1054
TAMBACOUNDA,TAMBACOUNDA,MISSIRAH,MISSIRAH,"VELINGARA BIDIANKOTO",93,113,830,765,1595
TAMBACOUNDA,TAMBACOUNDA,MISSIRAH,MISSIRAH,"VELINGARA LEGUEL (SARE BOUBOU)",29,32,292,318,610
TAMBACOUNDA,TAMBACOUNDA,MISSIRAH,MISSIRAH,"VELINGARA OUMAR",3,16,81,63,144
TAMBACOUNDA,TAMBACOUNDA,MISSIRAH,MISSIRAH,"VELINGARA PONT",23,28,135,126,261
TAMBACOUNDA,TAMBACOUNDA,MISSIRAH,MISSIRAH,"VELINGARA YAYA (SITAOULE)",35,38,242,198,440
TAMBACOUNDA,TAMBACOUNDA,MISSIRAH,MISSIRAH,DIAMWELY,9,22,112,121,233
TAMBACOUNDA,TAMBACOUNDA,MISSIRAH,MISSIRAH,"KOAR ALADJI",8,8,26,33,59
TAMBACOUNDA,TAMBACOUNDA,MISSIRAH,MISSIRAH,"LOUGUE NIALBEY",19,32,247,259,506
TAMBACOUNDA,TAMBACOUNDA,MISSIRAH,MISSIRAH,"SOUNTAFAR- MAAKAYAYA",3,3,18,13,31
TAMBACOUNDA,TAMBACOUNDA,MISSIRAH,MISSIRAH,"TEMENTO MALEDE",10,17,172,185,357
TAMBACOUNDA,TAMBACOUNDA,MISSIRAH,MISSIRAH,"H1 SINTHIOU SAMBA TALL",1,1,7,1,8
TAMBACOUNDA,TAMBACOUNDA,MISSIRAH,NETTEBOULOU,BANDIAGARA,11,11,113,100,213
TAMBACOUNDA,TAMBACOUNDA,MISSIRAH,NETTEBOULOU,"H1 SINTHIOU BOH",10,10,74,95,169
TAMBACOUNDA,TAMBACOUNDA,MISSIRAH,NETTEBOULOU,"BANFARA GOUREL",11,13,78,68,146
TAMBACOUNDA,TAMBACOUNDA,MISSIRAH,NETTEBOULOU,BANTANTINTI,69,72,532,516,1048
TAMBACOUNDA,TAMBACOUNDA,MISSIRAH,NETTEBOULOU,"BARKAYEL (COUMBA KOULOU)",18,24,117,127,244
TAMBACOUNDA,TAMBACOUNDA,MISSIRAH,NETTEBOULOU,"DAR SALAM",58,72,615,633,1248
TAMBACOUNDA,TAMBACOUNDA,MISSIRAH,NETTEBOULOU,DIADALA,19,20,160,152,312
TAMBACOUNDA,TAMBACOUNDA,MISSIRAH,NETTEBOULOU,DIARRA,6,6,45,58,103
TAMBACOUNDA,TAMBACOUNDA,MISSIRAH,NETTEBOULOU,"DJINKORE MANDING (BANTANKHOTO)",21,26,150,148,298
TAMBACOUNDA,TAMBACOUNDA,MISSIRAH,NETTEBOULOU,"DJINKORE PEULH",39,48,463,483,946
TAMBACOUNDA,TAMBACOUNDA,MISSIRAH,NETTEBOULOU,FARABA,43,51,383,393,776
TAMBACOUNDA,TAMBACOUNDA,MISSIRAH,NETTEBOULOU,"H1 TOUBA FARABA",1,1,3,0,3
TAMBACOUNDA,TAMBACOUNDA,MISSIRAH,NETTEBOULOU,"FODECOUNDA ANSOU( BAYOCOUNDA)",38,44,285,296,581
TAMBACOUNDA,TAMBACOUNDA,MISSIRAH,NETTEBOULOU,"FODECOUNDA SADIO",3,3,29,41,70
TAMBACOUNDA,TAMBACOUNDA,MISSIRAH,NETTEBOULOU,"GODIOYEL (NIANGIRI LAOBE)",9,17,155,92,247
TAMBACOUNDA,TAMBACOUNDA,MISSIRAH,NETTEBOULOU,GUENETTO,11,14,86,96,182
TAMBACOUNDA,TAMBACOUNDA,MISSIRAH,NETTEBOULOU,"H2 GUENETTO BAME",5,5,28,32,60
TAMBACOUNDA,TAMBACOUNDA,MISSIRAH,NETTEBOULOU,"KANDERY DEMBA NDAO",12,12,94,83,177
TAMBACOUNDA,TAMBACOUNDA,MISSIRAH,NETTEBOULOU,"KENIABA (SARE ALADJI)",40,41,359,344,703
TAMBACOUNDA,TAMBACOUNDA,MISSIRAH,NETTEBOULOU,"KENIDALA THIATHIORO",20,30,255,216,471
TAMBACOUNDA,TAMBACOUNDA,MISSIRAH,NETTEBOULOU,"KEREWANE FAFIDJI",7,7,54,55,109
TAMBACOUNDA,TAMBACOUNDA,MISSIRAH,NETTEBOULOU,KOULARE,29,36,340,335,675
TAMBACOUNDA,TAMBACOUNDA,MISSIRAH,NETTEBOULOU,KOUNKOUBA,28,39,367,415,782
TAMBACOUNDA,TAMBACOUNDA,MISSIRAH,NETTEBOULOU,"KOUNTOU DIOMBO (DJINKONE KOUNTOU)",14,21,177,157,334
TAMBACOUNDA,TAMBACOUNDA,MISSIRAH,NETTEBOULOU,"LAMOYE (BANFARA BOLY)",3,3,50,40,90
TAMBACOUNDA,TAMBACOUNDA,MISSIRAH,NETTEBOULOU,"MADINA GUENOTTO",19,19,248,279,527
TAMBACOUNDA,TAMBACOUNDA,MISSIRAH,NETTEBOULOU,"MAKA MEDINA",1,3,11,6,17
TAMBACOUNDA,TAMBACOUNDA,MISSIRAH,NETTEBOULOU,"MANDIANCOUNDA (SARE KALY)",10,12,56,54,110
TAMBACOUNDA,TAMBACOUNDA,MISSIRAH,NETTEBOULOU,"MEDINA DIALOUBE",13,32,269,156,425
TAMBACOUNDA,TAMBACOUNDA,MISSIRAH,NETTEBOULOU,"MEDINA SIBIKILING",9,9,70,48,118
TAMBACOUNDA,TAMBACOUNDA,MISSIRAH,NETTEBOULOU,"MEDINA YERA",11,12,58,57,115
TAMBACOUNDA,TAMBACOUNDA,MISSIRAH,NETTEBOULOU,"MISSIRAH SARAKHOLE (BABOKE)",32,36,504,500,1004
TAMBACOUNDA,TAMBACOUNDA,MISSIRAH,NETTEBOULOU,"NEMA MOUSSA",22,25,119,94,213
TAMBACOUNDA,TAMBACOUNDA,MISSIRAH,NETTEBOULOU,NEMATABA,10,19,65,76,141
TAMBACOUNDA,TAMBACOUNDA,MISSIRAH,NETTEBOULOU,NETTEBOULOU,134,162,1124,1167,2291
TAMBACOUNDA,TAMBACOUNDA,MISSIRAH,NETTEBOULOU,"OUNDOUNDOU DIAKHA",6,6,33,38,71
TAMBACOUNDA,TAMBACOUNDA,MISSIRAH,NETTEBOULOU,"OUNDOUNDOU DIAWARA (OUNDOUNDOU FADY SOW)",5,6,45,44,89
TAMBACOUNDA,TAMBACOUNDA,MISSIRAH,NETTEBOULOU,"OUNDOUNDOU KOUTHIA (SAMBA KOUTHIA)",6,11,114,122,236
TAMBACOUNDA,TAMBACOUNDA,MISSIRAH,NETTEBOULOU,"OUNDOUNDOU MAKHAN",19,33,181,151,332
TAMBACOUNDA,TAMBACOUNDA,MISSIRAH,NETTEBOULOU,"OUNDOUNDOU MEDINA NDIAYE",4,10,56,56,112
TAMBACOUNDA,TAMBACOUNDA,MISSIRAH,NETTEBOULOU,PADANDA,7,7,54,46,100
TAMBACOUNDA,TAMBACOUNDA,MISSIRAH,NETTEBOULOU,"PANTHIAN DIOBO",6,9,76,72,148
TAMBACOUNDA,TAMBACOUNDA,MISSIRAH,NETTEBOULOU,"SARE MOUDOU BA",9,13,111,58,169
TAMBACOUNDA,TAMBACOUNDA,MISSIRAH,NETTEBOULOU,"SARE MBANDY",15,18,182,118,300
TAMBACOUNDA,TAMBACOUNDA,MISSIRAH,NETTEBOULOU,"SARE MOUDOU 1",5,6,41,43,84
TAMBACOUNDA,TAMBACOUNDA,MISSIRAH,NETTEBOULOU,"SARE NDOUKE",11,12,100,84,184
TAMBACOUNDA,TAMBACOUNDA,MISSIRAH,NETTEBOULOU,"SARE NGABA",16,19,157,162,319
TAMBACOUNDA,TAMBACOUNDA,MISSIRAH,NETTEBOULOU,"SARE NIANA 1",23,32,217,196,413
TAMBACOUNDA,TAMBACOUNDA,MISSIRAH,NETTEBOULOU,"SARE NIANA 2 (NIANACOUNDA)",26,31,147,166,313
TAMBACOUNDA,TAMBACOUNDA,MISSIRAH,NETTEBOULOU,"SARE SALOUM",37,47,362,410,772
TAMBACOUNDA,TAMBACOUNDA,MISSIRAH,NETTEBOULOU,"SEGOU COURA",65,72,632,837,1469
TAMBACOUNDA,TAMBACOUNDA,MISSIRAH,NETTEBOULOU,SYLLABE,4,4,35,24,59
TAMBACOUNDA,TAMBACOUNDA,MISSIRAH,NETTEBOULOU,"SINTHIOU DIECKA (DJINKORI BABA GALLE)",12,15,105,98,203
TAMBACOUNDA,TAMBACOUNDA,MISSIRAH,NETTEBOULOU,"SINTHIOU KALY RENANE",12,12,86,70,156
TAMBACOUNDA,TAMBACOUNDA,MISSIRAH,NETTEBOULOU,"SITAOULE MANDINGUE (SITAOULE BOURE CAMARA)",30,44,272,276,548
TAMBACOUNDA,TAMBACOUNDA,MISSIRAH,NETTEBOULOU,"SARE BOURE",30,36,314,279,593
TAMBACOUNDA,TAMBACOUNDA,MISSIRAH,NETTEBOULOU,SOUROUYEL,76,85,745,723,1468
TAMBACOUNDA,TAMBACOUNDA,MISSIRAH,NETTEBOULOU,"TEMENTO PATHE",8,8,81,80,161
TAMBACOUNDA,TAMBACOUNDA,MISSIRAH,NETTEBOULOU,"THIARA (SINTHIOU YORO EDDE)",26,32,244,275,519
TAMBACOUNDA,TAMBACOUNDA,MISSIRAH,NETTEBOULOU,"TOUBA SARAKHOLE",6,7,106,84,190
TAMBACOUNDA,TAMBACOUNDA,MISSIRAH,NETTEBOULOU,TOUREMAN,17,22,207,184,391
TAMBACOUNDA,TAMBACOUNDA,MISSIRAH,NETTEBOULOU,"VELINGARA TOUNKE (SARE TOUNKE)",18,24,136,124,260
TAMBACOUNDA,TAMBACOUNDA,MISSIRAH,NETTEBOULOU,WAKILIBOUGOU,15,16,107,105,212
TAMBACOUNDA,TAMBACOUNDA,MISSIRAH,NETTEBOULOU,"DAR SALAM PEULH",7,7,63,55,118
TAMBACOUNDA,TAMBACOUNDA,MISSIRAH,NETTEBOULOU,"DIARRA BOUGOU",1,1,10,6,16
TAMBACOUNDA,TAMBACOUNDA,MISSIRAH,NETTEBOULOU,"DJINKORE MANFING",18,19,107,124,231
TAMBACOUNDA,TAMBACOUNDA,MISSIRAH,NETTEBOULOU,FOULANKANE,10,12,69,65,134
TAMBACOUNDA,TAMBACOUNDA,MISSIRAH,NETTEBOULOU,"MADINA HAROUNA",4,4,36,50,86
TAMBACOUNDA,TAMBACOUNDA,MISSIRAH,NETTEBOULOU,"MADINA HEREMANKONO",4,4,23,14,37
TAMBACOUNDA,TAMBACOUNDA,MISSIRAH,NETTEBOULOU,"SARE MOUDOU 2",1,1,2,4,6
TAMBACOUNDA,TAMBACOUNDA,MISSIRAH,NETTEBOULOU,"SINTHIOU OUMAR KOUBIA",12,12,131,128,259
TAMBACOUNDA,TAMBACOUNDA,MISSIRAH,NETTEBOULOU,"SINTHIOU VELINGARA",2,2,22,25,47
TAMBACOUNDA,TAMBACOUNDA,MISSIRAH,NETTEBOULOU,"TOUBA DAROU SALAM",13,17,120,119,239
TAMBACOUNDA,GOUDIRY,GOUDIRY,GOUDIRY,ABATTOIRS,125,155,783,770,1553
TAMBACOUNDA,GOUDIRY,GOUDIRY,GOUDIRY,CENTRE,81,100,557,598,1155
TAMBACOUNDA,GOUDIRY,GOUDIRY,GOUDIRY,"CITE DES ENSEIGNANTS",6,8,36,33,69
TAMBACOUNDA,GOUDIRY,GOUDIRY,GOUDIRY,DARSALAM,95,106,426,400,826
TAMBACOUNDA,GOUDIRY,GOUDIRY,GOUDIRY,FERGO,184,222,994,1077,2071
TAMBACOUNDA,GOUDIRY,GOUDIRY,GOUDIRY,HAFIA,94,98,406,369,775
TAMBACOUNDA,GOUDIRY,GOUDIRY,GOUDIRY,"GOUREL NGUETTE",81,113,435,463,898
TAMBACOUNDA,GOUDIRY,GOUDIRY,GOUDIRY,"PLACE DU MARCHE",59,80,348,354,702
TAMBACOUNDA,GOUDIRY,GOUDIRY,GOUDIRY,PONT,88,105,619,587,1206
TAMBACOUNDA,GOUDIRY,GOUDIRY,GOUDIRY,POSTE,85,134,601,371,972
TAMBACOUNDA,GOUDIRY,GOUDIRY,GOUDIRY,"ROUTE DE TAMBA",36,46,166,147,313
TAMBACOUNDA,GOUDIRY,BALA,BALA,BALA,338,403,1819,1432,3251
TAMBACOUNDA,GOUDIRY,BALA,BALA,"DAROU NDIOUFENE",21,26,123,129,252
TAMBACOUNDA,GOUDIRY,BALA,BALA,DIABY,10,15,53,44,97
TAMBACOUNDA,GOUDIRY,BALA,BALA,DIDE,4,7,70,76,146
TAMBACOUNDA,GOUDIRY,BALA,BALA,DIOULANGUEL,16,22,132,137,269
TAMBACOUNDA,GOUDIRY,BALA,BALA,"FASS KOUTHIA (FASS GOUNASS)",8,17,91,90,181
TAMBACOUNDA,GOUDIRY,BALA,BALA,"GAYE PARADJI",15,17,97,106,203
TAMBACOUNDA,GOUDIRY,BALA,BALA,"GOUREL BARTHIAM (NDIOUM DIAWARA)",1,1,19,16,35
TAMBACOUNDA,GOUDIRY,BALA,BALA,"GOUREL KONTE (GOUREL ADAMA)",1,1,14,15,29
TAMBACOUNDA,GOUDIRY,BALA,BALA,"KAHEL (DIYALA 2)",7,13,69,59,128
TAMBACOUNDA,GOUDIRY,BALA,BALA,"KOUTHIAKHASSE (KOUTIA)",92,102,732,792,1524
TAMBACOUNDA,GOUDIRY,BALA,BALA,LOUNTCHI,11,19,177,157,334
TAMBACOUNDA,GOUDIRY,BALA,BALA,"H1 HOFERA (GOUREL YORO)",1,4,32,14,46
TAMBACOUNDA,GOUDIRY,BALA,BALA,"MADINA TOBENE (NDONGO TOP)",11,11,55,45,100
TAMBACOUNDA,GOUDIRY,BALA,BALA,"H1 SINTHIOU SALIF THIAM",2,4,12,14,26
TAMBACOUNDA,GOUDIRY,BALA,BALA,MBANGOL,17,21,134,93,227
TAMBACOUNDA,GOUDIRY,BALA,BALA,"NDIAM SIBY",14,20,61,54,115
TAMBACOUNDA,GOUDIRY,BALA,BALA,"NDIOUM SAMBA CAMARA",6,14,87,80,167
TAMBACOUNDA,GOUDIRY,BALA,BALA,"H1 SINTHIOU BATHILY",2,3,15,10,25
TAMBACOUNDA,GOUDIRY,BALA,BALA,"NDIOUM SAMBA GUILLE  (NDIOUM DEMBA GUILLE)",17,20,119,111,230
TAMBACOUNDA,GOUDIRY,BALA,BALA,"NDOMBOTO (SINTHIOU DIAGUILI)",14,25,98,132,230
TAMBACOUNDA,GOUDIRY,BALA,BALA,NGUIDIVOL,1,1,8,12,20
TAMBACOUNDA,GOUDIRY,BALA,BALA,"H1 PROJET NGUIDIVOL",1,1,11,13,24
TAMBACOUNDA,GOUDIRY,BALA,BALA,"PASS KOUTIA",4,4,25,24,49
TAMBACOUNDA,GOUDIRY,BALA,BALA,SABOUCIRE,8,8,67,38,105
TAMBACOUNDA,GOUDIRY,BALA,BALA,"SINTHIOU BACAR KOBOR 2 (DIAGUILI)",6,7,76,77,153
TAMBACOUNDA,GOUDIRY,BALA,BALA,"SINTHIOU BAMBA",3,4,21,17,38
TAMBACOUNDA,GOUDIRY,BALA,BALA,"SINTHIOU DIOKHE (FRETHIE)",31,35,193,172,365
TAMBACOUNDA,GOUDIRY,BALA,BALA,"SINTHIOU MAKA",8,11,81,41,122
TAMBACOUNDA,GOUDIRY,BALA,BALA,THIARA,55,67,430,477,907
TAMBACOUNDA,GOUDIRY,BALA,BALA,TIVAOUANE,11,12,78,88,166
TAMBACOUNDA,GOUDIRY,BALA,BALA,"WIGUE 1",7,9,53,64,117
TAMBACOUNDA,GOUDIRY,BALA,BALA,"WIGUE 2 (GOUREL YOUNOUSSA)",9,11,54,51,105
TAMBACOUNDA,GOUDIRY,BALA,BALA,"NDIOUM DAOUDA",1,1,8,5,13
TAMBACOUNDA,GOUDIRY,BALA,GOUMBAYEL,BAGADADJI,14,19,124,145,269
TAMBACOUNDA,GOUDIRY,BALA,GOUMBAYEL,"H1 GOUREL YORO",2,4,26,33,59
TAMBACOUNDA,GOUDIRY,BALA,GOUMBAYEL,"H2 NELBOUDALA I (NELBOUDALA CHARIFOU)",6,8,33,50,83
TAMBACOUNDA,GOUDIRY,BALA,GOUMBAYEL,"BALA FOULBE (BALA HAMADY BODIEL)",22,32,213,189,402
TAMBACOUNDA,GOUDIRY,BALA,GOUMBAYEL,"H1 PANTHIANGUE",1,2,11,19,30
TAMBACOUNDA,GOUDIRY,BALA,GOUMBAYEL,"BALAM BOULOU",16,26,236,204,440
TAMBACOUNDA,GOUDIRY,BALA,GOUMBAYEL,BOFOULOU,4,12,83,97,180
TAMBACOUNDA,GOUDIRY,BALA,GOUMBAYEL,"H1 TOUMBOU",2,4,14,14,28
TAMBACOUNDA,GOUDIRY,BALA,GOUMBAYEL,BOKE,9,17,67,93,160
TAMBACOUNDA,GOUDIRY,BALA,GOUMBAYEL,"DAROU HIDJIRATOU",8,8,48,47,95
TAMBACOUNDA,GOUDIRY,BALA,GOUMBAYEL,"H1 GOUREL SEYDOU INNALAH",1,1,17,6,23
TAMBACOUNDA,GOUDIRY,BALA,GOUMBAYEL,GOUMBAYEL,103,115,855,915,1770
TAMBACOUNDA,GOUDIRY,BALA,GOUMBAYEL,"H1 FODE KOLIA",1,1,13,13,26
TAMBACOUNDA,GOUDIRY,BALA,GOUMBAYEL,"GOUME (FASS TONGOUDE)",7,11,63,69,132
TAMBACOUNDA,GOUDIRY,BALA,GOUMBAYEL,"H1 BOUCHRA",5,7,15,25,40
TAMBACOUNDA,GOUDIRY,BALA,GOUMBAYEL,"H2 GOUREL SAMBA TOUMANI",1,2,25,13,38
TAMBACOUNDA,GOUDIRY,BALA,GOUMBAYEL,"GOUREL FOULAH",4,11,80,104,184
TAMBACOUNDA,GOUDIRY,BALA,GOUMBAYEL,"GOUREL HAMADY",2,3,23,34,57
TAMBACOUNDA,GOUDIRY,BALA,GOUMBAYEL,"GOUREL MAYO",10,16,85,90,175
TAMBACOUNDA,GOUDIRY,BALA,GOUMBAYEL,"H1 KAPARTA",2,4,25,26,51
TAMBACOUNDA,GOUDIRY,BALA,GOUMBAYEL,"HAMDALLAYE 2",14,23,170,132,302
TAMBACOUNDA,GOUDIRY,BALA,GOUMBAYEL,"H1 GOUREL BATHIE",3,4,31,40,71
TAMBACOUNDA,GOUDIRY,BALA,GOUMBAYEL,KAGNIBE,45,53,334,322,656
TAMBACOUNDA,GOUDIRY,BALA,GOUMBAYEL,"H1 BATHIAM 1 (PASSAM WAYLOUBE)",2,6,18,21,39
TAMBACOUNDA,GOUDIRY,BALA,GOUMBAYEL,"H2 BACONTE (BATHIAM 1)",1,1,6,7,13
TAMBACOUNDA,GOUDIRY,BALA,GOUMBAYEL,"H3 GOUREL MAMAYE KANTE",2,2,19,16,35
TAMBACOUNDA,GOUDIRY,BALA,GOUMBAYEL,"H4 GOUREL PATHE",1,2,10,8,18
TAMBACOUNDA,GOUDIRY,BALA,GOUMBAYEL,"H5 GOUREL DEMBA",1,1,13,16,29
TAMBACOUNDA,GOUDIRY,BALA,GOUMBAYEL,"H6 GOUREL WOPA",2,2,18,18,36
TAMBACOUNDA,GOUDIRY,BALA,GOUMBAYEL,"H7 GOUREL ABDOULAYE",4,6,23,51,74
TAMBACOUNDA,GOUDIRY,BALA,GOUMBAYEL,"KEUR BOUBOU ANSE",13,15,82,73,155
TAMBACOUNDA,GOUDIRY,BALA,GOUMBAYEL,"MADINA DIOUNA(BAGADADJI DIOUNNA)",11,21,110,108,218
TAMBACOUNDA,GOUDIRY,BALA,GOUMBAYEL,NEMA,13,14,46,46,92
TAMBACOUNDA,GOUDIRY,BALA,GOUMBAYEL,PATHEROU,13,16,115,109,224
TAMBACOUNDA,GOUDIRY,BALA,GOUMBAYEL,SABIKHASSE,9,20,137,156,293
TAMBACOUNDA,GOUDIRY,BALA,GOUMBAYEL,"SAMBA GUITA",14,16,165,167,332
TAMBACOUNDA,GOUDIRY,BALA,GOUMBAYEL,"H1 GOUREL DIOULDE",2,3,24,27,51
TAMBACOUNDA,GOUDIRY,BALA,GOUMBAYEL,"H2 GOUREL BOCAR",1,1,9,4,13
TAMBACOUNDA,GOUDIRY,BALA,GOUMBAYEL,"SIMBANE FOULBES",16,31,213,193,406
TAMBACOUNDA,GOUDIRY,BALA,GOUMBAYEL,"SIMBANE MAMOUDOU",61,69,365,379,744
TAMBACOUNDA,GOUDIRY,BALA,GOUMBAYEL,"SINTHIOU CIRE WORDE (KOUNDEL)",18,21,190,164,354
TAMBACOUNDA,GOUDIRY,BALA,GOUMBAYEL,"SINTHIOU GADIRY",1,3,21,17,38
TAMBACOUNDA,GOUDIRY,BALA,GOUMBAYEL,"SINTHIOU MAMADOU KOUPA",19,20,88,90,178
TAMBACOUNDA,GOUDIRY,BALA,GOUMBAYEL,"SINTHIOU PATHE",18,30,205,146,351
TAMBACOUNDA,GOUDIRY,BALA,GOUMBAYEL,"SINTHIOU WOPA",4,8,47,41,88
TAMBACOUNDA,GOUDIRY,BALA,GOUMBAYEL,"TOULDE BANI",6,6,46,27,73
TAMBACOUNDA,GOUDIRY,BALA,KOAR,"BANFARA MOSSI",4,5,27,13,40
TAMBACOUNDA,GOUDIRY,BALA,KOAR,"DAROU NDIOBENE (SINTHIANE NAOURE)",11,11,48,40,88
TAMBACOUNDA,GOUDIRY,BALA,KOAR,"DIALOUBE (DIALICOUNDA)",42,51,357,372,729
TAMBACOUNDA,GOUDIRY,BALA,KOAR,"HI WOURO THIERNO BASSIROU BA",2,3,24,21,45
TAMBACOUNDA,GOUDIRY,BALA,KOAR,"DIARRA (SINTHIOUGROU)",4,5,83,104,187
TAMBACOUNDA,GOUDIRY,BALA,KOAR,"DIYABOUGOU  SAKHO",58,61,486,629,1115
TAMBACOUNDA,GOUDIRY,BALA,KOAR,GAMBIE,32,39,254,255,509
TAMBACOUNDA,GOUDIRY,BALA,KOAR,GODIEYEL,17,17,109,96,205
TAMBACOUNDA,GOUDIRY,BALA,KOAR,INNALAH,46,60,471,496,967
TAMBACOUNDA,GOUDIRY,BALA,KOAR,KOAR,89,109,1044,1006,2050
TAMBACOUNDA,GOUDIRY,BALA,KOAR,"MEDINA OUOLOF (DOROYEL)",38,50,278,280,558
TAMBACOUNDA,GOUDIRY,BALA,KOAR,"MEDINA TOUKOUTALA",12,14,171,151,322
TAMBACOUNDA,GOUDIRY,BALA,KOAR,NAOUDE,31,40,255,194,449
TAMBACOUNDA,GOUDIRY,BALA,KOAR,NGARIVOL,8,10,73,71,144
TAMBACOUNDA,GOUDIRY,BALA,KOAR,NOUMOUYEL,55,66,619,500,1119
TAMBACOUNDA,GOUDIRY,BALA,KOAR,"SARE NIANA",16,22,132,145,277
TAMBACOUNDA,GOUDIRY,BALA,KOAR,"SINTHIOU ABDOULAYE (SINTHIOU BOCAR SADA)",26,41,305,285,590
TAMBACOUNDA,GOUDIRY,BALA,KOAR,"SINTHIOU NGUIDIVOL",40,46,279,341,620
TAMBACOUNDA,GOUDIRY,BALA,KOAR,"H1 VELINGARA",8,11,59,59,118
TAMBACOUNDA,GOUDIRY,BALA,KOAR,"SIRACORO BOUGOU",14,15,94,54,148
TAMBACOUNDA,GOUDIRY,BALA,KOAR,TABANDING,48,55,705,836,1541
TAMBACOUNDA,GOUDIRY,BALA,KOAR,"TIVAOUANE (KROUME KOUPE)",23,28,161,158,319
TAMBACOUNDA,GOUDIRY,BALA,KOAR,"TOUBA NAOUDE (KOWEIT CITY)",1,1,11,14,25
TAMBACOUNDA,GOUDIRY,"BOYNGUEL BAMBA",DOUGUE,DIEYLANI,76,87,797,708,1505
TAMBACOUNDA,GOUDIRY,"BOYNGUEL BAMBA",DOUGUE,"H1 GONGHEDJI",8,10,102,91,193
TAMBACOUNDA,GOUDIRY,"BOYNGUEL BAMBA",DOUGUE,"H2 SIMBARABOUGOU",4,4,41,39,80
TAMBACOUNDA,GOUDIRY,"BOYNGUEL BAMBA",DOUGUE,DOUGUE,91,123,923,967,1890
TAMBACOUNDA,GOUDIRY,"BOYNGUEL BAMBA",DOUGUE,"H1 DIYALA",2,2,47,58,105
TAMBACOUNDA,GOUDIRY,"BOYNGUEL BAMBA",DOUGUE,FASS,10,12,122,137,259
TAMBACOUNDA,GOUDIRY,"BOYNGUEL BAMBA",DOUGUE,"GOUREL DEMBA (NDIARENDY DEMBA RAKY)",13,20,161,144,305
TAMBACOUNDA,GOUDIRY,"BOYNGUEL BAMBA",DOUGUE,KAPARTA,1,1,18,6,24
TAMBACOUNDA,GOUDIRY,"BOYNGUEL BAMBA",DOUGUE,"H1 PARAWOL",2,3,11,12,23
TAMBACOUNDA,GOUDIRY,"BOYNGUEL BAMBA",DOUGUE,NDIARENDY,8,14,101,108,209
TAMBACOUNDA,GOUDIRY,"BOYNGUEL BAMBA",DOUGUE,SAWNGADJI,12,13,111,121,232
TAMBACOUNDA,GOUDIRY,"BOYNGUEL BAMBA",DOUGUE,"H1 LOUMBOUL 2",1,1,3,0,3
TAMBACOUNDA,GOUDIRY,"BOYNGUEL BAMBA",DOUGUE,SOUTOUTA,91,110,834,992,1826
TAMBACOUNDA,GOUDIRY,"BOYNGUEL BAMBA",DOUGUE,"H1 GOUNDIOUROU TANGANA",2,3,23,32,55
TAMBACOUNDA,GOUDIRY,"BOYNGUEL BAMBA",DOUGUE,"H2 SINTHIOU MAKO",5,10,74,75,149
TAMBACOUNDA,GOUDIRY,"BOYNGUEL BAMBA",DOUGUE,"H3 GOUNDIOUROU CEBBE",3,3,30,23,53
TAMBACOUNDA,GOUDIRY,"BOYNGUEL BAMBA",DOUGUE,"H4 NDAWDING",1,2,34,14,48
TAMBACOUNDA,GOUDIRY,"BOYNGUEL BAMBA",DOUGUE,"H5 GOUNDIOUROU FOULBE",6,7,61,51,112
TAMBACOUNDA,GOUDIRY,"BOYNGUEL BAMBA",DOUGUE,"H6 GOUREL DAHIROU",1,1,15,9,24
TAMBACOUNDA,GOUDIRY,"BOYNGUEL BAMBA",DOUGUE,"H7 NEMATOULAYE",2,2,22,14,36
TAMBACOUNDA,GOUDIRY,"BOYNGUEL BAMBA",DOUGUE,"H10 DARSALAM",1,1,6,8,14
TAMBACOUNDA,GOUDIRY,"BOYNGUEL BAMBA",DOUGUE,"H11 GOUNDIOUROU THIERNODING",1,1,10,4,14
TAMBACOUNDA,GOUDIRY,"BOYNGUEL BAMBA",DOUGUE,"TALIBADJI TOUCOULEUR (TALIBADJI SAMBA HABA)",58,71,686,756,1442
TAMBACOUNDA,GOUDIRY,"BOYNGUEL BAMBA",DOUGUE,"H1 GOUREL HAMDALAYE",7,9,40,48,88
TAMBACOUNDA,GOUDIRY,"BOYNGUEL BAMBA",DOUGUE,"WOURO SILLY",24,35,228,310,538
TAMBACOUNDA,GOUDIRY,"BOYNGUEL BAMBA",DOUGUE,"H1 NEMA",1,2,19,29,48
TAMBACOUNDA,GOUDIRY,"BOYNGUEL BAMBA","BOYNGUEL BAMBA",AINOUMADY,57,68,712,738,1450
TAMBACOUNDA,GOUDIRY,"BOYNGUEL BAMBA","BOYNGUEL BAMBA",ALLAGUE,25,39,305,334,639
TAMBACOUNDA,GOUDIRY,"BOYNGUEL BAMBA","BOYNGUEL BAMBA","BANI TAPIRDE",13,16,150,139,289
TAMBACOUNDA,GOUDIRY,"BOYNGUEL BAMBA","BOYNGUEL BAMBA","H1 GOUREL MAMADOU (MEDINA SALAM)",2,3,29,13,42
TAMBACOUNDA,GOUDIRY,"BOYNGUEL BAMBA","BOYNGUEL BAMBA","H3 GOUREL DEMBA FOUNE",2,3,18,18,36
TAMBACOUNDA,GOUDIRY,"BOYNGUEL BAMBA","BOYNGUEL BAMBA",BODE,63,76,675,675,1350
TAMBACOUNDA,GOUDIRY,"BOYNGUEL BAMBA","BOYNGUEL BAMBA","H1 GOUREL BAKARY",15,18,154,153,307
TAMBACOUNDA,GOUDIRY,"BOYNGUEL BAMBA","BOYNGUEL BAMBA","H3 SINTHIOU DICKO (GOUREL SORY)",1,2,12,10,22
TAMBACOUNDA,GOUDIRY,"BOYNGUEL BAMBA","BOYNGUEL BAMBA","H4 TALIGO DIAWAMBE",4,5,24,15,39
TAMBACOUNDA,GOUDIRY,"BOYNGUEL BAMBA","BOYNGUEL BAMBA","H6 GOUREL MAKA",5,7,61,39,100
TAMBACOUNDA,GOUDIRY,"BOYNGUEL BAMBA","BOYNGUEL BAMBA","H7 GOUREL DEMBA HABIB",2,3,44,41,85
TAMBACOUNDA,GOUDIRY,"BOYNGUEL BAMBA","BOYNGUEL BAMBA",BOGAL,18,27,176,207,383
TAMBACOUNDA,GOUDIRY,"BOYNGUEL BAMBA","BOYNGUEL BAMBA","BOYNGUEL BAMBA",112,139,862,797,1659
TAMBACOUNDA,GOUDIRY,"BOYNGUEL BAMBA","BOYNGUEL BAMBA","H1 GOUREL DIAVAMBE (TAWBATOU)",2,3,15,13,28
TAMBACOUNDA,GOUDIRY,"BOYNGUEL BAMBA","BOYNGUEL BAMBA","BOYNGUEL WOURO",3,3,17,13,30
TAMBACOUNDA,GOUDIRY,"BOYNGUEL BAMBA","BOYNGUEL BAMBA","DENDOUDI DOKA",21,26,403,349,752
TAMBACOUNDA,GOUDIRY,"BOYNGUEL BAMBA","BOYNGUEL BAMBA","H1 MEDINA DIOKEL NDONGO (GOUREL DIOKEL)",1,4,33,31,64
TAMBACOUNDA,GOUDIRY,"BOYNGUEL BAMBA","BOYNGUEL BAMBA",FETENIEBE,35,49,432,399,831
TAMBACOUNDA,GOUDIRY,"BOYNGUEL BAMBA","BOYNGUEL BAMBA","H1 MEDINA THIAMBE",2,2,25,26,51
TAMBACOUNDA,GOUDIRY,"BOYNGUEL BAMBA","BOYNGUEL BAMBA",GOUMBO,10,15,114,121,235
TAMBACOUNDA,GOUDIRY,"BOYNGUEL BAMBA","BOYNGUEL BAMBA","H1 GOUREL MATHIOUBE",6,9,90,69,159
TAMBACOUNDA,GOUDIRY,"BOYNGUEL BAMBA","BOYNGUEL BAMBA","H2 TOULDE DOUKI",12,14,131,131,262
TAMBACOUNDA,GOUDIRY,"BOYNGUEL BAMBA","BOYNGUEL BAMBA","H3 HALWAR",1,4,44,44,88
TAMBACOUNDA,GOUDIRY,"BOYNGUEL BAMBA","BOYNGUEL BAMBA","H4 TOUMBOUNG AMADOU",2,6,30,28,58
TAMBACOUNDA,GOUDIRY,"BOYNGUEL BAMBA","BOYNGUEL BAMBA","GOUREL SAMBA RAMATA",4,7,54,34,88
TAMBACOUNDA,GOUDIRY,"BOYNGUEL BAMBA","BOYNGUEL BAMBA",GUELODE,14,27,322,349,671
TAMBACOUNDA,GOUDIRY,"BOYNGUEL BAMBA","BOYNGUEL BAMBA",KANHAMBE,16,23,304,240,544
TAMBACOUNDA,GOUDIRY,"BOYNGUEL BAMBA","BOYNGUEL BAMBA","H1 GOUREL SAMBA DJINDE",4,8,32,54,86
TAMBACOUNDA,GOUDIRY,"BOYNGUEL BAMBA","BOYNGUEL BAMBA",KOUDY,45,55,516,578,1094
TAMBACOUNDA,GOUDIRY,"BOYNGUEL BAMBA","BOYNGUEL BAMBA","LEVA DIAVANDEL",5,8,109,95,204
TAMBACOUNDA,GOUDIRY,"BOYNGUEL BAMBA","BOYNGUEL BAMBA",LOUGUE,13,15,109,100,209
TAMBACOUNDA,GOUDIRY,"BOYNGUEL BAMBA","BOYNGUEL BAMBA",MBACKNABE,25,33,280,274,554
TAMBACOUNDA,GOUDIRY,"BOYNGUEL BAMBA","BOYNGUEL BAMBA","MEDINA SADIO",2,2,22,15,37
TAMBACOUNDA,GOUDIRY,"BOYNGUEL BAMBA","BOYNGUEL BAMBA","NANGANEME 1",12,21,146,150,296
TAMBACOUNDA,GOUDIRY,"BOYNGUEL BAMBA","BOYNGUEL BAMBA","H1 GOULOUMBEL",3,6,37,43,80
TAMBACOUNDA,GOUDIRY,"BOYNGUEL BAMBA","BOYNGUEL BAMBA","H2 DAGADJI",1,3,14,15,29
TAMBACOUNDA,GOUDIRY,"BOYNGUEL BAMBA","BOYNGUEL BAMBA","NANGANAME 2",13,17,176,145,321
TAMBACOUNDA,GOUDIRY,"BOYNGUEL BAMBA","BOYNGUEL BAMBA","OURO DAOUDA",18,22,232,234,466
TAMBACOUNDA,GOUDIRY,"BOYNGUEL BAMBA","BOYNGUEL BAMBA","SINTHIOU ABDOUL ALASSANE (GOUREL MAKA)",4,5,26,49,75
TAMBACOUNDA,GOUDIRY,"BOYNGUEL BAMBA","BOYNGUEL BAMBA","SINTHIOU HAMADY MBEH",3,3,25,30,55
TAMBACOUNDA,GOUDIRY,"BOYNGUEL BAMBA","BOYNGUEL BAMBA","SINTHIOU BOCAR SAMBA",16,25,186,254,440
TAMBACOUNDA,GOUDIRY,"BOYNGUEL BAMBA","BOYNGUEL BAMBA","HI LOMBOL SAMBA HAWA",1,1,5,12,17
TAMBACOUNDA,GOUDIRY,"BOYNGUEL BAMBA","BOYNGUEL BAMBA","H2 GOUREL BOULAYE",2,2,27,28,55
TAMBACOUNDA,GOUDIRY,"BOYNGUEL BAMBA","BOYNGUEL BAMBA","SINTHIOU BOUBOU",20,25,248,258,506
TAMBACOUNDA,GOUDIRY,"BOYNGUEL BAMBA","BOYNGUEL BAMBA","SINTHIOU FOULBE",16,19,219,205,424
TAMBACOUNDA,GOUDIRY,"BOYNGUEL BAMBA","BOYNGUEL BAMBA","SINTHIOU GALLO SOW",11,15,70,85,155
TAMBACOUNDA,GOUDIRY,"BOYNGUEL BAMBA","BOYNGUEL BAMBA","SINTHIOU HARANE (GOUREL YORO SARR)",5,5,50,43,93
TAMBACOUNDA,GOUDIRY,"BOYNGUEL BAMBA","BOYNGUEL BAMBA","SINTHIOU MAMADOU CIRE",32,36,422,425,847
TAMBACOUNDA,GOUDIRY,"BOYNGUEL BAMBA","BOYNGUEL BAMBA","TALIBADJI WOLOF",20,29,158,153,311
TAMBACOUNDA,GOUDIRY,"BOYNGUEL BAMBA",KOUSSAN,DAKABA,27,35,302,339,641
TAMBACOUNDA,GOUDIRY,"BOYNGUEL BAMBA",KOUSSAN,"H1 GOUREL KARAMATOU",1,2,11,11,22
TAMBACOUNDA,GOUDIRY,"BOYNGUEL BAMBA",KOUSSAN,DOULOUYABE,36,50,445,526,971
TAMBACOUNDA,GOUDIRY,"BOYNGUEL BAMBA",KOUSSAN,FERGO,10,12,122,116,238
TAMBACOUNDA,GOUDIRY,"BOYNGUEL BAMBA",KOUSSAN,"GOUDIRY FOULBES",36,42,359,444,803
TAMBACOUNDA,GOUDIRY,"BOYNGUEL BAMBA",KOUSSAN,"GOUREL BAIDY",59,71,673,681,1354
TAMBACOUNDA,GOUDIRY,"BOYNGUEL BAMBA",KOUSSAN,KOUSSAN,100,115,704,721,1425
TAMBACOUNDA,GOUDIRY,"BOYNGUEL BAMBA",KOUSSAN,"LINGUE KONE",20,27,247,251,498
TAMBACOUNDA,GOUDIRY,"BOYNGUEL BAMBA",KOUSSAN,"SINTHIOU ALASSANE",15,19,197,209,406
TAMBACOUNDA,GOUDIRY,"BOYNGUEL BAMBA",KOUSSAN,"SINTHIOU LELEKON",45,65,561,613,1174
TAMBACOUNDA,GOUDIRY,"BOYNGUEL BAMBA",KOUSSAN,"H1 TOUMBOUM (OURO AYIBO)",3,5,47,54,101
TAMBACOUNDA,GOUDIRY,"BOYNGUEL BAMBA",KOUSSAN,"SINTHIOU MBALADJI",20,25,231,257,488
TAMBACOUNDA,GOUDIRY,"BOYNGUEL BAMBA",KOUSSAN,"SINTHIOU MOUSSA (SINTHIOU DEMBA)",36,49,635,731,1366
TAMBACOUNDA,GOUDIRY,"BOYNGUEL BAMBA",KOUSSAN,"SINTHIOU SEYDI MALI",18,23,183,199,382
TAMBACOUNDA,GOUDIRY,"BOYNGUEL BAMBA",KOUSSAN,THIECKE,7,16,114,91,205
TAMBACOUNDA,GOUDIRY,"BOYNGUEL BAMBA",KOUSSAN,TOUMOUNGUEL,20,27,263,313,576
TAMBACOUNDA,GOUDIRY,"BOYNGUEL BAMBA",KOUSSAN,TOUNKE,18,26,214,158,372
TAMBACOUNDA,GOUDIRY,"BOYNGUEL BAMBA","SINTHIOU MAMADOU BOUBOU","BELE 2",23,37,183,151,334
TAMBACOUNDA,GOUDIRY,"BOYNGUEL BAMBA","SINTHIOU MAMADOU BOUBOU","H1 GOUREL HAMET(SADATOU 2)",1,4,21,35,56
TAMBACOUNDA,GOUDIRY,"BOYNGUEL BAMBA","SINTHIOU MAMADOU BOUBOU","H2 GOUREL MAMOUDAL ( MAMADOU DEMBA)",2,7,49,36,85
TAMBACOUNDA,GOUDIRY,"BOYNGUEL BAMBA","SINTHIOU MAMADOU BOUBOU","H3 GOUREL MOYLEL",5,5,25,27,52
TAMBACOUNDA,GOUDIRY,"BOYNGUEL BAMBA","SINTHIOU MAMADOU BOUBOU","H4 SINTHIOU IDY 2",4,6,36,37,73
TAMBACOUNDA,GOUDIRY,"BOYNGUEL BAMBA","SINTHIOU MAMADOU BOUBOU","H5 WOURY MORY TOURE",2,4,22,17,39
TAMBACOUNDA,GOUDIRY,"BOYNGUEL BAMBA","SINTHIOU MAMADOU BOUBOU",BINGUEL,12,19,121,128,249
TAMBACOUNDA,GOUDIRY,"BOYNGUEL BAMBA","SINTHIOU MAMADOU BOUBOU","BIROM DIGUI 1",9,25,118,145,263
TAMBACOUNDA,GOUDIRY,"BOYNGUEL BAMBA","SINTHIOU MAMADOU BOUBOU","BOCKI GUILLE",20,47,453,452,905
TAMBACOUNDA,GOUDIRY,"BOYNGUEL BAMBA","SINTHIOU MAMADOU BOUBOU","H1 GOUREL MAKA",3,8,50,48,98
TAMBACOUNDA,GOUDIRY,"BOYNGUEL BAMBA","SINTHIOU MAMADOU BOUBOU","H2 SINTHIANE MATHIOUBE",11,15,124,88,212
TAMBACOUNDA,GOUDIRY,"BOYNGUEL BAMBA","SINTHIOU MAMADOU BOUBOU","H4 LOWEL",2,5,44,25,69
TAMBACOUNDA,GOUDIRY,"BOYNGUEL BAMBA","SINTHIOU MAMADOU BOUBOU","BOCKI MABOUBE",6,20,138,135,273
TAMBACOUNDA,GOUDIRY,"BOYNGUEL BAMBA","SINTHIOU MAMADOU BOUBOU","H1 VELINGARA (GOUREL SAMBA YORO)",1,3,24,38,62
TAMBACOUNDA,GOUDIRY,"BOYNGUEL BAMBA","SINTHIOU MAMADOU BOUBOU",BOULA,8,12,77,81,158
TAMBACOUNDA,GOUDIRY,"BOYNGUEL BAMBA","SINTHIOU MAMADOU BOUBOU",BOULEL,16,22,256,300,556
TAMBACOUNDA,GOUDIRY,"BOYNGUEL BAMBA","SINTHIOU MAMADOU BOUBOU","CIVIYABE (CIWABE)",25,42,316,336,652
TAMBACOUNDA,GOUDIRY,"BOYNGUEL BAMBA","SINTHIOU MAMADOU BOUBOU","H1 MADINA SAMBOUNABE",3,3,11,13,24
TAMBACOUNDA,GOUDIRY,"BOYNGUEL BAMBA","SINTHIOU MAMADOU BOUBOU","DENDOUDI SEYDI",18,35,215,173,388
TAMBACOUNDA,GOUDIRY,"BOYNGUEL BAMBA","SINTHIOU MAMADOU BOUBOU","H1 TOCKOSSOUROU (GOUREL FADOUBE)",10,15,64,81,145
TAMBACOUNDA,GOUDIRY,"BOYNGUEL BAMBA","SINTHIOU MAMADOU BOUBOU","H2 NAYKI ( GOUREL TOLLE)",2,4,18,24,42
TAMBACOUNDA,GOUDIRY,"BOYNGUEL BAMBA","SINTHIOU MAMADOU BOUBOU","H3 BOFEL",2,2,19,21,40
TAMBACOUNDA,GOUDIRY,"BOYNGUEL BAMBA","SINTHIOU MAMADOU BOUBOU","H4 GOUREL NIAKA",2,4,26,27,53
TAMBACOUNDA,GOUDIRY,"BOYNGUEL BAMBA","SINTHIOU MAMADOU BOUBOU","DIARE MABOUBE 2",15,18,176,171,347
TAMBACOUNDA,GOUDIRY,"BOYNGUEL BAMBA","SINTHIOU MAMADOU BOUBOU","DIARE MBOLO",40,53,472,534,1006
TAMBACOUNDA,GOUDIRY,"BOYNGUEL BAMBA","SINTHIOU MAMADOU BOUBOU","DOUBEL BAIDY",12,25,213,206,419
TAMBACOUNDA,GOUDIRY,"BOYNGUEL BAMBA","SINTHIOU MAMADOU BOUBOU",DOUBI,5,5,32,38,70
TAMBACOUNDA,GOUDIRY,"BOYNGUEL BAMBA","SINTHIOU MAMADOU BOUBOU","H1 MISSIRAH SALSABE",7,13,94,119,213
TAMBACOUNDA,GOUDIRY,"BOYNGUEL BAMBA","SINTHIOU MAMADOU BOUBOU","H2 SINTHIOU HAMADY BA",3,5,22,25,47
TAMBACOUNDA,GOUDIRY,"BOYNGUEL BAMBA","SINTHIOU MAMADOU BOUBOU","H3 SINTHIOU DEMBA",6,8,39,35,74
TAMBACOUNDA,GOUDIRY,"BOYNGUEL BAMBA","SINTHIOU MAMADOU BOUBOU",GALLOYABES,14,21,234,253,487
TAMBACOUNDA,GOUDIRY,"BOYNGUEL BAMBA","SINTHIOU MAMADOU BOUBOU",GARALLA,12,16,86,102,188
TAMBACOUNDA,GOUDIRY,"BOYNGUEL BAMBA","SINTHIOU MAMADOU BOUBOU",GONADE,4,5,42,37,79
TAMBACOUNDA,GOUDIRY,"BOYNGUEL BAMBA","SINTHIOU MAMADOU BOUBOU",GONGHEDJI,12,18,219,158,377
TAMBACOUNDA,GOUDIRY,"BOYNGUEL BAMBA","SINTHIOU MAMADOU BOUBOU","H1 BASSARA",2,2,24,15,39
TAMBACOUNDA,GOUDIRY,"BOYNGUEL BAMBA","SINTHIOU MAMADOU BOUBOU",GOUMEL,7,10,43,47,90
TAMBACOUNDA,GOUDIRY,"BOYNGUEL BAMBA","SINTHIOU MAMADOU BOUBOU","GUEVOL DIAVAMBE",18,24,188,194,382
TAMBACOUNDA,GOUDIRY,"BOYNGUEL BAMBA","SINTHIOU MAMADOU BOUBOU","H1 DAROU SALAM( GOUREL DORO)",2,4,70,79,149
TAMBACOUNDA,GOUDIRY,"BOYNGUEL BAMBA","SINTHIOU MAMADOU BOUBOU",GUINA,13,17,116,139,255
TAMBACOUNDA,GOUDIRY,"BOYNGUEL BAMBA","SINTHIOU MAMADOU BOUBOU","LEVA AMATH",23,40,334,381,715
TAMBACOUNDA,GOUDIRY,"BOYNGUEL BAMBA","SINTHIOU MAMADOU BOUBOU","LEVA BOKI DIOULKI",5,6,56,66,122
TAMBACOUNDA,GOUDIRY,"BOYNGUEL BAMBA","SINTHIOU MAMADOU BOUBOU","LEVA DIOLFOUBE",30,38,350,355,705
TAMBACOUNDA,GOUDIRY,"BOYNGUEL BAMBA","SINTHIOU MAMADOU BOUBOU",LORIDIE,10,15,97,90,187
TAMBACOUNDA,GOUDIRY,"BOYNGUEL BAMBA","SINTHIOU MAMADOU BOUBOU","H1 ARAMANI",4,6,36,30,66
TAMBACOUNDA,GOUDIRY,"BOYNGUEL BAMBA","SINTHIOU MAMADOU BOUBOU","MADINA HAMADY (GOUREL DIALOUBE)",5,9,47,41,88
TAMBACOUNDA,GOUDIRY,"BOYNGUEL BAMBA","SINTHIOU MAMADOU BOUBOU","MAYEL WAMBABE",17,28,164,144,308
TAMBACOUNDA,GOUDIRY,"BOYNGUEL BAMBA","SINTHIOU MAMADOU BOUBOU","H1 WOURO CIRE",2,3,12,14,26
TAMBACOUNDA,GOUDIRY,"BOYNGUEL BAMBA","SINTHIOU MAMADOU BOUBOU","H2 AINOU MADY (GOUREL SARA DEMBAYEL)",2,3,23,27,50
TAMBACOUNDA,GOUDIRY,"BOYNGUEL BAMBA","SINTHIOU MAMADOU BOUBOU",MBAILADJI,35,47,483,539,1022
TAMBACOUNDA,GOUDIRY,"BOYNGUEL BAMBA","SINTHIOU MAMADOU BOUBOU","H1 SINTHIOU BAMAMBE",8,12,63,67,130
TAMBACOUNDA,GOUDIRY,"BOYNGUEL BAMBA","SINTHIOU MAMADOU BOUBOU","MBALANDI KODIOLEL",8,14,74,93,167
TAMBACOUNDA,GOUDIRY,"BOYNGUEL BAMBA","SINTHIOU MAMADOU BOUBOU",MBANIOU,16,23,215,177,392
TAMBACOUNDA,GOUDIRY,"BOYNGUEL BAMBA","SINTHIOU MAMADOU BOUBOU","MADINA GUIRAYE",5,5,40,49,89
TAMBACOUNDA,GOUDIRY,"BOYNGUEL BAMBA","SINTHIOU MAMADOU BOUBOU",NDIAKONE,18,29,278,284,562
TAMBACOUNDA,GOUDIRY,"BOYNGUEL BAMBA","SINTHIOU MAMADOU BOUBOU",NDIYA,30,42,314,347,661
TAMBACOUNDA,GOUDIRY,"BOYNGUEL BAMBA","SINTHIOU MAMADOU BOUBOU","NGARI ALI (NGAREDJI)",13,22,153,173,326
TAMBACOUNDA,GOUDIRY,"BOYNGUEL BAMBA","SINTHIOU MAMADOU BOUBOU","WOURO GOUMBO",1,2,11,13,24
TAMBACOUNDA,GOUDIRY,"BOYNGUEL BAMBA","SINTHIOU MAMADOU BOUBOU","WOURO KABA",9,12,267,117,384
TAMBACOUNDA,GOUDIRY,"BOYNGUEL BAMBA","SINTHIOU MAMADOU BOUBOU","H1 BIROM DIGUI 2",11,15,127,143,270
TAMBACOUNDA,GOUDIRY,"BOYNGUEL BAMBA","SINTHIOU MAMADOU BOUBOU","WOURO SINGHA",11,20,120,138,258
TAMBACOUNDA,GOUDIRY,"BOYNGUEL BAMBA","SINTHIOU MAMADOU BOUBOU","H1 SINTHIOU KOLELE",6,11,74,86,160
TAMBACOUNDA,GOUDIRY,"BOYNGUEL BAMBA","SINTHIOU MAMADOU BOUBOU","H3 SINTHIANE HAMADY BA",2,7,51,48,99
TAMBACOUNDA,GOUDIRY,"BOYNGUEL BAMBA","SINTHIOU MAMADOU BOUBOU","SENO BODE",12,17,101,123,224
TAMBACOUNDA,GOUDIRY,"BOYNGUEL BAMBA","SINTHIOU MAMADOU BOUBOU","H1 PATIGUEL",1,1,5,0,5
TAMBACOUNDA,GOUDIRY,"BOYNGUEL BAMBA","SINTHIOU MAMADOU BOUBOU","SENO SAMBA YABE",6,14,54,48,102
TAMBACOUNDA,GOUDIRY,"BOYNGUEL BAMBA","SINTHIOU MAMADOU BOUBOU","H1 GOUREL DEMBA HAMADY",4,4,36,31,67
TAMBACOUNDA,GOUDIRY,"BOYNGUEL BAMBA","SINTHIOU MAMADOU BOUBOU","H2 GOUREL  DIAMBERE",2,4,16,21,37
TAMBACOUNDA,GOUDIRY,"BOYNGUEL BAMBA","SINTHIOU MAMADOU BOUBOU","SINTHIOU AMATH MODY",6,12,61,99,160
TAMBACOUNDA,GOUDIRY,"BOYNGUEL BAMBA","SINTHIOU MAMADOU BOUBOU","H1 SINTHIOU MOUDERI",3,3,21,10,31
TAMBACOUNDA,GOUDIRY,"BOYNGUEL BAMBA","SINTHIOU MAMADOU BOUBOU","SINTHIOU BILALI 2",5,10,116,134,250
TAMBACOUNDA,GOUDIRY,"BOYNGUEL BAMBA","SINTHIOU MAMADOU BOUBOU","SINTHIOU BODEL (GOUREL WAYLOUBE)",3,5,18,23,41
TAMBACOUNDA,GOUDIRY,"BOYNGUEL BAMBA","SINTHIOU MAMADOU BOUBOU","SINTHIOU DEMBA",3,5,39,35,74
TAMBACOUNDA,GOUDIRY,"BOYNGUEL BAMBA","SINTHIOU MAMADOU BOUBOU","H1 MADINA OUMAR( GOUREL NGOM)",4,6,44,39,83
TAMBACOUNDA,GOUDIRY,"BOYNGUEL BAMBA","SINTHIOU MAMADOU BOUBOU","SINTHIOU DOUBE VILLAGE",8,13,118,110,228
TAMBACOUNDA,GOUDIRY,"BOYNGUEL BAMBA","SINTHIOU MAMADOU BOUBOU","SINTHIOU IDY 1",5,6,62,53,115
TAMBACOUNDA,GOUDIRY,"BOYNGUEL BAMBA","SINTHIOU MAMADOU BOUBOU","SINTHIOU MAMADOU BOUBOU",30,42,362,433,795
TAMBACOUNDA,GOUDIRY,"BOYNGUEL BAMBA","SINTHIOU MAMADOU BOUBOU","H3 THIEKE",2,2,3,0,3
TAMBACOUNDA,GOUDIRY,"BOYNGUEL BAMBA","SINTHIOU MAMADOU BOUBOU","H5 YEREL",1,1,3,0,3
TAMBACOUNDA,GOUDIRY,"BOYNGUEL BAMBA","SINTHIOU MAMADOU BOUBOU","SINTHIOU OMAR HAVOYE",7,15,104,109,213
TAMBACOUNDA,GOUDIRY,"BOYNGUEL BAMBA","SINTHIOU MAMADOU BOUBOU","SINTHIOU OUMAR LILLE",5,12,82,69,151
TAMBACOUNDA,GOUDIRY,"BOYNGUEL BAMBA","SINTHIOU MAMADOU BOUBOU","SINTHIOU TAFSIROU",15,22,168,174,342
TAMBACOUNDA,GOUDIRY,"BOYNGUEL BAMBA","SINTHIOU MAMADOU BOUBOU",SOWOL,12,24,204,260,464
TAMBACOUNDA,GOUDIRY,"BOYNGUEL BAMBA","SINTHIOU MAMADOU BOUBOU","H1 RINKOU",3,3,21,10,31
TAMBACOUNDA,GOUDIRY,"BOYNGUEL BAMBA","SINTHIOU MAMADOU BOUBOU",THIASKY,15,21,254,189,443
TAMBACOUNDA,GOUDIRY,"BOYNGUEL BAMBA","SINTHIOU MAMADOU BOUBOU","THIEKE (SINTHIOU SALIF)",5,9,100,101,201
TAMBACOUNDA,GOUDIRY,"BOYNGUEL BAMBA","SINTHIOU MAMADOU BOUBOU",TOULEKEDE,18,29,294,238,532
TAMBACOUNDA,GOUDIRY,"BOYNGUEL BAMBA","SINTHIOU MAMADOU BOUBOU","VELINGARA (GOUREL THIAMMA)",3,6,68,55,123
TAMBACOUNDA,GOUDIRY,"BOYNGUEL BAMBA","SINTHIOU MAMADOU BOUBOU","WOYNDOU COLY",9,16,169,147,316
TAMBACOUNDA,GOUDIRY,"BOYNGUEL BAMBA","SINTHIOU MAMADOU BOUBOU",YAWOURODJI,11,23,169,154,323
TAMBACOUNDA,GOUDIRY,"BOYNGUEL BAMBA","SINTHIOU MAMADOU BOUBOU","H1 MADINA THIERNO",1,3,18,22,40
TAMBACOUNDA,GOUDIRY,"BOYNGUEL BAMBA","SINTHIOU MAMADOU BOUBOU","MADINA SAMBA CAMARA",3,3,25,22,47
TAMBACOUNDA,GOUDIRY,"BOYNGUEL BAMBA","SINTHIOU MAMADOU BOUBOU","WINNDE KAHE",7,12,120,122,242
TAMBACOUNDA,GOUDIRY,"BOYNGUEL BAMBA","SINTHIOU MAMADOU BOUBOU","HI DJIDA",5,6,64,55,119
TAMBACOUNDA,GOUDIRY,"DIANKE MAKHA","BANI ISRAEL","BANI ISRAEL",153,179,1269,1493,2762
TAMBACOUNDA,GOUDIRY,"DIANKE MAKHA","BANI ISRAEL","H1 KAMBAYA 1",2,2,9,5,14
TAMBACOUNDA,GOUDIRY,"DIANKE MAKHA","BANI ISRAEL","H5 BAGADADJI",1,1,6,5,11
TAMBACOUNDA,GOUDIRY,"DIANKE MAKHA","BANI ISRAEL","H7 KAMBAYA 2",4,4,47,56,103
TAMBACOUNDA,GOUDIRY,"DIANKE MAKHA","BANI ISRAEL",BANTANANI,24,47,386,414,800
TAMBACOUNDA,GOUDIRY,"DIANKE MAKHA","BANI ISRAEL","H1 FETTE BOKI",6,6,40,38,78
TAMBACOUNDA,GOUDIRY,"DIANKE MAKHA","BANI ISRAEL","H2 FÊTE CONDE",3,3,29,21,50
TAMBACOUNDA,GOUDIRY,"DIANKE MAKHA","BANI ISRAEL",DAKADOUNGAL,23,32,282,310,592
TAMBACOUNDA,GOUDIRY,"DIANKE MAKHA","BANI ISRAEL","DEMBA KOLI",16,22,111,117,228
TAMBACOUNDA,GOUDIRY,"DIANKE MAKHA","BANI ISRAEL",GADIALY,8,16,114,85,199
TAMBACOUNDA,GOUDIRY,"DIANKE MAKHA","BANI ISRAEL",GANGALY,7,9,83,66,149
TAMBACOUNDA,GOUDIRY,"DIANKE MAKHA","BANI ISRAEL","GOUREL BACHIROU (TALIYATOU)",4,8,86,73,159
TAMBACOUNDA,GOUDIRY,"DIANKE MAKHA","BANI ISRAEL","KEREVANE 5",9,13,96,104,200
TAMBACOUNDA,GOUDIRY,"DIANKE MAKHA","BANI ISRAEL",LONDON,20,27,164,147,311
TAMBACOUNDA,GOUDIRY,"DIANKE MAKHA","BANI ISRAEL","MEDINA DIAKHA",49,57,570,597,1167
TAMBACOUNDA,GOUDIRY,"DIANKE MAKHA","BANI ISRAEL","H7 KOLONGA",3,3,33,41,74
TAMBACOUNDA,GOUDIRY,"DIANKE MAKHA","BANI ISRAEL","H10 TALIKERE",1,1,4,9,13
TAMBACOUNDA,GOUDIRY,"DIANKE MAKHA","BANI ISRAEL","H13 FODE GOUGHOU",3,4,45,46,91
TAMBACOUNDA,GOUDIRY,"DIANKE MAKHA","BANI ISRAEL","H15 MADICOUMBAYA",2,2,17,18,35
TAMBACOUNDA,GOUDIRY,"DIANKE MAKHA","BANI ISRAEL","NGALAMBE (SINTHIOU DEMBA ALIOU)",2,5,41,42,83
TAMBACOUNDA,GOUDIRY,"DIANKE MAKHA","BANI ISRAEL","H1 SOUNATOU",2,2,16,21,37
TAMBACOUNDA,GOUDIRY,"DIANKE MAKHA","BANI ISRAEL",NIERY,29,33,363,324,687
TAMBACOUNDA,GOUDIRY,"DIANKE MAKHA","BANI ISRAEL","TALIKO FOULBE",12,13,125,148,273
TAMBACOUNDA,GOUDIRY,"DIANKE MAKHA","BANI ISRAEL","H1 SENO BAYA",2,4,73,57,130
TAMBACOUNDA,GOUDIRY,"DIANKE MAKHA","BANI ISRAEL",TAMBALA,17,19,156,160,316
TAMBACOUNDA,GOUDIRY,"DIANKE MAKHA","BANI ISRAEL","H1 GOUREL ILA",2,2,9,15,24
TAMBACOUNDA,GOUDIRY,"DIANKE MAKHA","BANI ISRAEL","H2 GOUREL HAMADY YERA",1,3,20,30,50
TAMBACOUNDA,GOUDIRY,"DIANKE MAKHA","BANI ISRAEL","H3 PARAVOL",2,2,8,7,15
TAMBACOUNDA,GOUDIRY,"DIANKE MAKHA","BANI ISRAEL","H4 GOUREL THIEDO",4,4,15,15,30
TAMBACOUNDA,GOUDIRY,"DIANKE MAKHA",BOUTOUCOUFARA,"BELY WAME DAKA",38,67,385,388,773
TAMBACOUNDA,GOUDIRY,"DIANKE MAKHA",BOUTOUCOUFARA,"BOUMBOUM CEBBES",15,26,251,272,523
TAMBACOUNDA,GOUDIRY,"DIANKE MAKHA",BOUTOUCOUFARA,"BOUMBOUM FOULBE",30,38,429,386,815
TAMBACOUNDA,GOUDIRY,"DIANKE MAKHA",BOUTOUCOUFARA,"H1 SINTHIOU MAMOUDOU",1,1,6,6,12
TAMBACOUNDA,GOUDIRY,"DIANKE MAKHA",BOUTOUCOUFARA,BOUTOUCOUFARA,57,85,648,669,1317
TAMBACOUNDA,GOUDIRY,"DIANKE MAKHA",BOUTOUCOUFARA,"DIATTA FITA",5,7,46,43,89
TAMBACOUNDA,GOUDIRY,"DIANKE MAKHA",BOUTOUCOUFARA,GALO,33,47,411,444,855
TAMBACOUNDA,GOUDIRY,"DIANKE MAKHA",BOUTOUCOUFARA,"GOUREL HAMADY",5,10,58,57,115
TAMBACOUNDA,GOUDIRY,"DIANKE MAKHA",BOUTOUCOUFARA,KAYAN,51,73,662,747,1409
TAMBACOUNDA,GOUDIRY,"DIANKE MAKHA",BOUTOUCOUFARA,"H1 INAKE",4,4,19,20,39
TAMBACOUNDA,GOUDIRY,"DIANKE MAKHA",BOUTOUCOUFARA,"H2 TAKOYA",1,1,1,0,1
TAMBACOUNDA,GOUDIRY,"DIANKE MAKHA",BOUTOUCOUFARA,KINDIMERY,22,34,197,202,399
TAMBACOUNDA,GOUDIRY,"DIANKE MAKHA",BOUTOUCOUFARA,KOUDOUSSOU,8,13,87,77,164
TAMBACOUNDA,GOUDIRY,"DIANKE MAKHA",BOUTOUCOUFARA,"MAREBA 1",5,10,54,43,97
TAMBACOUNDA,GOUDIRY,"DIANKE MAKHA",BOUTOUCOUFARA,"MAREBA 2",4,5,28,21,49
TAMBACOUNDA,GOUDIRY,"DIANKE MAKHA",BOUTOUCOUFARA,NGHONGHOYA,34,51,355,338,693
TAMBACOUNDA,GOUDIRY,"DIANKE MAKHA",BOUTOUCOUFARA,"SINTHIOU GALOYEL (GALOYA)",3,7,28,38,66
TAMBACOUNDA,GOUDIRY,"DIANKE MAKHA",BOUTOUCOUFARA,"SINTHIOU SALIF",18,29,187,148,335
TAMBACOUNDA,GOUDIRY,"DIANKE MAKHA",BOUTOUCOUFARA,TOUMBIMFARA,36,62,388,315,703
TAMBACOUNDA,GOUDIRY,"DIANKE MAKHA","DIANKE MAKHA","BELLY POURY",37,50,401,387,788
TAMBACOUNDA,GOUDIRY,"DIANKE MAKHA","DIANKE MAKHA",BOKOLAKHO,10,16,103,112,215
TAMBACOUNDA,GOUDIRY,"DIANKE MAKHA","DIANKE MAKHA",DALAFING,47,72,603,669,1272
TAMBACOUNDA,GOUDIRY,"DIANKE MAKHA","DIANKE MAKHA","DIANKE MAKHA",84,104,692,578,1270
TAMBACOUNDA,GOUDIRY,"DIANKE MAKHA","DIANKE MAKHA",FOULOUMBATOU,5,6,55,48,103
TAMBACOUNDA,GOUDIRY,"DIANKE MAKHA","DIANKE MAKHA","GOUTTA CEBBES",78,98,728,742,1470
TAMBACOUNDA,GOUDIRY,"DIANKE MAKHA","DIANKE MAKHA","H1 BODEYEL",1,1,5,0,5
TAMBACOUNDA,GOUDIRY,"DIANKE MAKHA","DIANKE MAKHA",KAVOYE,15,23,175,158,333
TAMBACOUNDA,GOUDIRY,"DIANKE MAKHA","DIANKE MAKHA","H1 SENO KAVOYE",4,12,66,50,116
TAMBACOUNDA,GOUDIRY,"DIANKE MAKHA","DIANKE MAKHA",KOTHIE,37,63,437,462,899
TAMBACOUNDA,GOUDIRY,"DIANKE MAKHA","DIANKE MAKHA","H1 GOUREL CHERIF",2,3,40,50,90
TAMBACOUNDA,GOUDIRY,"DIANKE MAKHA","DIANKE MAKHA","H2 GOUREL IBRAHIMA",1,3,37,39,76
TAMBACOUNDA,GOUDIRY,"DIANKE MAKHA","DIANKE MAKHA","H3 GOUREL SAMBA CISSSOKHO",1,3,22,27,49
TAMBACOUNDA,GOUDIRY,"DIANKE MAKHA","DIANKE MAKHA","H4 GOUREL SOUMAYE",3,4,42,28,70
TAMBACOUNDA,GOUDIRY,"DIANKE MAKHA","DIANKE MAKHA",KOTHIEYEL,9,24,157,159,316
TAMBACOUNDA,GOUDIRY,"DIANKE MAKHA","DIANKE MAKHA","H1 GOUREL FREBBE",4,4,31,33,64
TAMBACOUNDA,GOUDIRY,"DIANKE MAKHA","DIANKE MAKHA",KOUFADOU,23,29,217,170,387
TAMBACOUNDA,GOUDIRY,"DIANKE MAKHA","DIANKE MAKHA",LOUGUE,2,2,8,11,19
TAMBACOUNDA,GOUDIRY,"DIANKE MAKHA","DIANKE MAKHA",MARMACITA,20,24,184,214,398
TAMBACOUNDA,GOUDIRY,"DIANKE MAKHA","DIANKE MAKHA",MAYO,16,19,127,124,251
TAMBACOUNDA,GOUDIRY,"DIANKE MAKHA","DIANKE MAKHA","H1 GOUREL ISSA",1,1,2,0,2
TAMBACOUNDA,GOUDIRY,"DIANKE MAKHA","DIANKE MAKHA","MADINA KODIOLON",20,25,204,205,409
TAMBACOUNDA,GOUDIRY,"DIANKE MAKHA","DIANKE MAKHA",OUMBARE,20,31,146,111,257
TAMBACOUNDA,GOUDIRY,"DIANKE MAKHA","DIANKE MAKHA","SAME SORY DICKO",29,47,370,425,795
TAMBACOUNDA,GOUDIRY,"DIANKE MAKHA","DIANKE MAKHA","H1 THIEWEL",3,3,13,9,22
TAMBACOUNDA,GOUDIRY,"DIANKE MAKHA","DIANKE MAKHA","SENO BOBO",10,11,96,83,179
TAMBACOUNDA,GOUDIRY,"DIANKE MAKHA","DIANKE MAKHA","SENO DIANKE",22,24,171,221,392
TAMBACOUNDA,GOUDIRY,"DIANKE MAKHA","DIANKE MAKHA","SENO MODOU",1,3,12,6,18
TAMBACOUNDA,GOUDIRY,"DIANKE MAKHA","DIANKE MAKHA","SINTHIOU FODE",19,28,276,288,564
TAMBACOUNDA,GOUDIRY,"DIANKE MAKHA","DIANKE MAKHA",THIPPY,4,7,73,47,120
TAMBACOUNDA,GOUDIRY,"DIANKE MAKHA",KOMOTI,BAGADADJI,4,7,51,66,117
TAMBACOUNDA,GOUDIRY,"DIANKE MAKHA",KOMOTI,BANDIAGARA,7,8,58,30,88
TAMBACOUNDA,GOUDIRY,"DIANKE MAKHA",KOMOTI,"H1 GOUREL DABY",1,2,6,10,16
TAMBACOUNDA,GOUDIRY,"DIANKE MAKHA",KOMOTI,"H2 GOUREL NGATHIE",1,1,8,5,13
TAMBACOUNDA,GOUDIRY,"DIANKE MAKHA",KOMOTI,BERMA,6,12,65,70,135
TAMBACOUNDA,GOUDIRY,"DIANKE MAKHA",KOMOTI,BOKO,12,25,150,119,269
TAMBACOUNDA,GOUDIRY,"DIANKE MAKHA",KOMOTI,"H1 GOUREL MAYO",4,6,65,46,111
TAMBACOUNDA,GOUDIRY,"DIANKE MAKHA",KOMOTI,"H2 GOUREL SOULEYMANE",3,3,27,18,45
TAMBACOUNDA,GOUDIRY,"DIANKE MAKHA",KOMOTI,BOTOWOL,5,13,118,86,204
TAMBACOUNDA,GOUDIRY,"DIANKE MAKHA",KOMOTI,DARSALAM,14,25,98,97,195
TAMBACOUNDA,GOUDIRY,"DIANKE MAKHA",KOMOTI,DIAMWELI,5,7,34,30,64
TAMBACOUNDA,GOUDIRY,"DIANKE MAKHA",KOMOTI,"H1 GOUREL ABLAYE TARMESI",1,1,1,4,5
TAMBACOUNDA,GOUDIRY,"DIANKE MAKHA",KOMOTI,DIANA,88,104,882,976,1858
TAMBACOUNDA,GOUDIRY,"DIANKE MAKHA",KOMOTI,"H1 BAMBADINKA",5,6,46,54,100
TAMBACOUNDA,GOUDIRY,"DIANKE MAKHA",KOMOTI,"H2 KATELI 1",4,4,30,32,62
TAMBACOUNDA,GOUDIRY,"DIANKE MAKHA",KOMOTI,"H3 KATELI 2",2,2,10,8,18
TAMBACOUNDA,GOUDIRY,"DIANKE MAKHA",KOMOTI,"H4 KATELI 3",6,6,39,55,94
TAMBACOUNDA,GOUDIRY,"DIANKE MAKHA",KOMOTI,"H5 WOLOBIRITO 1",9,9,93,84,177
TAMBACOUNDA,GOUDIRY,"DIANKE MAKHA",KOMOTI,"H6 WOLOBIRITO 2",4,4,37,34,71
TAMBACOUNDA,GOUDIRY,"DIANKE MAKHA",KOMOTI,"H7 GOUREL DJIBY",1,1,4,12,16
TAMBACOUNDA,GOUDIRY,"DIANKE MAKHA",KOMOTI,"H8 SANGAKO",6,6,37,30,67
TAMBACOUNDA,GOUDIRY,"DIANKE MAKHA",KOMOTI,"H9 THEMASSOU",3,3,25,35,60
TAMBACOUNDA,GOUDIRY,"DIANKE MAKHA",KOMOTI,DIEYLANDING,9,9,74,125,199
TAMBACOUNDA,GOUDIRY,"DIANKE MAKHA",KOMOTI,"DIOUGOL CEBBE",14,15,142,144,286
TAMBACOUNDA,GOUDIRY,"DIANKE MAKHA",KOMOTI,"DIOUGOL FOULBES",9,13,72,79,151
TAMBACOUNDA,GOUDIRY,"DIANKE MAKHA",KOMOTI,DIYABOUGOU,7,10,51,55,106
TAMBACOUNDA,GOUDIRY,"DIANKE MAKHA",KOMOTI,FAYA,10,12,127,104,231
TAMBACOUNDA,GOUDIRY,"DIANKE MAKHA",KOMOTI,"GONDE SENY",15,21,108,113,221
TAMBACOUNDA,GOUDIRY,"DIANKE MAKHA",KOMOTI,"H1 NELBOUDALA 2",6,14,73,59,132
TAMBACOUNDA,GOUDIRY,"DIANKE MAKHA",KOMOTI,"H2 KOKOUMALA",5,8,40,44,84
TAMBACOUNDA,GOUDIRY,"DIANKE MAKHA",KOMOTI,"H3 GOUREL BARKA",6,9,41,29,70
TAMBACOUNDA,GOUDIRY,"DIANKE MAKHA",KOMOTI,"H4 GOUREL THIERNO",1,1,3,5,8
TAMBACOUNDA,GOUDIRY,"DIANKE MAKHA",KOMOTI,"H5 GOUREL LANDJI",1,3,20,21,41
TAMBACOUNDA,GOUDIRY,"DIANKE MAKHA",KOMOTI,"H6 KARAMATOU",1,1,46,17,63
TAMBACOUNDA,GOUDIRY,"DIANKE MAKHA",KOMOTI,HERIKO,3,5,59,61,120
TAMBACOUNDA,GOUDIRY,"DIANKE MAKHA",KOMOTI,KANIBA,11,19,201,240,441
TAMBACOUNDA,GOUDIRY,"DIANKE MAKHA",KOMOTI,"H1 GOUREL OUMAR DEMBA BA",1,1,16,10,26
TAMBACOUNDA,GOUDIRY,"DIANKE MAKHA",KOMOTI,"KENIE KENIEKO",19,33,186,183,369
TAMBACOUNDA,GOUDIRY,"DIANKE MAKHA",KOMOTI,"H1 GOUREL MAMADOU KEITA",1,1,4,7,11
TAMBACOUNDA,GOUDIRY,"DIANKE MAKHA",KOMOTI,"H2 GOUREL OUMAR SOW",1,1,7,12,19
TAMBACOUNDA,GOUDIRY,"DIANKE MAKHA",KOMOTI,"H3 GOUREL IBRAHIMA",1,1,6,4,10
TAMBACOUNDA,GOUDIRY,"DIANKE MAKHA",KOMOTI,KOMOTI,21,42,325,318,643
TAMBACOUNDA,GOUDIRY,"DIANKE MAKHA",KOMOTI,"H1 GOUREL SEYDOU",1,2,4,1,5
TAMBACOUNDA,GOUDIRY,"DIANKE MAKHA",KOMOTI,"H2 SAFALOU 1",2,4,17,15,32
TAMBACOUNDA,GOUDIRY,"DIANKE MAKHA",KOMOTI,"H3 GOUREL BOCAR",2,7,31,31,62
TAMBACOUNDA,GOUDIRY,"DIANKE MAKHA",KOMOTI,"H4 SAFALOU 2 / GOUREL BANIOU",1,1,11,2,13
TAMBACOUNDA,GOUDIRY,"DIANKE MAKHA",KOMOTI,"H5 BAMBADALA",1,18,87,71,158
TAMBACOUNDA,GOUDIRY,"DIANKE MAKHA",KOMOTI,"H6 PANANGOTO",4,5,39,33,72
TAMBACOUNDA,GOUDIRY,"DIANKE MAKHA",KOMOTI,"H7 GOUREL BAKARY",1,2,15,8,23
TAMBACOUNDA,GOUDIRY,"DIANKE MAKHA",KOMOTI,KONAYE,13,19,126,128,254
TAMBACOUNDA,GOUDIRY,"DIANKE MAKHA",KOMOTI,LOKOLOKO,6,9,99,81,180
TAMBACOUNDA,GOUDIRY,"DIANKE MAKHA",KOMOTI,"MEDINA THIANGOL",8,11,41,49,90
TAMBACOUNDA,GOUDIRY,"DIANKE MAKHA",KOMOTI,NEMA,5,5,58,81,139
TAMBACOUNDA,GOUDIRY,"DIANKE MAKHA",KOMOTI,"PENDA BOROVOL",6,10,61,43,104
TAMBACOUNDA,GOUDIRY,"DIANKE MAKHA",KOMOTI,"SAME CEBBE",24,30,247,263,510
TAMBACOUNDA,GOUDIRY,"DIANKE MAKHA",KOMOTI,"H1 BOULEL",8,11,77,104,181
TAMBACOUNDA,GOUDIRY,"DIANKE MAKHA",KOMOTI,SAROUDIA,23,25,197,174,371
TAMBACOUNDA,GOUDIRY,"DIANKE MAKHA",KOMOTI,"SENO BOBORAL",6,9,107,110,217
TAMBACOUNDA,GOUDIRY,"DIANKE MAKHA",KOMOTI,"SENO MOUSSA (SINTHIOU SEGA)",7,11,73,89,162
TAMBACOUNDA,GOUDIRY,"DIANKE MAKHA",KOMOTI,"SINTHIOU ALIOU (AINOUMADY)",6,7,57,54,111
TAMBACOUNDA,GOUDIRY,"DIANKE MAKHA",KOMOTI,"SINTHIOU AMADOU SALAM (BINGUEL)",36,79,366,345,711
TAMBACOUNDA,GOUDIRY,"DIANKE MAKHA",KOMOTI,"H1 MAREVA",3,8,53,60,113
TAMBACOUNDA,GOUDIRY,"DIANKE MAKHA",KOMOTI,"SINTHIOU MALAL",7,19,143,147,290
TAMBACOUNDA,GOUDIRY,"DIANKE MAKHA",KOMOTI,"SINTHIOU MAMADOU SAMBA",5,10,64,90,154
TAMBACOUNDA,GOUDIRY,"DIANKE MAKHA",KOMOTI,"H1 DJIPNE THIEWEL",10,17,85,72,157
TAMBACOUNDA,GOUDIRY,"DIANKE MAKHA",KOMOTI,SOUTOUBA,1,3,6,12,18
TAMBACOUNDA,GOUDIRY,"DIANKE MAKHA",KOMOTI,TABOTO,25,30,216,182,398
TAMBACOUNDA,GOUDIRY,"DIANKE MAKHA",KOMOTI,THIENEL,9,14,95,103,198
TAMBACOUNDA,GOUDIRY,"DIANKE MAKHA",KOMOTI,"H1 SENO DEMBA MBOUREL",2,7,35,30,65
TAMBACOUNDA,GOUDIRY,"DIANKE MAKHA",KOMOTI,"TOMBOUM KOMOTI",6,6,74,63,137
TAMBACOUNDA,GOUDIRY,"DIANKE MAKHA",KOMOTI,"H1 FETTE BOKI",2,2,17,14,31
TAMBACOUNDA,GOUDIRY,"DIANKE MAKHA",KOMOTI,"H2 FATOTO",4,4,39,23,62
TAMBACOUNDA,GOUDIRY,"DIANKE MAKHA",KOMOTI,"H3 DJIDA",4,4,18,22,40
TAMBACOUNDA,GOUDIRY,"DIANKE MAKHA",KOMOTI,"YERIMALE (GOUREL NDIOBO)",2,5,28,24,52
TAMBACOUNDA,GOUDIRY,"DIANKE MAKHA",KOMOTI,"H1 BIDA",2,4,13,11,24
TAMBACOUNDA,GOUDIRY,"DIANKE MAKHA",KOMOTI,"H2 SOUTOUKO",1,1,4,6,10
TAMBACOUNDA,GOUDIRY,"DIANKE MAKHA",KOMOTI,"H3 GOUREL MAKAM",1,4,12,7,19
TAMBACOUNDA,GOUDIRY,KOULOR,KOULOR,BANTAMBALY,15,24,146,134,280
TAMBACOUNDA,GOUDIRY,KOULOR,KOULOR,"BANTANGHEDJI (DJIDA)",19,24,113,115,228
TAMBACOUNDA,GOUDIRY,KOULOR,KOULOR,MBOKA,13,20,113,115,228
TAMBACOUNDA,GOUDIRY,KOULOR,KOULOR,CEFA,5,5,75,33,108
TAMBACOUNDA,GOUDIRY,KOULOR,KOULOR,"DAMAMBE (DAMAMBA)",25,38,266,256,522
TAMBACOUNDA,GOUDIRY,KOULOR,KOULOR,"H1 SINTHIOU AMATH DJIBY (VELINGARA)",7,8,41,41,82
TAMBACOUNDA,GOUDIRY,KOULOR,KOULOR,DAYTANGUEL,10,17,103,81,184
TAMBACOUNDA,GOUDIRY,KOULOR,KOULOR,"DIAMAGUENE (MAROVIE)",12,21,174,177,351
TAMBACOUNDA,GOUDIRY,KOULOR,KOULOR,"DIAMWELI DIALLO",5,6,85,92,177
TAMBACOUNDA,GOUDIRY,KOULOR,KOULOR,"DIARRE MABOUBE 1 (DIARE BOGUEL)",44,83,519,461,980
TAMBACOUNDA,GOUDIRY,KOULOR,KOULOR,"GAYE PARADJI 1",7,7,70,47,117
TAMBACOUNDA,GOUDIRY,KOULOR,KOULOR,"GAYE PARADJI 2",10,11,86,72,158
TAMBACOUNDA,GOUDIRY,KOULOR,KOULOR,"HAMDALAYE SENO",2,3,17,17,34
TAMBACOUNDA,GOUDIRY,KOULOR,KOULOR,"H1 SINTHIANE GALAYE",20,20,145,128,273
TAMBACOUNDA,GOUDIRY,KOULOR,KOULOR,"INAMOUSTAHINA (VERDOI)",4,6,37,38,75
TAMBACOUNDA,GOUDIRY,KOULOR,KOULOR,"KERKETE SAMBA CIRE (KERKETE LAOBE)",7,8,60,51,111
TAMBACOUNDA,GOUDIRY,KOULOR,KOULOR,KOULOR,129,168,1043,1039,2082
TAMBACOUNDA,GOUDIRY,KOULOR,KOULOR,"H1 DAROU WILANE",13,15,127,99,226
TAMBACOUNDA,GOUDIRY,KOULOR,KOULOR,"H2 DARSALAM",1,2,6,10,16
TAMBACOUNDA,GOUDIRY,KOULOR,KOULOR,LAMA,12,20,73,60,133
TAMBACOUNDA,GOUDIRY,KOULOR,KOULOR,"H1 GOUREL SAMBORDOU",4,8,26,25,51
TAMBACOUNDA,GOUDIRY,KOULOR,KOULOR,"H2 SINTHIOU YORO DIOP",1,3,13,9,22
TAMBACOUNDA,GOUDIRY,KOULOR,KOULOR,"MEDINA TOUAT",27,38,260,258,518
TAMBACOUNDA,GOUDIRY,KOULOR,KOULOR,MEREKOTO,7,14,62,61,123
TAMBACOUNDA,GOUDIRY,KOULOR,KOULOR,NDIABACK,15,19,123,114,237
TAMBACOUNDA,GOUDIRY,KOULOR,KOULOR,NDIOBENE,26,35,165,149,314
TAMBACOUNDA,GOUDIRY,KOULOR,KOULOR,"RABBIA (SIBIVORO)",32,41,262,263,525
TAMBACOUNDA,GOUDIRY,KOULOR,KOULOR,"H1 MEDINA LAOBE",8,12,116,100,216
TAMBACOUNDA,GOUDIRY,KOULOR,KOULOR,"SARE ISMA (FASS GOUNASS)",2,3,17,17,34
TAMBACOUNDA,GOUDIRY,KOULOR,KOULOR,"SARE NGHAYE (SARE BARKA)",22,29,194,182,376
TAMBACOUNDA,GOUDIRY,KOULOR,KOULOR,"SARE THIANA",4,8,27,27,54
TAMBACOUNDA,GOUDIRY,KOULOR,KOULOR,"SARE THIERNO",16,23,108,81,189
TAMBACOUNDA,GOUDIRY,KOULOR,KOULOR,"SINTHIOU AMATH ALI",9,17,89,77,166
TAMBACOUNDA,GOUDIRY,KOULOR,KOULOR,"H1 DAROU NEMA",6,10,54,59,113
TAMBACOUNDA,GOUDIRY,KOULOR,KOULOR,"H2 SINTHIOU DAMORO",2,4,24,24,48
TAMBACOUNDA,GOUDIRY,KOULOR,KOULOR,"SINTHIOU BARINABE",10,20,143,144,287
TAMBACOUNDA,GOUDIRY,KOULOR,KOULOR,"SINTHIOU BELE",23,29,180,183,363
TAMBACOUNDA,GOUDIRY,KOULOR,KOULOR,"SINTHIOU BOUGOUT DIOUF",21,37,184,249,433
TAMBACOUNDA,GOUDIRY,KOULOR,KOULOR,"H1 ALLAGUE THIAM",12,15,64,86,150
TAMBACOUNDA,GOUDIRY,KOULOR,KOULOR,"SINTHIOU DIAWBES I (CR ST BOCAR ALI)",18,32,196,184,380
TAMBACOUNDA,GOUDIRY,KOULOR,KOULOR,"H1 SINTHIOU OUMAR BA",1,3,10,15,25
TAMBACOUNDA,GOUDIRY,KOULOR,KOULOR,"SINTHIOU DIAWBES 2 (SINTHIOU OUMAR DIAM)",30,49,356,337,693
TAMBACOUNDA,GOUDIRY,KOULOR,KOULOR,"SINTHIOU MAMADOU NIAKOUROU",4,9,35,32,67
TAMBACOUNDA,GOUDIRY,KOULOR,KOULOR,"SINTHIOU NIBA DEMBA",6,12,56,57,113
TAMBACOUNDA,GOUDIRY,KOULOR,KOULOR,"SINTHIOU PATHE HAMADY",5,9,77,88,165
TAMBACOUNDA,GOUDIRY,KOULOR,KOULOR,"SINTHIOU SAMBA BOUBOU (OURO SAMBOUROU)",7,13,80,71,151
TAMBACOUNDA,GOUDIRY,KOULOR,KOULOR,"H1 DAYFA (GOUREL DEMBA BARRY)",3,6,28,26,54
TAMBACOUNDA,GOUDIRY,KOULOR,KOULOR,"SINTHIOU SAMBA SEYDOU",12,17,100,85,185
TAMBACOUNDA,GOUDIRY,KOULOR,KOULOR,"SINTHIOUYEL SINTHIOU (PARAWOL MABOUBE)",5,9,46,51,97
TAMBACOUNDA,GOUDIRY,KOULOR,KOULOR,"H1 LEWE",3,4,13,15,28
TAMBACOUNDA,GOUDIRY,KOULOR,KOULOR,TATA,18,27,141,144,285
TAMBACOUNDA,GOUDIRY,KOULOR,KOULOR,TAYBATOU,10,15,100,108,208
TAMBACOUNDA,GOUDIRY,KOULOR,KOULOR,THIOUROUCK,4,7,48,51,99
TAMBACOUNDA,GOUDIRY,KOULOR,KOULOR,"H1 SINTHIOU KEKOUTA",7,12,79,75,154
TAMBACOUNDA,GOUDIRY,KOULOR,KOULOR,"TOUBA KERKETE (KERKETE OUOLOF)",8,11,50,42,92
TAMBACOUNDA,GOUDIRY,KOULOR,KOULOR,"TOUBA NDIAGNENE",9,13,57,45,102
TAMBACOUNDA,GOUDIRY,KOULOR,KOULOR,"H1 MALSINE BOCAR",1,2,8,9,17
TAMBACOUNDA,GOUDIRY,KOULOR,KOULOR,"TOULDE KAHE",10,16,97,94,191
TAMBACOUNDA,GOUDIRY,KOULOR,KOULOR,"TOULDE THIOKOYE",2,7,24,18,42
TAMBACOUNDA,GOUDIRY,KOULOR,KOULOR,"H1 ALLALEWI",4,4,18,24,42
TAMBACOUNDA,GOUDIRY,KOULOR,KOULOR,VEREDOUBI,6,10,109,91,200
TAMBACOUNDA,GOUDIRY,KOULOR,KOULOR,"H1 MADINA FRESSE(GOUREL KALDIN)",2,3,14,15,29
TAMBACOUNDA,GOUDIRY,KOULOR,KOULOR,"WALI BABACAR",56,74,498,526,1024
TAMBACOUNDA,GOUDIRY,KOULOR,"SINTHIOU BOCAR ALY",BOKE,6,15,158,120,278
TAMBACOUNDA,GOUDIRY,KOULOR,"SINTHIOU BOCAR ALY",BOUYAGUE,7,16,57,47,104
TAMBACOUNDA,GOUDIRY,KOULOR,"SINTHIOU BOCAR ALY",DAHRA,12,21,101,109,210
TAMBACOUNDA,GOUDIRY,KOULOR,"SINTHIOU BOCAR ALY","H1 GOUREL KESSEL",1,2,17,18,35
TAMBACOUNDA,GOUDIRY,KOULOR,"SINTHIOU BOCAR ALY","DIARRE CEBBE",3,5,32,31,63
TAMBACOUNDA,GOUDIRY,KOULOR,"SINTHIOU BOCAR ALY",DINDEDJI,29,54,263,173,436
TAMBACOUNDA,GOUDIRY,KOULOR,"SINTHIOU BOCAR ALY","H1 BOGUE",4,10,60,43,103
TAMBACOUNDA,GOUDIRY,KOULOR,"SINTHIOU BOCAR ALY","H2 VELINGARA",9,10,58,49,107
TAMBACOUNDA,GOUDIRY,KOULOR,"SINTHIOU BOCAR ALY","H3 DIAMWELI",3,5,27,20,47
TAMBACOUNDA,GOUDIRY,KOULOR,"SINTHIOU BOCAR ALY","H4 LOUMBOUL YAYA",1,3,16,18,34
TAMBACOUNDA,GOUDIRY,KOULOR,"SINTHIOU BOCAR ALY","H5 LOUMBOUL SAMBA YABE",6,18,84,66,150
TAMBACOUNDA,GOUDIRY,KOULOR,"SINTHIOU BOCAR ALY","H6 WOURO OUSMANE COULIBALY",1,1,13,11,24
TAMBACOUNDA,GOUDIRY,KOULOR,"SINTHIOU BOCAR ALY",DOUROUNABE,3,4,24,37,61
TAMBACOUNDA,GOUDIRY,KOULOR,"SINTHIOU BOCAR ALY","H1 GOUREL WAYLOUBE",2,6,49,44,93
TAMBACOUNDA,GOUDIRY,KOULOR,"SINTHIOU BOCAR ALY","HAMDALAYE SAHETTE",7,11,47,42,89
TAMBACOUNDA,GOUDIRY,KOULOR,"SINTHIOU BOCAR ALY","H1 VELINGARA SAMBA GOULA",4,12,58,59,117
TAMBACOUNDA,GOUDIRY,KOULOR,"SINTHIOU BOCAR ALY",HONTORBE,13,18,99,88,187
TAMBACOUNDA,GOUDIRY,KOULOR,"SINTHIOU BOCAR ALY","H1 DAROU RAHMANE",1,2,9,13,22
TAMBACOUNDA,GOUDIRY,KOULOR,"SINTHIOU BOCAR ALY","H2 GOUREL YORO",2,4,23,24,47
TAMBACOUNDA,GOUDIRY,KOULOR,"SINTHIOU BOCAR ALY","H3 LOUMBI DIODO",1,1,7,5,12
TAMBACOUNDA,GOUDIRY,KOULOR,"SINTHIOU BOCAR ALY","H4 MADINA TERRY",1,2,46,29,75
TAMBACOUNDA,GOUDIRY,KOULOR,"SINTHIOU BOCAR ALY","H5 SENO DIAOBE",1,1,5,4,9
TAMBACOUNDA,GOUDIRY,KOULOR,"SINTHIOU BOCAR ALY","H6 THIANGOR CIRE",5,9,64,58,122
TAMBACOUNDA,GOUDIRY,KOULOR,"SINTHIOU BOCAR ALY",KAHEMBAL,1,2,9,7,16
TAMBACOUNDA,GOUDIRY,KOULOR,"SINTHIOU BOCAR ALY","H1 SITHIANE KAKHE",1,2,10,9,19
TAMBACOUNDA,GOUDIRY,KOULOR,"SINTHIOU BOCAR ALY",KALDEM,20,37,278,300,578
TAMBACOUNDA,GOUDIRY,KOULOR,"SINTHIOU BOCAR ALY","KOUNGALA GOREL",6,6,15,21,36
TAMBACOUNDA,GOUDIRY,KOULOR,"SINTHIOU BOCAR ALY","H1 GOUREL DEMBA SY",3,4,13,14,27
TAMBACOUNDA,GOUDIRY,KOULOR,"SINTHIOU BOCAR ALY",MADIE,28,49,428,367,795
TAMBACOUNDA,GOUDIRY,KOULOR,"SINTHIOU BOCAR ALY","H1 GODIOWEL",2,3,18,25,43
TAMBACOUNDA,GOUDIRY,KOULOR,"SINTHIOU BOCAR ALY","H2 GOUREL ADAMA",2,4,18,4,22
TAMBACOUNDA,GOUDIRY,KOULOR,"SINTHIOU BOCAR ALY","H3 MAYO LESSE",1,2,11,12,23
TAMBACOUNDA,GOUDIRY,KOULOR,"SINTHIOU BOCAR ALY","H4 MEDINA NDIAYBE",9,10,92,63,155
TAMBACOUNDA,GOUDIRY,KOULOR,"SINTHIOU BOCAR ALY","MADINA 2 (SINTHIOU DIALOUBE)",5,13,64,72,136
TAMBACOUNDA,GOUDIRY,KOULOR,"SINTHIOU BOCAR ALY","MALEME HAMADY SEYDI",9,13,59,62,121
TAMBACOUNDA,GOUDIRY,KOULOR,"SINTHIOU BOCAR ALY","H1 GOUREL THIERNO IBRAHIMA THIERNO SEYDOU LY",3,3,29,24,53
TAMBACOUNDA,GOUDIRY,KOULOR,"SINTHIOU BOCAR ALY","H2 WEINDOU MALAL",7,14,61,63,124
TAMBACOUNDA,GOUDIRY,KOULOR,"SINTHIOU BOCAR ALY","NEMA HAMADY DIOUM ( GOUREL LAOBE)",1,4,25,21,46
TAMBACOUNDA,GOUDIRY,KOULOR,"SINTHIOU BOCAR ALY","H1 GOUREL SAMBA SADIO",1,5,22,34,56
TAMBACOUNDA,GOUDIRY,KOULOR,"SINTHIOU BOCAR ALY",PANTHIANGHEDJI,21,40,213,179,392
TAMBACOUNDA,GOUDIRY,KOULOR,"SINTHIOU BOCAR ALY","H1 MAMADOU SOULEYE",5,22,126,106,232
TAMBACOUNDA,GOUDIRY,KOULOR,"SINTHIOU BOCAR ALY","H2 DAROU SALAM",2,3,32,29,61
TAMBACOUNDA,GOUDIRY,KOULOR,"SINTHIOU BOCAR ALY","H3 GOUREL MOUSSA",3,5,17,20,37
TAMBACOUNDA,GOUDIRY,KOULOR,"SINTHIOU BOCAR ALY","H4 SARE NDIOUGARI",1,5,48,29,77
TAMBACOUNDA,GOUDIRY,KOULOR,"SINTHIOU BOCAR ALY","H5 BOURQUE",3,4,31,21,52
TAMBACOUNDA,GOUDIRY,KOULOR,"SINTHIOU BOCAR ALY","H6 PANTHIANGHEDJI",2,2,11,16,27
TAMBACOUNDA,GOUDIRY,KOULOR,"SINTHIOU BOCAR ALY","H7 PARAWOL WOURO SADIBOU",1,1,8,4,12
TAMBACOUNDA,GOUDIRY,KOULOR,"SINTHIOU BOCAR ALY","H8 SENO DOUTE",2,4,24,24,48
TAMBACOUNDA,GOUDIRY,KOULOR,"SINTHIOU BOCAR ALY","H9 TOWGOO HAMIDOU DIOP",1,4,30,17,47
TAMBACOUNDA,GOUDIRY,KOULOR,"SINTHIOU BOCAR ALY","SINTHIOU BILALI 1",11,32,209,198,407
TAMBACOUNDA,GOUDIRY,KOULOR,"SINTHIOU BOCAR ALY","SINTHIOU BOCAR ALI",59,91,639,577,1216
TAMBACOUNDA,GOUDIRY,KOULOR,"SINTHIOU BOCAR ALY","H4 GOUREL DEMBA",1,3,9,9,18
TAMBACOUNDA,GOUDIRY,KOULOR,"SINTHIOU BOCAR ALY","H5 MADINA PATHE NDIAYE",1,2,9,10,19
TAMBACOUNDA,GOUDIRY,KOULOR,"SINTHIOU BOCAR ALY","SINTHIOU DIELY",17,29,210,131,341
TAMBACOUNDA,GOUDIRY,KOULOR,"SINTHIOU BOCAR ALY","SINTHIOU DOUBE AGABA (GOUREL AGA)",4,8,49,40,89
TAMBACOUNDA,GOUDIRY,KOULOR,"SINTHIOU BOCAR ALY","H1 GOUREL DIATA",2,7,33,40,73
TAMBACOUNDA,GOUDIRY,KOULOR,"SINTHIOU BOCAR ALY","SINTHIOU DOUBEL",6,11,59,46,105
TAMBACOUNDA,GOUDIRY,KOULOR,"SINTHIOU BOCAR ALY","SINTHIOU MABOUBE",11,16,115,116,231
TAMBACOUNDA,GOUDIRY,KOULOR,"SINTHIOU BOCAR ALY","H1 SINTHIOU BOUBOU",7,8,35,33,68
TAMBACOUNDA,GOUDIRY,KOULOR,"SINTHIOU BOCAR ALY","SINTHIOU NDIAYBE (GOUREL NDIAYBE)",11,18,114,109,223
TAMBACOUNDA,GOUDIRY,KOULOR,"SINTHIOU BOCAR ALY","H1 GOUREL PATHE",1,2,11,12,23
TAMBACOUNDA,GOUDIRY,KOULOR,"SINTHIOU BOCAR ALY","H2 SINTHIOU NDIAYEBE",2,4,30,37,67
TAMBACOUNDA,GOUDIRY,KOULOR,"SINTHIOU BOCAR ALY",THIODORBE,15,51,219,115,334
TAMBACOUNDA,GOUDIRY,KOULOR,"SINTHIOU BOCAR ALY","H1 GOUREL THIOUNE",4,9,27,20,47
TAMBACOUNDA,GOUDIRY,KOULOR,"SINTHIOU BOCAR ALY","H2 GOUREL DEMBA TERY",3,3,15,10,25
TAMBACOUNDA,GOUDIRY,KOULOR,KOTHIARY,ABATTOIRS,53,59,383,450,833
TAMBACOUNDA,GOUDIRY,KOULOR,KOTHIARY,CENTRE,65,84,521,536,1057
TAMBACOUNDA,GOUDIRY,KOULOR,KOTHIARY,DIAKHANKE,63,67,345,357,702
TAMBACOUNDA,GOUDIRY,KOULOR,KOTHIARY,EST,175,187,983,910,1893
TAMBACOUNDA,GOUDIRY,KOULOR,KOTHIARY,"GUINAW RAIL",101,110,432,384,816
TAMBACOUNDA,GOUDIRY,KOULOR,KOTHIARY,"HAMDALLAYE MOUSSA",15,21,226,191,417
TAMBACOUNDA,GOUDIRY,KOULOR,KOTHIARY,OUEST,24,30,184,185,369
TAMBACOUNDA,GOUDIRY,KOULOR,KOTHIARY,"SINTHIOU ALIOU SY (PONT)",8,8,37,33,70
TAMBACOUNDA,KOUPENTOUM,KOUMPENTOUM,KOUMPENTOUM,"ECOLE 1",127,151,707,800,1507
TAMBACOUNDA,KOUPENTOUM,KOUMPENTOUM,KOUMPENTOUM,"ECOLE 2 (TRAVAUX)",70,99,427,472,899
TAMBACOUNDA,KOUPENTOUM,KOUMPENTOUM,KOUMPENTOUM,"ESCALE 1",383,465,1953,1885,3838
TAMBACOUNDA,KOUPENTOUM,KOUMPENTOUM,KOUMPENTOUM,"ESCALE 2 (GUINAW RAIL)",124,148,743,691,1434
TAMBACOUNDA,KOUPENTOUM,KOUMPENTOUM,KOUMPENTOUM,"ESCALE 3",141,184,822,850,1672
TAMBACOUNDA,KOUPENTOUM,KOUMPENTOUM,KOUMPENTOUM,"ESCALE 4",253,284,1296,1307,2603
TAMBACOUNDA,KOUPENTOUM,KOUMPENTOUM,KOUMPENTOUM,"GRANDE VILLE 1",78,109,499,544,1043
TAMBACOUNDA,KOUPENTOUM,KOUMPENTOUM,KOUMPENTOUM,"GRANDE VILLE 2",66,81,512,536,1048
TAMBACOUNDA,KOUPENTOUM,KOUMPENTOUM,KOUMPENTOUM,"KOUMPENTOUM SOCE",38,43,232,208,440
TAMBACOUNDA,KOUPENTOUM,KOUMPENTOUM,KOUMPENTOUM,WASSADOU,105,131,668,571,1239
TAMBACOUNDA,KOUPENTOUM,"BAMBA THIALENE","BAMBA THIALENE",AINOUMANE,76,105,699,615,1314
TAMBACOUNDA,KOUPENTOUM,"BAMBA THIALENE","BAMBA THIALENE","BAMBA NDIAYENE (BAMBA THIALENE)",220,296,1775,1796,3571
TAMBACOUNDA,KOUPENTOUM,"BAMBA THIALENE","BAMBA THIALENE","DAROU NDIAWENE",109,132,853,789,1642
TAMBACOUNDA,KOUPENTOUM,"BAMBA THIALENE","BAMBA THIALENE","ELIHINA (KEUR THIERNO)",71,89,432,429,861
TAMBACOUNDA,KOUPENTOUM,"BAMBA THIALENE","BAMBA THIALENE","FASS NDIAYENE",45,62,496,386,882
TAMBACOUNDA,KOUPENTOUM,"BAMBA THIALENE","BAMBA THIALENE","FASS NDIMBELANE",85,104,635,580,1215
TAMBACOUNDA,KOUPENTOUM,"BAMBA THIALENE","BAMBA THIALENE","GOUBY GALAL",23,34,100,142,242
TAMBACOUNDA,KOUPENTOUM,"BAMBA THIALENE","BAMBA THIALENE",KISSANG,58,71,462,375,837
TAMBACOUNDA,KOUPENTOUM,"BAMBA THIALENE","BAMBA THIALENE",KOUNTOUATA,26,39,372,308,680
TAMBACOUNDA,KOUPENTOUM,"BAMBA THIALENE","BAMBA THIALENE",MASSEMBE,112,150,983,917,1900
TAMBACOUNDA,KOUPENTOUM,"BAMBA THIALENE","BAMBA THIALENE","MEDINA BISSY",31,47,264,266,530
TAMBACOUNDA,KOUPENTOUM,"BAMBA THIALENE","BAMBA THIALENE","MEDINA DADY KA",12,17,120,116,236
TAMBACOUNDA,KOUPENTOUM,"BAMBA THIALENE","BAMBA THIALENE","MEDINA THIALENE",30,39,289,255,544
TAMBACOUNDA,KOUPENTOUM,"BAMBA THIALENE","BAMBA THIALENE","H1 AEROPORT",2,3,22,20,42
TAMBACOUNDA,KOUPENTOUM,"BAMBA THIALENE","BAMBA THIALENE","MISSIRAH KOLONTO (KOLONTO)",76,125,686,720,1406
TAMBACOUNDA,KOUPENTOUM,"BAMBA THIALENE","BAMBA THIALENE","NDIAGNENE (SARE COLY)",17,25,137,124,261
TAMBACOUNDA,KOUPENTOUM,"BAMBA THIALENE","BAMBA THIALENE","NDIALAL SAMBA (YALA SAMBA)",8,11,56,47,103
TAMBACOUNDA,KOUPENTOUM,"BAMBA THIALENE","BAMBA THIALENE","NDIAWENE PEULH",13,20,130,113,243
TAMBACOUNDA,KOUPENTOUM,"BAMBA THIALENE","BAMBA THIALENE","NDIAYENE DIAM DIAM",145,183,954,1000,1954
TAMBACOUNDA,KOUPENTOUM,"BAMBA THIALENE","BAMBA THIALENE","H1 DIANDIOLY",7,8,45,22,67
TAMBACOUNDA,KOUPENTOUM,"BAMBA THIALENE","BAMBA THIALENE","SAM NGUEYENE",39,48,355,344,699
TAMBACOUNDA,KOUPENTOUM,"BAMBA THIALENE","BAMBA THIALENE","SARE ABDOULAYE",36,41,289,242,531
TAMBACOUNDA,KOUPENTOUM,"BAMBA THIALENE","BAMBA THIALENE","SARE DEMBA EGUE",17,40,189,191,380
TAMBACOUNDA,KOUPENTOUM,"BAMBA THIALENE","BAMBA THIALENE","TAOFEKH (VILLAGE XI)",57,66,479,464,943
TAMBACOUNDA,KOUPENTOUM,"BAMBA THIALENE","BAMBA THIALENE","VELINGARA DIAM DIAM",27,48,251,209,460
TAMBACOUNDA,KOUPENTOUM,"BAMBA THIALENE",KAHENE,BAITY,30,43,247,250,497
TAMBACOUNDA,KOUPENTOUM,"BAMBA THIALENE",KAHENE,"H1 DIALATODJI",14,20,120,126,246
TAMBACOUNDA,KOUPENTOUM,"BAMBA THIALENE",KAHENE,BOUP,39,44,258,209,467
TAMBACOUNDA,KOUPENTOUM,"BAMBA THIALENE",KAHENE,"BOUROUCOUNDA OUOLOF (NDIOBENE)",26,30,187,170,357
TAMBACOUNDA,KOUPENTOUM,"BAMBA THIALENE",KAHENE,"FADIYA TENING",16,17,105,62,167
TAMBACOUNDA,KOUPENTOUM,"BAMBA THIALENE",KAHENE,"FASS MBOYENE",8,16,109,102,211
TAMBACOUNDA,KOUPENTOUM,"BAMBA THIALENE",KAHENE,"H1 NIALING SENY",2,2,8,9,17
TAMBACOUNDA,KOUPENTOUM,"BAMBA THIALENE",KAHENE,KABA,238,312,2314,2541,4855
TAMBACOUNDA,KOUPENTOUM,"BAMBA THIALENE",KAHENE,KAHENE,102,133,743,677,1420
TAMBACOUNDA,KOUPENTOUM,"BAMBA THIALENE",KAHENE,KANOUMA,40,74,657,486,1143
TAMBACOUNDA,KOUPENTOUM,"BAMBA THIALENE",KAHENE,KANTA,131,157,1118,1063,2181
TAMBACOUNDA,KOUPENTOUM,"BAMBA THIALENE",KAHENE,"KAOUSSARA (VILLAGE 14)",58,62,338,278,616
TAMBACOUNDA,KOUPENTOUM,"BAMBA THIALENE",KAHENE,"KEUR SENY OUOLOF",16,18,97,77,174
TAMBACOUNDA,KOUPENTOUM,"BAMBA THIALENE",KAHENE,"KEUR SENY PEULH",10,18,110,101,211
TAMBACOUNDA,KOUPENTOUM,"BAMBA THIALENE",KAHENE,"H1 NDIAYENE SAMBA SOW",8,14,89,74,163
TAMBACOUNDA,KOUPENTOUM,"BAMBA THIALENE",KAHENE,KODIAM,16,19,118,90,208
TAMBACOUNDA,KOUPENTOUM,"BAMBA THIALENE",KAHENE,MBARO,28,40,196,185,381
TAMBACOUNDA,KOUPENTOUM,"BAMBA THIALENE",KAHENE,"MEDINA ABDOU (THIANKE)",15,22,161,126,287
TAMBACOUNDA,KOUPENTOUM,"BAMBA THIALENE",KAHENE,"MEDINA KANENE MALICK",57,111,804,654,1458
TAMBACOUNDA,KOUPENTOUM,"BAMBA THIALENE",KAHENE,"H1 SARE ALPHA",16,23,167,160,327
TAMBACOUNDA,KOUPENTOUM,"BAMBA THIALENE",KAHENE,"MEDINA THIECKENE (FADIYA)",21,24,139,121,260
TAMBACOUNDA,KOUPENTOUM,"BAMBA THIALENE",KAHENE,"MEDINA TOUATTES (TOULDE)",4,5,38,45,83
TAMBACOUNDA,KOUPENTOUM,"BAMBA THIALENE",KAHENE,"MISSIRAH THIARENE",63,91,585,577,1162
TAMBACOUNDA,KOUPENTOUM,"BAMBA THIALENE",KAHENE,"NDIOBENE 1 (MBOYE)",29,50,324,292,616
TAMBACOUNDA,KOUPENTOUM,"BAMBA THIALENE",KAHENE,"NDIOBENE 2",27,35,215,207,422
TAMBACOUNDA,KOUPENTOUM,"BAMBA THIALENE",KAHENE,"NGOUNTA BAMBA",9,20,96,73,169
TAMBACOUNDA,KOUPENTOUM,"BAMBA THIALENE",KAHENE,"H1 NGOUNTA NDIAYENE",2,5,18,27,45
TAMBACOUNDA,KOUPENTOUM,"BAMBA THIALENE",KAHENE,"H2 TAIF NIANI",7,7,55,50,105
TAMBACOUNDA,KOUPENTOUM,"BAMBA THIALENE",KAHENE,"NGOUNTA TOUCOULEUR",41,48,368,354,722
TAMBACOUNDA,KOUPENTOUM,"BAMBA THIALENE",KAHENE,"H1 SINTHIOU SOUMAYLA DIALLO",5,7,36,47,83
TAMBACOUNDA,KOUPENTOUM,"BAMBA THIALENE",KAHENE,NGUEYENE,28,32,192,195,387
TAMBACOUNDA,KOUPENTOUM,"BAMBA THIALENE",KAHENE,"SAM YABAL (VILLAGE 1)",18,21,120,124,244
TAMBACOUNDA,KOUPENTOUM,"BAMBA THIALENE",KAHENE,"SARE OKA (BOURONCOUNDA FOULBES)",8,8,63,45,108
TAMBACOUNDA,KOUPENTOUM,"BAMBA THIALENE",KAHENE,"SIINTHIOU ABDOU CISSE",12,19,81,77,158
TAMBACOUNDA,KOUPENTOUM,"BAMBA THIALENE",KAHENE,"SINTHIOU ABDOU CISSE",14,19,118,115,233
TAMBACOUNDA,KOUPENTOUM,"BAMBA THIALENE",KAHENE,"SINTHIOU DIOULDE (DEMBA KOUNDA)",10,15,89,79,168
TAMBACOUNDA,KOUPENTOUM,"BAMBA THIALENE",KAHENE,"SINTHIOU MANDAKH",19,34,149,127,276
TAMBACOUNDA,KOUPENTOUM,"BAMBA THIALENE",KAHENE,"SINTHIOU TABANANY",23,45,259,252,511
TAMBACOUNDA,KOUPENTOUM,"BAMBA THIALENE",KAHENE,"H1 SARE GNOUNKAROU",7,13,70,51,121
TAMBACOUNDA,KOUPENTOUM,"BAMBA THIALENE",KAHENE,TANEME,3,5,26,17,43
TAMBACOUNDA,KOUPENTOUM,"BAMBA THIALENE",KAHENE,"H1 SINTHIOU BOYE",4,7,40,29,69
TAMBACOUNDA,KOUPENTOUM,"BAMBA THIALENE",KAHENE,"H2 SINTHIOU NIOMENE",8,16,67,68,135
TAMBACOUNDA,KOUPENTOUM,"BAMBA THIALENE",KAHENE,TINKOLY,22,32,169,159,328
TAMBACOUNDA,KOUPENTOUM,"BAMBA THIALENE",KAHENE,"TIVAOUANE NIANI",50,53,337,369,706
TAMBACOUNDA,KOUPENTOUM,"BAMBA THIALENE",KAHENE,"SARE ABLAYE DIENG",1,1,12,14,26
TAMBACOUNDA,KOUPENTOUM,"BAMBA THIALENE",MERETO,"ABY SAMAOU",17,20,102,100,202
TAMBACOUNDA,KOUPENTOUM,"BAMBA THIALENE",MERETO,"DAROU FALL",108,130,659,564,1223
TAMBACOUNDA,KOUPENTOUM,"BAMBA THIALENE",MERETO,"DAROU SALOUM SAGUINE",3,4,35,15,50
TAMBACOUNDA,KOUPENTOUM,"BAMBA THIALENE",MERETO,"DIAGLE SINE",121,150,933,841,1774
TAMBACOUNDA,KOUPENTOUM,"BAMBA THIALENE",MERETO,FOULAKOULONG,108,127,735,689,1424
TAMBACOUNDA,KOUPENTOUM,"BAMBA THIALENE",MERETO,GALLE,93,112,527,486,1013
TAMBACOUNDA,KOUPENTOUM,"BAMBA THIALENE",MERETO,"KEUR DAOUDA",94,109,687,601,1288
TAMBACOUNDA,KOUPENTOUM,"BAMBA THIALENE",MERETO,KOUMARE,131,158,906,838,1744
TAMBACOUNDA,KOUPENTOUM,"BAMBA THIALENE",MERETO,"H1 KEUR ALY MANGANE",38,41,278,208,486
TAMBACOUNDA,KOUPENTOUM,"BAMBA THIALENE",MERETO,"KOUNDIAO NGUYA",13,26,110,77,187
TAMBACOUNDA,KOUPENTOUM,"BAMBA THIALENE",MERETO,"KOUNDIAO NIAKO",7,26,81,91,172
TAMBACOUNDA,KOUPENTOUM,"BAMBA THIALENE",MERETO,"KOUNDIAO SOUARE",33,51,247,216,463
TAMBACOUNDA,KOUPENTOUM,"BAMBA THIALENE",MERETO,"H1 SINTHIOU ALIOU BA",2,2,22,17,39
TAMBACOUNDA,KOUPENTOUM,"BAMBA THIALENE",MERETO,"KOUNDIAO YORO",13,30,152,120,272
TAMBACOUNDA,KOUPENTOUM,"BAMBA THIALENE",MERETO,MERETO,419,461,2415,2241,4656
TAMBACOUNDA,KOUPENTOUM,"BAMBA THIALENE",MERETO,"H1 DIAMWELY",2,2,7,7,14
TAMBACOUNDA,KOUPENTOUM,"BAMBA THIALENE",MERETO,NDIAMBOUR,33,58,402,425,827
TAMBACOUNDA,KOUPENTOUM,"BAMBA THIALENE",MERETO,"PARAMPAMPY 1 (DAGA)",6,13,71,58,129
TAMBACOUNDA,KOUPENTOUM,"BAMBA THIALENE",MERETO,"PARAMPAMPY 2",3,10,40,33,73
TAMBACOUNDA,KOUPENTOUM,"BAMBA THIALENE",MERETO,"TOUBA MEDINA FALL",4,4,13,9,22
TAMBACOUNDA,KOUPENTOUM,"BAMBA THIALENE",MERETO,"TOUBA SENE",13,13,73,34,107
TAMBACOUNDA,KOUPENTOUM,"BAMBA THIALENE",MERETO,"TOUBA SINE",93,107,628,520,1148
TAMBACOUNDA,KOUPENTOUM,"BAMBA THIALENE",MERETO,"TOUBA TAWFEKH",17,19,144,89,233
TAMBACOUNDA,KOUPENTOUM,"BAMBA THIALENE",NDAME,"BOBA DIADIE BA (BOBA FOULBES)",10,13,77,58,135
TAMBACOUNDA,KOUPENTOUM,"BAMBA THIALENE",NDAME,"BOULEL PEULH",17,36,189,201,390
TAMBACOUNDA,KOUPENTOUM,"BAMBA THIALENE",NDAME,"BOUSSOURA IV",23,28,148,158,306
TAMBACOUNDA,KOUPENTOUM,"BAMBA THIALENE",NDAME,"DAROU NDIMBELANE (BARKEVEL BERETE)",67,81,438,416,854
TAMBACOUNDA,KOUPENTOUM,"BAMBA THIALENE",NDAME,"DAROU SALAM SINE 2",124,158,911,839,1750
TAMBACOUNDA,KOUPENTOUM,"BAMBA THIALENE",NDAME,"DAROU SALAM THIECKENE",19,22,158,201,359
TAMBACOUNDA,KOUPENTOUM,"BAMBA THIALENE",NDAME,"DAROU THIECKENE (SINTHIOU NDAME)",7,12,75,85,160
TAMBACOUNDA,KOUPENTOUM,"BAMBA THIALENE",NDAME,"DIOKOUL (DIOKOUL THIEKENE)",48,58,251,247,498
TAMBACOUNDA,KOUPENTOUM,"BAMBA THIALENE",NDAME,"H1 KEUR GAYEL",6,28,105,116,221
TAMBACOUNDA,KOUPENTOUM,"BAMBA THIALENE",NDAME,"FASS GOUNASS",234,326,1926,1851,3777
TAMBACOUNDA,KOUPENTOUM,"BAMBA THIALENE",NDAME,"H1 DAARA ABI SABAKHOUNE (FASS GOUNASS)",1,2,48,2,50
TAMBACOUNDA,KOUPENTOUM,"BAMBA THIALENE",NDAME,"FASS NDAWENE (KEUR AMADY YACINE)",13,25,144,139,283
TAMBACOUNDA,KOUPENTOUM,"BAMBA THIALENE",NDAME,GOUNDIOUR,22,25,145,124,269
TAMBACOUNDA,KOUPENTOUM,"BAMBA THIALENE",NDAME,"KEUR GUIRANE (NIANINKOYE)",13,19,102,100,202
TAMBACOUNDA,KOUPENTOUM,"BAMBA THIALENE",NDAME,"MADINA BAMBARA",43,54,271,220,491
TAMBACOUNDA,KOUPENTOUM,"BAMBA THIALENE",NDAME,"MEDINA NDIOBENE (KIPP BABA)",31,40,193,170,363
TAMBACOUNDA,KOUPENTOUM,"BAMBA THIALENE",NDAME,NDAME,34,37,191,174,365
TAMBACOUNDA,KOUPENTOUM,"BAMBA THIALENE",NDAME,"NDOUMANE MBAYE",31,43,307,313,620
TAMBACOUNDA,KOUPENTOUM,"BAMBA THIALENE",NDAME,"H1 NDOUMANE 2 (NDOUMANE MBAYE)",1,2,13,29,42
TAMBACOUNDA,KOUPENTOUM,"BAMBA THIALENE",NDAME,"NGUEYENE (BARKAWEL)",31,46,218,209,427
TAMBACOUNDA,KOUPENTOUM,"BAMBA THIALENE",NDAME,"SARE PATHE",5,6,27,28,55
TAMBACOUNDA,KOUPENTOUM,"BAMBA THIALENE",NDAME,"SARE SADIO",8,14,66,78,144
TAMBACOUNDA,KOUPENTOUM,"BAMBA THIALENE",NDAME,"SINTHIOU DOKY",25,45,220,199,419
TAMBACOUNDA,KOUPENTOUM,"BAMBA THIALENE",NDAME,"SINTHIOU GOUNDIOUR",22,30,170,151,321
TAMBACOUNDA,KOUPENTOUM,"BAMBA THIALENE",NDAME,"SINTHIOU MBALBE",32,39,230,211,441
TAMBACOUNDA,KOUPENTOUM,"BAMBA THIALENE",NDAME,THORINGUEL,23,29,168,152,320
TAMBACOUNDA,KOUPENTOUM,"BAMBA THIALENE",NDAME,"TOUBA NIANI",29,34,179,136,315
TAMBACOUNDA,KOUPENTOUM,"BAMBA THIALENE",NDAME,"H2 SARE LAMINE BA (FASS GOUNASS)",1,1,6,5,11
TAMBACOUNDA,KOUPENTOUM,"BAMBA THIALENE",NDAME,"H2 TOUBA FASS (TOUBA NIANI)",1,1,2,6,8
TAMBACOUNDA,KOUPENTOUM,"BAMBA THIALENE",NDAME,"TOUBA SAM SAM",19,25,99,84,183
TAMBACOUNDA,KOUPENTOUM,"BAMBA THIALENE",NDAME,"TOUBA THIAMENE (BOBA DIOFOULBES)",51,62,274,242,516
TAMBACOUNDA,KOUPENTOUM,"KOUTHIABA WOLOF","KOUTHIA GUAYDI",BANDIAGARA,23,43,213,216,429
TAMBACOUNDA,KOUPENTOUM,"KOUTHIABA WOLOF","KOUTHIA GUAYDI","H1 GALLE HAMADY OUSMANE BA",4,6,20,24,44
TAMBACOUNDA,KOUPENTOUM,"KOUTHIABA WOLOF","KOUTHIA GUAYDI","H2 SINTHIOU BANDIAGARA",2,2,4,11,15
TAMBACOUNDA,KOUPENTOUM,"KOUTHIABA WOLOF","KOUTHIA GUAYDI","H3 GOUREL HAMA DIALLO",1,2,18,11,29
TAMBACOUNDA,KOUPENTOUM,"KOUTHIABA WOLOF","KOUTHIA GUAYDI","H4 WOURO DEMBOYE",4,8,45,40,85
TAMBACOUNDA,KOUPENTOUM,"KOUTHIABA WOLOF","KOUTHIA GUAYDI","H5 WOURO RISSA",1,16,34,31,65
TAMBACOUNDA,KOUPENTOUM,"KOUTHIABA WOLOF","KOUTHIA GUAYDI",BOUDOUCK,37,70,396,374,770
TAMBACOUNDA,KOUPENTOUM,"KOUTHIABA WOLOF","KOUTHIA GUAYDI","H1 SARE BAMBO",3,14,34,36,70
TAMBACOUNDA,KOUPENTOUM,"KOUTHIABA WOLOF","KOUTHIA GUAYDI","H2 SARE HAMAT",3,11,31,24,55
TAMBACOUNDA,KOUPENTOUM,"KOUTHIABA WOLOF","KOUTHIA GUAYDI","H3 THIEWEL",1,6,17,12,29
TAMBACOUNDA,KOUPENTOUM,"KOUTHIABA WOLOF","KOUTHIA GUAYDI","H4 GOUREL NGODY",6,21,71,90,161
TAMBACOUNDA,KOUPENTOUM,"KOUTHIABA WOLOF","KOUTHIA GUAYDI","H5 GOUREL SAMBEL",5,12,41,34,75
TAMBACOUNDA,KOUPENTOUM,"KOUTHIABA WOLOF","KOUTHIA GUAYDI","H6 WENDOU BIABY",6,22,58,49,107
TAMBACOUNDA,KOUPENTOUM,"KOUTHIABA WOLOF","KOUTHIA GUAYDI","H7 WOURO KALIDOU",4,12,41,28,69
TAMBACOUNDA,KOUPENTOUM,"KOUTHIABA WOLOF","KOUTHIA GUAYDI","H8 WOURO SIDEL(WARRY)",1,11,28,34,62
TAMBACOUNDA,KOUPENTOUM,"KOUTHIABA WOLOF","KOUTHIA GUAYDI","H9 WOURO THIERNO MANSOUR",5,14,59,44,103
TAMBACOUNDA,KOUPENTOUM,"KOUTHIABA WOLOF","KOUTHIA GUAYDI","BOULIMANGA MANDINGUE",52,69,383,358,741
TAMBACOUNDA,KOUPENTOUM,"KOUTHIABA WOLOF","KOUTHIA GUAYDI",KAHAL,14,35,113,139,252
TAMBACOUNDA,KOUPENTOUM,"KOUTHIABA WOLOF","KOUTHIA GUAYDI","H1 WOURO DEMBA SOUKI",4,30,66,64,130
TAMBACOUNDA,KOUPENTOUM,"KOUTHIABA WOLOF","KOUTHIA GUAYDI","KOUTHIA GAYDI",142,220,1424,1295,2719
TAMBACOUNDA,KOUPENTOUM,"KOUTHIABA WOLOF","KOUTHIA GUAYDI","MEDINA WAMBABE (THIANGUEL)",9,42,84,79,163
TAMBACOUNDA,KOUPENTOUM,"KOUTHIABA WOLOF","KOUTHIA GUAYDI",NDAYAR,40,66,283,288,571
TAMBACOUNDA,KOUPENTOUM,"KOUTHIABA WOLOF","KOUTHIA GUAYDI","H1 BELEL MOUSSA BA",10,16,60,57,117
TAMBACOUNDA,KOUPENTOUM,"KOUTHIABA WOLOF","KOUTHIA GUAYDI","H2 PETEL HEINDE",4,10,50,44,94
TAMBACOUNDA,KOUPENTOUM,"KOUTHIABA WOLOF","KOUTHIA GUAYDI","H3 WENDOU SENO",6,16,58,47,105
TAMBACOUNDA,KOUPENTOUM,"KOUTHIABA WOLOF","KOUTHIA GUAYDI","PASS TOROBE (BITNGUEL)",12,30,187,139,326
TAMBACOUNDA,KOUPENTOUM,"KOUTHIABA WOLOF","KOUTHIA GUAYDI","H1 GOUREL MAMADOU",2,5,24,17,41
TAMBACOUNDA,KOUPENTOUM,"KOUTHIABA WOLOF","KOUTHIA GUAYDI","PATOULANE NDIOBENE",29,40,290,127,417
TAMBACOUNDA,KOUPENTOUM,"KOUTHIABA WOLOF","KOUTHIA GUAYDI","PETEL LINGUEDIE",10,14,63,66,129
TAMBACOUNDA,KOUPENTOUM,"KOUTHIABA WOLOF","KOUTHIA GUAYDI","PIRE GOUNDO (SINTHIOU GOUNDO)",34,43,303,225,528
TAMBACOUNDA,KOUPENTOUM,"KOUTHIABA WOLOF","KOUTHIA GUAYDI","PIRE MBARA",30,50,227,196,423
TAMBACOUNDA,KOUPENTOUM,"KOUTHIABA WOLOF","KOUTHIA GUAYDI","H1 SINTHIOU AMIDOU DIALLO",9,24,105,98,203
TAMBACOUNDA,KOUPENTOUM,"KOUTHIABA WOLOF","KOUTHIA GUAYDI","H2 SINTHIOU YORO DEME",4,7,45,36,81
TAMBACOUNDA,KOUPENTOUM,"KOUTHIABA WOLOF","KOUTHIA GUAYDI","SARE BAMOL (SARE SOCE)",90,129,544,465,1009
TAMBACOUNDA,KOUPENTOUM,"KOUTHIABA WOLOF","KOUTHIA GUAYDI","SARE BOCAR",3,6,32,24,56
TAMBACOUNDA,KOUPENTOUM,"KOUTHIABA WOLOF","KOUTHIA GUAYDI","H1 SINTHIOU WEYANE",2,4,18,13,31
TAMBACOUNDA,KOUPENTOUM,"KOUTHIABA WOLOF","KOUTHIA GUAYDI","H2 LAMOUGUEL",5,12,57,58,115
TAMBACOUNDA,KOUPENTOUM,"KOUTHIABA WOLOF","KOUTHIA GUAYDI","SARE BOURANG (WOURO BOURANG)",8,9,73,76,149
TAMBACOUNDA,KOUPENTOUM,"KOUTHIABA WOLOF","KOUTHIA GUAYDI","H1 GOUREL HAMA",2,6,25,28,53
TAMBACOUNDA,KOUPENTOUM,"KOUTHIABA WOLOF","KOUTHIA GUAYDI","SARE HAMADY (SARE HAMADY LOFFE 1)",19,59,200,156,356
TAMBACOUNDA,KOUPENTOUM,"KOUTHIABA WOLOF","KOUTHIA GUAYDI","H1 KADIOLA",20,41,145,135,280
TAMBACOUNDA,KOUPENTOUM,"KOUTHIABA WOLOF","KOUTHIA GUAYDI","H2 PALOL",4,6,35,20,55
TAMBACOUNDA,KOUPENTOUM,"KOUTHIABA WOLOF","KOUTHIA GUAYDI","H3 DIALAMBANDY",3,4,14,21,35
TAMBACOUNDA,KOUPENTOUM,"KOUTHIABA WOLOF","KOUTHIA GUAYDI","H4 DIAMWELI",6,21,82,67,149
TAMBACOUNDA,KOUPENTOUM,"KOUTHIABA WOLOF","KOUTHIA GUAYDI","SARE SIKOUNA 2",64,87,561,490,1051
TAMBACOUNDA,KOUPENTOUM,"KOUTHIABA WOLOF","KOUTHIA GUAYDI","H1 SARE BIRANE",5,9,36,34,70
TAMBACOUNDA,KOUPENTOUM,"KOUTHIABA WOLOF","KOUTHIA GUAYDI","H2 SARE LIGUEL",5,18,67,65,132
TAMBACOUNDA,KOUPENTOUM,"KOUTHIABA WOLOF","KOUTHIA GUAYDI",SEMBANE,9,14,82,73,155
TAMBACOUNDA,KOUPENTOUM,"KOUTHIABA WOLOF","KOUTHIA GUAYDI","SINTHIOU ALY NDIAYE",6,18,45,43,88
TAMBACOUNDA,KOUPENTOUM,"KOUTHIABA WOLOF","KOUTHIA GUAYDI","H1 DIANDALA",4,4,22,24,46
TAMBACOUNDA,KOUPENTOUM,"KOUTHIABA WOLOF","KOUTHIA GUAYDI","H2 SINTHIOU OMAR NDIAYE",6,25,93,74,167
TAMBACOUNDA,KOUPENTOUM,"KOUTHIABA WOLOF","KOUTHIA GUAYDI","H3 SARE DIOULA",4,9,28,15,43
TAMBACOUNDA,KOUPENTOUM,"KOUTHIABA WOLOF","KOUTHIA GUAYDI","H4 WENDOKY",3,16,26,20,46
TAMBACOUNDA,KOUPENTOUM,"KOUTHIABA WOLOF","KOUTHIA GUAYDI","H5 SINTHIOU ALY BEYE",5,11,33,29,62
TAMBACOUNDA,KOUPENTOUM,"KOUTHIABA WOLOF","KOUTHIA GUAYDI","SINTHIOU BOULIMANGA (SINTHIOU NDENE NDAO)",39,65,392,460,852
TAMBACOUNDA,KOUPENTOUM,"KOUTHIABA WOLOF","KOUTHIA GUAYDI","SINTHIOU HAMADY SENO (LOFFE II)",29,169,369,298,667
TAMBACOUNDA,KOUPENTOUM,"KOUTHIABA WOLOF","KOUTHIA GUAYDI","H1 SARE FARBA",5,16,37,44,81
TAMBACOUNDA,KOUPENTOUM,"KOUTHIABA WOLOF","KOUTHIA GUAYDI","SINTHIOU SAMBA DEME BOGAL (LOUGUERE)",21,78,312,309,621
TAMBACOUNDA,KOUPENTOUM,"KOUTHIABA WOLOF","KOUTHIA GUAYDI","VELINGARA GUINTHE (VELINGARA SARE DIOP)",39,41,239,112,351
TAMBACOUNDA,KOUPENTOUM,"KOUTHIABA WOLOF","KOUTHIA GUAYDI","WENDOU DOULOUP",21,80,179,149,328
TAMBACOUNDA,KOUPENTOUM,"KOUTHIABA WOLOF","KOUTHIA GUAYDI","WENDOU KOULE (GOUREL KOULE)",13,22,92,84,176
TAMBACOUNDA,KOUPENTOUM,"KOUTHIABA WOLOF","KOUTHIA GUAYDI","H1 SINTHIOU SOUMAILA",7,11,40,48,88
TAMBACOUNDA,KOUPENTOUM,"KOUTHIABA WOLOF","KOUTHIA GUAYDI","H2 GOUREL YIGO",15,22,107,95,202
TAMBACOUNDA,KOUPENTOUM,"KOUTHIABA WOLOF","KOUTHIA GUAYDI","H3 GOUREL NDITY",5,12,46,47,93
TAMBACOUNDA,KOUPENTOUM,"KOUTHIABA WOLOF","KOUTHIA GUAYDI","WOURO ABDOULAYE",5,24,55,47,102
TAMBACOUNDA,KOUPENTOUM,"KOUTHIABA WOLOF","KOUTHIA GUAYDI","H1 GOUREL KALIDOU",4,18,47,39,86
TAMBACOUNDA,KOUPENTOUM,"KOUTHIABA WOLOF","KOUTHIA GUAYDI","H2 GOUREL YORO",1,3,15,22,37
TAMBACOUNDA,KOUPENTOUM,"KOUTHIABA WOLOF","KOUTHIA GUAYDI","H3 GOGOR",2,18,41,34,75
TAMBACOUNDA,KOUPENTOUM,"KOUTHIABA WOLOF","KOUTHIA GUAYDI","KOUTHIAYEL FOULBES (SINTHIOU SAMBA YABE)",16,33,140,162,302
TAMBACOUNDA,KOUPENTOUM,"KOUTHIABA WOLOF","KOUTHIA GUAYDI","H1 SINTHIOU KOUTHIAYEL",2,2,26,28,54
TAMBACOUNDA,KOUPENTOUM,"KOUTHIABA WOLOF","KOUTHIABA WOLOF","BALL MAYATA",12,16,87,78,165
TAMBACOUNDA,KOUPENTOUM,"KOUTHIABA WOLOF","KOUTHIABA WOLOF","H1 MEDINA MOUNAWARA",4,6,16,14,30
TAMBACOUNDA,KOUPENTOUM,"KOUTHIABA WOLOF","KOUTHIABA WOLOF","BALL MAYATA TAMPAYE",20,47,226,188,414
TAMBACOUNDA,KOUPENTOUM,"KOUTHIABA WOLOF","KOUTHIABA WOLOF","H1 SARE DIABEL",5,6,34,22,56
TAMBACOUNDA,KOUPENTOUM,"KOUTHIABA WOLOF","KOUTHIABA WOLOF","BALL MBASSOU",5,8,40,38,78
TAMBACOUNDA,KOUPENTOUM,"KOUTHIABA WOLOF","KOUTHIABA WOLOF","H1 SARE YORO",5,11,35,34,69
TAMBACOUNDA,KOUPENTOUM,"KOUTHIABA WOLOF","KOUTHIABA WOLOF","BALL OUOLOF",40,56,289,250,539
TAMBACOUNDA,KOUPENTOUM,"KOUTHIABA WOLOF","KOUTHIABA WOLOF","BANTANGUEL OUOLOF (SINTHIOU DIADJI)",25,33,124,122,246
TAMBACOUNDA,KOUPENTOUM,"KOUTHIABA WOLOF","KOUTHIABA WOLOF","BANTANGUEL PEULH 1",27,68,369,313,682
TAMBACOUNDA,KOUPENTOUM,"KOUTHIABA WOLOF","KOUTHIABA WOLOF","BITNGUEL (LEWE)",19,32,145,130,275
TAMBACOUNDA,KOUPENTOUM,"KOUTHIABA WOLOF","KOUTHIABA WOLOF","BOULINMANGA PEULH 2",27,71,231,226,457
TAMBACOUNDA,KOUPENTOUM,"KOUTHIABA WOLOF","KOUTHIABA WOLOF",BOUSTANE,42,45,258,250,508
TAMBACOUNDA,KOUPENTOUM,"KOUTHIABA WOLOF","KOUTHIABA WOLOF","BOYNGUAL DADY",33,79,397,352,749
TAMBACOUNDA,KOUPENTOUM,"KOUTHIABA WOLOF","KOUTHIABA WOLOF","DAROU KHADIM (SINTHIOU SALIOU)",30,46,263,252,515
TAMBACOUNDA,KOUPENTOUM,"KOUTHIABA WOLOF","KOUTHIABA WOLOF","H1 DAROU KHADIM(TOUBA BELEL)",1,1,42,8,50
TAMBACOUNDA,KOUPENTOUM,"KOUTHIABA WOLOF","KOUTHIABA WOLOF","DAROU NDIAYENE",37,41,281,266,547
TAMBACOUNDA,KOUPENTOUM,"KOUTHIABA WOLOF","KOUTHIABA WOLOF","H1 DAROU KHOUDOSS",5,8,49,43,92
TAMBACOUNDA,KOUPENTOUM,"KOUTHIABA WOLOF","KOUTHIABA WOLOF","H2 MORODJE PATHE",3,10,23,22,45
TAMBACOUNDA,KOUPENTOUM,"KOUTHIABA WOLOF","KOUTHIABA WOLOF","DAROU SALAM THIEKENE",43,53,234,188,422
TAMBACOUNDA,KOUPENTOUM,"KOUTHIABA WOLOF","KOUTHIABA WOLOF","DIAMAGUENE (SINTHIOU EL HADJI AMATH DADO)",23,36,160,95,255
TAMBACOUNDA,KOUPENTOUM,"KOUTHIABA WOLOF","KOUTHIABA WOLOF","FASS THIEKENE",32,45,235,205,440
TAMBACOUNDA,KOUPENTOUM,"KOUTHIABA WOLOF","KOUTHIABA WOLOF","H1 LOUMBOL ALY SECK",8,18,54,54,108
TAMBACOUNDA,KOUPENTOUM,"KOUTHIABA WOLOF","KOUTHIABA WOLOF",GAWANE,29,56,305,263,568
TAMBACOUNDA,KOUPENTOUM,"KOUTHIABA WOLOF","KOUTHIABA WOLOF","KAHENE PEULH (KAHENE DOUNDOU)",5,13,64,63,127
TAMBACOUNDA,KOUPENTOUM,"KOUTHIABA WOLOF","KOUTHIABA WOLOF","KEUR NDONGO",29,40,205,170,375
TAMBACOUNDA,KOUPENTOUM,"KOUTHIABA WOLOF","KOUTHIABA WOLOF","H1 RAWDATOU",14,17,158,111,269
TAMBACOUNDA,KOUPENTOUM,"KOUTHIABA WOLOF","KOUTHIABA WOLOF","KEUR PATHE",23,32,169,194,363
TAMBACOUNDA,KOUPENTOUM,"KOUTHIABA WOLOF","KOUTHIABA WOLOF","KOUKOUYEL OUOLOF (HAMDALAYE)",22,23,135,136,271
TAMBACOUNDA,KOUPENTOUM,"KOUTHIABA WOLOF","KOUTHIABA WOLOF","KOUKOUYEL PEULH",31,59,350,227,577
TAMBACOUNDA,KOUPENTOUM,"KOUTHIABA WOLOF","KOUTHIABA WOLOF","KOUTHIABA OUOLOF",185,240,1187,1127,2314
TAMBACOUNDA,KOUPENTOUM,"KOUTHIABA WOLOF","KOUTHIABA WOLOF","H1 MEDINA NIASSENE 2",1,1,71,7,78
TAMBACOUNDA,KOUPENTOUM,"KOUTHIABA WOLOF","KOUTHIABA WOLOF","KOUTHIABA PEULH",37,89,370,371,741
TAMBACOUNDA,KOUPENTOUM,"KOUTHIABA WOLOF","KOUTHIABA WOLOF","H1 KEUR GALLOUR",10,29,96,66,162
TAMBACOUNDA,KOUPENTOUM,"KOUTHIABA WOLOF","KOUTHIABA WOLOF","H2 SARE LIMETHIAL",4,6,33,39,72
TAMBACOUNDA,KOUPENTOUM,"KOUTHIABA WOLOF","KOUTHIABA WOLOF","LOUMBOL MAKAM (LOUMBOL PEULH)",33,74,341,290,631
TAMBACOUNDA,KOUPENTOUM,"KOUTHIABA WOLOF","KOUTHIABA WOLOF",MALEMBE,106,133,1274,896,2170
TAMBACOUNDA,KOUPENTOUM,"KOUTHIABA WOLOF","KOUTHIABA WOLOF","MEDINA NDAWENE",3,7,34,18,52
TAMBACOUNDA,KOUPENTOUM,"KOUTHIABA WOLOF","KOUTHIABA WOLOF","MISSIRAH MOURIDE",44,51,290,269,559
TAMBACOUNDA,KOUPENTOUM,"KOUTHIABA WOLOF","KOUTHIABA WOLOF","MISSIRAH PEULH",36,74,344,283,627
TAMBACOUNDA,KOUPENTOUM,"KOUTHIABA WOLOF","KOUTHIABA WOLOF","NGATHIE OUOLOF (SYLL BIRANE)",17,21,124,74,198
TAMBACOUNDA,KOUPENTOUM,"KOUTHIABA WOLOF","KOUTHIABA WOLOF","NGATHIE PEULH (KEUR MODY DJIBA)",26,39,182,158,340
TAMBACOUNDA,KOUPENTOUM,"KOUTHIABA WOLOF","KOUTHIABA WOLOF","H1 SYLL PEULH 2",7,16,86,71,157
TAMBACOUNDA,KOUPENTOUM,"KOUTHIABA WOLOF","KOUTHIABA WOLOF","NGAYENE (NGAYENE HAMDALLAYE)",23,43,125,152,277
TAMBACOUNDA,KOUPENTOUM,"KOUTHIABA WOLOF","KOUTHIABA WOLOF","PALANGHE HAMADY",58,112,616,566,1182
TAMBACOUNDA,KOUPENTOUM,"KOUTHIABA WOLOF","KOUTHIABA WOLOF","PALANGHE MANDINGUE",21,28,185,178,363
TAMBACOUNDA,KOUPENTOUM,"KOUTHIABA WOLOF","KOUTHIABA WOLOF","H1 MAISSA NIAPY",3,10,71,62,133
TAMBACOUNDA,KOUPENTOUM,"KOUTHIABA WOLOF","KOUTHIABA WOLOF",PANAL,32,56,246,248,494
TAMBACOUNDA,KOUPENTOUM,"KOUTHIABA WOLOF","KOUTHIABA WOLOF","H1 PANAL DOGA",58,78,389,386,775
TAMBACOUNDA,KOUPENTOUM,"KOUTHIABA WOLOF","KOUTHIABA WOLOF","SARE BOILY",66,123,515,443,958
TAMBACOUNDA,KOUPENTOUM,"KOUTHIABA WOLOF","KOUTHIABA WOLOF","SARE HAMADY",38,85,286,209,495
TAMBACOUNDA,KOUPENTOUM,"KOUTHIABA WOLOF","KOUTHIABA WOLOF","SINOULAYE (HAINOULAYE)",1,1,1,2,3
TAMBACOUNDA,KOUPENTOUM,"KOUTHIABA WOLOF","KOUTHIABA WOLOF","SINTHIOU BALL",40,91,304,230,534
TAMBACOUNDA,KOUPENTOUM,"KOUTHIABA WOLOF","KOUTHIABA WOLOF","H1 WOURO MAMADOU",1,4,20,24,44
TAMBACOUNDA,KOUPENTOUM,"KOUTHIABA WOLOF","KOUTHIABA WOLOF","SINTHIOU GALOUM PEULH",19,46,175,159,334
TAMBACOUNDA,KOUPENTOUM,"KOUTHIABA WOLOF","KOUTHIABA WOLOF","SINTHIOU MAKA BA",7,22,126,103,229
TAMBACOUNDA,KOUPENTOUM,"KOUTHIABA WOLOF","KOUTHIABA WOLOF","SINTHIOU SYLLA KA",32,50,310,248,558
TAMBACOUNDA,KOUPENTOUM,"KOUTHIABA WOLOF","KOUTHIABA WOLOF","SINTHIOU THIAKHATHIE",51,121,547,536,1083
TAMBACOUNDA,KOUPENTOUM,"KOUTHIABA WOLOF","KOUTHIABA WOLOF","H1 PANAL 2",8,14,68,50,118
TAMBACOUNDA,KOUPENTOUM,"KOUTHIABA WOLOF","KOUTHIABA WOLOF","H2 SINTHIOU LALODJI",8,21,99,94,193
TAMBACOUNDA,KOUPENTOUM,"KOUTHIABA WOLOF","KOUTHIABA WOLOF","SINTHIANE THIAKHENE",49,75,541,410,951
TAMBACOUNDA,KOUPENTOUM,"KOUTHIABA WOLOF","KOUTHIABA WOLOF","SYLL PEULH",23,44,179,187,366
TAMBACOUNDA,KOUPENTOUM,"KOUTHIABA WOLOF","KOUTHIABA WOLOF","SYLL SERIGNE MALICK",146,168,870,828,1698
TAMBACOUNDA,KOUPENTOUM,"KOUTHIABA WOLOF","KOUTHIABA WOLOF","H1 SYLL POMANENE",13,15,73,56,129
TAMBACOUNDA,KOUPENTOUM,"KOUTHIABA WOLOF","KOUTHIABA WOLOF","H2 KEUR DOUKA DIAO",3,3,22,21,43
TAMBACOUNDA,KOUPENTOUM,"KOUTHIABA WOLOF","KOUTHIABA WOLOF","H3 SYLL MORINGUEL",9,12,51,60,111
TAMBACOUNDA,KOUPENTOUM,"KOUTHIABA WOLOF","KOUTHIABA WOLOF","SYLL THIAKHANE",21,22,96,101,197
TAMBACOUNDA,KOUPENTOUM,"KOUTHIABA WOLOF","KOUTHIABA WOLOF","TAIBA NDOMENE (KEUR SAMBA NDOME)",21,32,133,153,286
TAMBACOUNDA,KOUPENTOUM,"KOUTHIABA WOLOF","KOUTHIABA WOLOF","TETHIE NANGUE",8,30,124,82,206
TAMBACOUNDA,KOUPENTOUM,"KOUTHIABA WOLOF","KOUTHIABA WOLOF","VELINGARA MANDING (SINTHIOU SAPANE PALDASS)",10,12,56,29,85
TAMBACOUNDA,KOUPENTOUM,"KOUTHIABA WOLOF","KOUTHIABA WOLOF","BANTANGUEL PEULH 2",15,43,314,233,547
TAMBACOUNDA,KOUPENTOUM,"KOUTHIABA WOLOF","PASS KOTO","BARINABE (SARE BARRY)",18,26,163,139,302
TAMBACOUNDA,KOUPENTOUM,"KOUTHIABA WOLOF","PASS KOTO","BOULIMANGA PEULH I",21,30,162,160,322
TAMBACOUNDA,KOUPENTOUM,"KOUTHIABA WOLOF","PASS KOTO","H1 SARE BA GODO (GOUNDO BA)",5,8,44,54,98
TAMBACOUNDA,KOUPENTOUM,"KOUTHIABA WOLOF","PASS KOTO","H2 SINTHIANE THIANA",4,4,22,17,39
TAMBACOUNDA,KOUPENTOUM,"KOUTHIABA WOLOF","PASS KOTO",BOUMKOUM,27,32,204,153,357
TAMBACOUNDA,KOUPENTOUM,"KOUTHIABA WOLOF","PASS KOTO","DIAGLE NDAWENE",27,28,196,199,395
TAMBACOUNDA,KOUPENTOUM,"KOUTHIABA WOLOF","PASS KOTO","DIAMWELI FARA",39,69,360,380,740
TAMBACOUNDA,KOUPENTOUM,"KOUTHIABA WOLOF","PASS KOTO","H1 SARE BOHOUM",1,4,23,20,43
TAMBACOUNDA,KOUPENTOUM,"KOUTHIABA WOLOF","PASS KOTO","FASS ALPHA",20,29,152,178,330
TAMBACOUNDA,KOUPENTOUM,"KOUTHIABA WOLOF","PASS KOTO","GUEUM YALLA  OUOLOF",13,19,132,124,256
TAMBACOUNDA,KOUPENTOUM,"KOUTHIABA WOLOF","PASS KOTO","GUEUM YALLA PEULH",14,17,109,74,183
TAMBACOUNDA,KOUPENTOUM,"KOUTHIABA WOLOF","PASS KOTO","H1 SARE DIATTA",16,23,150,132,282
TAMBACOUNDA,KOUPENTOUM,"KOUTHIABA WOLOF","PASS KOTO",KALOM,52,72,410,400,810
TAMBACOUNDA,KOUPENTOUM,"KOUTHIABA WOLOF","PASS KOTO","H1 DARA SERIGNE FALLOU",2,3,24,12,36
TAMBACOUNDA,KOUPENTOUM,"KOUTHIABA WOLOF","PASS KOTO","H2 DAARA SERIGNE ISSA",1,1,2,0,2
TAMBACOUNDA,KOUPENTOUM,"KOUTHIABA WOLOF","PASS KOTO",KOUSSALANG,52,88,412,390,802
TAMBACOUNDA,KOUPENTOUM,"KOUTHIABA WOLOF","PASS KOTO","H1 AMDALAYE KOUSSALANG",11,11,59,39,98
TAMBACOUNDA,KOUPENTOUM,"KOUTHIABA WOLOF","PASS KOTO","MADINA KABORENE (DAWADY)",24,28,200,168,368
TAMBACOUNDA,KOUPENTOUM,"KOUTHIABA WOLOF","PASS KOTO","NDATOU DIABA",31,82,350,341,691
TAMBACOUNDA,KOUPENTOUM,"KOUTHIABA WOLOF","PASS KOTO",NDOUNGOUSSINE,45,63,530,470,1000
TAMBACOUNDA,KOUPENTOUM,"KOUTHIABA WOLOF","PASS KOTO","NGANTHILANE DIADJI",17,25,158,132,290
TAMBACOUNDA,KOUPENTOUM,"KOUTHIABA WOLOF","PASS KOTO","H1 SARE MODOU",4,4,21,27,48
TAMBACOUNDA,KOUPENTOUM,"KOUTHIABA WOLOF","PASS KOTO","NGUINOKHE 1( BOUDAL)",20,41,168,152,320
TAMBACOUNDA,KOUPENTOUM,"KOUTHIABA WOLOF","PASS KOTO","NGUINOKHE 2",28,44,180,148,328
TAMBACOUNDA,KOUPENTOUM,"KOUTHIABA WOLOF","PASS KOTO","PASS KOTO",72,79,399,390,789
TAMBACOUNDA,KOUPENTOUM,"KOUTHIABA WOLOF","PASS KOTO","H1 PASS PEULH",20,31,136,161,297
TAMBACOUNDA,KOUPENTOUM,"KOUTHIABA WOLOF","PASS KOTO","H2 HALTOU PASS",40,46,141,159,300
TAMBACOUNDA,KOUPENTOUM,"KOUTHIABA WOLOF","PASS KOTO","PATOULANE OUOLOF",81,104,530,528,1058
TAMBACOUNDA,KOUPENTOUM,"KOUTHIABA WOLOF","PASS KOTO","PATOULANE PEULH",18,22,190,162,352
TAMBACOUNDA,KOUPENTOUM,"KOUTHIABA WOLOF","PASS KOTO","SARE MANSALI",7,10,76,72,148
TAMBACOUNDA,KOUPENTOUM,"KOUTHIABA WOLOF","PASS KOTO","SINTHIOU ALDIOUMA (SARE FOREYA)",27,55,303,290,593
TAMBACOUNDA,KOUPENTOUM,"KOUTHIABA WOLOF","PASS KOTO","SINTHIOU BADY DIOP",7,13,104,92,196
TAMBACOUNDA,KOUPENTOUM,"KOUTHIABA WOLOF","PASS KOTO","SINTHIOU BAMBY FOULBES",13,23,126,140,266
TAMBACOUNDA,KOUPENTOUM,"KOUTHIABA WOLOF","PASS KOTO","H1 AFIA",8,10,36,41,77
TAMBACOUNDA,KOUPENTOUM,"KOUTHIABA WOLOF","PASS KOTO","SINTHIOU BAMBY PAGNATE",11,15,86,82,168
TAMBACOUNDA,KOUPENTOUM,"KOUTHIABA WOLOF","PASS KOTO","SINTHIOU DIERY",14,24,125,143,268
TAMBACOUNDA,KOUPENTOUM,"KOUTHIABA WOLOF","PASS KOTO","SINTHIOU FODE",21,30,163,170,333
TAMBACOUNDA,KOUPENTOUM,"KOUTHIABA WOLOF","PASS KOTO","SINTHIOU KALDING",15,28,182,165,347
TAMBACOUNDA,KOUPENTOUM,"KOUTHIABA WOLOF","PASS KOTO","SINTHIOU YARE",19,39,190,161,351
TAMBACOUNDA,KOUPENTOUM,"KOUTHIABA WOLOF","PASS KOTO","SINTHIOU KOUTHIA (BOYNGHEUL)",23,36,141,110,251
TAMBACOUNDA,KOUPENTOUM,"KOUTHIABA WOLOF","PASS KOTO","SINTHIOU MAKAKOTO (SARE THIERNO)",19,28,210,181,391
TAMBACOUNDA,KOUPENTOUM,"KOUTHIABA WOLOF","PASS KOTO","SINTHIOU NDIENE",83,91,572,526,1098
TAMBACOUNDA,KOUPENTOUM,"KOUTHIABA WOLOF","PASS KOTO","H1 SINTHIOU ELHADJI",5,10,69,56,125
TAMBACOUNDA,KOUPENTOUM,"KOUTHIABA WOLOF","PASS KOTO","SINTHIOU PAGNATE",16,28,162,155,317
TAMBACOUNDA,KOUPENTOUM,"KOUTHIABA WOLOF","PASS KOTO","H1 SINTHIOU LAMINE",15,28,144,113,257
TAMBACOUNDA,KOUPENTOUM,"KOUTHIABA WOLOF","PASS KOTO","SINTHIOU TOUBA NIANI",23,28,200,211,411
TAMBACOUNDA,KOUPENTOUM,"KOUTHIABA WOLOF","PASS KOTO","H1 DAROU MINAME NIANI",1,2,15,7,22
TAMBACOUNDA,KOUPENTOUM,"KOUTHIABA WOLOF","PASS KOTO","H2 DAARA SERIGNE AMDY FALL",1,1,6,0,6
TAMBACOUNDA,KOUPENTOUM,"KOUTHIABA WOLOF","PASS KOTO","SINTHIOU KOBOTO ( YARE)",37,69,367,322,689
TAMBACOUNDA,KOUPENTOUM,"KOUTHIABA WOLOF","PASS KOTO",TAIBATOU,26,33,209,201,410
TAMBACOUNDA,KOUPENTOUM,"KOUTHIABA WOLOF","PASS KOTO","VELINGARA KOTO",71,86,683,660,1343
TAMBACOUNDA,KOUPENTOUM,"KOUTHIABA WOLOF","PASS KOTO",DAGAME,1,1,5,5,10
TAMBACOUNDA,KOUPENTOUM,"KOUTHIABA WOLOF","PASS KOTO","SARE GUEDADO",5,6,49,50,99
TAMBACOUNDA,KOUPENTOUM,"KOUTHIABA WOLOF",PAYAR,"AFFE BELEL DIAMALA",19,20,123,118,241
TAMBACOUNDA,KOUPENTOUM,"KOUTHIABA WOLOF",PAYAR,"BEKA DJIWA",9,24,84,89,173
TAMBACOUNDA,KOUPENTOUM,"KOUTHIABA WOLOF",PAYAR,"BELEL DIAMALA PEULH",21,47,188,185,373
TAMBACOUNDA,KOUPENTOUM,"KOUTHIABA WOLOF",PAYAR,"H1 BELEL THIANGHE",20,39,177,136,313
TAMBACOUNDA,KOUPENTOUM,"KOUTHIABA WOLOF",PAYAR,"BOKY SADA",84,108,676,593,1269
TAMBACOUNDA,KOUPENTOUM,"KOUTHIABA WOLOF",PAYAR,"H1 SINTHIOU ASRE",8,22,86,67,153
TAMBACOUNDA,KOUPENTOUM,"KOUTHIABA WOLOF",PAYAR,"H3 DIOULKY",5,13,60,53,113
TAMBACOUNDA,KOUPENTOUM,"KOUTHIABA WOLOF",PAYAR,"H4 SOUTOURA BODE",17,22,123,117,240
TAMBACOUNDA,KOUPENTOUM,"KOUTHIABA WOLOF",PAYAR,"H5 BELEL KOBA",13,22,109,114,223
TAMBACOUNDA,KOUPENTOUM,"KOUTHIABA WOLOF",PAYAR,"DAROU KHOUDOSS 1",14,23,98,98,196
TAMBACOUNDA,KOUPENTOUM,"KOUTHIABA WOLOF",PAYAR,"DAROU KHOUDOSS 2",18,33,175,168,343
TAMBACOUNDA,KOUPENTOUM,"KOUTHIABA WOLOF",PAYAR,"DAROU MANNA",56,67,347,341,688
TAMBACOUNDA,KOUPENTOUM,"KOUTHIABA WOLOF",PAYAR,"DAROU MARNANE",24,24,136,145,281
TAMBACOUNDA,KOUPENTOUM,"KOUTHIABA WOLOF",PAYAR,"DAROU MINAME",28,37,344,315,659
TAMBACOUNDA,KOUPENTOUM,"KOUTHIABA WOLOF",PAYAR,"H4 DAROU SALAM GATI",8,17,148,157,305
TAMBACOUNDA,KOUPENTOUM,"KOUTHIABA WOLOF",PAYAR,"H4 TOUBA KHELCOM",6,8,99,65,164
TAMBACOUNDA,KOUPENTOUM,"KOUTHIABA WOLOF",PAYAR,"DAROU NAHIM (BOGUEL BOFFE)",49,59,264,274,538
TAMBACOUNDA,KOUPENTOUM,"KOUTHIABA WOLOF",PAYAR,"DAROU RAHMANE (PETEL OUOLOF)",22,26,175,146,321
TAMBACOUNDA,KOUPENTOUM,"KOUTHIABA WOLOF",PAYAR,"DAROU SALAM 1",80,86,519,407,926
TAMBACOUNDA,KOUPENTOUM,"KOUTHIABA WOLOF",PAYAR,"H1 DAROU SALAM BALEL",1,1,10,3,13
TAMBACOUNDA,KOUPENTOUM,"KOUTHIABA WOLOF",PAYAR,"H2 TOBENE",30,50,224,244,468
TAMBACOUNDA,KOUPENTOUM,"KOUTHIABA WOLOF",PAYAR,"H3 DAROU MARNANE",3,3,15,22,37
TAMBACOUNDA,KOUPENTOUM,"KOUTHIABA WOLOF",PAYAR,"DAROU SALAM PAYAR",46,58,377,316,693
TAMBACOUNDA,KOUPENTOUM,"KOUTHIABA WOLOF",PAYAR,"H1 DAARA SERIGNE MOURTALA M’BACKE",2,7,48,45,93
TAMBACOUNDA,KOUPENTOUM,"KOUTHIABA WOLOF",PAYAR,"H2 BOUCHRA PAYAR",4,4,23,32,55
TAMBACOUNDA,KOUPENTOUM,"KOUTHIABA WOLOF",PAYAR,"DAROU SALOUM DIOUF",67,67,330,268,598
TAMBACOUNDA,KOUPENTOUM,"KOUTHIABA WOLOF",PAYAR,"H1 DAARA NDIOUROUL",1,1,42,0,42
TAMBACOUNDA,KOUPENTOUM,"KOUTHIABA WOLOF",PAYAR,"H2 DAARA NDIAPADAL",1,1,40,0,40
TAMBACOUNDA,KOUPENTOUM,"KOUTHIABA WOLOF",PAYAR,"H3 DARA SERIGNE MOUSTAPHA POUYE",8,8,35,29,64
TAMBACOUNDA,KOUPENTOUM,"KOUTHIABA WOLOF",PAYAR,"H4 DAARA SERIGNE MALICK DIOUF",5,5,30,11,41
TAMBACOUNDA,KOUPENTOUM,"KOUTHIABA WOLOF",PAYAR,"DIATMEL 1",68,155,650,562,1212
TAMBACOUNDA,KOUPENTOUM,"KOUTHIABA WOLOF",PAYAR,"H1 LOUMBOL KAHI DIATMEL",14,31,102,118,220
TAMBACOUNDA,KOUPENTOUM,"KOUTHIABA WOLOF",PAYAR,"H2 SINTHIANE DIATMEL",15,50,162,161,323
TAMBACOUNDA,KOUPENTOUM,"KOUTHIABA WOLOF",PAYAR,"H3 SINTHANE SIRAOULEYE",1,3,11,11,22
TAMBACOUNDA,KOUPENTOUM,"KOUTHIABA WOLOF",PAYAR,"DIATMEL 2",18,49,213,178,391
TAMBACOUNDA,KOUPENTOUM,"KOUTHIABA WOLOF",PAYAR,"DIOUGUEL BOULY",29,58,250,247,497
TAMBACOUNDA,KOUPENTOUM,"KOUTHIABA WOLOF",PAYAR,FOUBAR,12,32,132,128,260
TAMBACOUNDA,KOUPENTOUM,"KOUTHIABA WOLOF",PAYAR,"GALBASS HINDE",20,34,147,134,281
TAMBACOUNDA,KOUPENTOUM,"KOUTHIABA WOLOF",PAYAR,"H1 NDAKHAR",5,7,45,40,85
TAMBACOUNDA,KOUPENTOUM,"KOUTHIABA WOLOF",PAYAR,"GALL BASS",27,54,179,173,352
TAMBACOUNDA,KOUPENTOUM,"KOUTHIABA WOLOF",PAYAR,"H1 LOUMBY SARAWA",2,3,9,12,21
TAMBACOUNDA,KOUPENTOUM,"KOUTHIABA WOLOF",PAYAR,"H2 GASSEL",6,13,58,49,107
TAMBACOUNDA,KOUPENTOUM,"KOUTHIABA WOLOF",PAYAR,"H3 WENDOU PATOUDE",5,13,43,44,87
TAMBACOUNDA,KOUPENTOUM,"KOUTHIABA WOLOF",PAYAR,"H4 WENDOU KADIOLY",4,7,35,29,64
TAMBACOUNDA,KOUPENTOUM,"KOUTHIABA WOLOF",PAYAR,"H5 BELEL KADIOLY",5,9,37,41,78
TAMBACOUNDA,KOUPENTOUM,"KOUTHIABA WOLOF",PAYAR,"H6 LOUMBY SAMO",6,12,50,37,87
TAMBACOUNDA,KOUPENTOUM,"KOUTHIABA WOLOF",PAYAR,GASSE,49,98,429,397,826
TAMBACOUNDA,KOUPENTOUM,"KOUTHIABA WOLOF",PAYAR,"H1 MOURETEKI (H1 GASSE MERETEKY)",6,10,35,29,64
TAMBACOUNDA,KOUPENTOUM,"KOUTHIABA WOLOF",PAYAR,"H2 YARI MALE",11,37,172,166,338
TAMBACOUNDA,KOUPENTOUM,"KOUTHIABA WOLOF",PAYAR,"H3 BELAL",16,34,151,116,267
TAMBACOUNDA,KOUPENTOUM,"KOUTHIABA WOLOF",PAYAR,"H4 WENDY NODI",3,7,34,27,61
TAMBACOUNDA,KOUPENTOUM,"KOUTHIABA WOLOF",PAYAR,"H5 LOUMBOUL SAMBA YACINE",9,20,73,91,164
TAMBACOUNDA,KOUPENTOUM,"KOUTHIABA WOLOF",PAYAR,"H6 MBAYAR",2,2,15,8,23
TAMBACOUNDA,KOUPENTOUM,"KOUTHIABA WOLOF",PAYAR,"H7 MISSIRA ALIOU",10,21,108,85,193
TAMBACOUNDA,KOUPENTOUM,"KOUTHIABA WOLOF",PAYAR,"KEUR LAMINE WILANE (SOUTHIE OUOLOF)",25,37,211,197,408
TAMBACOUNDA,KOUPENTOUM,"KOUTHIABA WOLOF",PAYAR,"H1 BOULY DIOHE",11,27,101,82,183
TAMBACOUNDA,KOUPENTOUM,"KOUTHIABA WOLOF",PAYAR,"LOUMBOL AMADY",8,17,72,80,152
TAMBACOUNDA,KOUPENTOUM,"KOUTHIABA WOLOF",PAYAR,"LOUMBOL YORO",20,43,181,184,365
TAMBACOUNDA,KOUPENTOUM,"KOUTHIABA WOLOF",PAYAR,"LOUMBY ALY TEDY",20,40,157,167,324
TAMBACOUNDA,KOUPENTOUM,"KOUTHIABA WOLOF",PAYAR,"LOUMBY SIMBING",14,46,207,207,414
TAMBACOUNDA,KOUPENTOUM,"KOUTHIABA WOLOF",PAYAR,"H1 LOUMBY NIATH",17,29,139,106,245
TAMBACOUNDA,KOUPENTOUM,"KOUTHIABA WOLOF",PAYAR,"LOUMBY TRAVAUX",62,143,591,584,1175
TAMBACOUNDA,KOUPENTOUM,"KOUTHIABA WOLOF",PAYAR,"H1 SINTHOU BOULELE",12,32,123,124,247
TAMBACOUNDA,KOUPENTOUM,"KOUTHIABA WOLOF",PAYAR,"MEDINA PETEL",10,19,95,76,171
TAMBACOUNDA,KOUPENTOUM,"KOUTHIABA WOLOF",PAYAR,"MEDINA THIEKENE",9,9,57,42,99
TAMBACOUNDA,KOUPENTOUM,"KOUTHIABA WOLOF",PAYAR,"NAYOM BAPEL (NAYOM KADDI)",30,65,272,294,566
TAMBACOUNDA,KOUPENTOUM,"KOUTHIABA WOLOF",PAYAR,"NAYOM DIA (KEUR BANDIOUGOU)",5,18,77,62,139
TAMBACOUNDA,KOUPENTOUM,"KOUTHIABA WOLOF",PAYAR,"NAYOM MATH",18,39,192,181,373
TAMBACOUNDA,KOUPENTOUM,"KOUTHIABA WOLOF",PAYAR,"H1 BARKEYEL",9,15,81,88,169
TAMBACOUNDA,KOUPENTOUM,"KOUTHIABA WOLOF",PAYAR,"H2 BELEL BANI",3,6,30,33,63
TAMBACOUNDA,KOUPENTOUM,"KOUTHIABA WOLOF",PAYAR,"NAYOM PEULH (KEUR BOUBOU)",13,43,180,178,358
TAMBACOUNDA,KOUPENTOUM,"KOUTHIABA WOLOF",PAYAR,"H1 NAYOM JABAL",3,15,42,42,84
TAMBACOUNDA,KOUPENTOUM,"KOUTHIABA WOLOF",PAYAR,"NAYOM WILANENE",18,22,98,96,194
TAMBACOUNDA,KOUPENTOUM,"KOUTHIABA WOLOF",PAYAR,"H1 WILANENE",23,39,293,260,553
TAMBACOUNDA,KOUPENTOUM,"KOUTHIABA WOLOF",PAYAR,"NDINDY TOBENE OUOLOF (TOUBA DAROU KHADIM)",33,59,390,285,675
TAMBACOUNDA,KOUPENTOUM,"KOUTHIABA WOLOF",PAYAR,"NDINDY TOBENE PEULH (MORODJI)",39,95,413,377,790
TAMBACOUNDA,KOUPENTOUM,"KOUTHIABA WOLOF",PAYAR,"NGHABITOL 1",13,40,155,140,295
TAMBACOUNDA,KOUPENTOUM,"KOUTHIABA WOLOF",PAYAR,"NGHABITOL 2",22,94,343,297,640
TAMBACOUNDA,KOUPENTOUM,"KOUTHIABA WOLOF",PAYAR,PAYAR,199,257,1218,1041,2259
TAMBACOUNDA,KOUPENTOUM,"KOUTHIABA WOLOF",PAYAR,"H1 NDIAREME THIAMENE",8,10,85,50,135
TAMBACOUNDA,KOUPENTOUM,"KOUTHIABA WOLOF",PAYAR,"PETEL PEULH",19,34,149,165,314
TAMBACOUNDA,KOUPENTOUM,"KOUTHIABA WOLOF",PAYAR,"REHAYE DEMBA SANE",9,25,85,91,176
TAMBACOUNDA,KOUPENTOUM,"KOUTHIABA WOLOF",PAYAR,"REHAYE KADDI",5,29,93,80,173
TAMBACOUNDA,KOUPENTOUM,"KOUTHIABA WOLOF",PAYAR,"REHAYE SINTHIOU (GOLY)",21,78,291,320,611
TAMBACOUNDA,KOUPENTOUM,"KOUTHIABA WOLOF",PAYAR,"H1 REHAYE DIAGALY",3,9,33,30,63
TAMBACOUNDA,KOUPENTOUM,"KOUTHIABA WOLOF",PAYAR,"H2 REHAYE SARE LAMO",4,19,59,64,123
TAMBACOUNDA,KOUPENTOUM,"KOUTHIABA WOLOF",PAYAR,"REHAYE WALY DIALA",7,25,105,99,204
TAMBACOUNDA,KOUPENTOUM,"KOUTHIABA WOLOF",PAYAR,"SARE HAMADY LAITY",30,73,305,322,627
TAMBACOUNDA,KOUPENTOUM,"KOUTHIABA WOLOF",PAYAR,"SARE WOKA (NGABITOL PEULH)",40,134,602,483,1085
TAMBACOUNDA,KOUPENTOUM,"KOUTHIABA WOLOF",PAYAR,"H1 DOUMALE BAIDY",3,11,47,46,93
TAMBACOUNDA,KOUPENTOUM,"KOUTHIABA WOLOF",PAYAR,"SINTHIOU DEMBA DIALLO",13,26,133,122,255
TAMBACOUNDA,KOUPENTOUM,"KOUTHIABA WOLOF",PAYAR,"SINTHIOU DIOHE",11,21,126,144,270
TAMBACOUNDA,KOUPENTOUM,"KOUTHIABA WOLOF",PAYAR,"SINTHIOU DIOUGUEL",11,18,75,56,131
TAMBACOUNDA,KOUPENTOUM,"KOUTHIABA WOLOF",PAYAR,"H1 SARE MAMADOU BA",1,4,13,9,22
TAMBACOUNDA,KOUPENTOUM,"KOUTHIABA WOLOF",PAYAR,"H2 SARE HILO KA",10,14,43,42,85
TAMBACOUNDA,KOUPENTOUM,"KOUTHIABA WOLOF",PAYAR,"H3 SARE DAGA",11,26,114,118,232
TAMBACOUNDA,KOUPENTOUM,"KOUTHIABA WOLOF",PAYAR,"H4 BELEL DIERY",33,70,288,235,523
TAMBACOUNDA,KOUPENTOUM,"KOUTHIABA WOLOF",PAYAR,"H4 SARE DEMBA DIALLO (SARE GUELELE)",2,6,18,26,44
TAMBACOUNDA,KOUPENTOUM,"KOUTHIABA WOLOF",PAYAR,"H6 SARE HAMADY DIALLO",12,27,109,110,219
TAMBACOUNDA,KOUPENTOUM,"KOUTHIABA WOLOF",PAYAR,"H7 SARE NIOURKADE",3,9,30,35,65
TAMBACOUNDA,KOUPENTOUM,"KOUTHIABA WOLOF",PAYAR,"H8 SARE TAHE",4,5,18,20,38
TAMBACOUNDA,KOUPENTOUM,"KOUTHIABA WOLOF",PAYAR,"SINTHIOU GOLY",6,21,83,67,150
TAMBACOUNDA,KOUPENTOUM,"KOUTHIABA WOLOF",PAYAR,"SOUTHIE (SOUTHIE PEULH)",35,87,345,345,690
TAMBACOUNDA,KOUPENTOUM,"KOUTHIABA WOLOF",PAYAR,THIAKHATHIE,28,70,318,303,621
TAMBACOUNDA,KOUPENTOUM,"KOUTHIABA WOLOF",PAYAR,"TOUBA BAMBILOR",12,13,85,84,169
TAMBACOUNDA,KOUPENTOUM,"KOUTHIABA WOLOF",PAYAR,"TOUBA DAROU KHADIM",9,9,51,50,101
TAMBACOUNDA,KOUPENTOUM,"KOUTHIABA WOLOF",PAYAR,"TOUBA MOURIDE",23,23,111,87,198
TAMBACOUNDA,KOUPENTOUM,"KOUTHIABA WOLOF",PAYAR,"TOUBA NAYOM (NAYOM THIONG)",26,33,229,244,473
TAMBACOUNDA,KOUPENTOUM,"KOUTHIABA WOLOF",PAYAR,"H1 TOUBA KHITMATOULAHI",28,31,247,303,550
TAMBACOUNDA,KOUPENTOUM,"KOUTHIABA WOLOF",PAYAR,"TOUBA NDIAYENE",2,3,19,25,44
TAMBACOUNDA,KOUPENTOUM,"KOUTHIABA WOLOF",PAYAR,"TOUBA NGHABITOL",37,41,192,186,378
TAMBACOUNDA,KOUPENTOUM,"KOUTHIABA WOLOF",PAYAR,"WENDOU BOKY",4,11,43,40,83
TAMBACOUNDA,KOUPENTOUM,"KOUTHIABA WOLOF",PAYAR,"DAROU KHADIM TOUBA KHITMATOULAY",1,2,26,7,33
TAMBACOUNDA,KOUPENTOUM,"KOUTHIABA WOLOF",PAYAR,"DAROU SALAM BALEL",1,1,2,4,6
TAMBACOUNDA,KOUPENTOUM,"KOUTHIABA WOLOF",PAYAR,"DAROU WAHABE",1,2,44,5,49
TAMBACOUNDA,KOUPENTOUM,"KOUTHIABA WOLOF",PAYAR,"DIOUGUEL SARE MBAYE",25,50,238,214,452
TAMBACOUNDA,KOUPENTOUM,"KOUTHIABA WOLOF",PAYAR,JOLAYEL,2,3,17,10,27
TAMBACOUNDA,KOUPENTOUM,"KOUTHIABA WOLOF",PAYAR,"LOUMBY MBAYAR",4,4,17,16,33
TAMBACOUNDA,KOUPENTOUM,"KOUTHIABA WOLOF",PAYAR,"MEDINA DIALOUBE",5,29,92,100,192
TAMBACOUNDA,KOUPENTOUM,"KOUTHIABA WOLOF",PAYAR,"NAYOM DIA (KEUR BOUCAR DEME)",10,34,174,110,284
TAMBACOUNDA,KOUPENTOUM,"KOUTHIABA WOLOF",PAYAR,"NGODY BADIANE",1,1,8,6,14
TAMBACOUNDA,KOUPENTOUM,"KOUTHIABA WOLOF",PAYAR,"TOUBA MOUSKY",2,4,33,6,39
TAMBACOUNDA,KOUPENTOUM,"KOUTHIABA WOLOF","MALEM NIANI",CENTRAL,58,84,662,603,1265
TAMBACOUNDA,KOUPENTOUM,"KOUTHIABA WOLOF","MALEM NIANI","DEPOT (GUINAW RAIL)",62,65,317,309,626
TAMBACOUNDA,KOUPENTOUM,"KOUTHIABA WOLOF","MALEM NIANI","HAFIA (SINTHIANE KEDOUGOU)",95,105,541,514,1055
TAMBACOUNDA,KOUPENTOUM,"KOUTHIABA WOLOF","MALEM NIANI","MALEME KOTO",4,4,30,24,54
TAMBACOUNDA,KOUPENTOUM,"KOUTHIABA WOLOF","MALEM NIANI","SAMBA DIARY PEULH",40,45,257,299,556
TAMBACOUNDA,KOUPENTOUM,"KOUTHIABA WOLOF","MALEM NIANI",TRAVAUX,72,85,486,413,899
KAOLACK,KAOLACK,KAOLACK,KAOLACK,ABATTOIRS,635,936,4805,4346,9151
KAOLACK,KAOLACK,KAOLACK,KAOLACK,BONGRE,619,783,2140,2481,4621
KAOLACK,KAOLACK,KAOLACK,KAOLACK,"BOUSTANE 1",306,446,1817,1933,3750
KAOLACK,KAOLACK,KAOLACK,KAOLACK,"BOUSTANE 2",350,501,1704,1986,3690
KAOLACK,KAOLACK,KAOLACK,KAOLACK,"DAROU SALAM DIAMAGUENE",759,803,3709,2971,6680
KAOLACK,KAOLACK,KAOLACK,KAOLACK,"DAROU SALAM NDANGANE",996,1498,5703,5216,10919
KAOLACK,KAOLACK,KAOLACK,KAOLACK,"DIALEGNE 1",512,730,3418,3653,7071
KAOLACK,KAOLACK,KAOLACK,KAOLACK,"DIALEGNE 2",676,960,5167,5242,10409
KAOLACK,KAOLACK,KAOLACK,KAOLACK,"DIAMAGUENE 1",274,469,1657,1725,3382
KAOLACK,KAOLACK,KAOLACK,KAOLACK,"DIAMAGUENE EXTENTION",341,520,1579,1637,3216
KAOLACK,KAOLACK,KAOLACK,KAOLACK,"FASS CAMP DES GARDES",350,409,1631,1565,3196
KAOLACK,KAOLACK,KAOLACK,KAOLACK,GAWANE,479,557,2325,2564,4889
KAOLACK,KAOLACK,KAOLACK,KAOLACK,"HLM SARA",115,131,396,458,854
KAOLACK,KAOLACK,KAOLACK,KAOLACK,KABATOKI,782,852,3648,3860,7508
KAOLACK,KAOLACK,KAOLACK,KAOLACK,KASAVILLE,751,1097,4317,4522,8839
KAOLACK,KAOLACK,KAOLACK,KAOLACK,KASNACK,600,922,3325,3515,6840
KAOLACK,KAOLACK,KAOLACK,KAOLACK,KOUNDAM,345,524,3076,1788,4864
KAOLACK,KAOLACK,KAOLACK,KAOLACK,"LEONA CENTRE",444,752,2817,2935,5752
KAOLACK,KAOLACK,KAOLACK,KAOLACK,"LEONA ESCALE",172,303,955,907,1862
KAOLACK,KAOLACK,KAOLACK,KAOLACK,LYNDIANE,186,200,958,979,1937
KAOLACK,KAOLACK,KAOLACK,KAOLACK,"MEDINA BAYE",1508,1954,10998,11022,22020
KAOLACK,KAOLACK,KAOLACK,KAOLACK,"MEDINA MBABA 1",305,412,1835,1953,3788
KAOLACK,KAOLACK,KAOLACK,KAOLACK,"MEDINA MBABA 2",969,1167,5516,5883,11399
KAOLACK,KAOLACK,KAOLACK,KAOLACK,NDANGANE,167,310,1134,1364,2498
KAOLACK,KAOLACK,KAOLACK,KAOLACK,"NDAR GOU NDAW",484,798,3172,3352,6524
KAOLACK,KAOLACK,KAOLACK,KAOLACK,"NDORONG 1",288,369,1411,1396,2807
KAOLACK,KAOLACK,KAOLACK,KAOLACK,"NDORONG SADAGA",436,530,2175,2433,4608
KAOLACK,KAOLACK,KAOLACK,KAOLACK,"NGANE ALLASSANE",905,1054,5352,4612,9964
KAOLACK,KAOLACK,KAOLACK,KAOLACK,"NGANE SAER",762,884,3872,3792,7664
KAOLACK,KAOLACK,KAOLACK,KAOLACK,NIMZATT,503,625,2570,2909,5479
KAOLACK,KAOLACK,KAOLACK,KAOLACK,"PARCELLES ASSAINIES",799,1175,3252,3393,6645
KAOLACK,KAOLACK,KAOLACK,KAOLACK,SAM,1337,1695,7166,7591,14757
KAOLACK,KAOLACK,KAOLACK,KAOLACK,"DAROU RIDWANE",155,181,622,660,1282
KAOLACK,KAOLACK,KAOLACK,KAOLACK,"SARA NDIOUGARY",895,1141,4868,5262,10130
KAOLACK,KAOLACK,KAOLACK,KAOLACK,"SING SING",561,750,2543,2161,4704
KAOLACK,KAOLACK,KAOLACK,KAOLACK,"TABAGOYE 2",453,590,2885,3028,5913
KAOLACK,KAOLACK,KAOLACK,KAOLACK,"TABAYA (KASNACK NORD)",285,424,1696,1746,3442
KAOLACK,KAOLACK,KAOLACK,KAOLACK,THIOFFACK,2317,2892,14003,12819,26822
KAOLACK,KAOLACK,KAOLACK,KAOLACK,"TOUBA KAOLACK",1123,1393,5749,6478,12227
KAOLACK,KAOLACK,KAOLACK,KAOLACK,"TOUBA KAOLACK EXTENSION",794,876,3898,3902,7800
KAOLACK,KAOLACK,KAOLACK,KAOLACK,"DIAMAGUENE 2",295,398,1607,1704,3311
KAOLACK,KAOLACK,KAOLACK,KAOLACK,"FASS RIDWANE",359,380,1436,1332,2768
KAOLACK,KAOLACK,KAOLACK,KAOLACK,"KEUR MALOUM",324,388,1735,1971,3706
KAOLACK,KAOLACK,KAOLACK,KAOLACK,NGADE,215,230,974,725,1699
KAOLACK,KAOLACK,KAOLACK,KAOLACK,PEULGA,142,152,695,470,1165
KAOLACK,KAOLACK,KAOLACK,KAOLACK,"SAMA MOUSSA",293,312,1766,1288,3054
KAOLACK,KAOLACK,KAOLACK,KAOLACK,TABAGOYE,318,400,1529,1769,3298
KAOLACK,KAOLACK,KAHONE,KAHONE,"DAMOU NGHAYE",44,54,272,271,543
KAOLACK,KAOLACK,KAHONE,KAHONE,"DAROU HABIBI",278,303,1432,1268,2700
KAOLACK,KAOLACK,KAHONE,KAHONE,"FASS KAHONE",177,191,1070,894,1964
KAOLACK,KAOLACK,KAHONE,KAHONE,"FASS NDIOLOFFENE",103,109,402,446,848
KAOLACK,KAOLACK,KAHONE,KAHONE,"KAHONE 1",307,335,1485,1569,3054
KAOLACK,KAOLACK,KAHONE,KAHONE,"KAHONE 2",84,95,316,402,718
KAOLACK,KAOLACK,KAHONE,KAHONE,"KAHONE 3",130,152,564,598,1162
KAOLACK,KAOLACK,KAHONE,KAHONE,"KANDA AMADOU DIAKHO",354,410,2189,1570,3759
KAOLACK,KAOLACK,KAHONE,KAHONE,"KANDA FODE BAYO 1",314,384,1813,1495,3308
KAOLACK,KAOLACK,KAHONE,KAHONE,"KANDA FODE BAYO 2",604,758,3512,2977,6489
KAOLACK,KAOLACK,KAHONE,KAHONE,"MAKA NDIAYE",3,3,9,8,17
KAOLACK,KAOLACK,KAHONE,KAHONE,NGUOKARE,1,1,7,8,15
KAOLACK,KAOLACK,KAHONE,KAHONE,THIANTE,186,223,848,951,1799
KAOLACK,KAOLACK,NDIEDIENG,"KEUR SOCE","BATTARA KABA",24,29,192,194,386
KAOLACK,KAOLACK,NDIEDIENG,"KEUR SOCE","BATTARA NDIALLA",24,32,184,179,363
KAOLACK,KAOLACK,NDIEDIENG,"KEUR SOCE","BATTARA WOLOF",25,32,237,224,461
KAOLACK,KAOLACK,NDIEDIENG,"KEUR SOCE","DABANE GUELADIO",17,24,161,169,330
KAOLACK,KAOLACK,NDIEDIENG,"KEUR SOCE","H1 DABANE BAMBARA",7,9,83,64,147
KAOLACK,KAOLACK,NDIEDIENG,"KEUR SOCE","H2 THIERERE",14,14,98,96,194
KAOLACK,KAOLACK,NDIEDIENG,"KEUR SOCE","H3 KEUR DIENE (DABANE SAMBA SANOU)",8,10,70,58,128
KAOLACK,KAOLACK,NDIEDIENG,"KEUR SOCE","DABANE OGO",13,15,73,71,144
KAOLACK,KAOLACK,NDIEDIENG,"KEUR SOCE","DABANE WOLOF",17,24,92,100,192
KAOLACK,KAOLACK,NDIEDIENG,"KEUR SOCE","DAGA SAMBOU",108,144,843,1009,1852
KAOLACK,KAOLACK,NDIEDIENG,"KEUR SOCE","DAROU NIANGUENE",36,48,316,297,613
KAOLACK,KAOLACK,NDIEDIENG,"KEUR SOCE","H1 SANTHIABA",12,23,130,128,258
KAOLACK,KAOLACK,NDIEDIENG,"KEUR SOCE","DAROU SALAM",5,9,30,45,75
KAOLACK,KAOLACK,NDIEDIENG,"KEUR SOCE",DIAREKH,26,31,215,262,477
KAOLACK,KAOLACK,NDIEDIENG,"KEUR SOCE","FASS GUELADIO",6,7,46,57,103
KAOLACK,KAOLACK,NDIEDIENG,"KEUR SOCE","FASS NGUINDOR",19,25,126,129,255
KAOLACK,KAOLACK,NDIEDIENG,"KEUR SOCE","FASS THIAMENE",23,27,207,213,420
KAOLACK,KAOLACK,NDIEDIENG,"KEUR SOCE","FASS TOUCOULEUR",42,43,414,373,787
KAOLACK,KAOLACK,NDIEDIENG,"KEUR SOCE","GNILINE GOUMACK",79,95,657,665,1322
KAOLACK,KAOLACK,NDIEDIENG,"KEUR SOCE","GNILINE SANTHIE",21,25,174,134,308
KAOLACK,KAOLACK,NDIEDIENG,"KEUR SOCE",KACOTHIE,108,122,1005,864,1869
KAOLACK,KAOLACK,NDIEDIENG,"KEUR SOCE",KAOLAKATTE,26,29,180,161,341
KAOLACK,KAOLACK,NDIEDIENG,"KEUR SOCE",KAWITHIANE,17,22,121,123,244
KAOLACK,KAOLACK,NDIEDIENG,"KEUR SOCE",KEMBOU,13,18,125,86,211
KAOLACK,KAOLACK,NDIEDIENG,"KEUR SOCE","KEUR ABDOU MAME",17,18,101,99,200
KAOLACK,KAOLACK,NDIEDIENG,"KEUR SOCE","KEUR BALLA HANE",33,39,236,215,451
KAOLACK,KAOLACK,NDIEDIENG,"KEUR SOCE","KEUR BAYDO DIAO",6,9,50,40,90
KAOLACK,KAOLACK,NDIEDIENG,"KEUR SOCE","KEUR BIRAME DIOUMA",11,14,78,63,141
KAOLACK,KAOLACK,NDIEDIENG,"KEUR SOCE","KEUR DIENE (KEUR DIENE DIOUF)",10,10,59,42,101
KAOLACK,KAOLACK,NDIEDIENG,"KEUR SOCE","KEUR MAKAM",12,15,83,65,148
KAOLACK,KAOLACK,NDIEDIENG,"KEUR SOCE","KEUR MAMOUR",11,12,112,105,217
KAOLACK,KAOLACK,NDIEDIENG,"KEUR SOCE","KEUR MODIO",17,18,129,141,270
KAOLACK,KAOLACK,NDIEDIENG,"KEUR SOCE","KEUR MOUSSA LY",10,11,40,22,62
KAOLACK,KAOLACK,NDIEDIENG,"KEUR SOCE","KEUR MOUSSA NAYE",22,35,197,198,395
KAOLACK,KAOLACK,NDIEDIENG,"KEUR SOCE","KEUR NGARY",18,19,161,159,320
KAOLACK,KAOLACK,NDIEDIENG,"KEUR SOCE","KEUR NIENE OUOLOF",25,50,248,278,526
KAOLACK,KAOLACK,NDIEDIENG,"KEUR SOCE","KEUR PATHE MALICK",57,69,420,428,848
KAOLACK,KAOLACK,NDIEDIENG,"KEUR SOCE","KEUR SIDY TALL",11,22,105,137,242
KAOLACK,KAOLACK,NDIEDIENG,"KEUR SOCE","KEUR SAMBA FAYE",5,11,68,73,141
KAOLACK,KAOLACK,NDIEDIENG,"KEUR SOCE","KEUR SOCE",325,359,2028,2122,4150
KAOLACK,KAOLACK,NDIEDIENG,"KEUR SOCE",KOUTHIEYE,127,168,1040,1018,2058
KAOLACK,KAOLACK,NDIEDIENG,"KEUR SOCE","LAMARAME BADIANE",84,98,633,682,1315
KAOLACK,KAOLACK,NDIEDIENG,"KEUR SOCE","LAMARAME KAMBY",32,36,190,199,389
KAOLACK,KAOLACK,NDIEDIENG,"KEUR SOCE","LOUMENE MASSAR",2,2,17,12,29
KAOLACK,KAOLACK,NDIEDIENG,"KEUR SOCE","LOUMENE MOMATH",20,24,143,172,315
KAOLACK,KAOLACK,NDIEDIENG,"KEUR SOCE","MEDINA BEYE",30,44,315,269,584
KAOLACK,KAOLACK,NDIEDIENG,"KEUR SOCE","MBADIOU OUOLOF",18,24,167,141,308
KAOLACK,KAOLACK,NDIEDIENG,"KEUR SOCE","MBADIOU PEULH",21,25,160,182,342
KAOLACK,KAOLACK,NDIEDIENG,"KEUR SOCE",MBOUMA,65,89,583,653,1236
KAOLACK,KAOLACK,NDIEDIENG,"KEUR SOCE",MBOWENE,26,28,179,175,354
KAOLACK,KAOLACK,NDIEDIENG,"KEUR SOCE","MEDINA LEITY",17,19,108,110,218
KAOLACK,KAOLACK,NDIEDIENG,"KEUR SOCE","NDIAGNE LAGHEM",50,70,362,424,786
KAOLACK,KAOLACK,NDIEDIENG,"KEUR SOCE","NDIAGO DJILAKHAR",3,5,21,30,51
KAOLACK,KAOLACK,NDIEDIENG,"KEUR SOCE",NDIAGUENE,50,55,375,298,673
KAOLACK,KAOLACK,NDIEDIENG,"KEUR SOCE","NDIOBENE GALLO",50,61,366,399,765
KAOLACK,KAOLACK,NDIEDIENG,"KEUR SOCE","NDIOBENE MATH",14,15,99,105,204
KAOLACK,KAOLACK,NDIEDIENG,"KEUR SOCE",NDIOUFFENE,74,84,517,611,1128
KAOLACK,KAOLACK,NDIEDIENG,"KEUR SOCE",NGUINDOR,47,52,395,341,736
KAOLACK,KAOLACK,NDIEDIENG,"KEUR SOCE","NIAPPA SANTHIE",30,36,252,278,530
KAOLACK,KAOLACK,NDIEDIENG,"KEUR SOCE","H1 NDIAYENE",6,6,39,32,71
KAOLACK,KAOLACK,NDIEDIENG,"KEUR SOCE",NIASSENE,17,29,203,193,396
KAOLACK,KAOLACK,NDIEDIENG,"KEUR SOCE",SAGNAMEME,34,41,187,160,347
KAOLACK,KAOLACK,NDIEDIENG,"KEUR SOCE","SAMA NDIAYENE",70,79,447,472,919
KAOLACK,KAOLACK,NDIEDIENG,"KEUR SOCE","SAMA TOUCOULEUR",73,86,494,476,970
KAOLACK,KAOLACK,NDIEDIENG,"KEUR SOCE","KEUR DIAM (SARE DIAM DIAO)",11,18,137,118,255
KAOLACK,KAOLACK,NDIEDIENG,"KEUR SOCE","SARE ALY DIALLO ( KEUR ALY MODIA)",4,12,57,56,113
KAOLACK,KAOLACK,NDIEDIENG,"KEUR SOCE","SARE DIOUMA",14,17,159,161,320
KAOLACK,KAOLACK,NDIEDIENG,"KEUR SOCE","SARE SIDY",20,24,54,59,113
KAOLACK,KAOLACK,NDIEDIENG,"KEUR SOCE",TAIF,10,16,70,82,152
KAOLACK,KAOLACK,NDIEDIENG,"KEUR SOCE",THIAMBENE,10,13,86,87,173
KAOLACK,KAOLACK,NDIEDIENG,"KEUR SOCE","THIAMENE TABA",58,91,439,420,859
KAOLACK,KAOLACK,NDIEDIENG,"KEUR SOCE","THIARENE BOUBOU",4,4,24,21,45
KAOLACK,KAOLACK,NDIEDIENG,"KEUR SOCE","THIARENE MOMATH",26,27,207,159,366
KAOLACK,KAOLACK,NDIEDIENG,"KEUR SOCE","THIARENE YORO",15,17,137,116,253
KAOLACK,KAOLACK,NDIEDIENG,"KEUR SOCE","TOUBA FALL",9,9,44,24,68
KAOLACK,KAOLACK,NDIEDIENG,"KEUR SOCE","TOUBA THIARENE",20,24,190,154,344
KAOLACK,KAOLACK,NDIEDIENG,NDIAFFATE,"BANDOULOU SANTHIE",35,43,287,284,571
KAOLACK,KAOLACK,NDIEDIENG,NDIAFFATE,"BANDOULOU SERERE",25,31,122,132,254
KAOLACK,KAOLACK,NDIEDIENG,NDIAFFATE,"BANDOULOU TOUCOULEUR",98,108,825,756,1581
KAOLACK,KAOLACK,NDIEDIENG,NDIAFFATE,"BANE SAMANE (KEUR SAMANE)",17,24,131,151,282
KAOLACK,KAOLACK,NDIEDIENG,NDIAFFATE,"BANE SOUTOURA",15,19,130,141,271
KAOLACK,KAOLACK,NDIEDIENG,NDIAFFATE,"H1 KEUR GORY",10,14,79,91,170
KAOLACK,KAOLACK,NDIEDIENG,NDIAFFATE,"BILL BAMBARA",34,39,236,219,455
KAOLACK,KAOLACK,NDIEDIENG,NDIAFFATE,"BILL PEULH",24,26,193,164,357
KAOLACK,KAOLACK,NDIEDIENG,NDIAFFATE,BOULSOUTOURA,43,47,251,258,509
KAOLACK,KAOLACK,NDIEDIENG,NDIAFFATE,"BOULDIABE BOUMACK",25,32,189,214,403
KAOLACK,KAOLACK,NDIEDIENG,NDIAFFATE,"BOULDIABE SANTHIE",26,46,278,243,521
KAOLACK,KAOLACK,NDIEDIENG,NDIAFFATE,"H1 SANTHIE NELBE",12,13,97,81,178
KAOLACK,KAOLACK,NDIEDIENG,NDIAFFATE,"BOUNTOU BOLONG (KADDO)",33,35,212,196,408
KAOLACK,KAOLACK,NDIEDIENG,NDIAFFATE,"CAMPEMENT IBOU DRAME",18,20,114,110,224
KAOLACK,KAOLACK,NDIEDIENG,NDIAFFATE,"DAGA SANKHAYE",26,31,264,168,432
KAOLACK,KAOLACK,NDIEDIENG,NDIAFFATE,"H1 PEULGA de DAGA SANKHAYE",12,12,80,68,148
KAOLACK,KAOLACK,NDIEDIENG,NDIAFFATE,"H2 KEUR SANA",9,9,77,46,123
KAOLACK,KAOLACK,NDIEDIENG,NDIAFFATE,"DAROU MBITEYENE",114,138,838,703,1541
KAOLACK,KAOLACK,NDIEDIENG,NDIAFFATE,"DINGUIRAYE KORY",14,17,96,82,178
KAOLACK,KAOLACK,NDIEDIENG,NDIAFFATE,"H1 KEUR MORY",2,2,18,9,27
KAOLACK,KAOLACK,NDIEDIENG,NDIAFFATE,"DINGUIRAYE MARONDE",21,30,252,209,461
KAOLACK,KAOLACK,NDIEDIENG,NDIAFFATE,"DINGUIRAYE YOUSSOUPH",33,42,282,272,554
KAOLACK,KAOLACK,NDIEDIENG,NDIAFFATE,"H1 KEUR SORY",10,10,64,56,120
KAOLACK,KAOLACK,NDIEDIENG,NDIAFFATE,"GOUNDIOUR SALOUM",13,14,120,112,232
KAOLACK,KAOLACK,NDIEDIENG,NDIAFFATE,KAOUSSA,12,13,60,59,119
KAOLACK,KAOLACK,NDIEDIENG,NDIAFFATE,"KEUR BAKA",11,16,95,99,194
KAOLACK,KAOLACK,NDIEDIENG,NDIAFFATE,"KEUR BANA PENDA",14,14,86,86,172
KAOLACK,KAOLACK,NDIEDIENG,NDIAFFATE,"KEUR DEMBA DICKY",15,18,121,121,242
KAOLACK,KAOLACK,NDIEDIENG,NDIAFFATE,"KEUR DIARRA BAMBARA",32,34,221,175,396
KAOLACK,KAOLACK,NDIEDIENG,NDIAFFATE,"H1 KEUR DIARRA BOUMACK",7,7,112,42,154
KAOLACK,KAOLACK,NDIEDIENG,NDIAFFATE,"H2 KEUR DIARRA SANTHIE",4,4,27,29,56
KAOLACK,KAOLACK,NDIEDIENG,NDIAFFATE,"KEUR DIARRA PEULH",47,55,377,373,750
KAOLACK,KAOLACK,NDIEDIENG,NDIAFFATE,"KEUR DJIME",21,32,202,191,393
KAOLACK,KAOLACK,NDIEDIENG,NDIAFFATE,"KEUR GALLO COUMBA",15,17,135,107,242
KAOLACK,KAOLACK,NDIEDIENG,NDIAFFATE,"KEUR GALLO DIAWO",25,30,184,162,346
KAOLACK,KAOLACK,NDIEDIENG,NDIAFFATE,"KEUR GATTA SOW",12,12,84,71,155
KAOLACK,KAOLACK,NDIEDIENG,NDIAFFATE,"KEUR KEKOUTA",36,40,205,191,396
KAOLACK,KAOLACK,NDIEDIENG,NDIAFFATE,"KEUR KIBIRY",27,37,244,294,538
KAOLACK,KAOLACK,NDIEDIENG,NDIAFFATE,"KEUR LASSANA",16,18,124,103,227
KAOLACK,KAOLACK,NDIEDIENG,NDIAFFATE,"KEUR MAMADOU AISSATA",24,24,204,194,398
KAOLACK,KAOLACK,NDIEDIENG,NDIAFFATE,"KEUR MOUMINE",23,30,139,151,290
KAOLACK,KAOLACK,NDIEDIENG,NDIAFFATE,"KEUR NDIMB",7,7,38,42,80
KAOLACK,KAOLACK,NDIEDIENG,NDIAFFATE,"KEUR SAMBA DIAWO (SANTHIE EL HADJI SAMBA SAKHO)",20,27,165,175,340
KAOLACK,KAOLACK,NDIEDIENG,NDIAFFATE,"KEUR SAMBA HANE",11,12,42,51,93
KAOLACK,KAOLACK,NDIEDIENG,NDIAFFATE,"KEUR SAMBA SAKHO (KEUR SAMBA THIAJI)",14,17,124,104,228
KAOLACK,KAOLACK,NDIEDIENG,NDIAFFATE,"KEUR SELLE DIABONG",38,40,309,257,566
KAOLACK,KAOLACK,NDIEDIENG,NDIAFFATE,"KEUR SERIGNE NDAR",39,55,339,329,668
KAOLACK,KAOLACK,NDIEDIENG,NDIAFFATE,"KEUR SOCE COUMBA",50,59,416,299,715
KAOLACK,KAOLACK,NDIEDIENG,NDIAFFATE,"KEUR SOUTOURA EGUE",14,19,99,99,198
KAOLACK,KAOLACK,NDIEDIENG,NDIAFFATE,"KEUR WACK DIA",48,59,413,425,838
KAOLACK,KAOLACK,NDIEDIENG,NDIAFFATE,"KEUR WALY NDIAYE",31,34,170,175,345
KAOLACK,KAOLACK,NDIEDIENG,NDIAFFATE,"KEUR YORO SAMBOU",25,30,173,183,356
KAOLACK,KAOLACK,NDIEDIENG,NDIAFFATE,"KEUR YOUGA",9,14,109,103,212
KAOLACK,KAOLACK,NDIEDIENG,NDIAFFATE,"KOSSY ALY GUEYE",19,30,182,199,381
KAOLACK,KAOLACK,NDIEDIENG,NDIAFFATE,"KOSSY ATLANTA",6,7,38,33,71
KAOLACK,KAOLACK,NDIEDIENG,NDIAFFATE,"KOSSY MBITEYENE",114,132,784,797,1581
KAOLACK,KAOLACK,NDIEDIENG,NDIAFFATE,"H1 KEUR KANTA",4,6,35,35,70
KAOLACK,KAOLACK,NDIEDIENG,NDIAFFATE,"KOSSY SELLE NIASS",8,11,47,51,98
KAOLACK,KAOLACK,NDIEDIENG,NDIAFFATE,"KOSSY THIAMENE",62,66,370,318,688
KAOLACK,KAOLACK,NDIEDIENG,NDIAFFATE,KOUNKOUDIANG,17,20,129,98,227
KAOLACK,KAOLACK,NDIEDIENG,NDIAFFATE,"H1 TOURKA BOUGOU",7,7,50,54,104
KAOLACK,KAOLACK,NDIEDIENG,NDIAFFATE,"KOUTAL BAKA",12,12,81,35,116
KAOLACK,KAOLACK,NDIEDIENG,NDIAFFATE,"KOUTAL BAYE BAYE",22,23,147,114,261
KAOLACK,KAOLACK,NDIEDIENG,NDIAFFATE,"KOUTAL MALICK NDIAYE",158,163,834,680,1514
KAOLACK,KAOLACK,NDIEDIENG,NDIAFFATE,"KOUTAL NGAGNE",4,4,44,40,84
KAOLACK,KAOLACK,NDIEDIENG,NDIAFFATE,"KOUTAL OUOLOF (KOUTAL ABDOU)",650,744,3857,3613,7470
KAOLACK,KAOLACK,NDIEDIENG,NDIAFFATE,"KOUTAL SERERE (KOUTAL FAYE)",74,85,373,384,757
KAOLACK,KAOLACK,NDIEDIENG,NDIAFFATE,"KOUTAL YOUGO",18,20,144,120,264
KAOLACK,KAOLACK,NDIEDIENG,NDIAFFATE,"H1 KEUR WALY",1,3,27,25,52
KAOLACK,KAOLACK,NDIEDIENG,NDIAFFATE,"MBITEYENNE VELOR",18,23,159,135,294
KAOLACK,KAOLACK,NDIEDIENG,NDIAFFATE,"H1 PEULGA de MBITEYENNE VELOR",9,12,102,121,223
KAOLACK,KAOLACK,NDIEDIENG,NDIAFFATE,"NDIAFFATE ESCALE",274,311,1620,1549,3169
KAOLACK,KAOLACK,NDIEDIENG,NDIAFFATE,"NDIAFFATE OUOLOF (NDIAFFATE BEYROUTH)",25,35,198,182,380
KAOLACK,KAOLACK,NDIEDIENG,NDIAFFATE,"NDIAFATTE PEULH",20,23,181,152,333
KAOLACK,KAOLACK,NDIEDIENG,NDIAFFATE,"H1 KEUR GUIDO",7,8,45,46,91
KAOLACK,KAOLACK,NDIEDIENG,NDIAFFATE,"NDIAFFATE SERERE",72,77,441,452,893
KAOLACK,KAOLACK,NDIEDIENG,NDIAFFATE,"NDIAFFATE SOCE",48,55,291,305,596
KAOLACK,KAOLACK,NDIEDIENG,NDIAFFATE,NDIATHIANG,39,48,282,296,578
KAOLACK,KAOLACK,NDIEDIENG,NDIAFFATE,"SANTHIE PASSY (PASSY NGATTAM)",57,78,544,605,1149
KAOLACK,KAOLACK,NDIEDIENG,NDIAFFATE,"SOB BIRAME",18,25,164,115,279
KAOLACK,KAOLACK,NDIEDIENG,NDIAFFATE,"SOB MARY (KEUR MARY)",9,11,69,68,137
KAOLACK,KAOLACK,NDIEDIENG,NDIAFFATE,"TAWA MBOUDAYE (TAWA OUOLOF)",75,96,456,553,1009
KAOLACK,KAOLACK,NDIEDIENG,NDIAFFATE,"TAWA PEULH (MBOUDAYE TAWA PEULH)",35,38,264,267,531
KAOLACK,KAOLACK,NDIEDIENG,NDIAFFATE,"H1 KEUR SAMBA AWA",1,3,21,31,52
KAOLACK,KAOLACK,NDIEDIENG,NDIAFFATE,"H2 KEUR ALY",3,5,35,40,75
KAOLACK,KAOLACK,NDIEDIENG,NDIAFFATE,"THIAKHO THIOFFIOR",119,155,870,942,1812
KAOLACK,KAOLACK,NDIEDIENG,NDIAFFATE,THIOFFIOR,188,214,1044,1041,2085
KAOLACK,KAOLACK,NDIEDIENG,NDIAFFATE,"TOUBA SANOKHO",122,124,853,681,1534
KAOLACK,KAOLACK,NDIEDIENG,NDIAFFATE,"VELOR SERERE",49,61,270,267,537
KAOLACK,KAOLACK,NDIEDIENG,NDIAFFATE,"H1 TOUBA DIAGLE",3,4,129,102,231
KAOLACK,KAOLACK,NDIEDIENG,NDIAFFATE,"VELOR SOCE",5,5,35,25,60
KAOLACK,KAOLACK,NDIEDIENG,NDIEDIENG,DIAGAKHAM,18,25,192,170,362
KAOLACK,KAOLACK,NDIEDIENG,NDIEDIENG,"DJILEKHAR OUOLOF",196,260,1796,1685,3481
KAOLACK,KAOLACK,NDIEDIENG,NDIEDIENG,"DJILEKHAR PEULH",24,25,166,135,301
KAOLACK,KAOLACK,NDIEDIENG,NDIEDIENG,HAFFE,57,76,594,565,1159
KAOLACK,KAOLACK,NDIEDIENG,NDIEDIENG,"HARWAL (KEUR NGOUMBO)",25,34,300,244,544
KAOLACK,KAOLACK,NDIEDIENG,NDIEDIENG,"KEBE MBOUDAYE",5,8,46,46,92
KAOLACK,KAOLACK,NDIEDIENG,NDIEDIENG,"KEUR ALIOU BAYTA",7,9,60,56,116
KAOLACK,KAOLACK,NDIEDIENG,NDIEDIENG,"KEUR BAIDY BA",5,5,40,38,78
KAOLACK,KAOLACK,NDIEDIENG,NDIEDIENG,"KEUR BANO GORY (KEUR BANO PEULH)",19,26,174,165,339
KAOLACK,KAOLACK,NDIEDIENG,NDIEDIENG,"KEUR BANO OUOLOF",25,36,235,248,483
KAOLACK,KAOLACK,NDIEDIENG,NDIEDIENG,"KEUR BIRANE BITEYE (MBITEYENE KEUR BIRAME)",16,27,150,135,285
KAOLACK,KAOLACK,NDIEDIENG,NDIEDIENG,"KEUR BOCAR DIALLO",33,37,264,241,505
KAOLACK,KAOLACK,NDIEDIENG,NDIEDIENG,"KEUR BOCAR SOW (KEUR TAMSIR BOCAR)",12,15,95,114,209
KAOLACK,KAOLACK,NDIEDIENG,NDIEDIENG,"KEUR BOYDO DIAWO",21,28,194,179,373
KAOLACK,KAOLACK,NDIEDIENG,NDIEDIENG,"KEUR GAYE",7,11,59,78,137
KAOLACK,KAOLACK,NDIEDIENG,NDIEDIENG,"KEUR GUIRANE OUOLOF",4,10,30,37,67
KAOLACK,KAOLACK,NDIEDIENG,NDIEDIENG,"H1 THIALENE",6,12,49,41,90
KAOLACK,KAOLACK,NDIEDIENG,NDIEDIENG,"KEUR GUIRANE PEULH",15,17,115,118,233
KAOLACK,KAOLACK,NDIEDIENG,NDIEDIENG,"KEUR GUIRANE SERERE",30,31,186,182,368
KAOLACK,KAOLACK,NDIEDIENG,NDIEDIENG,"KEUR KABE",18,27,178,179,357
KAOLACK,KAOLACK,NDIEDIENG,NDIEDIENG,"KEUR MADIABOU",29,30,138,158,296
KAOLACK,KAOLACK,NDIEDIENG,NDIEDIENG,"KEUR MADICKE",37,58,492,429,921
KAOLACK,KAOLACK,NDIEDIENG,NDIEDIENG,"KEUR MAMADOU BOUYA",7,13,70,80,150
KAOLACK,KAOLACK,NDIEDIENG,NDIEDIENG,"KEUR NDENE KHAR",21,24,117,134,251
KAOLACK,KAOLACK,NDIEDIENG,NDIEDIENG,"KEUR NIENE SERERE",57,62,382,315,697
KAOLACK,KAOLACK,NDIEDIENG,NDIEDIENG,"KEUR OMAR KHOUDIA",42,55,371,384,755
KAOLACK,KAOLACK,NDIEDIENG,NDIEDIENG,"KEUR SACKO BAITY",64,74,652,614,1266
KAOLACK,KAOLACK,NDIEDIENG,NDIEDIENG,"KEUR SERIGNE NDAR",35,48,348,305,653
KAOLACK,KAOLACK,NDIEDIENG,NDIEDIENG,"KEUR THYSSE KEUR GUIRANE",15,19,142,125,267
KAOLACK,KAOLACK,NDIEDIENG,NDIEDIENG,LOYENE,35,46,369,306,675
KAOLACK,KAOLACK,NDIEDIENG,NDIEDIENG,"MBITEYENE ABDOU  (KEUR ABDOU DIAKHATE)",108,166,860,870,1730
KAOLACK,KAOLACK,NDIEDIENG,NDIEDIENG,"MBITEYENE MOMATH",8,11,71,59,130
KAOLACK,KAOLACK,NDIEDIENG,NDIEDIENG,"MBOUDAYE SERERE",183,218,1470,1346,2816
KAOLACK,KAOLACK,NDIEDIENG,NDIEDIENG,"MEDINA MALLE",19,20,148,189,337
KAOLACK,KAOLACK,NDIEDIENG,NDIEDIENG,NDAWENE,9,20,86,89,175
KAOLACK,KAOLACK,NDIEDIENG,NDIEDIENG,NDIAKHATE,187,225,1831,1819,3650
KAOLACK,KAOLACK,NDIEDIENG,NDIEDIENG,"NDIASSE BABOU",29,39,201,247,448
KAOLACK,KAOLACK,NDIEDIENG,NDIEDIENG,"NDIASSE SADIO",44,59,345,372,717
KAOLACK,KAOLACK,NDIEDIENG,NDIEDIENG,NDIEDIENG,295,367,1974,2116,4090
KAOLACK,KAOLACK,NDIEDIENG,NDIEDIENG,"NDIOBENE TALLENE",50,62,282,326,608
KAOLACK,KAOLACK,NDIEDIENG,NDIEDIENG,"NDJIGANE SERERE",55,67,372,397,769
KAOLACK,KAOLACK,NDIEDIENG,NDIEDIENG,"NGONDIAYE PEULH",18,21,133,131,264
KAOLACK,KAOLACK,NDIEDIENG,NDIEDIENG,"NGONDIAYE SERERE",34,39,289,260,549
KAOLACK,KAOLACK,NDIEDIENG,NDIEDIENG,"PAYEMAR ABDOULAYE (PAYEMAR ABDOULAYE DIALLO)",9,10,59,57,116
KAOLACK,KAOLACK,NDIEDIENG,NDIEDIENG,"PAYEMAR AMADY BAIDY",12,12,102,86,188
KAOLACK,KAOLACK,NDIEDIENG,NDIEDIENG,"PAYEMAR BIRAM",9,11,64,53,117
KAOLACK,KAOLACK,NDIEDIENG,NDIEDIENG,"PAYEMAR OUOLOF (PAYEMAR LOYENE)",55,84,513,561,1074
KAOLACK,KAOLACK,NDIEDIENG,NDIEDIENG,"SANTHIE NDIAYENE",7,8,55,55,110
KAOLACK,KAOLACK,NDIEDIENG,NDIEDIENG,"SANTHIOU SAMBOU",22,22,114,125,239
KAOLACK,KAOLACK,NDIEDIENG,NDIEDIENG,"SEKHELA DIARGA",42,44,265,252,517
KAOLACK,KAOLACK,NDIEDIENG,NDIEDIENG,"H1 KEUR ALBERT FAYE",1,1,12,7,19
KAOLACK,KAOLACK,NDIEDIENG,NDIEDIENG,"SEKHELA KOLANE",21,21,145,165,310
KAOLACK,KAOLACK,NDIEDIENG,NDIEDIENG,"TAIBA NIANGHENE",85,104,512,550,1062
KAOLACK,KAOLACK,NDIEDIENG,NDIEDIENG,TALLENE,99,123,675,817,1492
KAOLACK,KAOLACK,NDIEDIENG,NDIEDIENG,"THIAKHO NDJIGANE",31,60,764,554,1318
KAOLACK,KAOLACK,NDIEDIENG,NDIEDIENG,"THIAMENE SAMBA RAMATA",42,69,446,438,884
KAOLACK,KAOLACK,NDIEDIENG,NDIEDIENG,THIECKENE,4,7,42,38,80
KAOLACK,KAOLACK,NDIEDIENG,NDIEDIENG,"THYSSE MASSE",35,43,282,325,607
KAOLACK,KAOLACK,NDIEDIENG,NDIEDIENG,"THYSSE TALLENE",79,103,457,559,1016
KAOLACK,KAOLACK,NDIEDIENG,NDIEDIENG,"KEUR BIRAME MAINA",3,3,16,19,35
KAOLACK,KAOLACK,NDIEDIENG,NDIEDIENG,"KEUR GALLO",3,5,28,16,44
KAOLACK,KAOLACK,KOUMBAL,LATMINGUE,BOYNGUEL,28,38,188,230,418
KAOLACK,KAOLACK,KOUMBAL,LATMINGUE,"CAMPEMENT LATMINGUE",60,69,386,401,787
KAOLACK,KAOLACK,KOUMBAL,LATMINGUE,"H1 SANTHIE BOUCAR",5,5,35,25,60
KAOLACK,KAOLACK,KOUMBAL,LATMINGUE,"DAGA YOUNDOUM BAMBARA",77,95,387,454,841
KAOLACK,KAOLACK,KOUMBAL,LATMINGUE,"DAGA YOUNDOUM WOLOF",36,39,272,241,513
KAOLACK,KAOLACK,KOUMBAL,LATMINGUE,DIAGNEL,61,65,333,335,668
KAOLACK,KAOLACK,KOUMBAL,LATMINGUE,DIALALELE,17,18,150,93,243
KAOLACK,KAOLACK,KOUMBAL,LATMINGUE,"FASS BABA THIANE",35,43,288,270,558
KAOLACK,KAOLACK,KOUMBAL,LATMINGUE,"FASS KHOREDIA",77,106,678,712,1390
KAOLACK,KAOLACK,KOUMBAL,LATMINGUE,HAMDALAYE,3,6,28,23,51
KAOLACK,KAOLACK,KOUMBAL,LATMINGUE,HANENE,93,110,740,731,1471
KAOLACK,KAOLACK,KOUMBAL,LATMINGUE,KADIEL,12,25,125,108,233
KAOLACK,KAOLACK,KOUMBAL,LATMINGUE,KAVIL,80,84,409,392,801
KAOLACK,KAOLACK,KOUMBAL,LATMINGUE,"H1 KEUR KORY de KAVIL",9,10,69,61,130
KAOLACK,KAOLACK,KOUMBAL,LATMINGUE,"KEUR ABDOU KHOULE",18,23,158,100,258
KAOLACK,KAOLACK,KOUMBAL,LATMINGUE,"KEUR ABDOULAYE SOW",4,6,39,41,80
KAOLACK,KAOLACK,KOUMBAL,LATMINGUE,"KEUR ALY AWA",7,8,41,42,83
KAOLACK,KAOLACK,KOUMBAL,LATMINGUE,"KEUR ALY BASSINE",70,75,468,442,910
KAOLACK,KAOLACK,KOUMBAL,LATMINGUE,"KEUR ALY CODE",16,17,95,87,182
KAOLACK,KAOLACK,KOUMBAL,LATMINGUE,"KEUR ALY DABEL",2,2,14,25,39
KAOLACK,KAOLACK,KOUMBAL,LATMINGUE,"KEUR BANDIA",5,6,30,32,62
KAOLACK,KAOLACK,KOUMBAL,LATMINGUE,"KEUR BATHIAM",13,14,66,75,141
KAOLACK,KAOLACK,KOUMBAL,LATMINGUE,"KEUR BATHIE OLO",5,9,39,36,75
KAOLACK,KAOLACK,KOUMBAL,LATMINGUE,"KEUR BIRAME NDONG",6,12,66,83,149
KAOLACK,KAOLACK,KOUMBAL,LATMINGUE,"KEUR BOUNGHARY",35,46,256,197,453
KAOLACK,KAOLACK,KOUMBAL,LATMINGUE,"KEUR DAGA",28,36,207,212,419
KAOLACK,KAOLACK,KOUMBAL,LATMINGUE,"KEUR DAOUR",43,54,424,349,773
KAOLACK,KAOLACK,KOUMBAL,LATMINGUE,"KEUR DEMBA DIAWO",35,37,248,229,477
KAOLACK,KAOLACK,KOUMBAL,LATMINGUE,"KEUR DEMBA DICKY",9,9,39,36,75
KAOLACK,KAOLACK,KOUMBAL,LATMINGUE,"KEUR DIAM DIARY",20,30,142,146,288
KAOLACK,KAOLACK,KOUMBAL,LATMINGUE,"KEUR DIOMBO",9,10,61,55,116
KAOLACK,KAOLACK,KOUMBAL,LATMINGUE,"KEUR DIWRE",14,16,93,71,164
KAOLACK,KAOLACK,KOUMBAL,LATMINGUE,"KEUR EDY",4,6,36,28,64
KAOLACK,KAOLACK,KOUMBAL,LATMINGUE,"KEUR GALLO CISSE",4,4,16,14,30
KAOLACK,KAOLACK,KOUMBAL,LATMINGUE,"KEUR GALLO DEBO",18,20,119,126,245
KAOLACK,KAOLACK,KOUMBAL,LATMINGUE,"KEUR KHASSOUM",29,30,205,163,368
KAOLACK,KAOLACK,KOUMBAL,LATMINGUE,"KEUR MAMOUR LO BAMBARA",32,38,225,199,424
KAOLACK,KAOLACK,KOUMBAL,LATMINGUE,"KEUR MAMOUR LO WOLOF",25,29,204,211,415
KAOLACK,KAOLACK,KOUMBAL,LATMINGUE,"H1 PEULGA",5,6,39,38,77
KAOLACK,KAOLACK,KOUMBAL,LATMINGUE,"KEUR MAMOUR NDOUMBE",4,4,29,29,58
KAOLACK,KAOLACK,KOUMBAL,LATMINGUE,"KEUR MAMOUR SECK",57,67,445,379,824
KAOLACK,KAOLACK,KOUMBAL,LATMINGUE,"KEUR MARY",7,8,45,47,92
KAOLACK,KAOLACK,KOUMBAL,LATMINGUE,"H1 KEUR SENY",11,14,96,78,174
KAOLACK,KAOLACK,KOUMBAL,LATMINGUE,"H2 SINTHIOU",11,14,90,86,176
KAOLACK,KAOLACK,KOUMBAL,LATMINGUE,"KEUR MODY SALLA",23,29,192,176,368
KAOLACK,KAOLACK,KOUMBAL,LATMINGUE,"KEUR MODY SOW",2,2,18,9,27
KAOLACK,KAOLACK,KOUMBAL,LATMINGUE,"H1 KEUR EL HADJI  HARANDE",7,8,39,35,74
KAOLACK,KAOLACK,KOUMBAL,LATMINGUE,"KEUR MOR SOUTE",48,59,366,363,729
KAOLACK,KAOLACK,KOUMBAL,LATMINGUE,"KEUR NDIANG",42,59,322,449,771
KAOLACK,KAOLACK,KOUMBAL,LATMINGUE,"H1 KEUR KORY de KEUR NDIANG",5,6,25,27,52
KAOLACK,KAOLACK,KOUMBAL,LATMINGUE,"THICATH KEUR NDONGO",2,3,22,36,58
KAOLACK,KAOLACK,KOUMBAL,LATMINGUE,"KEUR NDONGO KOUMBAL",10,14,85,96,181
KAOLACK,KAOLACK,KOUMBAL,LATMINGUE,"KEUR OMAR BAMBARA",34,39,184,201,385
KAOLACK,KAOLACK,KOUMBAL,LATMINGUE,"KEUR OMAR WOLOF",30,31,153,187,340
KAOLACK,KAOLACK,KOUMBAL,LATMINGUE,"H1 KEUR NGOLLO",15,16,97,91,188
KAOLACK,KAOLACK,KOUMBAL,LATMINGUE,"KEUR OMAR PEULH",10,11,78,74,152
KAOLACK,KAOLACK,KOUMBAL,LATMINGUE,"KEUR PATHE",22,27,162,169,331
KAOLACK,KAOLACK,KOUMBAL,LATMINGUE,"KEUR SANOU",28,35,171,163,334
KAOLACK,KAOLACK,KOUMBAL,LATMINGUE,"KEUR SASSOUNA",13,17,106,86,192
KAOLACK,KAOLACK,KOUMBAL,LATMINGUE,"KEUR SOUKOUM",7,7,55,54,109
KAOLACK,KAOLACK,KOUMBAL,LATMINGUE,"KEUR SOUTOURA DIOMBO",7,8,48,55,103
KAOLACK,KAOLACK,KOUMBAL,LATMINGUE,"KEUR TAIBA OUOLOF",17,19,86,98,184
KAOLACK,KAOLACK,KOUMBAL,LATMINGUE,"H1 KEUR SARABA",5,7,45,41,86
KAOLACK,KAOLACK,KOUMBAL,LATMINGUE,"H2 SANTHIE MBAYE NDIAYE",16,20,114,137,251
KAOLACK,KAOLACK,KOUMBAL,LATMINGUE,"KEUR TAIBA PEULH",9,16,85,79,164
KAOLACK,KAOLACK,KOUMBAL,LATMINGUE,"H1 KEUR BIRAME",11,12,67,74,141
KAOLACK,KAOLACK,KOUMBAL,LATMINGUE,"KEUR YEDY",13,20,90,83,173
KAOLACK,KAOLACK,KOUMBAL,LATMINGUE,"KEUR YORODOU BAMBARA",32,37,241,210,451
KAOLACK,KAOLACK,KOUMBAL,LATMINGUE,"KEUR YORODOU WOLOF",39,47,226,353,579
KAOLACK,KAOLACK,KOUMBAL,LATMINGUE,KOUMBAL,169,189,1110,1133,2243
KAOLACK,KAOLACK,KOUMBAL,LATMINGUE,"KOYLAL ALPHA (KOYLAL BAMBARA)",47,49,303,285,588
KAOLACK,KAOLACK,KOUMBAL,LATMINGUE,"KOYLAL MOUSSA BOYE",69,80,496,492,988
KAOLACK,KAOLACK,KOUMBAL,LATMINGUE,LATMINGUE,381,475,2374,2434,4808
KAOLACK,KAOLACK,KOUMBAL,LATMINGUE,"H1 DAGA SAER",11,13,55,60,115
KAOLACK,KAOLACK,KOUMBAL,LATMINGUE,LOHENE,5,6,33,36,69
KAOLACK,KAOLACK,KOUMBAL,LATMINGUE,"MEDINA EL HADJI SAMBA DIAWARA",31,39,194,164,358
KAOLACK,KAOLACK,KOUMBAL,LATMINGUE,"MEDINA MAKA",7,7,51,51,102
KAOLACK,KAOLACK,KOUMBAL,LATMINGUE,"H1 SANTHIABA",28,33,303,313,616
KAOLACK,KAOLACK,KOUMBAL,LATMINGUE,NAOUDOUROU,12,18,97,110,207
KAOLACK,KAOLACK,KOUMBAL,LATMINGUE,NDANGANE,7,16,77,66,143
KAOLACK,KAOLACK,KOUMBAL,LATMINGUE,NDIAYENE,18,21,147,148,295
KAOLACK,KAOLACK,KOUMBAL,LATMINGUE,NDILLE,47,53,397,363,760
KAOLACK,KAOLACK,KOUMBAL,LATMINGUE,NDIONGUENE,19,23,161,179,340
KAOLACK,KAOLACK,KOUMBAL,LATMINGUE,NDIOUFFENE,8,11,82,74,156
KAOLACK,KAOLACK,KOUMBAL,LATMINGUE,NIASSENE,10,13,81,87,168
KAOLACK,KAOLACK,KOUMBAL,LATMINGUE,"SANGUIL MARY",3,4,19,38,57
KAOLACK,KAOLACK,KOUMBAL,LATMINGUE,"SANGUIL SERERE",77,90,606,634,1240
KAOLACK,KAOLACK,KOUMBAL,LATMINGUE,"SANGUIL YIGO",21,31,192,169,361
KAOLACK,KAOLACK,KOUMBAL,LATMINGUE,"SANTHIE ALIOU MBAYE",37,40,243,224,467
KAOLACK,KAOLACK,KOUMBAL,LATMINGUE,"THIAKHO MADIALE",111,124,658,645,1303
KAOLACK,KAOLACK,KOUMBAL,LATMINGUE,THIALANE,41,48,304,299,603
KAOLACK,KAOLACK,KOUMBAL,LATMINGUE,"THIAMENE BAMBARA",43,46,312,299,611
KAOLACK,KAOLACK,KOUMBAL,LATMINGUE,THIAWANDOU,83,94,872,600,1472
KAOLACK,KAOLACK,KOUMBAL,LATMINGUE,"H1 KEUR GALLO DELBY",4,4,35,34,69
KAOLACK,KAOLACK,KOUMBAL,LATMINGUE,"THICATH DIERY",44,55,203,247,450
KAOLACK,KAOLACK,KOUMBAL,LATMINGUE,"H1 KEUR PATHE",8,10,51,73,124
KAOLACK,KAOLACK,KOUMBAL,LATMINGUE,"H2 KEUR NDIOBA",9,13,76,77,153
KAOLACK,KAOLACK,KOUMBAL,LATMINGUE,"H3 KEUR ALHAMDOU",1,1,6,6,12
KAOLACK,KAOLACK,KOUMBAL,THIARE,"DAROU PAKATHIAR",64,75,493,536,1029
KAOLACK,KAOLACK,KOUMBAL,THIARE,GADIO,19,29,143,164,307
KAOLACK,KAOLACK,KOUMBAL,THIARE,"H1 TIVAOUANE OUOLOF",6,8,37,58,95
KAOLACK,KAOLACK,KOUMBAL,THIARE,KERVAL,59,79,483,348,831
KAOLACK,KAOLACK,KOUMBAL,THIARE,"KEUR BANO",22,26,191,171,362
KAOLACK,KAOLACK,KOUMBAL,THIARE,"KEUR BOCAR",22,24,162,134,296
KAOLACK,KAOLACK,KOUMBAL,THIARE,"KEUR DIABEL",17,24,189,149,338
KAOLACK,KAOLACK,KOUMBAL,THIARE,"KEUR GALLO",11,13,69,65,134
KAOLACK,KAOLACK,KOUMBAL,THIARE,"H1 KEUR MODY DIAO",11,16,79,66,145
KAOLACK,KAOLACK,KOUMBAL,THIARE,"KEUR KHOUSSENE",32,34,153,239,392
KAOLACK,KAOLACK,KOUMBAL,THIARE,"H1 KEUR ILLO",3,7,33,32,65
KAOLACK,KAOLACK,KOUMBAL,THIARE,"KEUR MALLE",52,60,386,393,779
KAOLACK,KAOLACK,KOUMBAL,THIARE,"KEUR MAMOUR",9,12,90,111,201
KAOLACK,KAOLACK,KOUMBAL,THIARE,"KEUR MANDIAYE",41,50,272,349,621
KAOLACK,KAOLACK,KOUMBAL,THIARE,"KEUR NDIAGA",38,63,406,358,764
KAOLACK,KAOLACK,KOUMBAL,THIARE,"KEUR NDOUDY",26,31,201,190,391
KAOLACK,KAOLACK,KOUMBAL,THIARE,"KEUR SAFADY",87,104,731,776,1507
KAOLACK,KAOLACK,KOUMBAL,THIARE,"KEUR SAMBA NDIATY",15,18,145,122,267
KAOLACK,KAOLACK,KOUMBAL,THIARE,"KEUR SERIGNE BASSIROU",52,57,399,422,821
KAOLACK,KAOLACK,KOUMBAL,THIARE,"KEUR SERIGNE DRAME",32,44,307,330,637
KAOLACK,KAOLACK,KOUMBAL,THIARE,"KEUR SETTE AWA",77,89,522,596,1118
KAOLACK,KAOLACK,KOUMBAL,THIARE,"KEUR SETTE DIOP",34,39,174,217,391
KAOLACK,KAOLACK,KOUMBAL,THIARE,"KOCKY SALOUM",54,61,425,364,789
KAOLACK,KAOLACK,KOUMBAL,THIARE,"KOUMPETHIE NDIENGUENE",42,43,322,302,624
KAOLACK,KAOLACK,KOUMBAL,THIARE,"KOUMPETHIE SERERE",32,34,231,248,479
KAOLACK,KAOLACK,KOUMBAL,THIARE,"KOUMPETHIE THIAMENE",49,57,367,355,722
KAOLACK,KAOLACK,KOUMBAL,THIARE,LEWE,23,24,190,188,378
KAOLACK,KAOLACK,KOUMBAL,THIARE,"MAKA FASS",59,69,440,543,983
KAOLACK,KAOLACK,KOUMBAL,THIARE,MALEME,8,11,65,77,142
KAOLACK,KAOLACK,KOUMBAL,THIARE,"MEDINA BABOU",41,46,251,314,565
KAOLACK,KAOLACK,KOUMBAL,THIARE,"MEDINA NDEURY",18,27,160,134,294
KAOLACK,KAOLACK,KOUMBAL,THIARE,"MOULA BIDJI",4,6,30,22,52
KAOLACK,KAOLACK,KOUMBAL,THIARE,"H1 MAMADOU SIRA",3,5,31,39,70
KAOLACK,KAOLACK,KOUMBAL,THIARE,"MOULA MAMOUR",21,23,151,170,321
KAOLACK,KAOLACK,KOUMBAL,THIARE,"MOULA NDIAGA",36,44,237,277,514
KAOLACK,KAOLACK,KOUMBAL,THIARE,NDAME,37,46,355,288,643
KAOLACK,KAOLACK,KOUMBAL,THIARE,NDIAMBOUR,32,40,232,278,510
KAOLACK,KAOLACK,KOUMBAL,THIARE,NDINDY,9,9,76,78,154
KAOLACK,KAOLACK,KOUMBAL,THIARE,NDIORENE,33,41,245,219,464
KAOLACK,KAOLACK,KOUMBAL,THIARE,NDOUNE,14,15,97,88,185
KAOLACK,KAOLACK,KOUMBAL,THIARE,NGAMBY,51,66,429,408,837
KAOLACK,KAOLACK,KOUMBAL,THIARE,"H1 KEUR AMATH THIAM",6,6,32,37,69
KAOLACK,KAOLACK,KOUMBAL,THIARE,"PACATHIAR KHAYES",17,20,138,124,262
KAOLACK,KAOLACK,KOUMBAL,THIARE,"PAKATHIAR NDAWENE",42,60,385,284,669
KAOLACK,KAOLACK,KOUMBAL,THIARE,"PAKATHIAR EL HADJI (PACATHIAR SECCO)",33,42,256,284,540
KAOLACK,KAOLACK,KOUMBAL,THIARE,"SANTHIE MBAYENE",13,26,186,133,319
KAOLACK,KAOLACK,KOUMBAL,THIARE,"SANTHIOU GALLO",10,13,88,94,182
KAOLACK,KAOLACK,KOUMBAL,THIARE,"SATHIE BOUGOUME",42,45,304,328,632
KAOLACK,KAOLACK,KOUMBAL,THIARE,"H1 KEUR BIDJI PEULH",5,5,36,37,73
KAOLACK,KAOLACK,KOUMBAL,THIARE,"SENALA KEUR ABDOU",26,34,181,196,377
KAOLACK,KAOLACK,KOUMBAL,THIARE,"SENALA KEUR DIABEL",62,102,568,547,1115
KAOLACK,KAOLACK,KOUMBAL,THIARE,"H1 KEUR EL MOTH DIALE",9,9,54,62,116
KAOLACK,KAOLACK,KOUMBAL,THIARE,"H3 KEUR DIAME",3,3,20,13,33
KAOLACK,KAOLACK,KOUMBAL,THIARE,"H4 KEUR MEDOUNE",6,6,34,26,60
KAOLACK,KAOLACK,KOUMBAL,THIARE,"SENALA KEUR MATAR",41,46,279,312,591
KAOLACK,KAOLACK,KOUMBAL,THIARE,SOME,37,46,310,270,580
KAOLACK,KAOLACK,KOUMBAL,THIARE,"TAIBA MOMATH",25,36,213,223,436
KAOLACK,KAOLACK,KOUMBAL,THIARE,TAIF,22,22,168,136,304
KAOLACK,KAOLACK,KOUMBAL,THIARE,"THIAKHO MATAR",67,77,493,634,1127
KAOLACK,KAOLACK,KOUMBAL,THIARE,"THIAKHO MATY",83,107,639,605,1244
KAOLACK,KAOLACK,KOUMBAL,THIARE,"THIANGA EL HADJI MOMATH",54,65,452,466,918
KAOLACK,KAOLACK,KOUMBAL,THIARE,"H1 KEUR BIDJI",22,23,163,179,342
KAOLACK,KAOLACK,KOUMBAL,THIARE,"THIANGA KEUR DIABEL",60,75,476,458,934
KAOLACK,KAOLACK,KOUMBAL,THIARE,"THIANGA LAHINE",35,55,500,374,874
KAOLACK,KAOLACK,KOUMBAL,THIARE,"THIANGA OMAR (THIANGA GOUMACK)",24,26,169,213,382
KAOLACK,KAOLACK,KOUMBAL,THIARE,THIARE,140,180,1076,1070,2146
KAOLACK,KAOLACK,KOUMBAL,THIARE,THINDOGNE,78,87,555,474,1029
KAOLACK,KAOLACK,KOUMBAL,THIARE,TOUBA,18,22,116,89,205
KAOLACK,KAOLACK,KOUMBAL,"KEUR BAKA","DAROU KHOUDOSS",16,25,160,159,319
KAOLACK,KAOLACK,KOUMBAL,"KEUR BAKA","DAROU MARNANE",30,31,183,202,385
KAOLACK,KAOLACK,KOUMBAL,"KEUR BAKA","FASS NGAYENNE (SANTHIOU BARAJI SARE ALY )",9,10,71,61,132
KAOLACK,KAOLACK,KOUMBAL,"KEUR BAKA","GANDA OUOLOF",28,37,369,252,621
KAOLACK,KAOLACK,KOUMBAL,"KEUR BAKA","H1 KEUR LEITY",1,4,35,21,56
KAOLACK,KAOLACK,KOUMBAL,"KEUR BAKA","GANDA PEULH",14,20,136,135,271
KAOLACK,KAOLACK,KOUMBAL,"KEUR BAKA",GOBACK,40,50,218,219,437
KAOLACK,KAOLACK,KOUMBAL,"KEUR BAKA","H1 KEUR NGAHAM",3,5,36,39,75
KAOLACK,KAOLACK,KOUMBAL,"KEUR BAKA","KEUR ABDOU DIANGO",29,37,303,351,654
KAOLACK,KAOLACK,KOUMBAL,"KEUR BAKA","KEUR ABDOU FATIM",6,6,53,61,114
KAOLACK,KAOLACK,KOUMBAL,"KEUR BAKA","KEUR ABLAYE MARAME",17,23,149,176,325
KAOLACK,KAOLACK,KOUMBAL,"KEUR BAKA","KEUR ALASSANE DIAW",16,18,127,113,240
KAOLACK,KAOLACK,KOUMBAL,"KEUR BAKA","KEUR AMATH NGONE",13,32,147,129,276
KAOLACK,KAOLACK,KOUMBAL,"KEUR BAKA","H1 KEUR YORO",4,11,38,41,79
KAOLACK,KAOLACK,KOUMBAL,"KEUR BAKA","KEUR BACAR BARRY",1,1,12,8,20
KAOLACK,KAOLACK,KOUMBAL,"KEUR BAKA","KEUR BAKA",87,95,479,504,983
KAOLACK,KAOLACK,KOUMBAL,"KEUR BAKA","KEUR BALLA (DAROU KEUR BALLA)",40,41,187,287,474
KAOLACK,KAOLACK,KOUMBAL,"KEUR BAKA","KEUR BAME",11,12,89,88,177
KAOLACK,KAOLACK,KOUMBAL,"KEUR BAKA","KEUR DEMBA M’BACKERY",14,16,96,71,167
KAOLACK,KAOLACK,KOUMBAL,"KEUR BAKA","KEUR GALLO",18,18,141,108,249
KAOLACK,KAOLACK,KOUMBAL,"KEUR BAKA","KEUR KABE",17,19,74,130,204
KAOLACK,KAOLACK,KOUMBAL,"KEUR BAKA","KEUR LIMBY (GOBACK LIMBY)",29,35,197,170,367
KAOLACK,KAOLACK,KOUMBAL,"KEUR BAKA","KEUR MAISSA",14,14,110,90,200
KAOLACK,KAOLACK,KOUMBAL,"KEUR BAKA","KEUR MALICK DIAW OUOLOF",22,26,177,215,392
KAOLACK,KAOLACK,KOUMBAL,"KEUR BAKA","KEUR MALICK DIAW PEULH",14,17,143,126,269
KAOLACK,KAOLACK,KOUMBAL,"KEUR BAKA","H1 KEUR SADER",8,14,86,75,161
KAOLACK,KAOLACK,KOUMBAL,"KEUR BAKA","KEUR MARI",11,17,109,82,191
KAOLACK,KAOLACK,KOUMBAL,"KEUR BAKA","KEUR MBAYE NDONG",23,25,108,134,242
KAOLACK,KAOLACK,KOUMBAL,"KEUR BAKA","KEUR NGOR",30,35,260,230,490
KAOLACK,KAOLACK,KOUMBAL,"KEUR BAKA","KEUR SERIGNE BABOU",39,49,207,292,499
KAOLACK,KAOLACK,KOUMBAL,"KEUR BAKA","KEUR SOULEYE BOUSSO",4,4,14,19,33
KAOLACK,KAOLACK,KOUMBAL,"KEUR BAKA","KEUR SOUTOURA EGUE",7,12,59,57,116
KAOLACK,KAOLACK,KOUMBAL,"KEUR BAKA","KEUR SOUTOURA PEULH",10,12,72,78,150
KAOLACK,KAOLACK,KOUMBAL,"KEUR BAKA","KEUR SOUTOURA TOUCOULEUR",48,63,411,420,831
KAOLACK,KAOLACK,KOUMBAL,"KEUR BAKA","KEUR WACK (KEUR WACK NIANG)",37,49,327,297,624
KAOLACK,KAOLACK,KOUMBAL,"KEUR BAKA","KONE ALY",18,19,138,142,280
KAOLACK,KAOLACK,KOUMBAL,"KEUR BAKA","KONE PEULH",16,19,144,120,264
KAOLACK,KAOLACK,KOUMBAL,"KEUR BAKA","KONE SERERE",28,36,258,272,530
KAOLACK,KAOLACK,KOUMBAL,"KEUR BAKA","MBADIENE (MBADIENE LAGHEM)",49,54,357,335,692
KAOLACK,KAOLACK,KOUMBAL,"KEUR BAKA","MBAMB (MBAMB LAGHEM)",92,103,463,506,969
KAOLACK,KAOLACK,KOUMBAL,"KEUR BAKA","MBAMB DIADJI",8,13,75,74,149
KAOLACK,KAOLACK,KOUMBAL,"KEUR BAKA","MBASS (MBOSS LAGHEM)",34,34,241,190,431
KAOLACK,KAOLACK,KOUMBAL,"KEUR BAKA","MBAYLAR OUOLOF",50,67,465,425,890
KAOLACK,KAOLACK,KOUMBAL,"KEUR BAKA","MBAYLAR PEULH",30,38,210,251,461
KAOLACK,KAOLACK,KOUMBAL,"KEUR BAKA","MEDINA NDAWENE",40,92,278,307,585
KAOLACK,KAOLACK,KOUMBAL,"KEUR BAKA","MEDINA NDIAYENE",7,7,37,37,74
KAOLACK,KAOLACK,KOUMBAL,"KEUR BAKA",NDIAME,21,29,173,161,334
KAOLACK,KAOLACK,KOUMBAL,"KEUR BAKA",NDOBENE,42,49,248,351,599
KAOLACK,KAOLACK,KOUMBAL,"KEUR BAKA","H1 KEUR NDANE",7,9,72,54,126
KAOLACK,KAOLACK,KOUMBAL,"KEUR BAKA",NGONDY,70,117,816,870,1686
KAOLACK,KAOLACK,KOUMBAL,"KEUR BAKA",PARACELLE,17,17,138,96,234
KAOLACK,KAOLACK,KOUMBAL,"KEUR BAKA",SAMBANDE,76,84,465,436,901
KAOLACK,KAOLACK,KOUMBAL,"KEUR BAKA","SANTHIOU FASS (KEUR MOR YACINE)",13,15,139,174,313
KAOLACK,KAOLACK,KOUMBAL,"KEUR BAKA","H1 KEUR BALLA",4,4,18,23,41
KAOLACK,KAOLACK,KOUMBAL,"KEUR BAKA","SANTHIOU GAPAKH",42,54,361,360,721
KAOLACK,KAOLACK,KOUMBAL,"KEUR BAKA","SANTHIOU MBOUTOU",24,27,161,114,275
KAOLACK,KAOLACK,KOUMBAL,"KEUR BAKA","SARE ALY (SARE ALCODE)",7,7,50,50,100
KAOLACK,KAOLACK,KOUMBAL,"KEUR BAKA","SARE DIAMBA",22,27,183,171,354
KAOLACK,KAOLACK,KOUMBAL,"KEUR BAKA","SARE GATTY",78,92,567,524,1091
KAOLACK,KAOLACK,KOUMBAL,"KEUR BAKA",SELLICK,88,99,561,528,1089
KAOLACK,KAOLACK,KOUMBAL,"KEUR BAKA",SIKATROUM,117,132,691,708,1399
KAOLACK,KAOLACK,KOUMBAL,"KEUR BAKA","SINDIANE SELLICK",15,18,124,111,235
KAOLACK,KAOLACK,KOUMBAL,"KEUR BAKA","TANDA BAR",67,85,463,500,963
KAOLACK,KAOLACK,KOUMBAL,"KEUR BAKA","TANDA MBOUDAYE",82,95,511,552,1063
KAOLACK,KAOLACK,KOUMBAL,"KEUR BAKA","THIANDERY (KEUR THIANDERY)",44,61,386,398,784
KAOLACK,KAOLACK,KOUMBAL,"KEUR BAKA",THIARIACK,81,92,443,410,853
KAOLACK,KAOLACK,KOUMBAL,NDOFFANE,"DAROU SALAM NORD",437,522,2131,2354,4485
KAOLACK,KAOLACK,KOUMBAL,NDOFFANE,"DAROU SALAM SUD",271,309,1223,1403,2626
KAOLACK,KAOLACK,KOUMBAL,NDOFFANE,DIAMAGUENE,312,403,2018,2270,4288
KAOLACK,KAOLACK,KOUMBAL,NDOFFANE,"KEUR DAME LEYE",20,22,98,106,204
KAOLACK,KAOLACK,KOUMBAL,NDOFFANE,"KEUR SAMBA NGOUFFA",8,8,34,36,70
KAOLACK,KAOLACK,KOUMBAL,NDOFFANE,"KEUR SERIGNE BAKARY",21,33,136,199,335
KAOLACK,KAOLACK,KOUMBAL,NDOFFANE,LEONA,145,252,810,954,1764
KAOLACK,KAOLACK,KOUMBAL,NDOFFANE,"MALO MALO",6,11,78,80,158
KAOLACK,KAOLACK,KOUMBAL,NDOFFANE,MBASSABOU,4,6,26,18,44
KAOLACK,KAOLACK,KOUMBAL,NDOFFANE,"PONE PONE",21,27,178,172,350
KAOLACK,KAOLACK,KOUMBAL,NDOFFANE,"SIX ROUTES",266,324,1406,1566,2972
KAOLACK,KAOLACK,KOUMBAL,NDOFFANE,THIERERE,144,201,788,890,1678
KAOLACK,KAOLACK,NGOTHIE,DYA,DAROU,34,43,337,357,694
KAOLACK,KAOLACK,NGOTHIE,DYA,DIAGLE,8,13,75,87,162
KAOLACK,KAOLACK,NGOTHIE,DYA,DIEMOUL,106,129,1018,462,1480
KAOLACK,KAOLACK,NGOTHIE,DYA,"DIOKOUL PEULH",9,11,68,72,140
KAOLACK,KAOLACK,NGOTHIE,DYA,"H1 DAROU KIBARY",5,5,27,29,56
KAOLACK,KAOLACK,NGOTHIE,DYA,"H2 DIAMBODE",4,4,37,35,72
KAOLACK,KAOLACK,NGOTHIE,DYA,"H3 KEUR MASS",2,3,19,15,34
KAOLACK,KAOLACK,NGOTHIE,DYA,"H4 WOURO BOUGOUTE",5,5,23,17,40
KAOLACK,KAOLACK,NGOTHIE,DYA,"H5 DAROU KIBARY",8,10,106,67,173
KAOLACK,KAOLACK,NGOTHIE,DYA,"H6 WOUROU NDIOUGA",6,8,58,39,97
KAOLACK,KAOLACK,NGOTHIE,DYA,"DIOKOUL SERERE",65,65,237,273,510
KAOLACK,KAOLACK,NGOTHIE,DYA,"H1 DAGA DIARAF",9,18,201,190,391
KAOLACK,KAOLACK,NGOTHIE,DYA,"DIOKOUL SOB 1",15,20,139,122,261
KAOLACK,KAOLACK,NGOTHIE,DYA,"H1 THIADJI",17,24,196,188,384
KAOLACK,KAOLACK,NGOTHIE,DYA,"H2 BAGALAR",9,12,82,67,149
KAOLACK,KAOLACK,NGOTHIE,DYA,DYA,97,142,578,623,1201
KAOLACK,KAOLACK,NGOTHIE,DYA,"H1 KOUKOUNOU",16,25,219,188,407
KAOLACK,KAOLACK,NGOTHIE,DYA,"H2 DYA TOCK",3,9,48,70,118
KAOLACK,KAOLACK,NGOTHIE,DYA,GOMONE,33,39,244,189,433
KAOLACK,KAOLACK,NGOTHIE,DYA,"H1 KEUR DIEGANE SAMB",8,12,47,45,92
KAOLACK,KAOLACK,NGOTHIE,DYA,"H2 SARARE",9,14,71,87,158
KAOLACK,KAOLACK,NGOTHIE,DYA,"H3 BELAOBE ( GOMONE)",12,17,109,103,212
KAOLACK,KAOLACK,NGOTHIE,DYA,"KEUR DIOGOYE NDIAYE",22,26,191,161,352
KAOLACK,KAOLACK,NGOTHIE,DYA,"KEUR MACODOU FOUNE",23,35,285,254,539
KAOLACK,KAOLACK,NGOTHIE,DYA,"KEUR MAMADOU NDAO",19,22,126,153,279
KAOLACK,KAOLACK,NGOTHIE,DYA,"KEUR NDENE COUMBA SARR",10,14,94,101,195
KAOLACK,KAOLACK,NGOTHIE,DYA,"H1 KEUR AMATH NDONG",6,10,56,56,112
KAOLACK,KAOLACK,NGOTHIE,DYA,"H2 BELAOBE (KEUR NDENE COUMBA SARR)",4,6,32,60,92
KAOLACK,KAOLACK,NGOTHIE,DYA,"KEUR NDENE NDAO",10,10,53,63,116
KAOLACK,KAOLACK,NGOTHIE,DYA,"H1 BIDJI TOCK",23,31,199,187,386
KAOLACK,KAOLACK,NGOTHIE,DYA,"H2 KEUR NDENE SANTHIE",6,9,34,55,89
KAOLACK,KAOLACK,NGOTHIE,DYA,"H3 NDAR GOU NDAW",4,9,94,91,185
KAOLACK,KAOLACK,NGOTHIE,DYA,"H4 NGOLKHAYAYE",30,44,205,198,403
KAOLACK,KAOLACK,NGOTHIE,DYA,"H5 BIDJI",7,9,69,50,119
KAOLACK,KAOLACK,NGOTHIE,DYA,"KEUR SENGHANE",13,17,75,81,156
KAOLACK,KAOLACK,NGOTHIE,DYA,"H1 KEUR FASARE",3,4,26,18,44
KAOLACK,KAOLACK,NGOTHIE,DYA,"KEUR SOUKA",18,26,140,138,278
KAOLACK,KAOLACK,NGOTHIE,DYA,"KEUR WALY",10,14,71,72,143
KAOLACK,KAOLACK,NGOTHIE,DYA,KHOMBOLE,19,19,92,98,190
KAOLACK,KAOLACK,NGOTHIE,DYA,MBODIENE,12,16,78,98,176
KAOLACK,KAOLACK,NGOTHIE,DYA,"H1 KEUR NGOR DIOUF",4,6,21,25,46
KAOLACK,KAOLACK,NGOTHIE,DYA,NDIOCKEL,19,19,139,126,265
KAOLACK,KAOLACK,NGOTHIE,DYA,"NDIOURBEL GOR",13,15,100,91,191
KAOLACK,KAOLACK,NGOTHIE,DYA,"NDIOURBEL SABOUR",12,14,109,83,192
KAOLACK,KAOLACK,NGOTHIE,DYA,"H1 NDIOURBEL PEULH",4,4,43,48,91
KAOLACK,KAOLACK,NGOTHIE,DYA,"H2 NDIOURBEL SERERE",6,7,60,41,101
KAOLACK,KAOLACK,NGOTHIE,DYA,"NGANE (NGANE DIOGOU)",4,7,37,44,81
KAOLACK,KAOLACK,NGOTHIE,DYA,"H1 NGANE SERERE",19,30,172,170,342
KAOLACK,KAOLACK,NGOTHIE,DYA,"H2 KEUR DIOKEL SARR",1,1,4,4,8
KAOLACK,KAOLACK,NGOTHIE,DYA,"H3 SAGNE SERERE",15,19,154,145,299
KAOLACK,KAOLACK,NGOTHIE,DYA,"H4 HALTE NGANE",29,31,155,183,338
KAOLACK,KAOLACK,NGOTHIE,DYA,"H5 SAGNE PEULH",5,9,50,55,105
KAOLACK,KAOLACK,NGOTHIE,DYA,NGAPPE,25,33,148,159,307
KAOLACK,KAOLACK,NGOTHIE,DYA,"H1 YINGUELE",13,23,183,179,362
KAOLACK,KAOLACK,NGOTHIE,DYA,NGONSY,18,24,155,182,337
KAOLACK,KAOLACK,NGOTHIE,DYA,NGOTHIE,221,257,1189,1170,2359
KAOLACK,KAOLACK,NGOTHIE,DYA,"H1 BAGUI",4,5,45,57,102
KAOLACK,KAOLACK,NGOTHIE,DYA,"SAGNE BAMBARA",61,65,371,295,666
KAOLACK,KAOLACK,NGOTHIE,DYA,"H2 NGUALAKHAYE",6,7,38,21,59
KAOLACK,KAOLACK,NGOTHIE,DYA,"H3 NGARIGNE",16,24,133,141,274
KAOLACK,KAOLACK,NGOTHIE,DYA,"H4 NGALKHAYAYE",2,4,26,23,49
KAOLACK,KAOLACK,NGOTHIE,DYA,SIKHANE,27,44,236,240,476
KAOLACK,KAOLACK,NGOTHIE,DYA,"H1 DIENE NDONG",3,3,29,20,49
KAOLACK,KAOLACK,NGOTHIE,DYA,"H2 NDIOWANE",13,17,112,139,251
KAOLACK,KAOLACK,NGOTHIE,DYA,"H3 NGANE 2",1,2,17,14,31
KAOLACK,KAOLACK,NGOTHIE,DYA,"SOB 2",45,54,380,355,735
KAOLACK,KAOLACK,NGOTHIE,DYA,THIALAPE,15,18,78,75,153
KAOLACK,KAOLACK,NGOTHIE,DYA,"H1 SINTHIANE",6,7,38,50,88
KAOLACK,KAOLACK,NGOTHIE,DYA,TOUCAR,17,21,152,140,292
KAOLACK,KAOLACK,NGOTHIE,DYA,"KEUR DIOMAYE DIOUF",3,4,43,56,99
KAOLACK,KAOLACK,NGOTHIE,NDIEBEL,BABOL,9,12,103,102,205
KAOLACK,KAOLACK,NGOTHIE,NDIEBEL,"H1 BABOL PEULH",7,7,36,38,74
KAOLACK,KAOLACK,NGOTHIE,NDIEBEL,"H2 KEUR COUMBA KOR DIOUF",2,3,26,20,46
KAOLACK,KAOLACK,NGOTHIE,NDIEBEL,"H2 KEUR ALASSANE DIENG",1,2,17,13,30
KAOLACK,KAOLACK,NGOTHIE,NDIEBEL,"H3 KEUR NDIOL DIAGNE",2,2,17,19,36
KAOLACK,KAOLACK,NGOTHIE,NDIEBEL,"H4 KEUR SAMBA BOCOUM",4,4,28,26,54
KAOLACK,KAOLACK,NGOTHIE,NDIEBEL,"H5 KEUR MAMADOU FAYE",2,2,6,11,17
KAOLACK,KAOLACK,NGOTHIE,NDIEBEL,"H6 KEUR DJIBY BOCOUM",1,2,6,8,14
KAOLACK,KAOLACK,NGOTHIE,NDIEBEL,"H7 KEUR BIRAME SARR",1,2,13,10,23
KAOLACK,KAOLACK,NGOTHIE,NDIEBEL,"H8 KEUR MANDIAYE FALL",3,4,19,20,39
KAOLACK,KAOLACK,NGOTHIE,NDIEBEL,"BELEL GADIALY",38,52,349,304,653
KAOLACK,KAOLACK,NGOTHIE,NDIEBEL,"H1 KAWSARA FALL",5,8,51,55,106
KAOLACK,KAOLACK,NGOTHIE,NDIEBEL,BODIONE,20,23,209,185,394
KAOLACK,KAOLACK,NGOTHIE,NDIEBEL,"H1 KEUR NGOR TINE",3,3,19,18,37
KAOLACK,KAOLACK,NGOTHIE,NDIEBEL,"BOUBY NDYAME",12,12,60,53,113
KAOLACK,KAOLACK,NGOTHIE,NDIEBEL,DIAMSIRA,25,45,260,258,518
KAOLACK,KAOLACK,NGOTHIE,NDIEBEL,"H1 BELELE NGONE",3,6,38,29,67
KAOLACK,KAOLACK,NGOTHIE,NDIEBEL,"DIAT MOURY KEUR MALICK NDIAYE",12,14,128,105,233
KAOLACK,KAOLACK,NGOTHIE,NDIEBEL,GOWETHIE,6,11,57,42,99
KAOLACK,KAOLACK,NGOTHIE,NDIEBEL,"H1 BOULY BOGUEL",27,30,186,180,366
KAOLACK,KAOLACK,NGOTHIE,NDIEBEL,"KARNDIANE (NGOTHIENE)",24,41,244,200,444
KAOLACK,KAOLACK,NGOTHIE,NDIEBEL,"H1 KEUR JOSEPH SENE",1,3,13,13,26
KAOLACK,KAOLACK,NGOTHIE,NDIEBEL,"KEUR BAMBA LEBA (KEUR LEBA)",12,16,92,92,184
KAOLACK,KAOLACK,NGOTHIE,NDIEBEL,"KEUR MADIOUF (KEUR NGARYGNE)",25,37,222,195,417
KAOLACK,KAOLACK,NGOTHIE,NDIEBEL,"H1 SASSEME",5,6,62,48,110
KAOLACK,KAOLACK,NGOTHIE,NDIEBEL,"H2 KEUR SOBEL",9,13,117,101,218
KAOLACK,KAOLACK,NGOTHIE,NDIEBEL,"KEUR MBAGNE DIOP 1",43,51,246,264,510
KAOLACK,KAOLACK,NGOTHIE,NDIEBEL,"H1 FAMBARA",11,11,101,103,204
KAOLACK,KAOLACK,NGOTHIE,NDIEBEL,"H2 TOKHAKHAL",5,8,37,37,74
KAOLACK,KAOLACK,NGOTHIE,NDIEBEL,"H3 KEUR NGOR DEB DIOP",8,11,103,88,191
KAOLACK,KAOLACK,NGOTHIE,NDIEBEL,"KEUR MBAGNE DIOP 2",13,26,149,152,301
KAOLACK,KAOLACK,NGOTHIE,NDIEBEL,"H1 KEUR MBAGNE DIOP NDIAYE",8,11,77,70,147
KAOLACK,KAOLACK,NGOTHIE,NDIEBEL,"H2 BIRANE NGOM",8,8,50,59,109
KAOLACK,KAOLACK,NGOTHIE,NDIEBEL,"H3 KEUR MBAR",9,11,83,67,150
KAOLACK,KAOLACK,NGOTHIE,NDIEBEL,"H3 KEUR YEDIME NDIAYE",5,9,40,51,91
KAOLACK,KAOLACK,NGOTHIE,NDIEBEL,"H4 KEUR DIENE SIGA BAKHOUM",4,5,33,28,61
KAOLACK,KAOLACK,NGOTHIE,NDIEBEL,"H6 KEUR DIENE FAYE",8,17,101,93,194
KAOLACK,KAOLACK,NGOTHIE,NDIEBEL,"KEUR SERIGNE OUSMANE LO (TOUBA MANDE)",9,9,54,48,102
KAOLACK,KAOLACK,NGOTHIE,NDIEBEL,"KOUNG KOUNG SERERE",30,46,319,325,644
KAOLACK,KAOLACK,NGOTHIE,NDIEBEL,"H1 KOUNG KOUNG THIAERE",7,10,71,80,151
KAOLACK,KAOLACK,NGOTHIE,NDIEBEL,"H2 SANKHA YEME",10,10,40,53,93
KAOLACK,KAOLACK,NGOTHIE,NDIEBEL,"H3 KEUR MAME BIRAME FAYE",2,4,31,37,68
KAOLACK,KAOLACK,NGOTHIE,NDIEBEL,"H4 KEUR KHOURY",15,21,159,182,341
KAOLACK,KAOLACK,NGOTHIE,NDIEBEL,"KOUNG KOUNG THIALENE",26,27,225,201,426
KAOLACK,KAOLACK,NGOTHIE,NDIEBEL,"M’BACKE SALOUM",34,34,177,195,372
KAOLACK,KAOLACK,NGOTHIE,NDIEBEL,"H1 KEUR NDANE SENE",2,3,18,19,37
KAOLACK,KAOLACK,NGOTHIE,NDIEBEL,"H2 KEUR OMAR DIOUF",4,5,32,29,61
KAOLACK,KAOLACK,NGOTHIE,NDIEBEL,"MBEL SOB",17,25,183,185,368
KAOLACK,KAOLACK,NGOTHIE,NDIEBEL,"NDALANE BAMBARA",14,22,124,117,241
KAOLACK,KAOLACK,NGOTHIE,NDIEBEL,"NDALANE KEUR MALICK NAR",11,18,117,143,260
KAOLACK,KAOLACK,NGOTHIE,NDIEBEL,"NDALANE KEUR MASSAMBA",18,25,176,160,336
KAOLACK,KAOLACK,NGOTHIE,NDIEBEL,"NDALANE KEUR NDIAYE GUEYE",19,22,186,176,362
KAOLACK,KAOLACK,NGOTHIE,NDIEBEL,"H1 KEUR NGOR DIOUF",2,4,19,21,40
KAOLACK,KAOLACK,NGOTHIE,NDIEBEL,"NDALANE SERERE (NDALANE BAOL)",13,18,115,108,223
KAOLACK,KAOLACK,NGOTHIE,NDIEBEL,NDIBA,36,47,270,258,528
KAOLACK,KAOLACK,NGOTHIE,NDIEBEL,NDIEBEL,220,262,1282,1316,2598
KAOLACK,KAOLACK,NGOTHIE,NDIEBEL,"H1 PINKA",12,14,90,76,166
KAOLACK,KAOLACK,NGOTHIE,NDIEBEL,"H2 TEOUROU KEUR SARA NDIEBEL",6,6,33,32,65
KAOLACK,KAOLACK,NGOTHIE,NDIEBEL,"H3 ODIOULDOU",7,7,48,49,97
KAOLACK,KAOLACK,NGOTHIE,NDIEBEL,"H4 KEUR COUMBA NDOFFENE",7,9,51,48,99
KAOLACK,KAOLACK,NGOTHIE,NDIEBEL,"H5 WADIOUROU",29,46,327,258,585
KAOLACK,KAOLACK,NGOTHIE,NDIEBEL,"H6 TEOUROU TIMACK",6,11,76,59,135
KAOLACK,KAOLACK,NGOTHIE,NDIEBEL,POUKHAME,27,37,224,214,438
KAOLACK,KAOLACK,NGOTHIE,NDIEBEL,SAME,12,16,75,82,157
KAOLACK,KAOLACK,NGOTHIE,NDIEBEL,"H1 KEUR DIOGO DIOUF",10,11,55,67,122
KAOLACK,KAOLACK,NGOTHIE,NDIEBEL,"SOB YEDIME",38,52,357,325,682
KAOLACK,KAOLACK,NGOTHIE,NDIEBEL,THIABE,21,25,148,136,284
KAOLACK,KAOLACK,NGOTHIE,THIOMBY,BELIKAEL,11,15,70,87,157
KAOLACK,KAOLACK,NGOTHIE,THIOMBY,"H1 KEUR WALY NDOUR",4,11,74,90,164
KAOLACK,KAOLACK,NGOTHIE,THIOMBY,"H2 KEUR COLY",3,3,12,17,29
KAOLACK,KAOLACK,NGOTHIE,THIOMBY,"H4 KEUR WALY SENE",3,5,38,44,82
KAOLACK,KAOLACK,NGOTHIE,THIOMBY,BILORY,23,31,196,179,375
KAOLACK,KAOLACK,NGOTHIE,THIOMBY,BOUTHIE,43,49,212,240,452
KAOLACK,KAOLACK,NGOTHIE,THIOMBY,"H1 NDANGANE DIENE",7,13,108,97,205
KAOLACK,KAOLACK,NGOTHIE,THIOMBY,"H2 NDOFFANE",9,13,151,139,290
KAOLACK,KAOLACK,NGOTHIE,THIOMBY,"H4 KEUR GANA SARR",9,12,63,70,133
KAOLACK,KAOLACK,NGOTHIE,THIOMBY,"H6 THIEKELE",9,10,67,78,145
KAOLACK,KAOLACK,NGOTHIE,THIOMBY,"H3 NGUEL TAMBA",5,8,44,68,112
KAOLACK,KAOLACK,NGOTHIE,THIOMBY,DARADJI,12,12,74,68,142
KAOLACK,KAOLACK,NGOTHIE,THIOMBY,"GAMBOUL KEUR MATAR",30,39,183,211,394
KAOLACK,KAOLACK,NGOTHIE,THIOMBY,"GAMBOUL PEULH",22,24,139,137,276
KAOLACK,KAOLACK,NGOTHIE,THIOMBY,"H1 KEUR GORY",22,23,100,90,190
KAOLACK,KAOLACK,NGOTHIE,THIOMBY,"GAMBOUL THIONGOU (GAMBOUL THIEDO)",94,114,607,577,1184
KAOLACK,KAOLACK,NGOTHIE,THIOMBY,"H1 NDANGANE",1,4,48,50,98
KAOLACK,KAOLACK,NGOTHIE,THIOMBY,"GANDE KEUR TAIBE",17,20,141,137,278
KAOLACK,KAOLACK,NGOTHIE,THIOMBY,"KEUR ALPHA",104,121,539,496,1035
KAOLACK,KAOLACK,NGOTHIE,THIOMBY,"KEUR BAKARY",16,18,118,103,221
KAOLACK,KAOLACK,NGOTHIE,THIOMBY,"H1 BARKAWEL PEUL",8,8,46,37,83
KAOLACK,KAOLACK,NGOTHIE,THIOMBY,"KEUR CISSOKHO MBAMBA",8,12,82,66,148
KAOLACK,KAOLACK,NGOTHIE,THIOMBY,"H1 NGUEWELE",4,6,67,49,116
KAOLACK,KAOLACK,NGOTHIE,THIOMBY,"KEUR COUMBA DAGA",24,32,278,172,450
KAOLACK,KAOLACK,NGOTHIE,THIOMBY,"H1 KEUR SALOLY",3,4,36,43,79
KAOLACK,KAOLACK,NGOTHIE,THIOMBY,"H2 KEUR LAM",1,1,7,15,22
KAOLACK,KAOLACK,NGOTHIE,THIOMBY,"KEUR GALOUP",9,9,44,42,86
KAOLACK,KAOLACK,NGOTHIE,THIOMBY,"H1 KEUR DIABEL",8,12,58,74,132
KAOLACK,KAOLACK,NGOTHIE,THIOMBY,"H3 KEUR NGAYO",2,3,16,12,28
KAOLACK,KAOLACK,NGOTHIE,THIOMBY,"H5 PEULGA",2,2,13,10,23
KAOLACK,KAOLACK,NGOTHIE,THIOMBY,"H2 KEUR MANDAME",2,7,22,26,48
KAOLACK,KAOLACK,NGOTHIE,THIOMBY,"KEUR MARY",57,77,398,372,770
KAOLACK,KAOLACK,NGOTHIE,THIOMBY,"KEUR SOUKHOUPE",24,32,132,143,275
KAOLACK,KAOLACK,NGOTHIE,THIOMBY,"H2 KABORY",4,6,38,37,75
KAOLACK,KAOLACK,NGOTHIE,THIOMBY,"H3 KEUR NGOR SENE",2,3,16,29,45
KAOLACK,KAOLACK,NGOTHIE,THIOMBY,"KEUR TAIBE",10,14,136,110,246
KAOLACK,KAOLACK,NGOTHIE,THIOMBY,"H1 PEULGA",8,9,63,49,112
KAOLACK,KAOLACK,NGOTHIE,THIOMBY,KHALAMBASSE,69,106,659,660,1319
KAOLACK,KAOLACK,NGOTHIE,THIOMBY,"H1 KEUR NGARY",5,5,64,54,118
KAOLACK,KAOLACK,NGOTHIE,THIOMBY,"H2 KEUR LAO",39,52,344,326,670
KAOLACK,KAOLACK,NGOTHIE,THIOMBY,MBELBOUCK,26,27,102,168,270
KAOLACK,KAOLACK,NGOTHIE,THIOMBY,"H1 FAMBARA",11,11,66,67,133
KAOLACK,KAOLACK,NGOTHIE,THIOMBY,"H2 KEUR EL HADJI IBRAHIMA DIOUF",17,26,198,167,365
KAOLACK,KAOLACK,NGOTHIE,THIOMBY,"H4 KEUR YALANE",20,26,204,185,389
KAOLACK,KAOLACK,NGOTHIE,THIOMBY,"MBELLONGUITHIE SERERE",19,24,165,177,342
KAOLACK,KAOLACK,NGOTHIE,THIOMBY,"H1 KEUR ALI NDIAYE",10,13,97,92,189
KAOLACK,KAOLACK,NGOTHIE,THIOMBY,"H2 MBELLONGUITHIE OUOLOF",28,33,235,195,430
KAOLACK,KAOLACK,NGOTHIE,THIOMBY,MBOKHODOFF,29,46,293,255,548
KAOLACK,KAOLACK,NGOTHIE,THIOMBY,"H1 KEUR TIMACK",21,24,164,141,305
KAOLACK,KAOLACK,NGOTHIE,THIOMBY,"NENE (KEUR MIGNANE)",7,14,80,79,159
KAOLACK,KAOLACK,NGOTHIE,THIOMBY,"H1 KEUR NIOKHOR NDOUR",4,6,37,39,76
KAOLACK,KAOLACK,NGOTHIE,THIOMBY,"H2 KEUR M’BACKE NDIAYE",4,4,25,39,64
KAOLACK,KAOLACK,NGOTHIE,THIOMBY,"H3 KEUR NDIAGA DIOUF",5,8,42,56,98
KAOLACK,KAOLACK,NGOTHIE,THIOMBY,SASSARA,56,65,456,420,876
KAOLACK,KAOLACK,NGOTHIE,THIOMBY,THIANGHANE,25,35,259,287,546
KAOLACK,KAOLACK,NGOTHIE,THIOMBY,"THIOMBY SERRERE",184,222,1091,1094,2185
KAOLACK,KAOLACK,NGOTHIE,THIOMBY,"H1 KEUR NGOR DIONE",8,9,82,86,168
KAOLACK,KAOLACK,NGOTHIE,THIOMBY,"H2 KEUR DEMBA THIAW",1,2,12,18,30
KAOLACK,KAOLACK,NGOTHIE,THIOMBY,"H3 KEUR DIOKEL GUEYE",2,2,12,17,29
KAOLACK,KAOLACK,NGOTHIE,THIOMBY,"THIOUPANE NDIACKANEME",34,51,295,307,602
KAOLACK,KAOLACK,NGOTHIE,THIOMBY,"H5 NDODOKE",17,28,143,169,312
KAOLACK,KAOLACK,NGOTHIE,THIOMBY,TOBENE,9,14,57,58,115
KAOLACK,KAOLACK,NGOTHIE,THIOMBY,"H1 KEUR THIAMA",1,1,9,5,14
KAOLACK,KAOLACK,NGOTHIE,THIOMBY,"H2 KEUR WALY NDIAYE",1,1,14,10,24
KAOLACK,KAOLACK,NGOTHIE,THIOMBY,"H4 KEUR DIERY GANDIAYE",2,3,11,6,17
KAOLACK,KAOLACK,NGOTHIE,THIOMBY,"THIOMBY BAMBARA",9,13,62,73,135
KAOLACK,KAOLACK,NGOTHIE,GANDIAYE,"DIAMAGUENE 1",167,215,852,936,1788
KAOLACK,KAOLACK,NGOTHIE,GANDIAYE,"DIAMAGUENE 2",174,200,795,881,1676
KAOLACK,KAOLACK,NGOTHIE,GANDIAYE,"KEUR FODE",26,31,147,141,288
KAOLACK,KAOLACK,NGOTHIE,GANDIAYE,GANGHANE,105,114,567,585,1152
KAOLACK,KAOLACK,NGOTHIE,GANDIAYE,MBAMBARA,133,143,712,692,1404
KAOLACK,KAOLACK,NGOTHIE,GANDIAYE,NDACK,46,65,387,375,762
KAOLACK,KAOLACK,NGOTHIE,GANDIAYE,NDIOBENE,226,255,1177,1116,2293
KAOLACK,KAOLACK,NGOTHIE,GANDIAYE,NGARAF,167,197,952,1056,2008
KAOLACK,KAOLACK,NGOTHIE,GANDIAYE,NGOULANG,244,290,1369,1477,2846
KAOLACK,KAOLACK,NGOTHIE,GANDIAYE,THIOUPANE,82,97,700,636,1336
KAOLACK,KAOLACK,NGOTHIE,GANDIAYE,"TOKO NDAME",248,304,1299,1387,2686
KAOLACK,KAOLACK,NGOTHIE,SIBASSOR,DIAMAGUENE,245,273,1027,1156,2183
KAOLACK,KAOLACK,NGOTHIE,SIBASSOR,DIOMKHEL,66,92,517,466,983
KAOLACK,KAOLACK,NGOTHIE,SIBASSOR,"GUINAW RAILS",188,209,1103,1124,2227
KAOLACK,KAOLACK,NGOTHIE,SIBASSOR,"MEDINA GOUNASS",191,218,812,928,1740
KAOLACK,KAOLACK,NGOTHIE,SIBASSOR,"NGOLOTHIE DIARNO",42,58,372,432,804
KAOLACK,KAOLACK,NGOTHIE,SIBASSOR,"NGOLOTHIE NDOURENE",45,64,316,320,636
KAOLACK,KAOLACK,NGOTHIE,SIBASSOR,SECCO,296,358,1421,1514,2935
KAOLACK,NIORO,NIORO,NIORO,"DAROU SALAM",644,755,3727,3735,7462
KAOLACK,NIORO,NIORO,NIORO,DIAMAGUENE,604,690,3221,3460,6681
KAOLACK,NIORO,NIORO,NIORO,"FASS HLM",539,600,2799,2549,5348
KAOLACK,NIORO,NIORO,NIORO,MEDINA,293,363,1733,1639,3372
KAOLACK,NIORO,NIORO,NIORO,"NOUROU LAYE",258,312,1411,1565,2976
KAOLACK,NIORO,NIORO,NIORO,THIERERE,251,310,1285,1367,2652
KAOLACK,NIORO,"MEDINA SABAKH",KAYEMOR,"COLOMBA TOUCOULEUR",19,31,263,245,508
KAOLACK,NIORO,"MEDINA SABAKH",KAYEMOR,COLOUMBODOU,119,143,1485,1298,2783
KAOLACK,NIORO,"MEDINA SABAKH",KAYEMOR,"DAROU KHOUDOSS",61,70,613,616,1229
KAOLACK,NIORO,"MEDINA SABAKH",KAYEMOR,"H1 SANTHIE MAGAYE",1,5,32,26,58
KAOLACK,NIORO,"MEDINA SABAKH",KAYEMOR,DIALACOUNA,29,71,242,262,504
KAOLACK,NIORO,"MEDINA SABAKH",KAYEMOR,KAYEMOR,228,307,1563,1702,3265
KAOLACK,NIORO,"MEDINA SABAKH",KAYEMOR,"H1 HAYNOU RAKHMATY",7,14,95,39,134
KAOLACK,NIORO,"MEDINA SABAKH",KAYEMOR,"KEUR ALY DIANKO",41,62,389,417,806
KAOLACK,NIORO,"MEDINA SABAKH",KAYEMOR,"KEUR AYIB TOURE",92,123,864,790,1654
KAOLACK,NIORO,"MEDINA SABAKH",KAYEMOR,"H1 SANTHIE EL HADJI SOULEYE TOURE",12,14,105,106,211
KAOLACK,NIORO,"MEDINA SABAKH",KAYEMOR,"KEUR BAKARY",235,382,1893,1845,3738
KAOLACK,NIORO,"MEDINA SABAKH",KAYEMOR,"KEUR SAMBA DIAMA",27,162,293,278,571
KAOLACK,NIORO,"MEDINA SABAKH",KAYEMOR,"H1 KEUR SOUKY",23,108,188,190,378
KAOLACK,NIORO,"MEDINA SABAKH",KAYEMOR,"KEUR SAMBA DIE",58,90,541,554,1095
KAOLACK,NIORO,"MEDINA SABAKH",KAYEMOR,"H1 TOUBA",16,21,174,152,326
KAOLACK,NIORO,"MEDINA SABAKH",KAYEMOR,NDIARGUENE,72,83,651,566,1217
KAOLACK,NIORO,"MEDINA SABAKH",KAYEMOR,"H1 NDIOBENE",6,31,51,50,101
KAOLACK,NIORO,"MEDINA SABAKH",KAYEMOR,"NDIBA KAYEMOR",6,9,102,63,165
KAOLACK,NIORO,"MEDINA SABAKH",KAYEMOR,"H1 PEULGA",17,20,109,91,200
KAOLACK,NIORO,"MEDINA SABAKH",KAYEMOR,"NDIMB BIRANE",25,37,217,269,486
KAOLACK,NIORO,"MEDINA SABAKH",KAYEMOR,"NDIMB TABA",24,32,214,169,383
KAOLACK,NIORO,"MEDINA SABAKH",KAYEMOR,"H1 NGOUYE",3,3,13,16,29
KAOLACK,NIORO,"MEDINA SABAKH",KAYEMOR,"H2 NDIMB NDIANKO",15,20,152,134,286
KAOLACK,NIORO,"MEDINA SABAKH",KAYEMOR,PADAFF,86,107,767,741,1508
KAOLACK,NIORO,"MEDINA SABAKH",KAYEMOR,"PASSY KAYEMOR",21,63,202,231,433
KAOLACK,NIORO,"MEDINA SABAKH",KAYEMOR,"SANTHIE KOHEL",80,92,637,596,1233
KAOLACK,NIORO,"MEDINA SABAKH",KAYEMOR,"SANTHIE PASSY",33,52,396,345,741
KAOLACK,NIORO,"MEDINA SABAKH",KAYEMOR,SONKORONG,122,167,1031,1063,2094
KAOLACK,NIORO,"MEDINA SABAKH",KAYEMOR,"H1 NDIAYENE",29,56,199,200,399
KAOLACK,NIORO,"MEDINA SABAKH",KAYEMOR,"H2 SAM",16,53,161,163,324
KAOLACK,NIORO,"MEDINA SABAKH",KAYEMOR,"H3 LEONA",15,21,111,96,207
KAOLACK,NIORO,"MEDINA SABAKH",KAYEMOR,"H4 NDAKHAR",58,67,409,392,801
KAOLACK,NIORO,"MEDINA SABAKH",KAYEMOR,SOTOKOYE,33,47,306,304,610
KAOLACK,NIORO,"MEDINA SABAKH",KAYEMOR,"TENE PEUL",33,78,290,267,557
KAOLACK,NIORO,"MEDINA SABAKH",KAYEMOR,"THYSSE KAYEMOR",92,123,894,1062,1956
KAOLACK,NIORO,"MEDINA SABAKH",KAYEMOR,"H2 KEUR DIANKHO",36,42,427,361,788
KAOLACK,NIORO,"MEDINA SABAKH",KAYEMOR,VELINGARA,13,27,231,163,394
KAOLACK,NIORO,"MEDINA SABAKH",KAYEMOR,NDIAGNENE,10,14,122,123,245
KAOLACK,NIORO,"MEDINA SABAKH",KAYEMOR,NGAYENE,27,67,302,200,502
KAOLACK,NIORO,"MEDINA SABAKH",KAYEMOR,THIEKENE,45,63,398,359,757
KAOLACK,NIORO,"MEDINA SABAKH",KAYEMOR,TOUCOULEURGA,22,29,266,264,530
KAOLACK,NIORO,"MEDINA SABAKH","MEDINA SABAKH",AINOUMANY,41,90,342,424,766
KAOLACK,NIORO,"MEDINA SABAKH","MEDINA SABAKH",CAMARA,32,39,250,257,507
KAOLACK,NIORO,"MEDINA SABAKH","MEDINA SABAKH","DIAGLE OMAR",26,44,302,318,620
KAOLACK,NIORO,"MEDINA SABAKH","MEDINA SABAKH","DIERY COW GUEYENE",51,67,482,493,975
KAOLACK,NIORO,"MEDINA SABAKH","MEDINA SABAKH","DIERY COW SANTHIE",36,54,270,287,557
KAOLACK,NIORO,"MEDINA SABAKH","MEDINA SABAKH",DJIGUIMAR,110,144,889,836,1725
KAOLACK,NIORO,"MEDINA SABAKH","MEDINA SABAKH","H1 SANTHIABA 1",32,45,260,321,581
KAOLACK,NIORO,"MEDINA SABAKH","MEDINA SABAKH","H2 KEUR BABOU SENE 2",17,29,188,195,383
KAOLACK,NIORO,"MEDINA SABAKH","MEDINA SABAKH",DONGORO,16,20,151,102,253
KAOLACK,NIORO,"MEDINA SABAKH","MEDINA SABAKH",FALIFA,63,100,664,632,1296
KAOLACK,NIORO,"MEDINA SABAKH","MEDINA SABAKH",FOUTA,15,31,97,185,282
KAOLACK,NIORO,"MEDINA SABAKH","MEDINA SABAKH","HAMDALLAYE THIAMENE",21,28,161,238,399
KAOLACK,NIORO,"MEDINA SABAKH","MEDINA SABAKH","KEUR ARDO",11,17,123,122,245
KAOLACK,NIORO,"MEDINA SABAKH","MEDINA SABAKH","KEUR AYIB GUEYE",832,1228,6115,5450,11565
KAOLACK,NIORO,"MEDINA SABAKH","MEDINA SABAKH","KEUR BABOU FADY",26,31,194,263,457
KAOLACK,NIORO,"MEDINA SABAKH","MEDINA SABAKH","KEUR BAKA (BASSINE)",35,40,323,367,690
KAOLACK,NIORO,"MEDINA SABAKH","MEDINA SABAKH","KEUR BAMBA GUEYE",79,104,478,730,1208
KAOLACK,NIORO,"MEDINA SABAKH","MEDINA SABAKH","KEUR BAMBA THIAM",20,20,127,152,279
KAOLACK,NIORO,"MEDINA SABAKH","MEDINA SABAKH","KEUR BOUBOU YORO",7,9,97,96,193
KAOLACK,NIORO,"MEDINA SABAKH","MEDINA SABAKH","H1 MEDINA KEUR ALPHA",12,15,145,112,257
KAOLACK,NIORO,"MEDINA SABAKH","MEDINA SABAKH","KEUR KATIM DIAKHOU",37,44,328,430,758
KAOLACK,NIORO,"MEDINA SABAKH","MEDINA SABAKH","KEUR KATIM DIAMA",72,107,757,730,1487
KAOLACK,NIORO,"MEDINA SABAKH","MEDINA SABAKH","KEUR KATIM PEULH",7,17,76,43,119
KAOLACK,NIORO,"MEDINA SABAKH","MEDINA SABAKH","KEUR LAHINE",41,51,220,249,469
KAOLACK,NIORO,"MEDINA SABAKH","MEDINA SABAKH","KEUR MODA DIAW",7,9,46,55,101
KAOLACK,NIORO,"MEDINA SABAKH","MEDINA SABAKH","KEUR NGATANE",110,119,935,850,1785
KAOLACK,NIORO,"MEDINA SABAKH","MEDINA SABAKH","KEUR SADER (SANTHIE SADER)",51,57,370,334,704
KAOLACK,NIORO,"MEDINA SABAKH","MEDINA SABAKH","KEUR SAKALA",7,8,40,46,86
KAOLACK,NIORO,"MEDINA SABAKH","MEDINA SABAKH","KEUR SAMBA KOUTA",52,72,800,499,1299
KAOLACK,NIORO,"MEDINA SABAKH","MEDINA SABAKH","KEUR SETTE DIABOU",44,56,316,262,578
KAOLACK,NIORO,"MEDINA SABAKH","MEDINA SABAKH",KOHEL,73,115,1036,856,1892
KAOLACK,NIORO,"MEDINA SABAKH","MEDINA SABAKH","H1 DAROU RAHMAAN",1,3,6,12,18
KAOLACK,NIORO,"MEDINA SABAKH","MEDINA SABAKH","KOUPAKH KEUR BIRANE",18,31,143,146,289
KAOLACK,NIORO,"MEDINA SABAKH","MEDINA SABAKH","KOUPAKH KEUR GAMOU",11,25,125,153,278
KAOLACK,NIORO,"MEDINA SABAKH","MEDINA SABAKH","H1 KEUR BAKA YACINE",9,14,121,120,241
KAOLACK,NIORO,"MEDINA SABAKH","MEDINA SABAKH",MBAPP,41,74,407,444,851
KAOLACK,NIORO,"MEDINA SABAKH","MEDINA SABAKH",MBOUMBOUNE,75,90,729,740,1469
KAOLACK,NIORO,"MEDINA SABAKH","MEDINA SABAKH","MEDINA KEUR MOMAR AISSA TOURE",10,20,179,162,341
KAOLACK,NIORO,"MEDINA SABAKH","MEDINA SABAKH","MEDINA SABAKH",528,797,3026,3188,6214
KAOLACK,NIORO,"MEDINA SABAKH","MEDINA SABAKH",NDIAGNENE,22,44,414,265,679
KAOLACK,NIORO,"MEDINA SABAKH","MEDINA SABAKH",NDIAHENE,45,68,531,563,1094
KAOLACK,NIORO,"MEDINA SABAKH","MEDINA SABAKH",NDIAWARA,46,64,454,426,880
KAOLACK,NIORO,"MEDINA SABAKH","MEDINA SABAKH","NDIBA NDIAYENE",220,287,1802,1832,3634
KAOLACK,NIORO,"MEDINA SABAKH","MEDINA SABAKH","NGAYENE 2",11,12,100,70,170
KAOLACK,NIORO,"MEDINA SABAKH","MEDINA SABAKH","NGUER FRANÇAIS",23,25,146,188,334
KAOLACK,NIORO,"MEDINA SABAKH","MEDINA SABAKH",PAKALA,103,162,846,1007,1853
KAOLACK,NIORO,"MEDINA SABAKH","MEDINA SABAKH","PAKANE KEUR DEMBA DJIDE",27,45,255,328,583
KAOLACK,NIORO,"MEDINA SABAKH","MEDINA SABAKH","PAKANE KEUR GAGNY",56,104,688,672,1360
KAOLACK,NIORO,"MEDINA SABAKH","MEDINA SABAKH","PAKANE NDIAWNARY",31,36,322,334,656
KAOLACK,NIORO,"MEDINA SABAKH","MEDINA SABAKH","PAKANE KEUR SAMBA",39,42,346,375,721
KAOLACK,NIORO,"MEDINA SABAKH","MEDINA SABAKH","PASSY HAMDALLAYE",49,63,496,492,988
KAOLACK,NIORO,"MEDINA SABAKH","MEDINA SABAKH","PASSY RIP",52,66,431,497,928
KAOLACK,NIORO,"MEDINA SABAKH","MEDINA SABAKH",PAYOMA,112,149,813,811,1624
KAOLACK,NIORO,"MEDINA SABAKH","MEDINA SABAKH",SANGHAP,99,176,851,815,1666
KAOLACK,NIORO,"MEDINA SABAKH","MEDINA SABAKH","SANTHIE MADINA (KEUR OMAR)",25,34,239,219,458
KAOLACK,NIORO,"MEDINA SABAKH","MEDINA SABAKH","SANTHIE MBAMBARA",6,6,44,35,79
KAOLACK,NIORO,"MEDINA SABAKH","MEDINA SABAKH","SANTHIE NDAKHAR",15,18,248,209,457
KAOLACK,NIORO,"MEDINA SABAKH","MEDINA SABAKH","SANTHIE NDIBA",44,56,566,525,1091
KAOLACK,NIORO,"MEDINA SABAKH","MEDINA SABAKH","SANTHIE SANGHAP",51,64,344,411,755
KAOLACK,NIORO,"MEDINA SABAKH","MEDINA SABAKH",SIWOL,48,56,343,334,677
KAOLACK,NIORO,"MEDINA SABAKH","MEDINA SABAKH","THIAMENE SANGHAP",77,126,821,906,1727
KAOLACK,NIORO,"MEDINA SABAKH","MEDINA SABAKH",YONGO,41,59,351,392,743
KAOLACK,NIORO,"MEDINA SABAKH","MEDINA SABAKH",YOUNA,37,41,389,333,722
KAOLACK,NIORO,"MEDINA SABAKH",NGAYENE,"DAROU MBAPP",181,257,1611,1917,3528
KAOLACK,NIORO,"MEDINA SABAKH",NGAYENE,"H1 PASSY DAROU",16,24,113,178,291
KAOLACK,NIORO,"MEDINA SABAKH",NGAYENE,"DAROU SALAM",31,37,382,362,744
KAOLACK,NIORO,"MEDINA SABAKH",NGAYENE,"DIAGLE NGAYENE",45,69,597,569,1166
KAOLACK,NIORO,"MEDINA SABAKH",NGAYENE,"DIAMA MOUSSA",86,175,593,741,1334
KAOLACK,NIORO,"MEDINA SABAKH",NGAYENE,"H1 FANA DIOUCKA",28,62,196,220,416
KAOLACK,NIORO,"MEDINA SABAKH",NGAYENE,"DIAMA PALLENE SYCOUNDA",36,45,324,240,564
KAOLACK,NIORO,"MEDINA SABAKH",NGAYENE,"DIAMA PALLENE KACOUNDA",69,85,484,612,1096
KAOLACK,NIORO,"MEDINA SABAKH",NGAYENE,"DIAMA PALLENE MBAYENE",61,70,579,522,1101
KAOLACK,NIORO,"MEDINA SABAKH",NGAYENE,"DIAMA PASSY",45,57,379,425,804
KAOLACK,NIORO,"MEDINA SABAKH",NGAYENE,"DIAMA THIEWY",133,150,1037,1043,2080
KAOLACK,NIORO,"MEDINA SABAKH",NGAYENE,"H1 DJIMBALA",7,10,55,68,123
KAOLACK,NIORO,"MEDINA SABAKH",NGAYENE,"FASS LOHENE",17,18,136,130,266
KAOLACK,NIORO,"MEDINA SABAKH",NGAYENE,"FASS NGAYENE",51,103,400,392,792
KAOLACK,NIORO,"MEDINA SABAKH",NGAYENE,"H1 KEUR MBILIME",31,41,356,346,702
KAOLACK,NIORO,"MEDINA SABAKH",NGAYENE,"KEUR DIANE",18,25,200,212,412
KAOLACK,NIORO,"MEDINA SABAKH",NGAYENE,LOHENE,225,268,1980,1979,3959
KAOLACK,NIORO,"MEDINA SABAKH",NGAYENE,"MBAPP LOYENE",42,65,442,510,952
KAOLACK,NIORO,"MEDINA SABAKH",NGAYENE,"MEDINA SERIGNE MBAYE",26,37,244,251,495
KAOLACK,NIORO,"MEDINA SABAKH",NGAYENE,NDIABO,49,65,390,577,967
KAOLACK,NIORO,"MEDINA SABAKH",NGAYENE,"NGAYENE SABAKH",309,398,2690,2734,5424
KAOLACK,NIORO,"MEDINA SABAKH",NGAYENE,"H1 SANTHIE TAPHA",7,8,49,61,110
KAOLACK,NIORO,"MEDINA SABAKH",NGAYENE,PALLENE,10,12,75,77,152
KAOLACK,NIORO,"MEDINA SABAKH",NGAYENE,"PASSY NGAYENE",168,218,1462,1718,3180
KAOLACK,NIORO,"MEDINA SABAKH",NGAYENE,"H1 NDIOBENE PASSY",7,13,61,88,149
KAOLACK,NIORO,"MEDINA SABAKH",NGAYENE,"SINE NGAYENE",193,280,1341,1401,2742
KAOLACK,NIORO,"MEDINA SABAKH",NGAYENE,TAIF,50,68,447,470,917
KAOLACK,NIORO,"MEDINA SABAKH",NGAYENE,"DIAMA THIAMBA",25,35,211,266,477
KAOLACK,NIORO,"MEDINA SABAKH",NGAYENE,THIECKENE,59,126,345,442,787
KAOLACK,NIORO,PAOSKOTO,"GAINTHE KAYE","BOUNAKH (KEUR SADER)",17,20,161,159,320
KAOLACK,NIORO,PAOSKOTO,"GAINTHE KAYE","DAGABANY WADENE",21,32,210,241,451
KAOLACK,NIORO,PAOSKOTO,"GAINTHE KAYE","DAROU FALL",20,24,134,111,245
KAOLACK,NIORO,PAOSKOTO,"GAINTHE KAYE","DAROU MARONE",18,25,225,204,429
KAOLACK,NIORO,PAOSKOTO,"GAINTHE KAYE","DAROU SALAM OUALO",97,109,517,570,1087
KAOLACK,NIORO,PAOSKOTO,"GAINTHE KAYE","FAOUROU MBOBENE",14,17,107,93,200
KAOLACK,NIORO,PAOSKOTO,"GAINTHE KAYE","FAOUROU PEULH",33,39,292,274,566
KAOLACK,NIORO,PAOSKOTO,"GAINTHE KAYE","FAOUROU SERERE",31,41,324,273,597
KAOLACK,NIORO,PAOSKOTO,"GAINTHE KAYE","GAINTE KAYE",134,169,1067,1013,2080
KAOLACK,NIORO,PAOSKOTO,"GAINTHE KAYE",HANENE,21,24,144,143,287
KAOLACK,NIORO,PAOSKOTO,"GAINTHE KAYE","KEBE OUALO",20,21,203,172,375
KAOLACK,NIORO,PAOSKOTO,"GAINTHE KAYE","KEUR BIRANE DIAW",30,47,372,334,706
KAOLACK,NIORO,PAOSKOTO,"GAINTHE KAYE","KEUR BIRANE DIENG",63,90,575,547,1122
KAOLACK,NIORO,PAOSKOTO,"GAINTHE KAYE","KEUR DESSADIO",58,71,406,381,787
KAOLACK,NIORO,PAOSKOTO,"GAINTHE KAYE","KEUR MAMOUR NDOUMBE",64,77,626,572,1198
KAOLACK,NIORO,PAOSKOTO,"GAINTHE KAYE","KEUR SAMBA RAKHI NDRAME",16,45,528,316,844
KAOLACK,NIORO,PAOSKOTO,"GAINTHE KAYE","KEUR SAMBA RAKHI NDIOBENE",59,108,739,664,1403
KAOLACK,NIORO,PAOSKOTO,"GAINTHE KAYE","KEUR YOYA",13,16,137,125,262
KAOLACK,NIORO,PAOSKOTO,"GAINTHE KAYE","KOUARE BABA",45,78,659,404,1063
KAOLACK,NIORO,PAOSKOTO,"GAINTHE KAYE","MEDINA DIANKOU",26,35,245,233,478
KAOLACK,NIORO,PAOSKOTO,"GAINTHE KAYE","MEDINA THIALLENE",37,82,474,448,922
KAOLACK,NIORO,PAOSKOTO,"GAINTHE KAYE","MISSIRAH ALBADE",154,233,1346,1334,2680
KAOLACK,NIORO,PAOSKOTO,"GAINTHE KAYE","NDIAWARA AL KALY",179,261,1626,1697,3323
KAOLACK,NIORO,PAOSKOTO,"GAINTHE KAYE","NDIAYENE KAD (NDIAYENE NDIOBENE)",46,55,362,347,709
KAOLACK,NIORO,PAOSKOTO,"GAINTHE KAYE","NDIAYENE SANTHIE",112,134,941,958,1899
KAOLACK,NIORO,PAOSKOTO,"GAINTHE KAYE",NIANTA,28,42,294,279,573
KAOLACK,NIORO,PAOSKOTO,"GAINTHE KAYE","NIAPPA BALLA TOURE",154,197,1411,1256,2667
KAOLACK,NIORO,PAOSKOTO,"GAINTHE KAYE","NIAPPA NDIAGNE",72,109,742,718,1460
KAOLACK,NIORO,PAOSKOTO,"GAINTHE KAYE","SAME OUALO",20,37,210,187,397
KAOLACK,NIORO,PAOSKOTO,"GAINTHE KAYE","SANTHIE AMATH FALL",64,112,634,686,1320
KAOLACK,NIORO,PAOSKOTO,"GAINTHE KAYE","SANTHIE BIDJI DIALLO",18,24,187,191,378
KAOLACK,NIORO,PAOSKOTO,"GAINTHE KAYE","SANTHIE MISSIRAH",42,76,527,458,985
KAOLACK,NIORO,PAOSKOTO,"GAINTHE KAYE","SANTHIE GEORGES",4,5,37,26,63
KAOLACK,NIORO,PAOSKOTO,"GAINTHE KAYE","TAIBA NDIOUFFENE",82,99,740,706,1446
KAOLACK,NIORO,PAOSKOTO,"GAINTHE KAYE","THIARENE KEUR SACOUMBA",75,93,672,592,1264
KAOLACK,NIORO,PAOSKOTO,"GAINTHE KAYE",THIARIAK,14,16,123,118,241
KAOLACK,NIORO,PAOSKOTO,"GAINTHE KAYE",THIOUBENE,183,272,1855,1447,3302
KAOLACK,NIORO,PAOSKOTO,"GAINTHE KAYE","TOUBA FALL",80,99,632,629,1261
KAOLACK,NIORO,PAOSKOTO,"GAINTHE KAYE","TOUBA NIANE",88,127,916,716,1632
KAOLACK,NIORO,PAOSKOTO,"PAOS KOTO","BOUSTANE KEUR KABE",5,8,45,48,93
KAOLACK,NIORO,PAOSKOTO,"PAOS KOTO","DAROU NAHIM",25,42,253,251,504
KAOLACK,NIORO,PAOSKOTO,"PAOS KOTO","DAROU NDEMENE",5,5,35,58,93
KAOLACK,NIORO,PAOSKOTO,"PAOS KOTO",DINGUIRAYE,376,446,2447,2587,5034
KAOLACK,NIORO,PAOSKOTO,"PAOS KOTO","FASS KEUR MOMAR KOUTA",8,10,47,58,105
KAOLACK,NIORO,PAOSKOTO,"PAOS KOTO",GAPAKH,69,75,464,472,936
KAOLACK,NIORO,PAOSKOTO,"PAOS KOTO","KENIEBA KEUR BANDIOUGOU",17,22,216,195,411
KAOLACK,NIORO,PAOSKOTO,"PAOS KOTO","KEUR AMATH DRAME",51,64,380,469,849
KAOLACK,NIORO,PAOSKOTO,"PAOS KOTO","KEUR BARA TAMBEDOU",56,59,319,369,688
KAOLACK,NIORO,PAOSKOTO,"PAOS KOTO","KEUR BIRANE BA",10,13,106,112,218
KAOLACK,NIORO,PAOSKOTO,"PAOS KOTO","KEUR DEMBA DIALLO",15,17,120,128,248
KAOLACK,NIORO,PAOSKOTO,"PAOS KOTO","KEUR DEMBA CARDO",4,4,30,40,70
KAOLACK,NIORO,PAOSKOTO,"PAOS KOTO","KEUR DIERY CISSE",36,39,270,224,494
KAOLACK,NIORO,PAOSKOTO,"PAOS KOTO","KEUR GAGNY NDAO",21,25,211,177,388
KAOLACK,NIORO,PAOSKOTO,"PAOS KOTO","H1 KEUR HILLO BA",12,12,58,81,139
KAOLACK,NIORO,PAOSKOTO,"PAOS KOTO","KEUR KATIM TOURE",34,43,326,328,654
KAOLACK,NIORO,PAOSKOTO,"PAOS KOTO","KEUR MACOUMBA NDIAYE",29,32,259,251,510
KAOLACK,NIORO,PAOSKOTO,"PAOS KOTO","KEUR MALAO",19,25,134,123,257
KAOLACK,NIORO,PAOSKOTO,"PAOS KOTO","KEUR MALLE",39,49,266,278,544
KAOLACK,NIORO,PAOSKOTO,"PAOS KOTO","KEUR MBARA THIAM",8,11,72,75,147
KAOLACK,NIORO,PAOSKOTO,"PAOS KOTO","KEUR NDIOGOU DIENG",16,25,187,149,336
KAOLACK,NIORO,PAOSKOTO,"PAOS KOTO","KEUR NDIOUGA DRAME",32,36,294,272,566
KAOLACK,NIORO,PAOSKOTO,"PAOS KOTO","KEUR NDJIGOU",23,25,253,318,571
KAOLACK,NIORO,PAOSKOTO,"PAOS KOTO","KEUR OUSMANE NDIAMATOU",35,37,263,203,466
KAOLACK,NIORO,PAOSKOTO,"PAOS KOTO","KEUR SAMBA GUEYE",27,31,198,189,387
KAOLACK,NIORO,PAOSKOTO,"PAOS KOTO","KEUR SAMBA MALICK",12,14,99,91,190
KAOLACK,NIORO,PAOSKOTO,"PAOS KOTO","KEUR SAMBA SIGA THIAM",10,13,83,93,176
KAOLACK,NIORO,PAOSKOTO,"PAOS KOTO","KEUR SOULEYE NDIAYE",38,48,277,287,564
KAOLACK,NIORO,PAOSKOTO,"PAOS KOTO","KEUR SOULEYE THIAM",14,27,105,140,245
KAOLACK,NIORO,PAOSKOTO,"PAOS KOTO","KEUR YORO EGGE",14,20,164,146,310
KAOLACK,NIORO,PAOSKOTO,"PAOS KOTO","KOLMA PEULH",23,31,158,145,303
KAOLACK,NIORO,PAOSKOTO,"PAOS KOTO","MBAYE FAYE (KEUR SADAGA)",5,9,78,78,156
KAOLACK,NIORO,PAOSKOTO,"PAOS KOTO","MBAYE FAYE FAFA",13,14,117,75,192
KAOLACK,NIORO,PAOSKOTO,"PAOS KOTO","MBAYE FAYE MASSERIGNE",33,45,307,279,586
KAOLACK,NIORO,PAOSKOTO,"PAOS KOTO","MEDINA FAYENE",72,75,470,451,921
KAOLACK,NIORO,PAOSKOTO,"PAOS KOTO","MEDINA MBAYENE",16,17,122,139,261
KAOLACK,NIORO,PAOSKOTO,"PAOS KOTO","MEDINA NDIAYENE",6,14,111,94,205
KAOLACK,NIORO,PAOSKOTO,"PAOS KOTO","MEDINA SAMBA WOURY",4,5,49,39,88
KAOLACK,NIORO,PAOSKOTO,"PAOS KOTO","NDIENGUENE KEUR ALY",17,28,213,215,428
KAOLACK,NIORO,PAOSKOTO,"PAOS KOTO",NGUEWY,15,16,104,104,208
KAOLACK,NIORO,PAOSKOTO,"PAOS KOTO","PAKALA MBAYENE",13,31,264,201,465
KAOLACK,NIORO,PAOSKOTO,"PAOS KOTO","PAKALA THYSSE",9,16,58,47,105
KAOLACK,NIORO,PAOSKOTO,"PAOS KOTO",PALENE,4,4,27,27,54
KAOLACK,NIORO,PAOSKOTO,"PAOS KOTO",PAOSKOTO,244,292,1892,1893,3785
KAOLACK,NIORO,PAOSKOTO,"PAOS KOTO","SANTHIE BABOU DIALLO",8,9,57,51,108
KAOLACK,NIORO,PAOSKOTO,"PAOS KOTO","KEUR DJIM",18,20,91,98,189
KAOLACK,NIORO,PAOSKOTO,"PAOS KOTO","TAIBA NDRAME",33,35,145,205,350
KAOLACK,NIORO,PAOSKOTO,"PAOS KOTO",WENTHIEWY,20,22,136,140,276
KAOLACK,NIORO,PAOSKOTO,"PAOS KOTO","H1 KEUR SADOKI",5,5,53,62,115
KAOLACK,NIORO,PAOSKOTO,POROKHANE,"AFIA THIAMENE",64,74,564,544,1108
KAOLACK,NIORO,PAOSKOTO,POROKHANE,BOULIBOKY,33,43,302,277,579
KAOLACK,NIORO,PAOSKOTO,POROKHANE,"BOUSTANE (KEUR CHEIKH SOW)",18,23,106,91,197
KAOLACK,NIORO,PAOSKOTO,POROKHANE,"DAGA ALBOURY",39,50,293,327,620
KAOLACK,NIORO,PAOSKOTO,POROKHANE,"DAGA DIOGOP",18,33,166,133,299
KAOLACK,NIORO,PAOSKOTO,POROKHANE,"H1 KEUR GORA",7,10,54,44,98
KAOLACK,NIORO,PAOSKOTO,POROKHANE,"DAROU MOUGNAGUENE",94,126,709,781,1490
KAOLACK,NIORO,PAOSKOTO,POROKHANE,"DAROU SAHETTE",25,34,389,289,678
KAOLACK,NIORO,PAOSKOTO,POROKHANE,"FASS KEUR OUMAR SOKHNA",8,9,50,56,106
KAOLACK,NIORO,PAOSKOTO,POROKHANE,"KEUR ALASSANE KHODIA",50,61,465,507,972
KAOLACK,NIORO,PAOSKOTO,POROKHANE,"KEUR ALY SAMBA",86,108,745,775,1520
KAOLACK,NIORO,PAOSKOTO,POROKHANE,"KEUR ANTOU MBAYE",30,36,159,178,337
KAOLACK,NIORO,PAOSKOTO,POROKHANE,"KEUR BABOU DIOP",71,100,658,593,1251
KAOLACK,NIORO,PAOSKOTO,POROKHANE,"KEUR BABOU NGONE",75,81,523,548,1071
KAOLACK,NIORO,PAOSKOTO,POROKHANE,"KEUR BIDJI AWA",63,85,530,497,1027
KAOLACK,NIORO,PAOSKOTO,POROKHANE,"KEUR BIRANE DIA (MAMBI TOUCOULEUR)",41,57,362,320,682
KAOLACK,NIORO,PAOSKOTO,POROKHANE,"KEUR DEMBA DIABY",10,11,67,49,116
KAOLACK,NIORO,PAOSKOTO,POROKHANE,"KEUR DIATTA",33,41,256,202,458
KAOLACK,NIORO,PAOSKOTO,POROKHANE,"KEUR DIOUMA DIALLO",7,9,71,62,133
KAOLACK,NIORO,PAOSKOTO,POROKHANE,"KEUR ILLO KA",47,57,451,417,868
KAOLACK,NIORO,PAOSKOTO,POROKHANE,"KEUR LAHINE GUEYE",48,61,376,335,711
KAOLACK,NIORO,PAOSKOTO,POROKHANE,"KEUR LALLY",12,15,105,90,195
KAOLACK,NIORO,PAOSKOTO,POROKHANE,"KEUR MBANA",10,13,123,88,211
KAOLACK,NIORO,PAOSKOTO,POROKHANE,"H1 TOUBA KEUR MBANA",1,1,16,13,29
KAOLACK,NIORO,PAOSKOTO,POROKHANE,"KEUR MOUSSA FRONTIERE",135,159,1213,1126,2339
KAOLACK,NIORO,PAOSKOTO,POROKHANE,"KEUR NAIMBELY",6,6,39,35,74
KAOLACK,NIORO,PAOSKOTO,POROKHANE,"KEUR NALLA",31,36,250,190,440
KAOLACK,NIORO,PAOSKOTO,POROKHANE,"KEUR OMAR SABALY",29,34,236,200,436
KAOLACK,NIORO,PAOSKOTO,POROKHANE,"KEUR SAMBA NDOUCKOU",20,29,188,192,380
KAOLACK,NIORO,PAOSKOTO,POROKHANE,"KEUR SAMBOYE",41,46,411,405,816
KAOLACK,NIORO,PAOSKOTO,POROKHANE,"KEUR SETTE DIAKHOU",80,97,729,818,1547
KAOLACK,NIORO,PAOSKOTO,POROKHANE,"H1 KEUR SETTE PEULH",10,11,96,78,174
KAOLACK,NIORO,PAOSKOTO,POROKHANE,"KEUR SOUNTOU",74,115,692,702,1394
KAOLACK,NIORO,PAOSKOTO,POROKHANE,"KEUR TAMBA",46,63,419,312,731
KAOLACK,NIORO,PAOSKOTO,POROKHANE,"KEUR WALOME",17,18,155,116,271
KAOLACK,NIORO,PAOSKOTO,POROKHANE,"KEUR WAR",35,36,288,278,566
KAOLACK,NIORO,PAOSKOTO,POROKHANE,"KEUR YORO SY",15,15,108,77,185
KAOLACK,NIORO,PAOSKOTO,POROKHANE,"KEUR YOUGA SADIO",26,31,222,244,466
KAOLACK,NIORO,PAOSKOTO,POROKHANE,"MAMBI WOLOF",20,27,169,163,332
KAOLACK,NIORO,PAOSKOTO,POROKHANE,"MANKACOUNDA RIP",23,29,217,160,377
KAOLACK,NIORO,PAOSKOTO,POROKHANE,MBAPP,27,35,219,210,429
KAOLACK,NIORO,PAOSKOTO,POROKHANE,"MBOULEDJI GUIDOM",21,22,173,137,310
KAOLACK,NIORO,PAOSKOTO,POROKHANE,"MEDINA OMAR NIANG",70,88,762,739,1501
KAOLACK,NIORO,PAOSKOTO,POROKHANE,"MEDINA MOUNAWARA (SANTHIE EL HADJI MOUSSA)",62,75,571,520,1091
KAOLACK,NIORO,PAOSKOTO,POROKHANE,"MEDINA NDIOBENE",56,76,501,499,1000
KAOLACK,NIORO,PAOSKOTO,POROKHANE,"MEDINA SALAM",4,7,39,50,89
KAOLACK,NIORO,PAOSKOTO,POROKHANE,NDIAPTO,27,50,346,228,574
KAOLACK,NIORO,PAOSKOTO,POROKHANE,"NDIAWENE IBRA",5,11,41,44,85
KAOLACK,NIORO,PAOSKOTO,POROKHANE,"NDIENGUENE KEUR MALOBE",79,90,724,765,1489
KAOLACK,NIORO,PAOSKOTO,POROKHANE,"NDIENGUENE KEUR MAMOUR",9,9,44,44,88
KAOLACK,NIORO,PAOSKOTO,POROKHANE,"NDIOBENE BANGADJI",24,31,244,199,443
KAOLACK,NIORO,PAOSKOTO,POROKHANE,"PAKALA NGAGNE",12,25,167,119,286
KAOLACK,NIORO,PAOSKOTO,POROKHANE,"POROKHANE PEULH",81,94,488,534,1022
KAOLACK,NIORO,PAOSKOTO,POROKHANE,"POROKHANE TOUCOULEUR",30,44,355,326,681
KAOLACK,NIORO,PAOSKOTO,POROKHANE,"POROKHANE WOLOF",701,924,4592,5200,9792
KAOLACK,NIORO,PAOSKOTO,POROKHANE,"SAME KEUR ABDOU BOURY",13,14,89,100,189
KAOLACK,NIORO,PAOSKOTO,POROKHANE,"SAME KEUR SACOUMBA",22,23,147,125,272
KAOLACK,NIORO,PAOSKOTO,POROKHANE,"SAME KEUR TOUBEYE",32,32,196,220,416
KAOLACK,NIORO,PAOSKOTO,POROKHANE,"SANTHIE BAKARY",4,6,55,35,90
KAOLACK,NIORO,PAOSKOTO,POROKHANE,SOTOKOYE,40,53,355,308,663
KAOLACK,NIORO,PAOSKOTO,POROKHANE,"TAWA RIP",21,22,101,162,263
KAOLACK,NIORO,PAOSKOTO,POROKHANE,"TOUBA POROKHANE",10,12,65,63,128
KAOLACK,NIORO,PAOSKOTO,POROKHANE,YOUNA,30,46,301,320,621
KAOLACK,NIORO,PAOSKOTO,"TAIBA NIASSENE",DAFFAR,55,62,382,444,826
KAOLACK,NIORO,PAOSKOTO,"TAIBA NIASSENE","FASS KEUR OMAR TOUNKARA",62,98,880,741,1621
KAOLACK,NIORO,PAOSKOTO,"TAIBA NIASSENE","KEUR ABIBOU NIASS",74,123,695,725,1420
KAOLACK,NIORO,PAOSKOTO,"TAIBA NIASSENE","KEUR ALIOU PATHE",32,44,368,337,705
KAOLACK,NIORO,PAOSKOTO,"TAIBA NIASSENE","KEUR ALY GUEYE",76,100,564,638,1202
KAOLACK,NIORO,PAOSKOTO,"TAIBA NIASSENE","KEUR AMATH ASTA",42,51,354,343,697
KAOLACK,NIORO,PAOSKOTO,"TAIBA NIASSENE","H1 PEULGA",23,30,226,202,428
KAOLACK,NIORO,PAOSKOTO,"TAIBA NIASSENE","KEUR AMATH ROKHY",41,59,394,377,771
KAOLACK,NIORO,PAOSKOTO,"TAIBA NIASSENE","KEUR GAYE YACINE",69,87,821,769,1590
KAOLACK,NIORO,PAOSKOTO,"TAIBA NIASSENE","KEUR LAYENE KHOUREDIA",49,71,510,579,1089
KAOLACK,NIORO,PAOSKOTO,"TAIBA NIASSENE","KEUR MABA AWA",124,169,740,833,1573
KAOLACK,NIORO,PAOSKOTO,"TAIBA NIASSENE","KEUR SAMBA NIABOU",22,25,220,216,436
KAOLACK,NIORO,PAOSKOTO,"TAIBA NIASSENE","KOLMA DIOR DIOR",116,145,978,958,1936
KAOLACK,NIORO,PAOSKOTO,"TAIBA NIASSENE","MBITEYENE WALO",117,160,1140,954,2094
KAOLACK,NIORO,PAOSKOTO,"TAIBA NIASSENE","H1 PEUL KANTA",33,39,239,211,450
KAOLACK,NIORO,PAOSKOTO,"TAIBA NIASSENE","NDIOBENE KEUR AMATH MADJIGUENE",40,42,297,263,560
KAOLACK,NIORO,PAOSKOTO,"TAIBA NIASSENE","NDIOBENE KEUR OUSMANE",19,22,150,151,301
KAOLACK,NIORO,PAOSKOTO,"TAIBA NIASSENE",NIANGUENE,62,82,594,522,1116
KAOLACK,NIORO,PAOSKOTO,"TAIBA NIASSENE","SANTHIE THIAMENE",166,220,1223,1114,2337
KAOLACK,NIORO,PAOSKOTO,"TAIBA NIASSENE","TAIBA NIASSENE",770,1009,6036,6061,12097
KAOLACK,NIORO,PAOSKOTO,"TAIBA NIASSENE","TAWA WALO",90,126,964,879,1843
KAOLACK,NIORO,PAOSKOTO,"TAIBA NIASSENE","THIAMENE WALO",180,234,1083,1108,2191
KAOLACK,NIORO,PAOSKOTO,"TAIBA NIASSENE","THYSSE DAME",28,38,288,290,578
KAOLACK,NIORO,PAOSKOTO,"TAIBA NIASSENE","THYSSE HAMDALAYE",13,15,93,80,173
KAOLACK,NIORO,PAOSKOTO,DABALY,BAHOU,83,104,712,661,1373
KAOLACK,NIORO,PAOSKOTO,DABALY,"BAMBA DRAME (BAMBA DIAKHOUTOU)",20,26,234,262,496
KAOLACK,NIORO,PAOSKOTO,DABALY,DABALY,113,142,866,781,1647
KAOLACK,NIORO,PAOSKOTO,DABALY,"DAROU RAHMANE (SANTHIE SOULEYE NDIAYE)",8,22,97,98,195
KAOLACK,NIORO,PAOSKOTO,DABALY,"FASS NGUEYENE (KEUR BAKA GUEYE)",25,29,217,161,378
KAOLACK,NIORO,PAOSKOTO,DABALY,FIRGUI,56,64,483,428,911
KAOLACK,NIORO,PAOSKOTO,DABALY,"FIRGUI GAWANE",10,13,134,101,235
KAOLACK,NIORO,PAOSKOTO,DABALY,KABAKOTO,137,167,1015,989,2004
KAOLACK,NIORO,PAOSKOTO,DABALY,"KANTORA DIASSE",48,56,532,431,963
KAOLACK,NIORO,PAOSKOTO,DABALY,"KANTORA LY",43,70,668,546,1214
KAOLACK,NIORO,PAOSKOTO,DABALY,"KEUR ABDOU BOURY",44,60,461,449,910
KAOLACK,NIORO,PAOSKOTO,DABALY,"KEUR MADEMBA",12,23,207,182,389
KAOLACK,NIORO,PAOSKOTO,DABALY,"KEUR NDIAGA",6,7,32,37,69
KAOLACK,NIORO,PAOSKOTO,DABALY,"KEUR NDIOBA RIP (KEUR ILLO RIP)",25,33,267,190,457
KAOLACK,NIORO,PAOSKOTO,DABALY,"KEUR OMAR COUMBA",27,31,276,264,540
KAOLACK,NIORO,PAOSKOTO,DABALY,LEYENNE,37,43,292,294,586
KAOLACK,NIORO,PAOSKOTO,DABALY,"MEDINA LAMINE TOURE",13,20,130,146,276
KAOLACK,NIORO,PAOSKOTO,DABALY,"MEDINA NDAWENE",21,23,191,145,336
KAOLACK,NIORO,PAOSKOTO,DABALY,"MEDINA NGUEYENNE (BOUDOUCK)",28,33,495,277,772
KAOLACK,NIORO,PAOSKOTO,DABALY,"MEDINA NGOR SARR (KEUR NGOR SARR)",3,3,24,18,42
KAOLACK,NIORO,PAOSKOTO,DABALY,"SANTHIE LEYENNE (KEUR OUSSEYNOU)",21,21,133,147,280
KAOLACK,NIORO,PAOSKOTO,DABALY,"SANTHIE MAMOUR NDARY",64,78,661,520,1181
KAOLACK,NIORO,PAOSKOTO,"DAROU SALAM",BARKEWEL,146,174,898,856,1754
KAOLACK,NIORO,PAOSKOTO,"DAROU SALAM","BOUBOU DEME",37,42,229,301,530
KAOLACK,NIORO,PAOSKOTO,"DAROU SALAM","DAROU ALIME (NDIAWENE)",42,44,372,386,758
KAOLACK,NIORO,PAOSKOTO,"DAROU SALAM","DAROU BAILA",15,18,80,91,171
KAOLACK,NIORO,PAOSKOTO,"DAROU SALAM","DAROU KHOUDOSS",29,34,263,241,504
KAOLACK,NIORO,PAOSKOTO,"DAROU SALAM","DAROU LOUGUE",19,20,184,181,365
KAOLACK,NIORO,PAOSKOTO,"DAROU SALAM","DAROU MOUSTY",9,13,71,88,159
KAOLACK,NIORO,PAOSKOTO,"DAROU SALAM","DAROU SALAM",204,245,1358,1448,2806
KAOLACK,NIORO,PAOSKOTO,"DAROU SALAM","DAROU THISSE (NDAWENE)",40,56,429,408,837
KAOLACK,NIORO,PAOSKOTO,"DAROU SALAM","DERTADY NDIAYENNE",47,56,313,371,684
KAOLACK,NIORO,PAOSKOTO,"DAROU SALAM","DERTADY PEULH",11,14,68,71,139
KAOLACK,NIORO,PAOSKOTO,"DAROU SALAM","H1 KEUR KALABA",16,18,118,119,237
KAOLACK,NIORO,PAOSKOTO,"DAROU SALAM",DIAMAGUENE,88,106,562,505,1067
KAOLACK,NIORO,PAOSKOTO,"DAROU SALAM","DIAMWELY PEULH",25,27,148,171,319
KAOLACK,NIORO,PAOSKOTO,"DAROU SALAM","DINGUIRAYE ILLOT (KEUR ILLOT)",10,13,74,78,152
KAOLACK,NIORO,PAOSKOTO,"DAROU SALAM","DOUTA KEUR MBODERY",9,10,85,79,164
KAOLACK,NIORO,PAOSKOTO,"DAROU SALAM","DIAMWELY WOLOF",42,51,274,237,511
KAOLACK,NIORO,PAOSKOTO,"DAROU SALAM","FOUNEYNI (KEUR SAMBA HARY)",18,19,88,117,205
KAOLACK,NIORO,PAOSKOTO,"DAROU SALAM",HAMDALLAYE,14,18,87,98,185
KAOLACK,NIORO,PAOSKOTO,"DAROU SALAM","KAPAYE KEUR NDIAGA",16,18,81,83,164
KAOLACK,NIORO,PAOSKOTO,"DAROU SALAM","KAPAYE THISSE",5,6,33,31,64
KAOLACK,NIORO,PAOSKOTO,"DAROU SALAM","KEUR AMADOU CISSE",27,38,278,295,573
KAOLACK,NIORO,PAOSKOTO,"DAROU SALAM","KEUR AMATH BAKHOUM",13,16,89,95,184
KAOLACK,NIORO,PAOSKOTO,"DAROU SALAM","KEUR BABOU DIA",8,8,51,72,123
KAOLACK,NIORO,PAOSKOTO,"DAROU SALAM","KEUR BIDJI WOURY",35,41,257,266,523
KAOLACK,NIORO,PAOSKOTO,"DAROU SALAM","KEUR CHEIKHOU OUMAR",38,50,498,386,884
KAOLACK,NIORO,PAOSKOTO,"DAROU SALAM","KEUR DAGA NGUIDALDY",14,14,113,87,200
KAOLACK,NIORO,PAOSKOTO,"DAROU SALAM","KEUR DAGA THIECKENE",52,59,424,418,842
KAOLACK,NIORO,PAOSKOTO,"DAROU SALAM","H1 PEULGA",8,8,47,44,91
KAOLACK,NIORO,PAOSKOTO,"DAROU SALAM","H2 KEUR AMATH BA",4,6,26,25,51
KAOLACK,NIORO,PAOSKOTO,"DAROU SALAM","KEUR DEMBA HARY",11,14,99,77,176
KAOLACK,NIORO,PAOSKOTO,"DAROU SALAM","KEUR DIEBEL",26,32,245,196,441
KAOLACK,NIORO,PAOSKOTO,"DAROU SALAM","KEUR EL HADJI KATIM",38,46,454,430,884
KAOLACK,NIORO,PAOSKOTO,"DAROU SALAM","KEUR GALLO WOURY",18,20,113,130,243
KAOLACK,NIORO,PAOSKOTO,"DAROU SALAM","KEUR GAMOU",69,77,564,536,1100
KAOLACK,NIORO,PAOSKOTO,"DAROU SALAM","KEUR IBRAHIMA DIALLO",9,13,114,106,220
KAOLACK,NIORO,PAOSKOTO,"DAROU SALAM","KEUR MADIABEL",23,27,174,143,317
KAOLACK,NIORO,PAOSKOTO,"DAROU SALAM","KEUR MAMOUR DRAME",16,22,137,122,259
KAOLACK,NIORO,PAOSKOTO,"DAROU SALAM","KEUR MARY",26,26,178,161,339
KAOLACK,NIORO,PAOSKOTO,"DAROU SALAM","KEUR MATAR BA",13,19,157,116,273
KAOLACK,NIORO,PAOSKOTO,"DAROU SALAM","KEUR MOUSSA DRAME",18,23,188,160,348
KAOLACK,NIORO,PAOSKOTO,"DAROU SALAM","KEUR NDARY NDIAYE",33,44,225,198,423
KAOLACK,NIORO,PAOSKOTO,"DAROU SALAM","KEUR PATHE DIOUF",9,11,81,86,167
KAOLACK,NIORO,PAOSKOTO,"DAROU SALAM","KEUR SAFATIM",65,69,414,408,822
KAOLACK,NIORO,PAOSKOTO,"DAROU SALAM","KEUR SAMBA DIALLO",20,24,124,149,273
KAOLACK,NIORO,PAOSKOTO,"DAROU SALAM","MAKA NDIEGUENE (KEUR MASS DIAGNE)",71,82,725,656,1381
KAOLACK,NIORO,PAOSKOTO,"DAROU SALAM","MANKA COUNDA NDEMENE",6,9,45,48,93
KAOLACK,NIORO,PAOSKOTO,"DAROU SALAM","MEDINA OMAR TOURE (SANTHIE SAMA)",60,68,445,566,1011
KAOLACK,NIORO,PAOSKOTO,"DAROU SALAM","MEDINA PARKHA",62,71,371,454,825
KAOLACK,NIORO,PAOSKOTO,"DAROU SALAM","MEDINA THIEKENE",73,85,398,602,1000
KAOLACK,NIORO,PAOSKOTO,"DAROU SALAM","MEDINA YALL (SANTHIE YALL)",38,55,293,369,662
KAOLACK,NIORO,PAOSKOTO,"DAROU SALAM","NDAMA (THIECKENNE)",65,108,709,774,1483
KAOLACK,NIORO,PAOSKOTO,"DAROU SALAM","NDEMENE KEUR BIRANE",38,44,283,277,560
KAOLACK,NIORO,PAOSKOTO,"DAROU SALAM","NDEMENE TATA",23,31,198,214,412
KAOLACK,NIORO,PAOSKOTO,"DAROU SALAM","H1 KEUR SAMBA PANE",10,11,111,65,176
KAOLACK,NIORO,PAOSKOTO,"DAROU SALAM","KEUR MORY DIAO",13,13,114,107,221
KAOLACK,NIORO,PAOSKOTO,"DAROU SALAM","H1 DAROU ANNANE",32,32,138,141,279
KAOLACK,NIORO,PAOSKOTO,"DAROU SALAM","NDIAW NDEMENE",19,25,208,167,375
KAOLACK,NIORO,PAOSKOTO,"DAROU SALAM","SANTHIE KEUR SAMBA BA",7,7,39,31,70
KAOLACK,NIORO,PAOSKOTO,"DAROU SALAM","SANTHIE NDEMENE (KEUR BIRANE)",5,8,31,43,74
KAOLACK,NIORO,PAOSKOTO,"DAROU SALAM","SANTHIE SAMBA KA",14,18,116,81,197
KAOLACK,NIORO,PAOSKOTO,"DAROU SALAM","TOUBA NDEMENE",7,7,40,30,70
KAOLACK,NIORO,PAOSKOTO,"DAROU SALAM","TOUBA PARKHA",8,13,65,68,133
KAOLACK,NIORO,PAOSKOTO,"DAROU SALAM","TOUBA SALOUM",173,208,1183,1431,2614
KAOLACK,NIORO,PAOSKOTO,"DAROU SALAM","VELINGARA NDEMENE",38,48,318,344,662
KAOLACK,NIORO,PAOSKOTO,"DAROU SALAM","YALLE KEUR EL HADJI MALICK",70,88,585,545,1130
KAOLACK,NIORO,PAOSKOTO,"DAROU SALAM","YADOULAYE NDEMENE",28,41,225,242,467
KAOLACK,NIORO,PAOSKOTO,"DAROU SALAM","NDAMA TISSE",41,57,348,387,735
KAOLACK,NIORO,"WACK NGOUNA","KEUR MABA DIAKHOU",BOUSSOURA,10,15,134,77,211
KAOLACK,NIORO,"WACK NGOUNA","KEUR MABA DIAKHOU","DAROU SALAM",11,16,108,92,200
KAOLACK,NIORO,"WACK NGOUNA","KEUR MABA DIAKHOU","FASS KEUR SERIGNE MBAYE",27,33,445,369,814
KAOLACK,NIORO,"WACK NGOUNA","KEUR MABA DIAKHOU",FAYENE,19,23,142,146,288
KAOLACK,NIORO,"WACK NGOUNA","KEUR MABA DIAKHOU",GORIA,62,70,412,378,790
KAOLACK,NIORO,"WACK NGOUNA","KEUR MABA DIAKHOU","KEUR AMATH SEYDOU",99,120,841,638,1479
KAOLACK,NIORO,"WACK NGOUNA","KEUR MABA DIAKHOU","KEUR DIAMBODJI",16,16,174,134,308
KAOLACK,NIORO,"WACK NGOUNA","KEUR MABA DIAKHOU","KEUR FODE",32,42,147,158,305
KAOLACK,NIORO,"WACK NGOUNA","KEUR MABA DIAKHOU","KEUR GALDERY",52,56,412,382,794
KAOLACK,NIORO,"WACK NGOUNA","KEUR MABA DIAKHOU","KEUR GALAYE BARRY",6,11,76,65,141
KAOLACK,NIORO,"WACK NGOUNA","KEUR MABA DIAKHOU","KEUR GORY",39,42,206,242,448
KAOLACK,NIORO,"WACK NGOUNA","KEUR MABA DIAKHOU","KEUR GUELADIO",13,19,81,72,153
KAOLACK,NIORO,"WACK NGOUNA","KEUR MABA DIAKHOU","KEUR MABA DIAKHOU",115,134,907,845,1752
KAOLACK,NIORO,"WACK NGOUNA","KEUR MABA DIAKHOU","KEUR MALICK RAMATA",24,42,207,199,406
KAOLACK,NIORO,"WACK NGOUNA","KEUR MABA DIAKHOU","KEUR MAMADOU BONGUEL",19,25,160,181,341
KAOLACK,NIORO,"WACK NGOUNA","KEUR MABA DIAKHOU","KEUR MANKANDJI",45,58,425,417,842
KAOLACK,NIORO,"WACK NGOUNA","KEUR MABA DIAKHOU","KEUR MASSAMBA CODOU",25,30,218,194,412
KAOLACK,NIORO,"WACK NGOUNA","KEUR MABA DIAKHOU","KEUR MASSAR BA",45,53,500,518,1018
KAOLACK,NIORO,"WACK NGOUNA","KEUR MABA DIAKHOU","KEUR SAMBA YACINE",17,26,129,146,275
KAOLACK,NIORO,"WACK NGOUNA","KEUR MABA DIAKHOU","KEUR SAROKHY (KANKA)",65,95,669,643,1312
KAOLACK,NIORO,"WACK NGOUNA","KEUR MABA DIAKHOU","KEUR SERIGNE BA",37,45,337,305,642
KAOLACK,NIORO,"WACK NGOUNA","KEUR MABA DIAKHOU","H1 KEUR SALAOBE",14,15,108,103,211
KAOLACK,NIORO,"WACK NGOUNA","KEUR MABA DIAKHOU","KEUR TAMSIR KHODIA",9,10,141,104,245
KAOLACK,NIORO,"WACK NGOUNA","KEUR MABA DIAKHOU","KEUR THIERNO DIEYE",38,41,267,273,540
KAOLACK,NIORO,"WACK NGOUNA","KEUR MABA DIAKHOU","KEUR YERY",24,30,306,115,421
KAOLACK,NIORO,"WACK NGOUNA","KEUR MABA DIAKHOU",KOURANKO,21,22,157,132,289
KAOLACK,NIORO,"WACK NGOUNA","KEUR MABA DIAKHOU","LOUMENE OUSMANE",42,54,317,337,654
KAOLACK,NIORO,"WACK NGOUNA","KEUR MABA DIAKHOU",MANDERA,65,101,525,400,925
KAOLACK,NIORO,"WACK NGOUNA","KEUR MABA DIAKHOU",MBOULEDJI,13,18,272,226,498
KAOLACK,NIORO,"WACK NGOUNA","KEUR MABA DIAKHOU","MEDINA 2",7,14,68,54,122
KAOLACK,NIORO,"WACK NGOUNA","KEUR MABA DIAKHOU",NAOULEROU,45,70,444,359,803
KAOLACK,NIORO,"WACK NGOUNA","KEUR MABA DIAKHOU","NDAME LO",21,24,148,170,318
KAOLACK,NIORO,"WACK NGOUNA","KEUR MABA DIAKHOU",NDEMENELE,38,46,389,359,748
KAOLACK,NIORO,"WACK NGOUNA","KEUR MABA DIAKHOU","NDIAGNE WALO",110,136,757,728,1485
KAOLACK,NIORO,"WACK NGOUNA","KEUR MABA DIAKHOU",NDIAWENE,26,26,178,113,291
KAOLACK,NIORO,"WACK NGOUNA","KEUR MABA DIAKHOU","NDIAYENE POSTE",49,53,246,242,488
KAOLACK,NIORO,"WACK NGOUNA","KEUR MABA DIAKHOU","NDIOBENE SANTHIE",93,103,550,586,1136
KAOLACK,NIORO,"WACK NGOUNA","KEUR MABA DIAKHOU","NDIOBENE WALO",111,142,855,764,1619
KAOLACK,NIORO,"WACK NGOUNA","KEUR MABA DIAKHOU","NDRAME NDIMB",57,76,407,408,815
KAOLACK,NIORO,"WACK NGOUNA","KEUR MABA DIAKHOU","NDRAME NGATA",10,15,93,94,187
KAOLACK,NIORO,"WACK NGOUNA","KEUR MABA DIAKHOU","NGAYENE SINE",30,32,188,147,335
KAOLACK,NIORO,"WACK NGOUNA","KEUR MABA DIAKHOU","NGUEYENE MAMADY",58,75,357,427,784
KAOLACK,NIORO,"WACK NGOUNA","KEUR MABA DIAKHOU",NIANGHENE,21,37,196,174,370
KAOLACK,NIORO,"WACK NGOUNA","KEUR MABA DIAKHOU","NIASSENE WALO",77,99,563,556,1119
KAOLACK,NIORO,"WACK NGOUNA","KEUR MABA DIAKHOU","PANE ABDOULAYE DIOP",69,82,523,524,1047
KAOLACK,NIORO,"WACK NGOUNA","KEUR MABA DIAKHOU","PASSY KHOUR",24,39,127,179,306
KAOLACK,NIORO,"WACK NGOUNA","KEUR MABA DIAKHOU",SAMBOUMBA,47,57,288,288,576
KAOLACK,NIORO,"WACK NGOUNA","KEUR MABA DIAKHOU","SANTHIE MAKHA",12,14,79,64,143
KAOLACK,NIORO,"WACK NGOUNA","KEUR MABA DIAKHOU","SANTHIE MBAYENE",26,33,225,242,467
KAOLACK,NIORO,"WACK NGOUNA","KEUR MABA DIAKHOU","SANTHIE OMAR DIAGNE",10,22,166,171,337
KAOLACK,NIORO,"WACK NGOUNA","KEUR MABA DIAKHOU",THIAMBENE,49,65,410,340,750
KAOLACK,NIORO,"WACK NGOUNA","KEUR MABA DIAKHOU","THIARENE MATAR",87,95,659,627,1286
KAOLACK,NIORO,"WACK NGOUNA","KEUR MABA DIAKHOU","H1 TAWFEKH",8,11,58,56,114
KAOLACK,NIORO,"WACK NGOUNA","KEUR MABA DIAKHOU",THIOYENE,19,24,128,137,265
KAOLACK,NIORO,"WACK NGOUNA","KEUR MABA DIAKHOU","THILLA GRAND",83,102,565,526,1091
KAOLACK,NIORO,"WACK NGOUNA","KEUR MABA DIAKHOU","THILLA NDIAYE",30,33,188,200,388
KAOLACK,NIORO,"WACK NGOUNA","KEUR MABA DIAKHOU",TONGO,13,21,144,130,274
KAOLACK,NIORO,"WACK NGOUNA","KEUR MABA DIAKHOU",VELINGARA,145,201,1113,1137,2250
KAOLACK,NIORO,"WACK NGOUNA","KEUR MABA DIAKHOU","H1 KEUR MATAR (DRAME)",12,15,75,79,154
KAOLACK,NIORO,"WACK NGOUNA","NDRAME ESCALE",AINOUMANE,4,4,42,33,75
KAOLACK,NIORO,"WACK NGOUNA","NDRAME ESCALE",BOWE,99,130,732,735,1467
KAOLACK,NIORO,"WACK NGOUNA","NDRAME ESCALE","DAROU MBITEYENE",7,8,55,49,104
KAOLACK,NIORO,"WACK NGOUNA","NDRAME ESCALE","DJISSA ALIOU",36,38,279,277,556
KAOLACK,NIORO,"WACK NGOUNA","NDRAME ESCALE","H1 NGUEYENE KEUR MALICK FILY",9,11,69,72,141
KAOLACK,NIORO,"WACK NGOUNA","NDRAME ESCALE","DJISSA SADIO",18,24,152,130,282
KAOLACK,NIORO,"WACK NGOUNA","NDRAME ESCALE","FASS NGUEYENE (KEUR BIRANE GUEYE)",18,39,276,293,569
KAOLACK,NIORO,"WACK NGOUNA","NDRAME ESCALE","HANNENE WALO",11,16,93,88,181
KAOLACK,NIORO,"WACK NGOUNA","NDRAME ESCALE","KERE (KERE OUALO)",15,17,95,92,187
KAOLACK,NIORO,"WACK NGOUNA","NDRAME ESCALE","KEUR ABDOU MATA",23,31,273,231,504
KAOLACK,NIORO,"WACK NGOUNA","NDRAME ESCALE","KEUR BAKA AWA",21,28,189,200,389
KAOLACK,NIORO,"WACK NGOUNA","NDRAME ESCALE","KEUR BIRANE NDOUPY",71,85,498,581,1079
KAOLACK,NIORO,"WACK NGOUNA","NDRAME ESCALE","KEUR BOH FALL",14,15,81,84,165
KAOLACK,NIORO,"WACK NGOUNA","NDRAME ESCALE","KEUR DAME",51,68,510,413,923
KAOLACK,NIORO,"WACK NGOUNA","NDRAME ESCALE","KEUR ELHADJI SAMBA",12,25,173,164,337
KAOLACK,NIORO,"WACK NGOUNA","NDRAME ESCALE","KEUR FAFA BOURY",21,26,225,230,455
KAOLACK,NIORO,"WACK NGOUNA","NDRAME ESCALE","KEUR GAYE",28,41,252,304,556
KAOLACK,NIORO,"WACK NGOUNA","NDRAME ESCALE","KEUR KATIM (KEUR KATIM TOURE)",14,21,147,146,293
KAOLACK,NIORO,"WACK NGOUNA","NDRAME ESCALE","KEUR LAHINE SAKHO",71,86,524,519,1043
KAOLACK,NIORO,"WACK NGOUNA","NDRAME ESCALE","KEUR MACIRE DIAWARA",19,24,163,142,305
KAOLACK,NIORO,"WACK NGOUNA","NDRAME ESCALE","KEUR MALICK NDIERE",28,44,314,220,534
KAOLACK,NIORO,"WACK NGOUNA","NDRAME ESCALE","KEUR MAMOUR ANTA",37,60,566,421,987
KAOLACK,NIORO,"WACK NGOUNA","NDRAME ESCALE","KEUR MASSAKHO",25,38,215,267,482
KAOLACK,NIORO,"WACK NGOUNA","NDRAME ESCALE","KEUR MATAR SOUNA (NIETTY NECK)",31,49,330,343,673
KAOLACK,NIORO,"WACK NGOUNA","NDRAME ESCALE","KEUR MOMATH ANTA",54,65,641,463,1104
KAOLACK,NIORO,"WACK NGOUNA","NDRAME ESCALE","KEUR SAMBA AMATH",44,54,327,397,724
KAOLACK,NIORO,"WACK NGOUNA","NDRAME ESCALE","KEUR THIERNO TOURE",29,44,240,281,521
KAOLACK,NIORO,"WACK NGOUNA","NDRAME ESCALE",M’BACKERY,28,36,221,196,417
KAOLACK,NIORO,"WACK NGOUNA","NDRAME ESCALE","MEDINA DIANE (KEUR ABDOU DIANE)",18,22,170,139,309
KAOLACK,NIORO,"WACK NGOUNA","NDRAME ESCALE","MEDINA MBANDJI ( SANTHIE YAGUE )",10,23,90,117,207
KAOLACK,NIORO,"WACK NGOUNA","NDRAME ESCALE","MEDINA SALAM",41,63,390,287,677
KAOLACK,NIORO,"WACK NGOUNA","NDRAME ESCALE","MISSIRAH THISSE",26,27,184,139,323
KAOLACK,NIORO,"WACK NGOUNA","NDRAME ESCALE","NDIAYE COUNDA",28,32,235,202,437
KAOLACK,NIORO,"WACK NGOUNA","NDRAME ESCALE","NDIENGHENE MODY",60,65,356,393,749
KAOLACK,NIORO,"WACK NGOUNA","NDRAME ESCALE",NDIOBENE,26,35,340,278,618
KAOLACK,NIORO,"WACK NGOUNA","NDRAME ESCALE",NDIOFFORY,16,29,165,167,332
KAOLACK,NIORO,"WACK NGOUNA","NDRAME ESCALE","NDRAME ESCALE",271,341,1804,1950,3754
KAOLACK,NIORO,"WACK NGOUNA","NDRAME ESCALE","NDRAME PEULH",177,205,1156,1224,2380
KAOLACK,NIORO,"WACK NGOUNA","NDRAME ESCALE","NGUEYENE NDARY",13,16,101,122,223
KAOLACK,NIORO,"WACK NGOUNA","NDRAME ESCALE","TALLENE GUEDE",37,41,267,224,491
KAOLACK,NIORO,"WACK NGOUNA","NDRAME ESCALE","H1 KEUR CHEIKH KANDJI",14,19,129,109,238
KAOLACK,NIORO,"WACK NGOUNA","NDRAME ESCALE","THIAMENE KEUR MASSAMBA",15,35,209,185,394
KAOLACK,NIORO,"WACK NGOUNA","NDRAME ESCALE","THIAMENE MAKA",25,47,239,240,479
KAOLACK,NIORO,"WACK NGOUNA","NDRAME ESCALE","THIAMENE MOMATH BINTA",31,45,249,258,507
KAOLACK,NIORO,"WACK NGOUNA","NDRAME ESCALE","THIARENE DJISSA",36,56,416,427,843
KAOLACK,NIORO,"WACK NGOUNA","NDRAME ESCALE","THIOYENE MATAR",18,22,116,149,265
KAOLACK,NIORO,"WACK NGOUNA","NDRAME ESCALE","TOUBA 2",52,69,395,473,868
KAOLACK,NIORO,"WACK NGOUNA","NDRAME ESCALE",KOTINETE,71,78,494,457,951
KAOLACK,NIORO,"WACK NGOUNA","WACK NGOUNA","AFFE KEUR AMADY",40,82,391,342,733
KAOLACK,NIORO,"WACK NGOUNA","WACK NGOUNA","DAGA BANY NDRAME",42,58,439,404,843
KAOLACK,NIORO,"WACK NGOUNA","WACK NGOUNA","DAROU MATAR",83,101,753,839,1592
KAOLACK,NIORO,"WACK NGOUNA","WACK NGOUNA","DAROU SALAM MOURIDE",49,67,580,486,1066
KAOLACK,NIORO,"WACK NGOUNA","WACK NGOUNA","FASS NGAYENE",6,9,63,78,141
KAOLACK,NIORO,"WACK NGOUNA","WACK NGOUNA",FETTO,45,50,459,322,781
KAOLACK,NIORO,"WACK NGOUNA","WACK NGOUNA","GUINEE (GUINEE WALO)",15,26,193,157,350
KAOLACK,NIORO,"WACK NGOUNA","WACK NGOUNA","KEUR ALY MBATH",10,14,80,78,158
KAOLACK,NIORO,"WACK NGOUNA","WACK NGOUNA","KEUR AMADY NDIOME",8,11,87,75,162
KAOLACK,NIORO,"WACK NGOUNA","WACK NGOUNA","KEUR AMADY NGUENAR",32,40,345,316,661
KAOLACK,NIORO,"WACK NGOUNA","WACK NGOUNA",NIDJI,10,12,76,71,147
KAOLACK,NIORO,"WACK NGOUNA","WACK NGOUNA","KEUR AMATH NDIBA",47,57,434,403,837
KAOLACK,NIORO,"WACK NGOUNA","WACK NGOUNA","KEUR ASSANE DIASSE",28,30,245,208,453
KAOLACK,NIORO,"WACK NGOUNA","WACK NGOUNA","KEUR BABOU MBOMBE",56,65,470,474,944
KAOLACK,NIORO,"WACK NGOUNA","WACK NGOUNA","KEUR BOURAMA DIARA 2",33,35,258,212,470
KAOLACK,NIORO,"WACK NGOUNA","WACK NGOUNA","KEUR CHEIKHOU NDIAYE",16,18,185,145,330
KAOLACK,NIORO,"WACK NGOUNA","WACK NGOUNA","KEUR DEMBA CIRE",28,40,248,269,517
KAOLACK,NIORO,"WACK NGOUNA","WACK NGOUNA","KEUR DINGUERE",8,10,89,107,196
KAOLACK,NIORO,"WACK NGOUNA","WACK NGOUNA","KEUR LAMINE",11,14,92,92,184
KAOLACK,NIORO,"WACK NGOUNA","WACK NGOUNA","KEUR MADY YACINE",112,147,846,923,1769
KAOLACK,NIORO,"WACK NGOUNA","WACK NGOUNA","KEUR MALAHINE",17,25,164,198,362
KAOLACK,NIORO,"WACK NGOUNA","WACK NGOUNA","KEUR MAMADOU MAMA",36,37,242,243,485
KAOLACK,NIORO,"WACK NGOUNA","WACK NGOUNA","KEUR MAMADOU NENE",37,43,292,219,511
KAOLACK,NIORO,"WACK NGOUNA","WACK NGOUNA","KEUR MAMOUR COUMBA",71,86,620,673,1293
KAOLACK,NIORO,"WACK NGOUNA","WACK NGOUNA","KEUR MATEKHE",21,33,164,300,464
KAOLACK,NIORO,"WACK NGOUNA","WACK NGOUNA","KEUR NDIAGA DIALE",32,37,240,251,491
KAOLACK,NIORO,"WACK NGOUNA","WACK NGOUNA","KEUR NDIAGA PEULH",9,10,78,65,143
KAOLACK,NIORO,"WACK NGOUNA","WACK NGOUNA","H1 SANGHOLANE",15,17,134,116,250
KAOLACK,NIORO,"WACK NGOUNA","WACK NGOUNA","KEUR NDONGO",47,71,362,363,725
KAOLACK,NIORO,"WACK NGOUNA","WACK NGOUNA","KEUR NGOR",30,47,312,300,612
KAOLACK,NIORO,"WACK NGOUNA","WACK NGOUNA","KEUR OMAR OUMY",18,24,145,188,333
KAOLACK,NIORO,"WACK NGOUNA","WACK NGOUNA","KEUR SACOUMBA",22,24,179,157,336
KAOLACK,NIORO,"WACK NGOUNA","WACK NGOUNA","KEUR SAMADY",4,8,45,35,80
KAOLACK,NIORO,"WACK NGOUNA","WACK NGOUNA","KEUR SAMBA KA",55,63,417,395,812
KAOLACK,NIORO,"WACK NGOUNA","WACK NGOUNA","KEUR SEYDOU BA",34,45,302,323,625
KAOLACK,NIORO,"WACK NGOUNA","WACK NGOUNA","KEUR SEYDOU HANNE",25,32,259,238,497
KAOLACK,NIORO,"WACK NGOUNA","WACK NGOUNA","KEUR TAPHA",21,27,165,162,327
KAOLACK,NIORO,"WACK NGOUNA","WACK NGOUNA","KEUR YORO KHODIA",180,249,1645,1503,3148
KAOLACK,NIORO,"WACK NGOUNA","WACK NGOUNA",KOUTANGO,57,57,281,296,577
KAOLACK,NIORO,"WACK NGOUNA","WACK NGOUNA",MBADIENE,35,48,290,285,575
KAOLACK,NIORO,"WACK NGOUNA","WACK NGOUNA",MBAYENE,76,108,903,815,1718
KAOLACK,NIORO,"WACK NGOUNA","WACK NGOUNA","MEDINA MASS (SANTHIE)",12,14,108,88,196
KAOLACK,NIORO,"WACK NGOUNA","WACK NGOUNA","MEDINA THIAMENE",33,48,289,301,590
KAOLACK,NIORO,"WACK NGOUNA","WACK NGOUNA","MERELA SANTHIE",17,23,130,112,242
KAOLACK,NIORO,"WACK NGOUNA","WACK NGOUNA","MERELA YORO",39,46,365,265,630
KAOLACK,NIORO,"WACK NGOUNA","WACK NGOUNA","NDIAGO 1",87,108,728,745,1473
KAOLACK,NIORO,"WACK NGOUNA","WACK NGOUNA","NDIAYENE MOMATH",43,47,393,336,729
KAOLACK,NIORO,"WACK NGOUNA","WACK NGOUNA","NDIOUFENE THIWALO",33,36,219,211,430
KAOLACK,NIORO,"WACK NGOUNA","WACK NGOUNA",NGOMENE,26,29,142,178,320
KAOLACK,NIORO,"WACK NGOUNA","WACK NGOUNA","NGUER BABOU",56,87,500,447,947
KAOLACK,NIORO,"WACK NGOUNA","WACK NGOUNA","NGUEYENE DJIM",14,21,174,194,368
KAOLACK,NIORO,"WACK NGOUNA","WACK NGOUNA","PANE AMATH (PANE SADEL)",91,121,840,804,1644
KAOLACK,NIORO,"WACK NGOUNA","WACK NGOUNA","PASSY BABOU",69,81,584,581,1165
KAOLACK,NIORO,"WACK NGOUNA","WACK NGOUNA",SABOYA,144,161,724,648,1372
KAOLACK,NIORO,"WACK NGOUNA","WACK NGOUNA","SAMAKO BAMBARA (SAMAKOU BAMBARA)",28,34,231,168,399
KAOLACK,NIORO,"WACK NGOUNA","WACK NGOUNA","SAMAKO TOUCOULEUR (SAMAKOU TOUCOULEUR)",55,61,399,382,781
KAOLACK,NIORO,"WACK NGOUNA","WACK NGOUNA","SANTHIE TOURE",14,19,113,100,213
KAOLACK,NIORO,"WACK NGOUNA","WACK NGOUNA",SOUCOUTA,114,182,1264,1114,2378
KAOLACK,NIORO,"WACK NGOUNA","WACK NGOUNA","THIAMENE DIOGO",47,59,446,491,937
KAOLACK,NIORO,"WACK NGOUNA","WACK NGOUNA","THIARENE ALASSANE",94,103,829,933,1762
KAOLACK,NIORO,"WACK NGOUNA","WACK NGOUNA","TOUBA FASS",13,16,116,105,221
KAOLACK,NIORO,"WACK NGOUNA","WACK NGOUNA","TOUBA PEULH",27,28,188,149,337
KAOLACK,NIORO,"WACK NGOUNA","WACK NGOUNA","WACK MBATHIO",17,32,271,250,521
KAOLACK,NIORO,"WACK NGOUNA","WACK NGOUNA","WACK NGOUNA",376,491,2352,2196,4548
KAOLACK,NIORO,"WACK NGOUNA","KEUR MANDONGO",DOUBOUROU,11,13,100,81,181
KAOLACK,NIORO,"WACK NGOUNA","KEUR MANDONGO","KEUR ABDOU DIAFE TOUCOULEUR",48,57,572,405,977
KAOLACK,NIORO,"WACK NGOUNA","KEUR MANDONGO","KEUR MALO",9,18,99,104,203
KAOLACK,NIORO,"WACK NGOUNA","KEUR MANDONGO","KEUR MANDONGO (KONTEYENE)",131,168,1213,1239,2452
KAOLACK,NIORO,"WACK NGOUNA","KEUR MANDONGO","KEUR MANIEBE",23,30,174,220,394
KAOLACK,NIORO,"WACK NGOUNA","KEUR MANDONGO",KOUDOME,13,19,139,119,258
KAOLACK,NIORO,"WACK NGOUNA","KEUR MANDONGO","LOYENE (LOYENE WALO)",21,37,254,246,500
KAOLACK,NIORO,"WACK NGOUNA","KEUR MANDONGO","MISSIRAH DINE",61,77,587,597,1184
KAOLACK,NIORO,"WACK NGOUNA","KEUR MANDONGO",NDEME,76,83,476,506,982
KAOLACK,NIORO,"WACK NGOUNA","KEUR MANDONGO","NDIAGO 2 (NDIAGO DJILAKHAR)",41,54,357,386,743
KAOLACK,NIORO,"WACK NGOUNA","KEUR MANDONGO","NDIENGUENE KEUR IBRA",33,56,429,414,843
KAOLACK,NIORO,"WACK NGOUNA","KEUR MANDONGO","NDIOUGOUTY MALICK",27,38,247,233,480
KAOLACK,NIORO,"WACK NGOUNA","KEUR MANDONGO","NDIOUGOUTY SERIGNE",23,41,212,223,435
KAOLACK,NIORO,"WACK NGOUNA","KEUR MANDONGO","NGUER ALY",8,10,90,100,190
KAOLACK,NIORO,"WACK NGOUNA","KEUR MANDONGO","SINTHIOU YORO SOW",2,2,15,10,25
KAOLACK,NIORO,"WACK NGOUNA","KEUR MANDONGO","TAIBA MBAYENE",68,98,728,720,1448
KAOLACK,NIORO,"WACK NGOUNA","KEUR MANDONGO","H1 SANTHIE BABA MBAYE",3,10,69,71,140
KAOLACK,NIORO,"WACK NGOUNA","KEUR MANDONGO","THIAMENE OUSMANE",23,46,317,313,630
KAOLACK,NIORO,"WACK NGOUNA","KEUR MANDONGO","H1 MEDINA NDIOBENE",5,10,38,31,69
KAOLACK,NIORO,"WACK NGOUNA","KEUR MANDONGO","THIOYENE SERIGNE",45,57,416,403,819
KAOLACK,NIORO,"WACK NGOUNA","KEUR MANDONGO","THYSSE KEUR MANDONGO",33,44,246,289,535
KAOLACK,NIORO,"WACK NGOUNA","KEUR MADIABEL",LANSAR,128,160,882,919,1801
KAOLACK,NIORO,"WACK NGOUNA","KEUR MADIABEL",LEONA,363,431,2207,2259,4466
KAOLACK,NIORO,"WACK NGOUNA","KEUR MADIABEL","MEDINA GRANDE MOSQUEE",101,129,567,702,1269
KAOLACK,NIORO,"WACK NGOUNA","KEUR MADIABEL","MEDINE NIASSENE",133,241,1064,1061,2125
KAOLACK,NIORO,"WACK NGOUNA","KEUR MADIABEL",SAM,364,427,2189,2195,4384
KAOLACK,NIORO,"WACK NGOUNA","KEUR MADIABEL","SANTHIE ABDOU BIGUE",200,229,1232,1274,2506
KAOLACK,GUINGUINEO,GUINGUINEO,GUINGUINEO,CAMPEMENT,413,450,1760,2027,3787
KAOLACK,GUINGUINEO,GUINGUINEO,GUINGUINEO,FARABOUGOU,77,81,479,438,917
KAOLACK,GUINGUINEO,GUINGUINEO,GUINGUINEO,KANENE,388,476,1965,2220,4185
KAOLACK,GUINGUINEO,GUINGUINEO,GUINGUINEO,"KEUR MACODE BAR",419,520,2327,2377,4704
KAOLACK,GUINGUINEO,GUINGUINEO,GUINGUINEO,PALENE,229,271,1043,1115,2158
KAOLACK,GUINGUINEO,GUINGUINEO,GUINGUINEO,THIERERE,232,271,1332,1359,2691
KAOLACK,GUINGUINEO,GUINGUINEO,GUINGUINEO,WALO,158,184,914,984,1898
KAOLACK,GUINGUINEO,MBADAKHOUNE,MBADAKHOUNE,BACK,18,22,108,91,199
KAOLACK,GUINGUINEO,MBADAKHOUNE,MBADAKHOUNE,"H1 MBOULOMBOFY",20,32,184,177,361
KAOLACK,GUINGUINEO,MBADAKHOUNE,MBADAKHOUNE,BOURNDOU,38,44,224,190,414
KAOLACK,GUINGUINEO,MBADAKHOUNE,MBADAKHOUNE,"H1 PAPAO",8,11,86,73,159
KAOLACK,GUINGUINEO,MBADAKHOUNE,MBADAKHOUNE,"H2 DAROU MIRAYA",1,1,304,19,323
KAOLACK,GUINGUINEO,MBADAKHOUNE,MBADAKHOUNE,"DAGA BOKY",56,61,311,341,652
KAOLACK,GUINGUINEO,MBADAKHOUNE,MBADAKHOUNE,"H1 KALIERE",10,14,107,94,201
KAOLACK,GUINGUINEO,MBADAKHOUNE,MBADAKHOUNE,FARABOUGOU,61,73,397,347,744
KAOLACK,GUINGUINEO,MBADAKHOUNE,MBADAKHOUNE,GNOLANEME,294,314,1657,1251,2908
KAOLACK,GUINGUINEO,MBADAKHOUNE,MBADAKHOUNE,"H2 KAWSARA FALL",107,108,456,458,914
KAOLACK,GUINGUINEO,MBADAKHOUNE,MBADAKHOUNE,"H3 KEUR YANGANE",10,13,92,51,143
KAOLACK,GUINGUINEO,MBADAKHOUNE,MBADAKHOUNE,"KEBE WOLOF",26,33,182,175,357
KAOLACK,GUINGUINEO,MBADAKHOUNE,MBADAKHOUNE,"KEBE PEULH",7,8,41,29,70
KAOLACK,GUINGUINEO,MBADAKHOUNE,MBADAKHOUNE,"KEBE SERERE",21,37,224,196,420
KAOLACK,GUINGUINEO,MBADAKHOUNE,MBADAKHOUNE,"KEUR OUSMANE DEMBA",13,14,85,96,181
KAOLACK,GUINGUINEO,MBADAKHOUNE,MBADAKHOUNE,KONGHOLY,14,16,117,123,240
KAOLACK,GUINGUINEO,MBADAKHOUNE,MBADAKHOUNE,"H1 CARRIERE",11,12,86,77,163
KAOLACK,GUINGUINEO,MBADAKHOUNE,MBADAKHOUNE,"H4 SANTHIE",11,13,69,66,135
KAOLACK,GUINGUINEO,MBADAKHOUNE,MBADAKHOUNE,"H5 KEUR MBALLOU",6,10,47,54,101
KAOLACK,GUINGUINEO,MBADAKHOUNE,MBADAKHOUNE,"MAKA KAHONE",121,154,630,709,1339
KAOLACK,GUINGUINEO,MBADAKHOUNE,MBADAKHOUNE,"H2 KEUR MBIND MODY",4,5,20,20,40
KAOLACK,GUINGUINEO,MBADAKHOUNE,MBADAKHOUNE,"H3 MAKA SUD (KEUR IBRAHIMA FAYE)",19,22,158,133,291
KAOLACK,GUINGUINEO,MBADAKHOUNE,MBADAKHOUNE,"MBABOUMY ARDO",15,18,98,83,181
KAOLACK,GUINGUINEO,MBADAKHOUNE,MBADAKHOUNE,"H1 MBABOUMY LOUCKY",11,12,61,53,114
KAOLACK,GUINGUINEO,MBADAKHOUNE,MBADAKHOUNE,"H2 MBABOUMY KEUR NGAGNE",1,1,9,10,19
KAOLACK,GUINGUINEO,MBADAKHOUNE,MBADAKHOUNE,"MBABOUMY NGUEMBE",18,21,76,83,159
KAOLACK,GUINGUINEO,MBADAKHOUNE,MBADAKHOUNE,"MBABOUNY GUEYENE (KEUR SAMBA GUEYE)",14,15,88,109,197
KAOLACK,GUINGUINEO,MBADAKHOUNE,MBADAKHOUNE,MBADAKHOUNE,92,125,481,475,956
KAOLACK,GUINGUINEO,MBADAKHOUNE,MBADAKHOUNE,"MBABOUMY PALENE",19,24,172,155,327
KAOLACK,GUINGUINEO,MBADAKHOUNE,MBADAKHOUNE,"MBABOUMY PEULH",7,9,68,49,117
KAOLACK,GUINGUINEO,MBADAKHOUNE,MBADAKHOUNE,"H1 MBABOUMY (KEUR RAMADAN)",1,1,14,14,28
KAOLACK,GUINGUINEO,MBADAKHOUNE,MBADAKHOUNE,MBANKOUMA,7,8,44,30,74
KAOLACK,GUINGUINEO,MBADAKHOUNE,MBADAKHOUNE,MBOULEME,40,53,269,245,514
KAOLACK,GUINGUINEO,MBADAKHOUNE,MBADAKHOUNE,"NDOUR NDOUR",18,37,184,171,355
KAOLACK,GUINGUINEO,MBADAKHOUNE,MBADAKHOUNE,"PAFFA BOU NDAW",21,29,149,141,290
KAOLACK,GUINGUINEO,MBADAKHOUNE,MBADAKHOUNE,"H1 PAFFA (BOUMACK)",13,18,93,87,180
KAOLACK,GUINGUINEO,MBADAKHOUNE,MBADAKHOUNE,"PALADO 1",17,21,88,87,175
KAOLACK,GUINGUINEO,MBADAKHOUNE,MBADAKHOUNE,"H1 PALADO PEULGA",15,21,146,138,284
KAOLACK,GUINGUINEO,MBADAKHOUNE,MBADAKHOUNE,"H2 PALADO SANGUE",10,19,159,148,307
KAOLACK,GUINGUINEO,MBADAKHOUNE,MBADAKHOUNE,PARACELLE,98,104,550,462,1012
KAOLACK,GUINGUINEO,MBADAKHOUNE,MBADAKHOUNE,"H1 PEULGA",2,3,25,20,45
KAOLACK,GUINGUINEO,MBADAKHOUNE,MBADAKHOUNE,"SAWILA MODOU BARA",18,23,108,95,203
KAOLACK,GUINGUINEO,MBADAKHOUNE,MBADAKHOUNE,"SAWILA PEUL",11,14,100,89,189
KAOLACK,GUINGUINEO,MBADAKHOUNE,MBADAKHOUNE,"H1 SAWILA RENAME",12,13,87,78,165
KAOLACK,GUINGUINEO,MBADAKHOUNE,MBADAKHOUNE,SEANE,50,60,296,262,558
KAOLACK,GUINGUINEO,MBADAKHOUNE,MBADAKHOUNE,"H1 THIARE",16,18,102,109,211
KAOLACK,GUINGUINEO,MBADAKHOUNE,MBADAKHOUNE,"H3 DIERY",7,10,56,46,102
KAOLACK,GUINGUINEO,MBADAKHOUNE,MBADAKHOUNE,"DAROU MINAME",175,189,1709,602,2311
KAOLACK,GUINGUINEO,MBADAKHOUNE,MBADAKHOUNE,"DAROU NDIAYE",39,41,185,196,381
KAOLACK,GUINGUINEO,MBADAKHOUNE,MBADAKHOUNE,DJIBAYALLA,18,18,91,75,166
KAOLACK,GUINGUINEO,MBADAKHOUNE,MBADAKHOUNE,"GNOLANEME NORD OUEST",102,122,517,446,963
KAOLACK,GUINGUINEO,MBADAKHOUNE,MBADAKHOUNE,"KIRPA SESSENE",6,6,45,39,84
KAOLACK,GUINGUINEO,MBADAKHOUNE,MBADAKHOUNE,LOUCKY,32,38,179,165,344
KAOLACK,GUINGUINEO,MBADAKHOUNE,MBADAKHOUNE,RANDA,24,27,190,207,397
KAOLACK,GUINGUINEO,MBADAKHOUNE,MBADAKHOUNE,SAKHA,45,66,407,379,786
KAOLACK,GUINGUINEO,MBADAKHOUNE,MBADAKHOUNE,"H1 DUNDAL",10,14,75,83,158
KAOLACK,GUINGUINEO,MBADAKHOUNE,MBADAKHOUNE,"H1 KEUR BELLAL (KEUR NDIOUGA)",38,38,183,175,358
KAOLACK,GUINGUINEO,MBADAKHOUNE,MBADAKHOUNE,"SARE MBANA ( SEN GAZ)",124,139,780,566,1346
KAOLACK,GUINGUINEO,MBADAKHOUNE,MBADAKHOUNE,"H1 MONGNAGUEN",107,113,532,401,933
KAOLACK,GUINGUINEO,MBADAKHOUNE,MBADAKHOUNE,"SAWILA NDAO",6,9,31,34,65
KAOLACK,GUINGUINEO,MBADAKHOUNE,NDIAGO,"DAROU DIADJI",20,23,87,115,202
KAOLACK,GUINGUINEO,MBADAKHOUNE,NDIAGO,"H1 DIADJI",18,25,172,160,332
KAOLACK,GUINGUINEO,MBADAKHOUNE,NDIAGO,"H2 KEUR DAOUDA DOUMBOUYA",1,1,6,3,9
KAOLACK,GUINGUINEO,MBADAKHOUNE,NDIAGO,"DAROU RAHMANE",9,9,62,41,103
KAOLACK,GUINGUINEO,MBADAKHOUNE,NDIAGO,"H1 GUIRANE FAYE",9,16,96,109,205
KAOLACK,GUINGUINEO,MBADAKHOUNE,NDIAGO,"H2 KEUR MADIOP SEYE",13,15,132,81,213
KAOLACK,GUINGUINEO,MBADAKHOUNE,NDIAGO,"H3 ADOU KALPE",11,14,79,82,161
KAOLACK,GUINGUINEO,MBADAKHOUNE,NDIAGO,"H4 NDIOBENE",1,2,21,22,43
KAOLACK,GUINGUINEO,MBADAKHOUNE,NDIAGO,"KATHIANE WOLOF",7,9,63,61,124
KAOLACK,GUINGUINEO,MBADAKHOUNE,NDIAGO,"H1 KATHIANE PEULH",4,7,65,67,132
KAOLACK,GUINGUINEO,MBADAKHOUNE,NDIAGO,"H4 KEUR MOR KANE ET HI KEUR MBAYE COUMBA",17,32,233,165,398
KAOLACK,GUINGUINEO,MBADAKHOUNE,NDIAGO,"KEUR NDIOUGA SEYE",5,10,41,40,81
KAOLACK,GUINGUINEO,MBADAKHOUNE,NDIAGO,"MADINA KAWSARA",12,15,97,74,171
KAOLACK,GUINGUINEO,MBADAKHOUNE,NDIAGO,"H1 NDIRENE GORYA",12,15,146,120,266
KAOLACK,GUINGUINEO,MBADAKHOUNE,NDIAGO,"H2 NDIRENE PEULH",8,8,55,41,96
KAOLACK,GUINGUINEO,MBADAKHOUNE,NDIAGO,"MAKA MBAYE",37,45,233,227,460
KAOLACK,GUINGUINEO,MBADAKHOUNE,NDIAGO,"H1 NDIRENNE",2,2,13,9,22
KAOLACK,GUINGUINEO,MBADAKHOUNE,NDIAGO,"H4 NGATHIE FALL",25,25,105,86,191
KAOLACK,GUINGUINEO,MBADAKHOUNE,NDIAGO,"H5 NGUICK",31,35,207,217,424
KAOLACK,GUINGUINEO,MBADAKHOUNE,NDIAGO,NDELLE,123,144,863,746,1609
KAOLACK,GUINGUINEO,MBADAKHOUNE,NDIAGO,"H1 KEUR LAITY FAYE",3,6,16,26,42
KAOLACK,GUINGUINEO,MBADAKHOUNE,NDIAGO,"H2 KEUR MBAYE NGOM",5,5,28,28,56
KAOLACK,GUINGUINEO,MBADAKHOUNE,NDIAGO,"NDIAGNE KAHONE",40,47,244,277,521
KAOLACK,GUINGUINEO,MBADAKHOUNE,NDIAGO,"H1 MBODIENE",12,12,49,56,105
KAOLACK,GUINGUINEO,MBADAKHOUNE,NDIAGO,NDIAGO,34,41,251,237,488
KAOLACK,GUINGUINEO,MBADAKHOUNE,NDIAGO,"H1 MBETHIELOU",12,16,124,109,233
KAOLACK,GUINGUINEO,MBADAKHOUNE,NDIAGO,"H3 THIELO",11,16,69,63,132
KAOLACK,GUINGUINEO,MBADAKHOUNE,NDIAGO,"H4 KEUR MAMADOU SENE (KEUR MAPAL)",6,13,77,68,145
KAOLACK,GUINGUINEO,MBADAKHOUNE,NDIAGO,"H8 KALASSANE",51,58,292,289,581
KAOLACK,GUINGUINEO,MBADAKHOUNE,NDIAGO,"H2 THIARAKHOULE",1,1,8,10,18
KAOLACK,GUINGUINEO,MBADAKHOUNE,NDIAGO,"H10 KEUR DAOUDA",78,82,367,353,720
KAOLACK,GUINGUINEO,MBADAKHOUNE,NDIAGO,"NDINDY DIOP",12,14,190,106,296
KAOLACK,GUINGUINEO,MBADAKHOUNE,NDIAGO,NDIOLOFENE,14,23,178,119,297
KAOLACK,GUINGUINEO,MBADAKHOUNE,NDIAGO,"H1 KEUR ABLAYE BA",2,5,24,19,43
KAOLACK,GUINGUINEO,MBADAKHOUNE,NDIAGO,"H2 KEUR INNE KEUR GALLO",4,8,78,34,112
KAOLACK,GUINGUINEO,MBADAKHOUNE,NDIAGO,"H3 KEUR ILLO DIALLO",16,19,96,96,192
KAOLACK,GUINGUINEO,MBADAKHOUNE,NDIAGO,"NGARE DIA",24,29,151,124,275
KAOLACK,GUINGUINEO,MBADAKHOUNE,NDIAGO,"H1 KEUR BIREYE SOW",1,2,6,7,13
KAOLACK,GUINGUINEO,MBADAKHOUNE,NDIAGO,"NGARE KEUR AMADOU YACINE",43,56,265,215,480
KAOLACK,GUINGUINEO,MBADAKHOUNE,NDIAGO,"H2 KEUR YORO",2,10,44,32,76
KAOLACK,GUINGUINEO,MBADAKHOUNE,NDIAGO,"H3 NGARE SERERE",12,15,94,57,151
KAOLACK,GUINGUINEO,MBADAKHOUNE,NDIAGO,"NGARE KEUR MADIENG",37,44,263,208,471
KAOLACK,GUINGUINEO,MBADAKHOUNE,NDIAGO,"H1 KEUR MBAYE LEYE",15,20,87,94,181
KAOLACK,GUINGUINEO,MBADAKHOUNE,NDIAGO,"NGARE KEUR NAIMBELLY BA",28,33,162,151,313
KAOLACK,GUINGUINEO,MBADAKHOUNE,NDIAGO,"SAKHAGNE OUOLOF",12,18,68,58,126
KAOLACK,GUINGUINEO,MBADAKHOUNE,NDIAGO,"H1 KEUR BIRANE GUEYE",18,21,115,128,243
KAOLACK,GUINGUINEO,MBADAKHOUNE,NDIAGO,"H2 SAKHAGNE NDIAMBOUR",5,7,27,16,43
KAOLACK,GUINGUINEO,MBADAKHOUNE,NDIAGO,"H3 KEUR BIDJI",8,10,61,68,129
KAOLACK,GUINGUINEO,MBADAKHOUNE,NDIAGO,"SAKHAGNE PEULH",6,6,31,44,75
KAOLACK,GUINGUINEO,MBADAKHOUNE,NDIAGO,"TEOUROU PATEIGNE",6,7,31,33,64
KAOLACK,GUINGUINEO,MBADAKHOUNE,NDIAGO,"H1 KEUR SOPHIE DIALLO (TEOUROU PEULH)",11,13,66,55,121
KAOLACK,GUINGUINEO,MBADAKHOUNE,NDIAGO,"H2 TEOUROU PEULH",2,2,7,8,15
KAOLACK,GUINGUINEO,MBADAKHOUNE,NDIAGO,"H3 SARE BOUBA",7,8,35,35,70
KAOLACK,GUINGUINEO,MBADAKHOUNE,NDIAGO,"THIADIA (KEUR SERIGNE MOR DJITE)",22,29,185,170,355
KAOLACK,GUINGUINEO,MBADAKHOUNE,NDIAGO,"WENDOU GNIWA",9,13,72,43,115
KAOLACK,GUINGUINEO,MBADAKHOUNE,NDIAGO,"H1 KEUR NIOKHOR",25,45,306,234,540
KAOLACK,GUINGUINEO,MBADAKHOUNE,"NGATHIE NAOUDE","DAGA DAOUR",35,39,224,195,419
KAOLACK,GUINGUINEO,MBADAKHOUNE,"NGATHIE NAOUDE","H1 KEUR NGOR SARR",16,27,138,163,301
KAOLACK,GUINGUINEO,MBADAKHOUNE,"NGATHIE NAOUDE","H2 KEUR MODY",13,15,79,78,157
KAOLACK,GUINGUINEO,MBADAKHOUNE,"NGATHIE NAOUDE","H3 DAGA SILATY",37,44,378,393,771
KAOLACK,GUINGUINEO,MBADAKHOUNE,"NGATHIE NAOUDE","H4 KEUR ILLO DJIMBY",12,13,68,50,118
KAOLACK,GUINGUINEO,MBADAKHOUNE,"NGATHIE NAOUDE","H5 KEUR DAOUDA",7,8,50,44,94
KAOLACK,GUINGUINEO,MBADAKHOUNE,"NGATHIE NAOUDE","DAGA MIGNANE (NDOFFANE MASSERIGNE )",51,54,210,196,406
KAOLACK,GUINGUINEO,MBADAKHOUNE,"NGATHIE NAOUDE","H2 DINGUERE",16,18,144,127,271
KAOLACK,GUINGUINEO,MBADAKHOUNE,"NGATHIE NAOUDE","H5 DANGARA",24,27,183,159,342
KAOLACK,GUINGUINEO,MBADAKHOUNE,"NGATHIE NAOUDE","H6 KEUR GORY",2,3,14,11,25
KAOLACK,GUINGUINEO,MBADAKHOUNE,"NGATHIE NAOUDE","H7 KEUR SAMBANA",5,5,23,27,50
KAOLACK,GUINGUINEO,MBADAKHOUNE,"NGATHIE NAOUDE","H8 KEUR FADEL",4,6,46,41,87
KAOLACK,GUINGUINEO,MBADAKHOUNE,"NGATHIE NAOUDE","H9 DAROU SALAM",32,37,193,188,381
KAOLACK,GUINGUINEO,MBADAKHOUNE,"NGATHIE NAOUDE","DAROU DIAW",41,54,309,291,600
KAOLACK,GUINGUINEO,MBADAKHOUNE,"NGATHIE NAOUDE","H1 KEUR ASSANE THIAW",4,4,45,47,92
KAOLACK,GUINGUINEO,MBADAKHOUNE,"NGATHIE NAOUDE","DAROU DIENE",18,18,341,220,561
KAOLACK,GUINGUINEO,MBADAKHOUNE,"NGATHIE NAOUDE","H2 SALEGNA",2,3,27,21,48
KAOLACK,GUINGUINEO,MBADAKHOUNE,"NGATHIE NAOUDE","DAROU NAHIM",26,34,351,274,625
KAOLACK,GUINGUINEO,MBADAKHOUNE,"NGATHIE NAOUDE","KEUR MOR NGONE",19,21,120,143,263
KAOLACK,GUINGUINEO,MBADAKHOUNE,"NGATHIE NAOUDE","KEUR TORO",13,14,82,70,152
KAOLACK,GUINGUINEO,MBADAKHOUNE,"NGATHIE NAOUDE",KIRPA,28,39,200,187,387
KAOLACK,GUINGUINEO,MBADAKHOUNE,"NGATHIE NAOUDE","H2 THIERERE",1,1,6,4,10
KAOLACK,GUINGUINEO,MBADAKHOUNE,"NGATHIE NAOUDE","H3 KIRPA PEULH",20,24,153,141,294
KAOLACK,GUINGUINEO,MBADAKHOUNE,"NGATHIE NAOUDE",MBENGUENE,23,27,152,187,339
KAOLACK,GUINGUINEO,MBADAKHOUNE,"NGATHIE NAOUDE","NDOFFANE DIOMAYE",48,53,253,256,509
KAOLACK,GUINGUINEO,MBADAKHOUNE,"NGATHIE NAOUDE","NGATHIE BOFFEL",21,26,131,117,248
KAOLACK,GUINGUINEO,MBADAKHOUNE,"NGATHIE NAOUDE","NGATHIE KEUR OLDY",85,88,481,463,944
KAOLACK,GUINGUINEO,MBADAKHOUNE,"NGATHIE NAOUDE","H2 KEUR DEMBA SOUTOURA",3,4,32,25,57
KAOLACK,GUINGUINEO,MBADAKHOUNE,"NGATHIE NAOUDE","H3 KEUR DIOUMA",9,14,73,79,152
KAOLACK,GUINGUINEO,MBADAKHOUNE,"NGATHIE NAOUDE","H6 KEUR PATHE",6,12,73,72,145
KAOLACK,GUINGUINEO,MBADAKHOUNE,"NGATHIE NAOUDE","H7 KEUR BACARY",7,8,33,28,61
KAOLACK,GUINGUINEO,MBADAKHOUNE,"NGATHIE NAOUDE","NGATHIE NAOUDE",177,206,937,976,1913
KAOLACK,GUINGUINEO,MBADAKHOUNE,"NGATHIE NAOUDE","H2 DOUFANGO",25,28,213,157,370
KAOLACK,GUINGUINEO,MBADAKHOUNE,"NGATHIE NAOUDE","H1 KHOUYREY (DIAMAGUENE)",10,12,62,68,130
KAOLACK,GUINGUINEO,MBADAKHOUNE,"NGATHIE NAOUDE","H3 SANDA NGAHAM",16,22,134,139,273
KAOLACK,GUINGUINEO,MBADAKHOUNE,"NGATHIE NAOUDE","H4 NDIAYENNE KASSASS",17,22,143,129,272
KAOLACK,GUINGUINEO,MBADAKHOUNE,"NGATHIE NAOUDE","H5 FOYRE",13,13,62,64,126
KAOLACK,GUINGUINEO,MBADAKHOUNE,"NGATHIE NAOUDE","NGATHIE NARGA",13,15,113,81,194
KAOLACK,GUINGUINEO,MBADAKHOUNE,"NGATHIE NAOUDE","H1 NGALAGNE",39,40,327,297,624
KAOLACK,GUINGUINEO,MBADAKHOUNE,"NGATHIE NAOUDE","NGATHIE NDIASSANE",35,35,215,164,379
KAOLACK,GUINGUINEO,MBADAKHOUNE,"NGATHIE NAOUDE","H1 KADDO",7,9,69,64,133
KAOLACK,GUINGUINEO,MBADAKHOUNE,"NGATHIE NAOUDE","NGATHIE PEULH",43,46,259,224,483
KAOLACK,GUINGUINEO,MBADAKHOUNE,"NGATHIE NAOUDE","H1 GOURFY",6,6,40,21,61
KAOLACK,GUINGUINEO,MBADAKHOUNE,"NGATHIE NAOUDE","H6 SARE PATHE",13,15,86,68,154
KAOLACK,GUINGUINEO,MBADAKHOUNE,"NGATHIE NAOUDE","H7 SARE GAGNADO",8,8,32,30,62
KAOLACK,GUINGUINEO,MBADAKHOUNE,"NGATHIE NAOUDE","NGOLOUM MACK",95,102,476,519,995
KAOLACK,GUINGUINEO,MBADAKHOUNE,"NGATHIE NAOUDE","NGOLOUM NDOFFANE",66,75,375,370,745
KAOLACK,GUINGUINEO,MBADAKHOUNE,"NGATHIE NAOUDE","H2 GOURFY ET KEUR ADAMA KA",12,13,94,76,170
KAOLACK,GUINGUINEO,MBADAKHOUNE,"NGATHIE NAOUDE","H3 MBOSS NGOLOUM",4,6,62,26,88
KAOLACK,GUINGUINEO,MBADAKHOUNE,"NGATHIE NAOUDE","DAGA DIAKHATE",67,67,313,347,660
KAOLACK,GUINGUINEO,MBADAKHOUNE,"NGATHIE NAOUDE","DAGA MIGNANE 2",31,31,138,119,257
KAOLACK,GUINGUINEO,MBADAKHOUNE,"NGATHIE NAOUDE","KEUR MAKAM",11,12,60,58,118
KAOLACK,GUINGUINEO,MBADAKHOUNE,"NGATHIE NAOUDE","H1 THIASKY",5,5,43,31,74
KAOLACK,GUINGUINEO,MBADAKHOUNE,"NGATHIE NAOUDE",MADIERY,19,23,202,153,355
KAOLACK,GUINGUINEO,MBADAKHOUNE,"NGATHIE NAOUDE",MBAFAYE,46,56,389,355,744
KAOLACK,GUINGUINEO,MBADAKHOUNE,"NGATHIE NAOUDE","MEDINA NDIEKOUNDOU",9,10,104,99,203
KAOLACK,GUINGUINEO,MBADAKHOUNE,"NGATHIE NAOUDE","TEWROU MBAYE",22,29,192,208,400
KAOLACK,GUINGUINEO,MBADAKHOUNE,"NGATHIE NAOUDE","H1 THIEMENE",5,5,22,23,45
KAOLACK,GUINGUINEO,MBADAKHOUNE,"KHELCOM BIRANE","BACK SAMBA DIOR",56,69,410,356,766
KAOLACK,GUINGUINEO,MBADAKHOUNE,"KHELCOM BIRANE","H1 KEUR LADIOUGA SARR",10,11,67,70,137
KAOLACK,GUINGUINEO,MBADAKHOUNE,"KHELCOM BIRANE","DAGA SAMBARE",27,33,207,152,359
KAOLACK,GUINGUINEO,MBADAKHOUNE,"KHELCOM BIRANE","H1 DAGA SAMBARE SERERE",12,12,74,81,155
KAOLACK,GUINGUINEO,MBADAKHOUNE,"KHELCOM BIRANE","DAROU BACK",56,69,371,410,781
KAOLACK,GUINGUINEO,MBADAKHOUNE,"KHELCOM BIRANE","DIAGLE NGOR",29,36,233,184,417
KAOLACK,GUINGUINEO,MBADAKHOUNE,"KHELCOM BIRANE","DIOMEKHEL KEUR BALLE",8,15,118,93,211
KAOLACK,GUINGUINEO,MBADAKHOUNE,"KHELCOM BIRANE","KEUR SAMBA SAKHO",2,7,44,32,76
KAOLACK,GUINGUINEO,MBADAKHOUNE,"KHELCOM BIRANE",KHAYOKH,12,28,157,148,305
KAOLACK,GUINGUINEO,MBADAKHOUNE,"KHELCOM BIRANE","H1 NGOUTT",15,22,154,140,294
KAOLACK,GUINGUINEO,MBADAKHOUNE,"KHELCOM BIRANE","KHELCOM BIRAME",146,179,798,793,1591
KAOLACK,GUINGUINEO,MBADAKHOUNE,"KHELCOM BIRANE","H1 KEUR SADIOUGA PEULGA",3,4,18,13,31
KAOLACK,GUINGUINEO,MBADAKHOUNE,"KHELCOM BIRANE",LIKEME,35,46,271,245,516
KAOLACK,GUINGUINEO,MBADAKHOUNE,"KHELCOM BIRANE","H2 SADIGANE",13,19,131,119,250
KAOLACK,GUINGUINEO,MBADAKHOUNE,"KHELCOM BIRANE","NDOFFANE COLY",19,37,280,230,510
KAOLACK,GUINGUINEO,MBADAKHOUNE,"KHELCOM BIRANE","H1 DJIBAYALLA",8,9,71,47,118
KAOLACK,GUINGUINEO,MBADAKHOUNE,"KHELCOM BIRANE","H2 TEUGUE",4,6,35,18,53
KAOLACK,GUINGUINEO,MBADAKHOUNE,"KHELCOM BIRANE","NDOFFANE MBAGNICK",12,24,116,97,213
KAOLACK,GUINGUINEO,MBADAKHOUNE,"KHELCOM BIRANE","NDOFFANE TANEWAR",27,55,321,285,606
KAOLACK,GUINGUINEO,MBADAKHOUNE,"KHELCOM BIRANE",NDOUBOR,54,60,430,398,828
KAOLACK,GUINGUINEO,MBADAKHOUNE,"KHELCOM BIRANE",NGUEKHOKH,113,132,834,796,1630
KAOLACK,GUINGUINEO,MBADAKHOUNE,"KHELCOM BIRANE","PEULH NGADIARY",17,19,115,89,204
KAOLACK,GUINGUINEO,MBADAKHOUNE,"KHELCOM BIRANE",SAGNAR,22,22,148,107,255
KAOLACK,GUINGUINEO,MBADAKHOUNE,"KHELCOM BIRANE","H1 NDIGANE WARDIAKHAL",3,4,23,19,42
KAOLACK,GUINGUINEO,MBADAKHOUNE,"KHELCOM BIRANE",SAM,27,34,249,256,505
KAOLACK,GUINGUINEO,MBADAKHOUNE,"KHELCOM BIRANE","SATE WALY",59,80,491,440,931
KAOLACK,GUINGUINEO,MBADAKHOUNE,"KHELCOM BIRANE",THIAKALAR,80,135,751,761,1512
KAOLACK,GUINGUINEO,MBADAKHOUNE,"KHELCOM BIRANE","H1 TOUCOULEUR",9,14,66,61,127
KAOLACK,GUINGUINEO,MBADAKHOUNE,"KHELCOM BIRANE","H2 YENGUELE",11,12,126,85,211
KAOLACK,GUINGUINEO,MBADAKHOUNE,"KHELCOM BIRANE","H3 NGASSA KHASSE",25,28,190,161,351
KAOLACK,GUINGUINEO,MBADAKHOUNE,"KHELCOM BIRANE","H4 MBELAOBE",8,12,134,119,253
KAOLACK,GUINGUINEO,MBADAKHOUNE,"KHELCOM BIRANE","H5 PEULGA",2,2,11,8,19
KAOLACK,GUINGUINEO,MBADAKHOUNE,"KHELCOM BIRANE",THIOLONGANE,19,25,123,118,241
KAOLACK,GUINGUINEO,MBADAKHOUNE,"KHELCOM BIRANE","TOUBA DIAGLE",16,21,199,173,372
KAOLACK,GUINGUINEO,MBADAKHOUNE,"KHELCOM BIRANE","H1 KEUR NIAHKAR SARR",3,4,40,41,81
KAOLACK,GUINGUINEO,MBADAKHOUNE,"KHELCOM BIRANE","H2 KEUR DIOUMA (TOUBA DIOUMA)",5,12,54,48,102
KAOLACK,GUINGUINEO,MBADAKHOUNE,"KHELCOM BIRANE","TOUBA KHAYOKH",29,50,321,298,619
KAOLACK,GUINGUINEO,MBADAKHOUNE,"KHELCOM BIRANE","WARDIAKHAL 1",57,61,279,278,557
KAOLACK,GUINGUINEO,MBADAKHOUNE,"KHELCOM BIRANE","WARDIAKHAL 2",60,66,340,296,636
KAOLACK,GUINGUINEO,MBADAKHOUNE,FASS,ESCALE,62,71,330,368,698
KAOLACK,GUINGUINEO,MBADAKHOUNE,FASS,GARAGE,68,77,453,408,861
KAOLACK,GUINGUINEO,MBADAKHOUNE,FASS,KANENE,72,79,347,387,734
KAOLACK,GUINGUINEO,MBADAKHOUNE,FASS,NDIOBENE,79,93,357,446,803
KAOLACK,GUINGUINEO,MBADAKHOUNE,FASS,PINTHIE,68,94,349,479,828
KAOLACK,GUINGUINEO,MBADAKHOUNE,FASS,DIAMAGUENE,77,83,290,335,625
KAOLACK,GUINGUINEO,MBADAKHOUNE,FASS,"KOFFE CENTRE",59,72,353,360,713
KAOLACK,GUINGUINEO,MBADAKHOUNE,FASS,"KOFFE NORD",46,52,219,235,454
KAOLACK,GUINGUINEO,MBADAKHOUNE,FASS,"KOFFE SUD",69,78,351,386,737
KAOLACK,GUINGUINEO,NGUELOU,GAGNICK,"ATHIOU SAMBA FAYE",32,35,219,184,403
KAOLACK,GUINGUINEO,NGUELOU,GAGNICK,"H1 KEUR ADAMA KA (SINTHIOU ADAMA KA)",2,2,9,9,18
KAOLACK,GUINGUINEO,NGUELOU,GAGNICK,"H2 ATHIOU KEUR MALICK NGOM",3,3,36,22,58
KAOLACK,GUINGUINEO,NGUELOU,GAGNICK,"H3 NGOLANE DE MEO MEO",12,15,56,65,121
KAOLACK,GUINGUINEO,NGUELOU,GAGNICK,"ATHIOU THIAMBENE",36,48,302,281,583
KAOLACK,GUINGUINEO,NGUELOU,GAGNICK,DAKKAR,14,15,82,83,165
KAOLACK,GUINGUINEO,NGUELOU,GAGNICK,"H1 KEUR BOUCAR",14,17,92,82,174
KAOLACK,GUINGUINEO,NGUELOU,GAGNICK,DIERY,13,27,168,153,321
KAOLACK,GUINGUINEO,NGUELOU,GAGNICK,"GAGNICK HALTE 1",25,40,211,169,380
KAOLACK,GUINGUINEO,NGUELOU,GAGNICK,"GAGNICK HALTE 2",50,56,218,249,467
KAOLACK,GUINGUINEO,NGUELOU,GAGNICK,"GAGNICK KHODJIL 1",45,47,218,255,473
KAOLACK,GUINGUINEO,NGUELOU,GAGNICK,"GAGNICK KHODJIL 2",80,95,405,511,916
KAOLACK,GUINGUINEO,NGUELOU,GAGNICK,"GAGNICK MACK 1",28,36,216,212,428
KAOLACK,GUINGUINEO,NGUELOU,GAGNICK,"GAGNICK MACK 2",24,31,171,134,305
KAOLACK,GUINGUINEO,NGUELOU,GAGNICK,"GAGNICK TIBOU",34,43,287,302,589
KAOLACK,GUINGUINEO,NGUELOU,GAGNICK,"KEUR KABOU",38,44,269,270,539
KAOLACK,GUINGUINEO,NGUELOU,GAGNICK,"MEDINA RASSOUL",52,61,316,283,599
KAOLACK,GUINGUINEO,NGUELOU,GAGNICK,"MEO MEO",48,50,268,246,514
KAOLACK,GUINGUINEO,NGUELOU,GAGNICK,"H2 KEUR DIEGANE",20,20,143,137,280
KAOLACK,GUINGUINEO,NGUELOU,GAGNICK,NDIALIGUE,26,30,181,170,351
KAOLACK,GUINGUINEO,NGUELOU,GAGNICK,"NDINGLER KEUR MAHAWA",11,16,93,81,174
KAOLACK,GUINGUINEO,NGUELOU,GAGNICK,"NDINGLER MBOUBENE 1",7,9,72,46,118
KAOLACK,GUINGUINEO,NGUELOU,GAGNICK,"NDINGLER MBOUBENE 2",11,16,138,100,238
KAOLACK,GUINGUINEO,NGUELOU,GAGNICK,"NDINGLER PEULH",18,21,155,110,265
KAOLACK,GUINGUINEO,NGUELOU,GAGNICK,"NDINGLER TAWFEKH 1",29,35,259,214,473
KAOLACK,GUINGUINEO,NGUELOU,GAGNICK,"NDINGLER TAWFEKH 2",18,19,108,97,205
KAOLACK,GUINGUINEO,NGUELOU,GAGNICK,"NDINGLERE NDIAYENE",20,21,115,109,224
KAOLACK,GUINGUINEO,NGUELOU,GAGNICK,POULAMACK,23,29,128,120,248
KAOLACK,GUINGUINEO,NGUELOU,GAGNICK,"SINDIEGNE SERERE",23,23,117,99,216
KAOLACK,GUINGUINEO,NGUELOU,GAGNICK,"WALO 1 (DAROU CISSE)",9,12,62,82,144
KAOLACK,GUINGUINEO,NGUELOU,GAGNICK,"WALO 2 (SEINDIEGNE WALO)",12,14,93,86,179
KAOLACK,GUINGUINEO,NGUELOU,GAGNICK,"GOLADOU DE NDINGLER PEULH",5,8,50,54,104
KAOLACK,GUINGUINEO,NGUELOU,NGUELOU,BINDIVE,5,5,34,14,48
KAOLACK,GUINGUINEO,NGUELOU,NGUELOU,"DAROU SALAM NDIOUFFENE",25,38,218,177,395
KAOLACK,GUINGUINEO,NGUELOU,NGUELOU,KAYI,51,69,450,403,853
KAOLACK,GUINGUINEO,NGUELOU,NGUELOU,"KEUR NGAGNE (SAMBAME)",5,9,59,57,116
KAOLACK,GUINGUINEO,NGUELOU,NGUELOU,"KEUR SARA",15,17,118,97,215
KAOLACK,GUINGUINEO,NGUELOU,NGUELOU,"KEUR SADIOUKA",30,31,233,213,446
KAOLACK,GUINGUINEO,NGUELOU,NGUELOU,LALOYE,30,37,184,151,335
KAOLACK,GUINGUINEO,NGUELOU,NGUELOU,MBEDIARE,4,4,12,13,25
KAOLACK,GUINGUINEO,NGUELOU,NGUELOU,"MBOURSINE 1",13,22,124,116,240
KAOLACK,GUINGUINEO,NGUELOU,NGUELOU,"MBOURSINE 2",42,68,343,317,660
KAOLACK,GUINGUINEO,NGUELOU,NGUELOU,"NDIAMBOUR 1",15,23,161,169,330
KAOLACK,GUINGUINEO,NGUELOU,NGUELOU,"NDIAMBOUR 2",8,13,99,84,183
KAOLACK,GUINGUINEO,NGUELOU,NGUELOU,NGADAGA,23,34,190,170,360
KAOLACK,GUINGUINEO,NGUELOU,NGUELOU,"NGATHIE DAROU FALL",5,6,43,53,96
KAOLACK,GUINGUINEO,NGUELOU,NGUELOU,"NGELOU DISSE (NDIABAYENE)",12,15,98,102,200
KAOLACK,GUINGUINEO,NGUELOU,NGUELOU,NGUELOU,100,127,590,614,1204
KAOLACK,GUINGUINEO,NGUELOU,NGUELOU,"SAMBAME PEULH",16,21,163,120,283
KAOLACK,GUINGUINEO,NGUELOU,NGUELOU,"H1 KEUR DIBOR DIOUF",1,1,9,11,20
KAOLACK,GUINGUINEO,NGUELOU,NGUELOU,"H2 BELLY",5,8,38,27,65
KAOLACK,GUINGUINEO,NGUELOU,NGUELOU,"TENE FODE",38,50,270,272,542
KAOLACK,GUINGUINEO,NGUELOU,NGUELOU,"H1 KEUR SANTHIEWE",5,6,28,23,51
KAOLACK,GUINGUINEO,NGUELOU,NGUELOU,"TEOUROU NGARY",12,17,118,90,208
KAOLACK,GUINGUINEO,NGUELOU,NGUELOU,"H1 KEUR MANGUY DIOUF",2,6,32,35,67
KAOLACK,GUINGUINEO,NGUELOU,NGUELOU,"H2 KEUR ABDOU SAGNE",1,5,17,22,39
KAOLACK,GUINGUINEO,NGUELOU,NGUELOU,"THICKY OUOLOF",111,132,612,563,1175
KAOLACK,GUINGUINEO,NGUELOU,NGUELOU,"H1 KEUR NDIAWAR",11,15,68,66,134
KAOLACK,GUINGUINEO,NGUELOU,NGUELOU,"H2 NDIODIONE",18,26,139,117,256
KAOLACK,GUINGUINEO,NGUELOU,NGUELOU,"THICKY SERERE (DAGAGNE)",19,33,225,228,453
KAOLACK,GUINGUINEO,NGUELOU,NGUELOU,"H1 TEOUROU BALACK",8,19,113,95,208
KAOLACK,GUINGUINEO,NGUELOU,NGUELOU,"H2 WILLA WILL",16,27,148,143,291
KAOLACK,GUINGUINEO,NGUELOU,NGUELOU,"H3 BELEL BAMBY",12,16,121,111,232
KAOLACK,GUINGUINEO,NGUELOU,NGUELOU,"H4 MBEMBEME",11,17,101,78,179
KAOLACK,GUINGUINEO,NGUELOU,NGUELOU,"H5 BELEL KOYLY",6,13,75,62,137
KAOLACK,GUINGUINEO,NGUELOU,NGUELOU,"TOUBA NDIOUFENE",15,46,250,270,520
KAOLACK,GUINGUINEO,NGUELOU,NGUELOU,"TOUBA NGADAGA",22,29,225,213,438
KAOLACK,GUINGUINEO,NGUELOU,NGUELOU,"H1 MBELKHAMONE",15,24,169,151,320
KAOLACK,GUINGUINEO,NGUELOU,OUROUR,"COLOBANE LAMBAYE",33,44,339,314,653
KAOLACK,GUINGUINEO,NGUELOU,OUROUR,"COLOBANE SOUMBEL",7,9,62,69,131
KAOLACK,GUINGUINEO,NGUELOU,OUROUR,"GOWETHIE PEULH",9,15,64,80,144
KAOLACK,GUINGUINEO,NGUELOU,OUROUR,"H1 KEUR MAMADOU DIALLO",1,2,7,4,11
KAOLACK,GUINGUINEO,NGUELOU,OUROUR,"GOWETHIE SERERE",45,57,358,367,725
KAOLACK,GUINGUINEO,NGUELOU,OUROUR,"H1 KEUR ADIOUMA SARR",3,12,78,79,157
KAOLACK,GUINGUINEO,NGUELOU,OUROUR,"H2 KEUR DIATTA NGOM",10,19,90,84,174
KAOLACK,GUINGUINEO,NGUELOU,OUROUR,"GOWETHIE WADENE",34,65,293,283,576
KAOLACK,GUINGUINEO,NGUELOU,OUROUR,"KANGAREL 1",3,15,95,93,188
KAOLACK,GUINGUINEO,NGUELOU,OUROUR,"KANGAREL 2",31,49,327,309,636
KAOLACK,GUINGUINEO,NGUELOU,OUROUR,"KANGAREL 3",5,7,51,36,87
KAOLACK,GUINGUINEO,NGUELOU,OUROUR,"KEUR GALLO NDIAYE (SOUMBEL BOURE NGOM)",11,15,83,94,177
KAOLACK,GUINGUINEO,NGUELOU,OUROUR,"H1 KEUR SALIOU SENE",5,6,40,42,82
KAOLACK,GUINGUINEO,NGUELOU,OUROUR,"KEUR MALICK SY",6,7,90,95,185
KAOLACK,GUINGUINEO,NGUELOU,OUROUR,"H1 KADO KEUR MALICK SY",19,26,135,138,273
KAOLACK,GUINGUINEO,NGUELOU,OUROUR,"KEUR YERI CISSE",35,38,200,167,367
KAOLACK,GUINGUINEO,NGUELOU,OUROUR,"LAMBOCK 1",26,52,412,361,773
KAOLACK,GUINGUINEO,NGUELOU,OUROUR,"H1 KEUR SOUDOU SENE",5,7,46,50,96
KAOLACK,GUINGUINEO,NGUELOU,OUROUR,"LAMBOCK 2",34,57,368,350,718
KAOLACK,GUINGUINEO,NGUELOU,OUROUR,"MAKA SOUMBEL",17,24,175,153,328
KAOLACK,GUINGUINEO,NGUELOU,OUROUR,"MANDE KEUR DIEGANE DIOP",8,8,64,47,111
KAOLACK,GUINGUINEO,NGUELOU,OUROUR,"MANDE KEUR DIEGANE THIARE",27,34,234,183,417
KAOLACK,GUINGUINEO,NGUELOU,OUROUR,"H1 NGUEYENE",1,4,13,25,38
KAOLACK,GUINGUINEO,NGUELOU,OUROUR,"MANDE KEUR DIENOBAL",9,13,96,82,178
KAOLACK,GUINGUINEO,NGUELOU,OUROUR,"MANDE KEUR MBISSANE",10,10,64,77,141
KAOLACK,GUINGUINEO,NGUELOU,OUROUR,"MANDE KEUR MIGNANE",32,41,254,258,512
KAOLACK,GUINGUINEO,NGUELOU,OUROUR,"MANDE KOUTA 1",23,38,237,270,507
KAOLACK,GUINGUINEO,NGUELOU,OUROUR,"H1 CAMPEMENT",6,8,61,61,122
KAOLACK,GUINGUINEO,NGUELOU,OUROUR,"MANDE KOUTA 2",18,23,204,217,421
KAOLACK,GUINGUINEO,NGUELOU,OUROUR,MBELODE,14,20,166,139,305
KAOLACK,GUINGUINEO,NGUELOU,OUROUR,"MBOCKY NDIEME",18,26,143,170,313
KAOLACK,GUINGUINEO,NGUELOU,OUROUR,NGALAGNE,18,25,158,155,313
KAOLACK,GUINGUINEO,NGUELOU,OUROUR,"NGATHIE GOWETHIE",22,26,182,158,340
KAOLACK,GUINGUINEO,NGUELOU,OUROUR,"H1 KEUR SANEGUI MARONE",2,3,17,15,32
KAOLACK,GUINGUINEO,NGUELOU,OUROUR,"OUROUR KADA 1",12,14,68,55,123
KAOLACK,GUINGUINEO,NGUELOU,OUROUR,"OUROUR KADA 2",47,54,306,256,562
KAOLACK,GUINGUINEO,NGUELOU,OUROUR,"OUROUR NDIODO",13,17,89,95,184
KAOLACK,GUINGUINEO,NGUELOU,OUROUR,"OUROUR SABALY",9,10,40,51,91
KAOLACK,GUINGUINEO,NGUELOU,OUROUR,"OUROUR SANTHIE",75,87,374,404,778
KAOLACK,GUINGUINEO,NGUELOU,OUROUR,"H1 MORKIDORY",4,6,33,29,62
KAOLACK,GUINGUINEO,NGUELOU,OUROUR,SANGHAI,5,17,137,151,288
KAOLACK,GUINGUINEO,NGUELOU,OUROUR,"H1 BELLE",12,19,133,126,259
KAOLACK,GUINGUINEO,NGUELOU,OUROUR,"H2 LAMBAYE (KHAYAKH DIOR)",18,24,188,177,365
KAOLACK,GUINGUINEO,NGUELOU,OUROUR,"SOUMBEL KEUR MICHEL (MISSION)",25,33,195,183,378
KAOLACK,GUINGUINEO,NGUELOU,OUROUR,"SOUMBEL WOULA",21,32,251,228,479
KAOLACK,GUINGUINEO,NGUELOU,OUROUR,"TABAKALY SERERE",26,42,299,295,594
KAOLACK,GUINGUINEO,NGUELOU,OUROUR,"H1 KEUR MEDOUNE",1,1,8,14,22
KAOLACK,GUINGUINEO,NGUELOU,OUROUR,"TABAKALY WOLOF",21,26,198,182,380
KAOLACK,GUINGUINEO,NGUELOU,OUROUR,"THIOUCK 1",11,11,35,49,84
KAOLACK,GUINGUINEO,NGUELOU,OUROUR,"THIOUCK 2",30,35,209,178,387
KAOLACK,GUINGUINEO,NGUELOU,"DARA MBOSS","BENE TENE",12,14,105,61,166
KAOLACK,GUINGUINEO,NGUELOU,"DARA MBOSS","DARA DIACKE",22,25,212,198,410
KAOLACK,GUINGUINEO,NGUELOU,"DARA MBOSS","DARA MBOSS",38,52,264,255,519
KAOLACK,GUINGUINEO,NGUELOU,"DARA MBOSS","H1 LOUMBAL DARA",7,11,79,60,139
KAOLACK,GUINGUINEO,NGUELOU,"DARA MBOSS","DARA NIASSENE",37,47,275,259,534
KAOLACK,GUINGUINEO,NGUELOU,"DARA MBOSS","DARA PALENE",36,44,295,280,575
KAOLACK,GUINGUINEO,NGUELOU,"DARA MBOSS","DARA THIARENE",24,41,219,195,414
KAOLACK,GUINGUINEO,NGUELOU,"DARA MBOSS","DARA THYSSE",19,26,259,199,458
KAOLACK,GUINGUINEO,NGUELOU,"DARA MBOSS","DIAMAGUENE NGALANKA",9,12,93,85,178
KAOLACK,GUINGUINEO,NGUELOU,"DARA MBOSS","LOUNKA DIACKE",8,11,103,79,182
KAOLACK,GUINGUINEO,NGUELOU,"DARA MBOSS","MADINA NIANG",19,20,141,122,263
KAOLACK,GUINGUINEO,NGUELOU,"DARA MBOSS","MBOSSEDJI BARA",28,36,234,184,418
KAOLACK,GUINGUINEO,NGUELOU,"DARA MBOSS","MBOSSEDJI MACISSE",8,17,77,79,156
KAOLACK,GUINGUINEO,NGUELOU,"DARA MBOSS","MBOSSEDJI MANSALY",4,15,68,75,143
KAOLACK,GUINGUINEO,NGUELOU,"DARA MBOSS","MBOSSEDJI NGOUNDIA",2,10,63,39,102
KAOLACK,GUINGUINEO,NGUELOU,"DARA MBOSS",NDAWENE,26,29,103,132,235
KAOLACK,GUINGUINEO,NGUELOU,"DARA MBOSS","H1 TOUBA NGNINGUENE",4,5,22,23,45
KAOLACK,GUINGUINEO,NGUELOU,"DARA MBOSS","PETEIGNE 1 (NDIOBENE)",8,8,47,37,84
KAOLACK,GUINGUINEO,NGUELOU,"DARA MBOSS","PETEIGNE 2 (MBOUBENE)",6,7,34,33,67
KAOLACK,GUINGUINEO,NGUELOU,"DARA MBOSS","H1 DAROU SALAM",1,3,13,8,21
KAOLACK,GUINGUINEO,NGUELOU,"DARA MBOSS","PETEIGNE 3",8,8,47,28,75
KAOLACK,GUINGUINEO,NGUELOU,"DARA MBOSS","TEUD BITY",13,21,123,93,216
KAOLACK,GUINGUINEO,NGUELOU,"DARA MBOSS","THIADIA MBOSS",28,30,249,181,430
KAOLACK,GUINGUINEO,NGUELOU,"DARA MBOSS","H1 DIAMAGUENE",8,8,30,39,69
KAOLACK,GUINGUINEO,NGUELOU,"DARA MBOSS","H2 KEUR CHEIKH SOW",1,1,8,8,16
KAOLACK,GUINGUINEO,NGUELOU,"DARA MBOSS","H3 KEUR YERO BA",1,3,18,12,30
KAOLACK,GUINGUINEO,NGUELOU,"DARA MBOSS","H4 KEUR MALICK FAYE",4,6,46,49,95
KAOLACK,GUINGUINEO,NGUELOU,"DARA MBOSS","YOUGOURE MASS",37,57,360,314,674
KAOLACK,GUINGUINEO,NGUELOU,"DARA MBOSS","YOUGOURE NDIOLOFENE",11,11,75,68,143
KAOLACK,GUINGUINEO,NGUELOU,"PANAL OUOLOF","AINOUMANE MADINA",10,13,104,103,207
KAOLACK,GUINGUINEO,NGUELOU,"PANAL OUOLOF",AWNOULAYE,7,11,56,67,123
KAOLACK,GUINGUINEO,NGUELOU,"PANAL OUOLOF","BAYE NDIAYE",13,13,83,70,153
KAOLACK,GUINGUINEO,NGUELOU,"PANAL OUOLOF","DAROU SALAM NDIOMENE",14,20,126,119,245
KAOLACK,GUINGUINEO,NGUELOU,"PANAL OUOLOF","DIAMEGUENE THIALLE",3,4,29,28,57
KAOLACK,GUINGUINEO,NGUELOU,"PANAL OUOLOF","DIAMWELLI ALASSANE",29,28,202,163,365
KAOLACK,GUINGUINEO,NGUELOU,"PANAL OUOLOF","DIAMWELLI MOR",19,29,148,159,307
KAOLACK,GUINGUINEO,NGUELOU,"PANAL OUOLOF","H1 DAROU GUEYE",2,5,40,43,83
KAOLACK,GUINGUINEO,NGUELOU,"PANAL OUOLOF","DIATMEL MOUSSA",27,36,197,180,377
KAOLACK,GUINGUINEO,NGUELOU,"PANAL OUOLOF","DIATMEL SAER (DIATMEL)",23,26,118,107,225
KAOLACK,GUINGUINEO,NGUELOU,"PANAL OUOLOF","MBOSS BALLO PEULH 1",12,25,146,146,292
KAOLACK,GUINGUINEO,NGUELOU,"PANAL OUOLOF","MBOSS BALLO PEULH 2",8,16,85,74,159
KAOLACK,GUINGUINEO,NGUELOU,"PANAL OUOLOF","MBOSS BALLO SERERE",5,12,66,42,108
KAOLACK,GUINGUINEO,NGUELOU,"PANAL OUOLOF","MBOSS BALLO WOLOF",6,10,72,59,131
KAOLACK,GUINGUINEO,NGUELOU,"PANAL OUOLOF","MBOULOUGNE DIACK SAO",36,44,415,411,826
KAOLACK,GUINGUINEO,NGUELOU,"PANAL OUOLOF","MBOULOUGNE DIAWANDOU",27,49,303,337,640
KAOLACK,GUINGUINEO,NGUELOU,"PANAL OUOLOF","MBOULOUGNE MADEMBA",22,28,178,182,360
KAOLACK,GUINGUINEO,NGUELOU,"PANAL OUOLOF","MBOULOUGNE SENO OUOLOF",27,50,277,257,534
KAOLACK,GUINGUINEO,NGUELOU,"PANAL OUOLOF","MBOULOUGNE SENO PEULH 1",15,29,142,107,249
KAOLACK,GUINGUINEO,NGUELOU,"PANAL OUOLOF","MBOULOUGNE SENO PEULH 2",5,6,43,27,70
KAOLACK,GUINGUINEO,NGUELOU,"PANAL OUOLOF",NDINGUELERE,9,9,56,45,101
KAOLACK,GUINGUINEO,NGUELOU,"PANAL OUOLOF","PANAL NDIARE NDIAYE",27,27,109,138,247
KAOLACK,GUINGUINEO,NGUELOU,"PANAL OUOLOF","PANAL NDIOBENE",9,13,65,70,135
KAOLACK,GUINGUINEO,NGUELOU,"PANAL OUOLOF","PANAL NGUEYENE",19,22,90,97,187
KAOLACK,GUINGUINEO,NGUELOU,"PANAL OUOLOF","PANAL OUOLOF",31,47,187,209,396
KAOLACK,GUINGUINEO,NGUELOU,"PANAL OUOLOF","PANAL PEULH",13,13,75,68,143
KAOLACK,GUINGUINEO,NGUELOU,"PANAL OUOLOF","PANAL SERERE",17,18,109,110,219
KAOLACK,GUINGUINEO,NGUELOU,"PANAL OUOLOF","PANAL THIARENE",81,85,577,455,1032
KAOLACK,GUINGUINEO,NGUELOU,"PANAL OUOLOF","SANTHIOU THIENEBA",42,49,273,251,524
KAOLACK,GUINGUINEO,NGUELOU,"PANAL OUOLOF","TOUBA TILENE (THILLA)",12,13,99,70,169
KAOLACK,GUINGUINEO,NGUELOU,"PANAL OUOLOF","H1 GOUYE NDIMB",4,10,31,48,79
KAOLACK,GUINGUINEO,NGUELOU,"PANAL OUOLOF","WOURO BAI BAI",11,15,106,103,209
KAOLACK,GUINGUINEO,NGUELOU,"PANAL OUOLOF","DAROU SALAM RANWI",11,14,113,95,208
KAOLACK,GUINGUINEO,NGUELOU,MBOSS,"MBOSS ESCALE",90,103,566,593,1159
KAOLACK,GUINGUINEO,NGUELOU,MBOSS,"MBOSS KHAYANE",40,43,249,217,466
KAOLACK,GUINGUINEO,NGUELOU,MBOSS,"MBOSS MOURIDE",79,93,426,454,880
KAOLACK,GUINGUINEO,NGUELOU,MBOSS,"MBOSS NDIAMBOUR",113,129,680,624,1304
KAOLACK,GUINGUINEO,NGUELOU,MBOSS,"MBOSS NDIOMENE",11,11,70,71,141
KAOLACK,GUINGUINEO,NGUELOU,MBOSS,"MBOSS TIDIANE",59,69,509,516,1025
KAOLACK,GUINGUINEO,NGUELOU,MBOSS,"MBOSS WADIOUR",9,12,69,80,149
KAOLACK,GUINGUINEO,NGUELOU,MBOSS,NGALANKA,11,17,100,106,206
KAOLACK,GUINGUINEO,NGUELOU,MBOSS,"WENDOU BOWDE",11,22,99,117,216
KAOLACK,GUINGUINEO,NGUELOU,MBOSS,MEDINE,45,46,269,279,548
THIES,M’BOUR,"JOAL FADHIOUTH","JOAL FADHIOUTH","AFDAYE DIAMAGUENE",151,206,715,682,1397
THIES,M’BOUR,"JOAL FADHIOUTH","JOAL FADHIOUTH",CARITAS,1178,1428,5478,4961,10439
THIES,M’BOUR,"JOAL FADHIOUTH","JOAL FADHIOUTH","CITE LYCEE",596,827,3442,2813,6255
THIES,M’BOUR,"JOAL FADHIOUTH","JOAL FADHIOUTH","DAROU SALAM 1",296,326,1640,1488,3128
THIES,M’BOUR,"JOAL FADHIOUTH","JOAL FADHIOUTH","DAROU SALAM 2",226,255,1072,1052,2124
THIES,M’BOUR,"JOAL FADHIOUTH","JOAL FADHIOUTH",DIONG,174,270,999,890,1889
THIES,M’BOUR,"JOAL FADHIOUTH","JOAL FADHIOUTH","FADIOUTH (DIOUME)",143,305,501,617,1118
THIES,M’BOUR,"JOAL FADHIOUTH","JOAL FADHIOUTH",HAMDALLAH,724,806,3393,3249,6642
THIES,M’BOUR,"JOAL FADHIOUTH","JOAL FADHIOUTH","MBOUR DIOUKHAM",251,383,1583,1378,2961
THIES,M’BOUR,"JOAL FADHIOUTH","JOAL FADHIOUTH","NDIONGUENE (FADIOUTH)",49,121,233,247,480
THIES,M’BOUR,"JOAL FADHIOUTH","JOAL FADHIOUTH",NDOUBAB,194,310,968,961,1929
THIES,M’BOUR,"JOAL FADHIOUTH","JOAL FADHIOUTH",NGAZOBIL,29,50,216,104,320
THIES,M’BOUR,"JOAL FADHIOUTH","JOAL FADHIOUTH","SANTHIE 2 (IBOU FAYE)",705,1045,4645,3944,8589
THIES,M’BOUR,"JOAL FADHIOUTH","JOAL FADHIOUTH","SANTHIE 3 (GARE ROUTIERE)",550,972,3884,3078,6962
THIES,M’BOUR,"JOAL FADHIOUTH","JOAL FADHIOUTH","OCEAN 1 ET 2",9,19,48,57,105
THIES,M’BOUR,"JOAL FADHIOUTH","JOAL FADHIOUTH",SANTHIE,496,874,3728,3516,7244
THIES,M’BOUR,MBOUR,MBOUR,11-nov,604,1117,4029,3916,7945
THIES,M’BOUR,MBOUR,MBOUR,"CHATEAU D'EAU NORD",1109,1789,6096,6050,12146
THIES,M’BOUR,MBOUR,MBOUR,"CHATEAU D'EAU SUD",1208,1830,7328,6807,14135
THIES,M’BOUR,MBOUR,MBOUR,"DAROU SALAM",1128,1529,6175,5951,12126
THIES,M’BOUR,MBOUR,MBOUR,"DIAMAGUENE 1",1225,1770,7822,7377,15199
THIES,M’BOUR,MBOUR,MBOUR,"DIAMAGUENE 2",567,752,3303,3372,6675
THIES,M’BOUR,MBOUR,MBOUR,ESCALE,55,90,230,169,399
THIES,M’BOUR,MBOUR,MBOUR,GOLF,352,538,3042,2510,5552
THIES,M’BOUR,MBOUR,MBOUR,"GRAND MBOUR 1",728,992,3145,3303,6448
THIES,M’BOUR,MBOUR,MBOUR,"GRAND MBOUR 2",998,1406,4282,4320,8602
THIES,M’BOUR,MBOUR,MBOUR,"LIBERTE 1",1019,1128,4684,4178,8862
THIES,M’BOUR,MBOUR,MBOUR,"LIBERTE 2",644,765,3107,2724,5831
THIES,M’BOUR,MBOUR,MBOUR,"SONATEL EXTENSION",511,550,2028,1965,3993
THIES,M’BOUR,MBOUR,MBOUR,"MBOUR MAURE",241,301,1190,1086,2276
THIES,M’BOUR,MBOUR,MBOUR,"MBOUR SERERE KAW",725,1019,4003,4098,8101
THIES,M’BOUR,MBOUR,MBOUR,"MBOUR SERERE SOUF",116,160,1572,679,2251
THIES,M’BOUR,MBOUR,MBOUR,"MBOUR TOUCOULEUR",528,839,3356,3215,6571
THIES,M’BOUR,MBOUR,MBOUR,MEDINE,642,921,3440,3338,6778
THIES,M’BOUR,MBOUR,MBOUR,"MEDINE EXTENSION",737,863,3163,3088,6251
THIES,M’BOUR,MBOUR,MBOUR,SANTESSOU,566,813,3559,3556,7115
THIES,M’BOUR,MBOUR,MBOUR,TEFESS,430,822,3727,3897,7624
THIES,M’BOUR,MBOUR,MBOUR,"THIOCE EST",544,757,3625,3550,7175
THIES,M’BOUR,MBOUR,MBOUR,"THIOCE OUEST",525,812,3748,3762,7510
THIES,M’BOUR,MBOUR,MBOUR,"ZONE SONATEL",567,665,2402,2433,4835
THIES,M’BOUR,MBOUR,MBOUR,"DIAMAGUENE 2 COMPLEMENTAIRE",408,477,2337,1993,4330
THIES,M’BOUR,MBOUR,MBOUR,"DIAMAGUENE 3",691,910,4383,4146,8529
THIES,M’BOUR,MBOUR,MBOUR,"GOUYE MOURIDE 1",577,705,2881,2641,5522
THIES,M’BOUR,MBOUR,MBOUR,"GOUYE MOURIDE 2",786,952,4403,3921,8324
THIES,M’BOUR,MBOUR,MBOUR,"LYCEE TECHNIQUE",328,379,1916,1621,3537
THIES,M’BOUR,MBOUR,MBOUR,"MEDINE 2",581,754,2838,2778,5616
THIES,M’BOUR,MBOUR,MBOUR,"SANTE YALLA",1231,1471,6607,5754,12361
THIES,M’BOUR,MBOUR,MBOUR,"SANTHIE 1",923,1181,5301,4904,10205
THIES,M’BOUR,MBOUR,MBOUR,"SANTHIE 2",813,1171,4089,3738,7827
THIES,M’BOUR,MBOUR,MBOUR,"TERROU MBALLING",517,559,2244,2114,4358
THIES,M’BOUR,MBOUR,MBOUR,"THIOCE EST EXTENSION",910,1224,5579,5336,10915
THIES,M’BOUR,MBOUR,MBOUR,"THIOCE EST ONCAD",1685,2054,8762,8422,17184
THIES,M’BOUR,MBOUR,MBOUR,"THIOCE SUD ONCAD",601,757,3373,2885,6258
THIES,M’BOUR,MBOUR,MBOUR,"ZONE SONATEL ARAFAT",539,657,2427,2396,4823
THIES,M’BOUR,FISSEL,FISSEL,BACK,40,156,776,784,1560
THIES,M’BOUR,FISSEL,FISSEL,BADD,36,58,280,317,597
THIES,M’BOUR,FISSEL,FISSEL,"H1 BACK SECK",47,68,425,475,900
THIES,M’BOUR,FISSEL,FISSEL,CISSIS,23,56,279,306,585
THIES,M’BOUR,FISSEL,FISSEL,"H1 KHO",11,28,128,142,270
THIES,M’BOUR,FISSEL,FISSEL,"H4 NGOULTOUNE",17,27,129,207,336
THIES,M’BOUR,FISSEL,FISSEL,DIOB,45,96,472,455,927
THIES,M’BOUR,FISSEL,FISSEL,"FISSEL ESCALE (FISSEL MBADANE)",240,314,1356,1503,2859
THIES,M’BOUR,FISSEL,FISSEL,"H1 NGOL",11,12,72,38,110
THIES,M’BOUR,FISSEL,FISSEL,"H2 TOUBEYE",10,10,64,82,146
THIES,M’BOUR,FISSEL,FISSEL,"FISSEL SERERE",147,205,732,786,1518
THIES,M’BOUR,FISSEL,FISSEL,"H1 NDIOBENE",6,12,59,82,141
THIES,M’BOUR,FISSEL,FISSEL,"H4 SIMGAM",5,17,103,119,222
THIES,M’BOUR,FISSEL,FISSEL,"H6 KEUR NGOR SARR",5,9,70,74,144
THIES,M’BOUR,FISSEL,FISSEL,"H7 KEUR SAKHATE",2,6,19,30,49
THIES,M’BOUR,FISSEL,FISSEL,"H8 TOCKO DIACK",17,19,121,113,234
THIES,M’BOUR,FISSEL,FISSEL,"H9 NDIOBENE",3,6,40,39,79
THIES,M’BOUR,FISSEL,FISSEL,"KHAOUL GODAGUENE",8,32,158,197,355
THIES,M’BOUR,FISSEL,FISSEL,"H1 SABENA",6,16,119,110,229
THIES,M’BOUR,FISSEL,FISSEL,"H2 MBOUDIO DIAM",9,27,197,178,375
THIES,M’BOUR,FISSEL,FISSEL,"H4 WOURKHALANG",17,30,122,157,279
THIES,M’BOUR,FISSEL,FISSEL,"H5 PINE DAKHA",4,8,38,38,76
THIES,M’BOUR,FISSEL,FISSEL,"H6 MBA FAYE",23,39,189,231,420
THIES,M’BOUR,FISSEL,FISSEL,"H7 TOC NGOL",8,8,50,64,114
THIES,M’BOUR,FISSEL,FISSEL,"H8 NDOYENA",1,1,4,5,9
THIES,M’BOUR,FISSEL,FISSEL,"H9 NDIE DIENG",11,23,126,123,249
THIES,M’BOUR,FISSEL,FISSEL,"H10 PADATGA",4,29,145,136,281
THIES,M’BOUR,FISSEL,FISSEL,"H11 LOCK DIAKHOUL",31,48,405,363,768
THIES,M’BOUR,FISSEL,FISSEL,"H12 SANGO",18,38,208,215,423
THIES,M’BOUR,FISSEL,FISSEL,"KHAOUL TOC NGOL",45,72,488,447,935
THIES,M’BOUR,FISSEL,FISSEL,"H2 LOCK DIAKHOUDE",9,16,85,66,151
THIES,M’BOUR,FISSEL,FISSEL,LAMBAYENE,32,100,536,579,1115
THIES,M’BOUR,FISSEL,FISSEL,LANGOMACK,26,68,293,307,600
THIES,M’BOUR,FISSEL,FISSEL,"H1 NDINGUELERE",6,20,38,41,79
THIES,M’BOUR,FISSEL,FISSEL,"H2 SANDIGUENE",18,44,134,143,277
THIES,M’BOUR,FISSEL,FISSEL,"H3 NDIANOU GAYE",2,4,22,26,48
THIES,M’BOUR,FISSEL,FISSEL,"H4 TOKORAK",19,30,220,200,420
THIES,M’BOUR,FISSEL,FISSEL,MBALAMSOME,93,116,732,758,1490
THIES,M’BOUR,FISSEL,FISSEL,"H1 NDIASSANE SASSAL",21,22,188,161,349
THIES,M’BOUR,FISSEL,FISSEL,"H2 NDIASSANE KEUR DIOUMA",74,88,472,595,1067
THIES,M’BOUR,FISSEL,FISSEL,"H3 DIARANE",8,14,74,83,157
THIES,M’BOUR,FISSEL,FISSEL,"H4 NDIAGNE",6,7,41,42,83
THIES,M’BOUR,FISSEL,FISSEL,"H5 TONGHOR",1,3,26,13,39
THIES,M’BOUR,FISSEL,FISSEL,"H6 NDIANGHAYE",22,47,251,288,539
THIES,M’BOUR,FISSEL,FISSEL,"H7 KEUR KHALLA",10,11,113,91,204
THIES,M’BOUR,FISSEL,FISSEL,"H8 KEUR KHAR",19,29,172,193,365
THIES,M’BOUR,FISSEL,FISSEL,MBALCAM,18,53,283,413,696
THIES,M’BOUR,FISSEL,FISSEL,MBEDAP,29,47,301,251,552
THIES,M’BOUR,FISSEL,FISSEL,"H1 KARIGNE NDEP",6,9,44,53,97
THIES,M’BOUR,FISSEL,FISSEL,"H2 KOTEMARY",11,13,87,109,196
THIES,M’BOUR,FISSEL,FISSEL,MBELLANGOUTH,24,43,226,216,442
THIES,M’BOUR,FISSEL,FISSEL,"H1 MOLANE",12,24,146,157,303
THIES,M’BOUR,FISSEL,FISSEL,"H2 KOBRANE",47,71,431,381,812
THIES,M’BOUR,FISSEL,FISSEL,MBOUFOUDJI,26,85,481,530,1011
THIES,M’BOUR,FISSEL,FISSEL,"H3 NGANEME",3,4,33,24,57
THIES,M’BOUR,FISSEL,FISSEL,"MBOULOUCTENE SECCO",19,23,141,113,254
THIES,M’BOUR,FISSEL,FISSEL,"H2 KEUR KOR",13,26,176,148,324
THIES,M’BOUR,FISSEL,FISSEL,"H3 KEUR MABIGUE",6,6,17,2,19
THIES,M’BOUR,FISSEL,FISSEL,"H4 KEUR CHEIKH BOUSSO",6,6,45,22,67
THIES,M’BOUR,FISSEL,FISSEL,"H5 KEUR DIOL FALL",10,17,121,99,220
THIES,M’BOUR,FISSEL,FISSEL,"H6 SANTHE",9,11,64,51,115
THIES,M’BOUR,FISSEL,FISSEL,"H7 TOUBE",1,2,13,12,25
THIES,M’BOUR,FISSEL,FISSEL,"H8 KEUR MOURY",2,6,30,25,55
THIES,M’BOUR,FISSEL,FISSEL,"H9 KEUR MOR FALL",1,1,6,8,14
THIES,M’BOUR,FISSEL,FISSEL,"H10 CISSIS SANTHIE",8,35,178,206,384
THIES,M’BOUR,FISSEL,FISSEL,"MEDINE (NIAMAR)",28,106,126,137,263
THIES,M’BOUR,FISSEL,FISSEL,"H1 LAT DIAKHE",30,192,384,344,728
THIES,M’BOUR,FISSEL,FISSEL,"H2 MAKHTEL",4,22,34,39,73
THIES,M’BOUR,FISSEL,FISSEL,"H3 KEUR SASSOUNE",4,22,31,27,58
THIES,M’BOUR,FISSEL,FISSEL,"H4 MBANGHEME",12,14,79,59,138
THIES,M’BOUR,FISSEL,FISSEL,"H5 RINDEL",15,24,142,137,279
THIES,M’BOUR,FISSEL,FISSEL,"H6 DIANING ET NIANGAR",17,31,184,194,378
THIES,M’BOUR,FISSEL,FISSEL,"H7 SINGHANE",9,40,62,62,124
THIES,M’BOUR,FISSEL,FISSEL,"NDAG DAM",54,99,493,491,984
THIES,M’BOUR,FISSEL,FISSEL,"NDIASSANE (DJIGUIYAM TOCK)",13,73,354,392,746
THIES,M’BOUR,FISSEL,FISSEL,"H1 BOTH",26,94,424,459,883
THIES,M’BOUR,FISSEL,FISSEL,"H2 NDJIKDAKHINE",28,86,436,442,878
THIES,M’BOUR,FISSEL,FISSEL,NDOFFANE,54,84,408,448,856
THIES,M’BOUR,FISSEL,FISSEL,NDOUNGH,50,111,632,714,1346
THIES,M’BOUR,FISSEL,FISSEL,"H1 BAKEME",9,16,144,119,263
THIES,M’BOUR,FISSEL,FISSEL,"H2 KEUR DETHIE DEMBA",21,24,185,141,326
THIES,M’BOUR,FISSEL,FISSEL,"H3 MBALNGOGNE",22,39,237,228,465
THIES,M’BOUR,FISSEL,FISSEL,"H4 BAKAPOME",3,5,21,23,44
THIES,M’BOUR,FISSEL,FISSEL,"H5 MBOUDAYEME",13,17,142,138,280
THIES,M’BOUR,FISSEL,FISSEL,"H6 THIATHIAW COOPE",16,39,252,282,534
THIES,M’BOUR,FISSEL,FISSEL,NDOYOMBOUTH,57,82,536,505,1041
THIES,M’BOUR,FISSEL,FISSEL,"H1 KEUR OUMAR LEYE",1,2,14,12,26
THIES,M’BOUR,FISSEL,FISSEL,NGONEME,28,58,384,371,755
THIES,M’BOUR,FISSEL,FISSEL,"H1 BAKA POME",10,20,109,107,216
THIES,M’BOUR,FISSEL,FISSEL,NGUERANE,33,44,240,279,519
THIES,M’BOUR,FISSEL,FISSEL,"H1 BACK DIECK",32,48,279,240,519
THIES,M’BOUR,FISSEL,FISSEL,SASSAKH,14,44,316,263,579
THIES,M’BOUR,FISSEL,FISSEL,"SASSAL (KEUR DIOGOU)",21,29,212,181,393
THIES,M’BOUR,FISSEL,FISSEL,"H1 KEUR ARDO",18,25,159,178,337
THIES,M’BOUR,FISSEL,FISSEL,"H2 SASSAL GANDIOL",8,10,68,64,132
THIES,M’BOUR,FISSEL,FISSEL,"H3 TKAB (H3 PROJET TOUBA KHELCOM AGRO)",4,4,28,19,47
THIES,M’BOUR,FISSEL,FISSEL,"H4 TOKODIOUNE",19,60,343,353,696
THIES,M’BOUR,FISSEL,FISSEL,SOP,52,121,794,784,1578
THIES,M’BOUR,FISSEL,FISSEL,"H1 PINE DAHA",2,16,88,85,173
THIES,M’BOUR,FISSEL,FISSEL,"H2 YOR YOR",2,4,29,30,59
THIES,M’BOUR,FISSEL,FISSEL,"H3 NGODJILEME",17,44,307,313,620
THIES,M’BOUR,FISSEL,FISSEL,"H4 NDOSS MBADAT",14,45,266,282,548
THIES,M’BOUR,FISSEL,FISSEL,"H5 NDOSS DJITA",13,33,170,192,362
THIES,M’BOUR,FISSEL,FISSEL,"H6 THIATHIAW",31,54,435,427,862
THIES,M’BOUR,FISSEL,FISSEL,TOCOMACK,67,104,653,607,1260
THIES,M’BOUR,FISSEL,FISSEL,"H2 MBELMOREW",21,33,163,136,299
THIES,M’BOUR,FISSEL,FISSEL,"BODEL TOKOUMAK",2,2,5,12,17
THIES,M’BOUR,FISSEL,FISSEL,KAMOUNGASSOU,15,20,138,148,286
THIES,M’BOUR,FISSEL,FISSEL,"MEDINE 2",4,26,92,103,195
THIES,M’BOUR,FISSEL,NDIAGANIAO,COTHIANE,21,66,381,408,789
THIES,M’BOUR,FISSEL,NDIAGANIAO,"H1 GAMEKOL",8,24,150,150,300
THIES,M’BOUR,FISSEL,NDIAGANIAO,"DAP THIOR",10,35,204,193,397
THIES,M’BOUR,FISSEL,NDIAGANIAO,FANDOR,16,30,173,192,365
THIES,M’BOUR,FISSEL,NDIAGANIAO,"H1 PAKALA",11,32,192,170,362
THIES,M’BOUR,FISSEL,NDIAGANIAO,"H2 SANTHIE",11,14,95,74,169
THIES,M’BOUR,FISSEL,NDIAGANIAO,"FAO (KAM FAO)",10,46,244,253,497
THIES,M’BOUR,FISSEL,NDIAGANIAO,"H1 SENGHOR",9,36,163,158,321
THIES,M’BOUR,FISSEL,NDIAGANIAO,"H2 THIATHIAO",7,15,59,69,128
THIES,M’BOUR,FISSEL,NDIAGANIAO,"H3 LOUDIOR",8,15,43,62,105
THIES,M’BOUR,FISSEL,NDIAGANIAO,"H4 NGOUDJIL",4,21,83,89,172
THIES,M’BOUR,FISSEL,NDIAGANIAO,GASS,20,26,160,119,279
THIES,M’BOUR,FISSEL,NDIAGANIAO,GNIGNING,15,63,376,326,702
THIES,M’BOUR,FISSEL,NDIAGANIAO,"GODAGUENE (MBADATE)",27,83,413,423,836
THIES,M’BOUR,FISSEL,NDIAGANIAO,"H1 BABACK",31,86,505,485,990
THIES,M’BOUR,FISSEL,NDIAGANIAO,"H2 NGOKHOTHIE",41,84,393,450,843
THIES,M’BOUR,FISSEL,NDIAGANIAO,"H3 SANDE",13,31,164,139,303
THIES,M’BOUR,FISSEL,NDIAGANIAO,"GUELOR OUOLOF (KEUR YAKHAR NDIAYE)",6,9,48,42,90
THIES,M’BOUR,FISSEL,NDIAGANIAO,"H1 KEUR NGOUDA",11,15,96,88,184
THIES,M’BOUR,FISSEL,NDIAGANIAO,"H3 DARA CHEIKH MASSAMBA DIOUF",1,1,2,4,6
THIES,M’BOUR,FISSEL,NDIAGANIAO,"H4 KEUR DJIBRIL FALL",9,16,84,93,177
THIES,M’BOUR,FISSEL,NDIAGANIAO,"H5 DJIMLENE",11,19,162,148,310
THIES,M’BOUR,FISSEL,NDIAGANIAO,"H7 KEUR MEDOUNE NDIAYE",5,8,51,37,88
THIES,M’BOUR,FISSEL,NDIAGANIAO,"H11 TOUBA NGUEMBE",15,17,163,117,280
THIES,M’BOUR,FISSEL,NDIAGANIAO,"GUELOR SERERE (NDIOBENE SOWORE)",16,68,576,603,1179
THIES,M’BOUR,FISSEL,NDIAGANIAO,"H1 PAKALA MAR NANE",13,49,365,375,740
THIES,M’BOUR,FISSEL,NDIAGANIAO,"H2 MBOULEL",5,9,73,73,146
THIES,M’BOUR,FISSEL,NDIAGANIAO,"H3 KEUR BOCAR SENE",1,6,51,47,98
THIES,M’BOUR,FISSEL,NDIAGANIAO,"H4 SOROKH NDEPPE",5,10,63,61,124
THIES,M’BOUR,FISSEL,NDIAGANIAO,"H5 KEUR MOR SENE",17,26,187,185,372
THIES,M’BOUR,FISSEL,NDIAGANIAO,"GUITYR OUOLOF (MBAMPA)",27,43,327,327,654
THIES,M’BOUR,FISSEL,NDIAGANIAO,"GUITYR SERERE (NDIODIONE)",10,25,173,174,347
THIES,M’BOUR,FISSEL,NDIAGANIAO,"H1 SANDAGA",6,10,50,51,101
THIES,M’BOUR,FISSEL,NDIAGANIAO,"H2 MBAFAYE",5,10,50,50,100
THIES,M’BOUR,FISSEL,NDIAGANIAO,"H3 NDIOKHNEME TOCK",3,5,24,28,52
THIES,M’BOUR,FISSEL,NDIAGANIAO,"H4 NDIOKHNEME SOUF",9,28,172,173,345
THIES,M’BOUR,FISSEL,NDIAGANIAO,"H5 NDENDERE",2,8,63,49,112
THIES,M’BOUR,FISSEL,NDIAGANIAO,"H6 KAKENE",12,32,244,219,463
THIES,M’BOUR,FISSEL,NDIAGANIAO,"H7 NGOUDEME",6,8,45,27,72
THIES,M’BOUR,FISSEL,NDIAGANIAO,"H8 SASSELENE",2,4,38,30,68
THIES,M’BOUR,FISSEL,NDIAGANIAO,"H9 TOULE",1,10,111,93,204
THIES,M’BOUR,FISSEL,NDIAGANIAO,"KEUR MALICK NDIAYE",5,23,132,138,270
THIES,M’BOUR,FISSEL,NDIAGANIAO,"KOULOUCK MBADA",20,70,384,388,772
THIES,M’BOUR,FISSEL,NDIAGANIAO,"H2 KOULOUCK KEUR DOUFFI",13,25,241,216,457
THIES,M’BOUR,FISSEL,NDIAGANIAO,"KOULOUCK OUOLOF",13,29,206,212,418
THIES,M’BOUR,FISSEL,NDIAGANIAO,"H1 KEUR CHEIKH",22,38,175,186,361
THIES,M’BOUR,FISSEL,NDIAGANIAO,"KOULOUCK SERERE (BOURDING)",25,66,491,525,1016
THIES,M’BOUR,FISSEL,NDIAGANIAO,"H1 KONE",24,61,324,344,668
THIES,M’BOUR,FISSEL,NDIAGANIAO,"H2 KOULOUCK KEUR SIMEL",3,8,60,58,118
THIES,M’BOUR,FISSEL,NDIAGANIAO,"H5 TOUBA CITE",7,12,69,72,141
THIES,M’BOUR,FISSEL,NDIAGANIAO,"KOUTHIE SERERE",27,93,580,492,1072
THIES,M’BOUR,FISSEL,NDIAGANIAO,LOUMATYR,19,84,328,341,669
THIES,M’BOUR,FISSEL,NDIAGANIAO,"H1 DOUTOUTE",7,42,336,242,578
THIES,M’BOUR,FISSEL,NDIAGANIAO,MBAFAYE,7,34,204,233,437
THIES,M’BOUR,FISSEL,NDIAGANIAO,"H1 YOKHAME",14,64,445,366,811
THIES,M’BOUR,FISSEL,NDIAGANIAO,"H2 FOUDIOL",9,40,207,231,438
THIES,M’BOUR,FISSEL,NDIAGANIAO,"H3 NDIAYE NDIAYE",1,9,48,45,93
THIES,M’BOUR,FISSEL,NDIAGANIAO,MBALAKHATE,21,92,424,442,866
THIES,M’BOUR,FISSEL,NDIAGANIAO,"H1 TOMOUNE",23,80,451,517,968
THIES,M’BOUR,FISSEL,NDIAGANIAO,"H2 YORE YORE",18,62,370,405,775
THIES,M’BOUR,FISSEL,NDIAGANIAO,"H3 NGOGOM",8,22,152,176,328
THIES,M’BOUR,FISSEL,NDIAGANIAO,"MBOULOUCTENE KOULOUCK (KEUR MANDIKOU)",4,5,44,40,84
THIES,M’BOUR,FISSEL,NDIAGANIAO,"H1 MBALOKH",6,30,350,343,693
THIES,M’BOUR,FISSEL,NDIAGANIAO,"H2 TOUBE",26,37,287,253,540
THIES,M’BOUR,FISSEL,NDIAGANIAO,"H3 PEYDOM",12,26,254,289,543
THIES,M’BOUR,FISSEL,NDIAGANIAO,"H4 KEUR SALIOU TOURE",1,1,5,3,8
THIES,M’BOUR,FISSEL,NDIAGANIAO,"H5 KOULOUCK GANDIOL",18,46,310,357,667
THIES,M’BOUR,FISSEL,NDIAGANIAO,"H6 KEUR FALLE",8,13,124,74,198
THIES,M’BOUR,FISSEL,NDIAGANIAO,"H8 KEUR MAPENDA DIOP",4,4,57,45,102
THIES,M’BOUR,FISSEL,NDIAGANIAO,"H9 KEUR MALICK COUMBA",11,12,65,63,128
THIES,M’BOUR,FISSEL,NDIAGANIAO,"H10 KEUR ELHADJI KEBE",2,5,37,42,79
THIES,M’BOUR,FISSEL,NDIAGANIAO,"H11 KEUR NDEME",6,6,36,39,75
THIES,M’BOUR,FISSEL,NDIAGANIAO,"H12 KOULOUCK (KEUR DIEGANE)",6,15,152,133,285
THIES,M’BOUR,FISSEL,NDIAGANIAO,"NDADAFAKH SERERE",2,10,92,87,179
THIES,M’BOUR,FISSEL,NDIAGANIAO,"H1 TITINE",2,34,215,214,429
THIES,M’BOUR,FISSEL,NDIAGANIAO,"H2 MBELANE",1,10,68,79,147
THIES,M’BOUR,FISSEL,NDIAGANIAO,"H3 NDENDERE",1,8,103,80,183
THIES,M’BOUR,FISSEL,NDIAGANIAO,"H4 NDADAFAKH KAME",9,34,196,178,374
THIES,M’BOUR,FISSEL,NDIAGANIAO,"H5 DADAF",2,3,24,21,45
THIES,M’BOUR,FISSEL,NDIAGANIAO,"H6 PINTOK",4,7,91,64,155
THIES,M’BOUR,FISSEL,NDIAGANIAO,"NDAME (NDIROR)",13,30,247,218,465
THIES,M’BOUR,FISSEL,NDIAGANIAO,"H1 NGOUTHE",6,19,142,130,272
THIES,M’BOUR,FISSEL,NDIAGANIAO,"H2 NDAME (MBOUFOUTHIE)",4,10,77,76,153
THIES,M’BOUR,FISSEL,NDIAGANIAO,"H3 NDAME (NGAME)",5,16,125,124,249
THIES,M’BOUR,FISSEL,NDIAGANIAO,"NDIAGANIAO BOTH ESCALE",431,573,2386,2605,4991
THIES,M’BOUR,FISSEL,NDIAGANIAO,NDIANDIAYE,328,400,2488,2360,4848
THIES,M’BOUR,FISSEL,NDIAGANIAO,NDIARAO,27,115,677,657,1334
THIES,M’BOUR,FISSEL,NDIAGANIAO,"H1 DADAF",3,17,88,93,181
THIES,M’BOUR,FISSEL,NDIAGANIAO,"H2 WOLAR",8,36,222,239,461
THIES,M’BOUR,FISSEL,NDIAGANIAO,NDINGLER,24,98,609,571,1180
THIES,M’BOUR,FISSEL,NDIAGANIAO,"H1 SANGHAYE DIAGA",7,37,220,216,436
THIES,M’BOUR,FISSEL,NDIAGANIAO,"H2 KASMAS",1,3,31,31,62
THIES,M’BOUR,FISSEL,NDIAGANIAO,"H3 NGOKHOTHIE",6,12,73,59,132
THIES,M’BOUR,FISSEL,NDIAGANIAO,NDIOUDIOUF,13,72,461,459,920
THIES,M’BOUR,FISSEL,NDIAGANIAO,NDORONG,22,123,784,710,1494
THIES,M’BOUR,FISSEL,NDIAGANIAO,"NGAKHAYE (SOWOR)",3,10,88,83,171
THIES,M’BOUR,FISSEL,NDIAGANIAO,"H1 DOUK",1,13,83,60,143
THIES,M’BOUR,FISSEL,NDIAGANIAO,"H2 NDOFF",2,11,69,72,141
THIES,M’BOUR,FISSEL,NDIAGANIAO,"H3 NGAKHAYE",2,10,92,96,188
THIES,M’BOUR,FISSEL,NDIAGANIAO,"H4 SESSENE",1,7,40,24,64
THIES,M’BOUR,FISSEL,NDIAGANIAO,"NGUEDJI 1",25,84,566,490,1056
THIES,M’BOUR,FISSEL,NDIAGANIAO,"NGUEDJI 2",47,122,722,708,1430
THIES,M’BOUR,FISSEL,NDIAGANIAO,"H1 KEUR CHEIKH FAYE",1,6,45,39,84
THIES,M’BOUR,FISSEL,NDIAGANIAO,SANGHAYE,16,62,404,396,800
THIES,M’BOUR,FISSEL,NDIAGANIAO,SESSENE,4,23,151,138,289
THIES,M’BOUR,FISSEL,NDIAGANIAO,"H1 SEKAR",5,24,125,134,259
THIES,M’BOUR,FISSEL,NDIAGANIAO,"SOUSSOUNG (SOUSSOUNG GAM)",7,20,144,135,279
THIES,M’BOUR,FISSEL,NDIAGANIAO,"H1 KEUR WALY",4,11,154,112,266
THIES,M’BOUR,FISSEL,NDIAGANIAO,"H2 SOUSSOUNG PEULH",34,68,348,211,559
THIES,M’BOUR,FISSEL,NDIAGANIAO,"H3 MBOUFOUTHIE",4,29,190,185,375
THIES,M’BOUR,FISSEL,NDIAGANIAO,"H5 SESSENE",14,57,385,301,686
THIES,M’BOUR,FISSEL,NDIAGANIAO,"H6 DAARADJI DE SERIGNE DJILI",1,1,45,0,45
THIES,M’BOUR,FISSEL,NDIAGANIAO,"H7 MBEFETHIE",12,48,294,314,608
THIES,M’BOUR,FISSEL,NDIAGANIAO,"H8 DIENDERE",14,21,160,142,302
THIES,M’BOUR,FISSEL,NDIAGANIAO,"H9 NDIOUKEME",3,5,20,17,37
THIES,M’BOUR,FISSEL,NDIAGANIAO,"H10 NDOUROKH (DAARA SERIGNE M’BACKE )",1,1,7,0,7
THIES,M’BOUR,FISSEL,NDIAGANIAO,"H11 SANDIGUENE",5,21,123,128,251
THIES,M’BOUR,FISSEL,NDIAGANIAO,THIANDENE,249,314,1632,1687,3319
THIES,M’BOUR,FISSEL,NDIAGANIAO,"H1 NGANE",33,61,318,336,654
THIES,M’BOUR,FISSEL,NDIAGANIAO,"H2 NDIAMBOUR",1,5,38,25,63
THIES,M’BOUR,FISSEL,NDIAGANIAO,"H3 NIOLINE",2,2,16,8,24
THIES,M’BOUR,FISSEL,NDIAGANIAO,"TITINE (NGAM)",42,49,244,228,472
THIES,M’BOUR,FISSEL,NDIAGANIAO,"H1 NDIAMBOUR",2,11,49,42,91
THIES,M’BOUR,FISSEL,NDIAGANIAO,"H2 PINE KHADAKH",5,13,64,50,114
THIES,M’BOUR,FISSEL,NDIAGANIAO,"H3 NGADEME",8,12,74,50,124
THIES,M’BOUR,FISSEL,NDIAGANIAO,"H4 MBILOR",6,37,167,170,337
THIES,M’BOUR,FISSEL,NDIAGANIAO,"H5 SOWOR",6,16,101,97,198
THIES,M’BOUR,SESSENE,NGUENIENE,"AGA BABOU",13,27,151,133,284
THIES,M’BOUR,SESSENE,NGUENIENE,"H1 DOUGOKHOULOUP",36,69,377,299,676
THIES,M’BOUR,SESSENE,NGUENIENE,"H3 KARIGNE MAR",42,62,345,338,683
THIES,M’BOUR,SESSENE,NGUENIENE,"H5 THIAREME",30,42,276,243,519
THIES,M’BOUR,SESSENE,NGUENIENE,"AGA BIRAME",45,95,741,637,1378
THIES,M’BOUR,SESSENE,NGUENIENE,"AGA NDIMACK",14,24,151,148,299
THIES,M’BOUR,SESSENE,NGUENIENE,"H1 PINDO DIOHINE",11,15,98,76,174
THIES,M’BOUR,SESSENE,NGUENIENE,"H2 SOBEME",16,23,118,104,222
THIES,M’BOUR,SESSENE,NGUENIENE,"H3 MBOYENE",14,19,118,92,210
THIES,M’BOUR,SESSENE,NGUENIENE,"BAGANA OUOLOF",13,21,143,133,276
THIES,M’BOUR,SESSENE,NGUENIENE,"H1 KEUR MAWANE",12,15,97,77,174
THIES,M’BOUR,SESSENE,NGUENIENE,"H2 KEUR BIRANE FAYE",4,5,26,24,50
THIES,M’BOUR,SESSENE,NGUENIENE,"BAGANA SERERE",40,61,410,385,795
THIES,M’BOUR,SESSENE,NGUENIENE,BALLABOUGOU,25,38,240,211,451
THIES,M’BOUR,SESSENE,NGUENIENE,"H1 SALY BOUGOU",20,35,244,213,457
THIES,M’BOUR,SESSENE,NGUENIENE,"H2 WIRNDE BOKY",12,17,105,69,174
THIES,M’BOUR,SESSENE,NGUENIENE,"H3 WIRNDE BODY",23,58,353,338,691
THIES,M’BOUR,SESSENE,NGUENIENE,"H4 BALAKHALY",33,48,253,260,513
THIES,M’BOUR,SESSENE,NGUENIENE,"H5 NGOLNA",22,30,249,198,447
THIES,M’BOUR,SESSENE,NGUENIENE,"H6 WIRNDE THIOYANE",19,23,112,71,183
THIES,M’BOUR,SESSENE,NGUENIENE,"H7 GUEDJI DIB DIOUF",9,16,143,109,252
THIES,M’BOUR,SESSENE,NGUENIENE,"DIOLOFIRA (DIOLOFIRA OUOLOF)",7,13,60,61,121
THIES,M’BOUR,SESSENE,NGUENIENE,"H1 DIOLOFIRA SECCO",8,10,65,58,123
THIES,M’BOUR,SESSENE,NGUENIENE,"H2 KEUR IBRAHIMA SENE",7,16,95,94,189
THIES,M’BOUR,SESSENE,NGUENIENE,"H3 SOUDIANE",16,34,215,176,391
THIES,M’BOUR,SESSENE,NGUENIENE,"H4 KEUR MODOU BA",7,14,78,77,155
THIES,M’BOUR,SESSENE,NGUENIENE,"DIOLOFIRA SERERE",45,103,673,517,1190
THIES,M’BOUR,SESSENE,NGUENIENE,"FADIAL BAMBARA",80,105,396,425,821
THIES,M’BOUR,SESSENE,NGUENIENE,"FADIAL SERERE",104,109,405,403,808
THIES,M’BOUR,SESSENE,NGUENIENE,"H1 MADINA",24,32,208,168,376
THIES,M’BOUR,SESSENE,NGUENIENE,"H2 KARAMOKHO",11,14,74,74,148
THIES,M’BOUR,SESSENE,NGUENIENE,"FOUA 1",21,43,211,202,413
THIES,M’BOUR,SESSENE,NGUENIENE,"H1 KEUR NDIAGA BA",5,7,47,46,93
THIES,M’BOUR,SESSENE,NGUENIENE,"H2 PINDO KHAOUL",7,11,73,102,175
THIES,M’BOUR,SESSENE,NGUENIENE,"H3 FOUA TAKH",18,28,198,152,350
THIES,M’BOUR,SESSENE,NGUENIENE,"H4 LOULALA",16,26,138,139,277
THIES,M’BOUR,SESSENE,NGUENIENE,"H6 TOKOUKHOULOUP (FOUA I)",19,49,268,252,520
THIES,M’BOUR,SESSENE,NGUENIENE,"H8 PINDO FADANE",15,31,211,188,399
THIES,M’BOUR,SESSENE,NGUENIENE,"FOUA 2",87,126,776,718,1494
THIES,M’BOUR,SESSENE,NGUENIENE,LEONA,31,40,177,166,343
THIES,M’BOUR,SESSENE,NGUENIENE,"H1 NDIOBENE",18,25,158,146,304
THIES,M’BOUR,SESSENE,NGUENIENE,"H2 SASSENE",17,17,93,76,169
THIES,M’BOUR,SESSENE,NGUENIENE,"H1 KEUR NDIOUKERY",21,29,182,174,356
THIES,M’BOUR,SESSENE,NGUENIENE,MBODIENE,339,410,1258,1437,2695
THIES,M’BOUR,SESSENE,NGUENIENE,"H1 PEULGA",27,32,139,128,267
THIES,M’BOUR,SESSENE,NGUENIENE,"H2 GUEDJI MADE",48,65,377,309,686
THIES,M’BOUR,SESSENE,NGUENIENE,"H3 GUEDJI DIOULY",28,38,206,194,400
THIES,M’BOUR,SESSENE,NGUENIENE,NDIANDA,421,561,2960,2874,5834
THIES,M’BOUR,SESSENE,NGUENIENE,"H1 SANKHAYE",8,13,47,42,89
THIES,M’BOUR,SESSENE,NGUENIENE,"H2 KEUR NGONEKHOU",7,7,73,64,137
THIES,M’BOUR,SESSENE,NGUENIENE,"H3 KEUR NDANE SENGHOR",4,4,29,21,50
THIES,M’BOUR,SESSENE,NGUENIENE,"H4 KEUR SANDOKH NDIAYE",25,39,249,211,460
THIES,M’BOUR,SESSENE,NGUENIENE,"H5 KEUR BOURE",3,4,51,26,77
THIES,M’BOUR,SESSENE,NGUENIENE,"H6 NGOUYE DIAGA",4,4,15,13,28
THIES,M’BOUR,SESSENE,NGUENIENE,"H7 KEUR PEULGA",13,17,85,68,153
THIES,M’BOUR,SESSENE,NGUENIENE,"H8 GUEDJ NGO TENING",16,18,116,92,208
THIES,M’BOUR,SESSENE,NGUENIENE,"H9 KEUR EL HADJI DEMBA KA",1,2,20,14,34
THIES,M’BOUR,SESSENE,NGUENIENE,"NDIAROGNE OUOLOF",36,44,154,157,311
THIES,M’BOUR,SESSENE,NGUENIENE,"H1 NDIAROGNE OUSMANE",5,5,18,20,38
THIES,M’BOUR,SESSENE,NGUENIENE,"H2 DIABOUGOU",45,53,200,231,431
THIES,M’BOUR,SESSENE,NGUENIENE,"NDIAROGNE SERERE",38,54,279,272,551
THIES,M’BOUR,SESSENE,NGUENIENE,"H1 KEUR MALICK DIOP",4,6,38,26,64
THIES,M’BOUR,SESSENE,NGUENIENE,"H2 KEUR SAMBA THIORO DIOP",16,18,119,120,239
THIES,M’BOUR,SESSENE,NGUENIENE,"NDIEMANE (NDIEMANE CENTRE)",65,72,387,359,746
THIES,M’BOUR,SESSENE,NGUENIENE,"H1 KEUR SASSAMBA",17,27,172,146,318
THIES,M’BOUR,SESSENE,NGUENIENE,"H2 KEUR YORO WINDOU SOW",13,18,104,94,198
THIES,M’BOUR,SESSENE,NGUENIENE,"H3 KEUR CHEIKH DIOP",13,16,117,102,219
THIES,M’BOUR,SESSENE,NGUENIENE,"H5 GUEDJI MODY",6,7,35,21,56
THIES,M’BOUR,SESSENE,NGUENIENE,"H6 KEUR KEMESSOU",24,24,135,108,243
THIES,M’BOUR,SESSENE,NGUENIENE,"H7 GUEDJI MARTIN",79,113,687,558,1245
THIES,M’BOUR,SESSENE,NGUENIENE,"H8 NGOLNA",21,26,138,123,261
THIES,M’BOUR,SESSENE,NGUENIENE,NDOFFANE,108,131,649,651,1300
THIES,M’BOUR,SESSENE,NGUENIENE,"H1 KEUR NDIAGA SECK",21,31,203,172,375
THIES,M’BOUR,SESSENE,NGUENIENE,"H3 KEUR AMATH SARR",13,17,137,97,234
THIES,M’BOUR,SESSENE,NGUENIENE,"H5 KEUR DIAWOYE",14,15,99,98,197
THIES,M’BOUR,SESSENE,NGUENIENE,"H4 NDIGA KHOKH",57,73,422,417,839
THIES,M’BOUR,SESSENE,NGUENIENE,"H7 NDOFFANE SERERE",26,38,240,216,456
THIES,M’BOUR,SESSENE,NGUENIENE,NGOYOCOP,35,54,352,368,720
THIES,M’BOUR,SESSENE,NGUENIENE,"NGUENIENE OUOLOF",406,536,2362,2545,4907
THIES,M’BOUR,SESSENE,NGUENIENE,"H1 KEUR DIATTA",9,12,77,75,152
THIES,M’BOUR,SESSENE,NGUENIENE,"H2 PAPA MANE",10,13,91,63,154
THIES,M’BOUR,SESSENE,NGUENIENE,"NGUENIENE PEULH (KEUR NGOR DIAGNE)",31,43,315,254,569
THIES,M’BOUR,SESSENE,NGUENIENE,"NGUENIENE SERERE",255,347,1506,1586,3092
THIES,M’BOUR,SESSENE,NGUENIENE,"H1 KEUR DIOMAYE",3,3,2,1,3
THIES,M’BOUR,SESSENE,NGUENIENE,"H2 KEUR MODY SOW (KEUR NOPE)",5,5,27,38,65
THIES,M’BOUR,SESSENE,NGUENIENE,"H3 TOKOUKHOULOUM",3,3,23,27,50
THIES,M’BOUR,SESSENE,NGUENIENE,"H4 DIOHINE (NGUENIENE DIOKHINE)",27,38,305,266,571
THIES,M’BOUR,SESSENE,NGUENIENE,"H5 NDOUNEME",13,20,160,148,308
THIES,M’BOUR,SESSENE,NGUENIENE,"LOULY SESSENE",2,3,30,28,58
THIES,M’BOUR,SESSENE,NGUENIENE,"VELINGARA NDOFFANE",52,63,399,367,766
THIES,M’BOUR,SESSENE,SANDIARA,FAYELAR,43,118,764,780,1544
THIES,M’BOUR,SESSENE,SANDIARA,"H1 FAYELAR 2",32,43,239,210,449
THIES,M’BOUR,SESSENE,SANDIARA,"KEUR DIBA",11,15,73,49,122
THIES,M’BOUR,SESSENE,SANDIARA,"KIBICK (NDIAGANIAO)",31,92,476,445,921
THIES,M’BOUR,SESSENE,SANDIARA,KOUTHIE,59,64,355,344,699
THIES,M’BOUR,SESSENE,SANDIARA,"H1 MBADATE",8,15,78,62,140
THIES,M’BOUR,SESSENE,SANDIARA,"H2 KIBIC NGOY",5,19,180,148,328
THIES,M’BOUR,SESSENE,SANDIARA,"H3 LOULY CHERIF",8,8,84,55,139
THIES,M’BOUR,SESSENE,SANDIARA,"H4 KEUR BIRAME NDOUR",3,11,66,76,142
THIES,M’BOUR,SESSENE,SANDIARA,"H5 LOULY NGACKE",9,30,218,184,402
THIES,M’BOUR,SESSENE,SANDIARA,"LOULY BENTEGNE",71,152,926,865,1791
THIES,M’BOUR,SESSENE,SANDIARA,"LOULY MBAFAYE",32,144,994,849,1843
THIES,M’BOUR,SESSENE,SANDIARA,"H2 LOULY NDIAYENE KOUTHIE",12,31,184,138,322
THIES,M’BOUR,SESSENE,SANDIARA,"LOULY NDIA",81,89,442,461,903
THIES,M’BOUR,SESSENE,SANDIARA,"LOULY NGOGOM",36,60,389,396,785
THIES,M’BOUR,SESSENE,SANDIARA,"LOULY SINDIANE",81,126,776,629,1405
THIES,M’BOUR,SESSENE,SANDIARA,"H1 MBALAKHATE",24,30,181,155,336
THIES,M’BOUR,SESSENE,SANDIARA,"H2 NDIAGNE",12,19,113,102,215
THIES,M’BOUR,SESSENE,SANDIARA,MBOUROKH,68,68,354,265,619
THIES,M’BOUR,SESSENE,SANDIARA,"H1 MBOUROKH TOUCOULEUR",31,34,272,202,474
THIES,M’BOUR,SESSENE,SANDIARA,"H2 MBOUROKH SERERE",7,22,160,131,291
THIES,M’BOUR,SESSENE,SANDIARA,"H3 MBOUROKH PEULH",26,49,320,289,609
THIES,M’BOUR,SESSENE,SANDIARA,"NDIOUKH FISSEL",25,81,423,406,829
THIES,M’BOUR,SESSENE,SANDIARA,"H1 NDIOUKH GOREYA",28,66,433,366,799
THIES,M’BOUR,SESSENE,SANDIARA,"NDIOUKH THIAROKH",49,104,566,549,1115
THIES,M’BOUR,SESSENE,SANDIARA,NDOLLOR,25,51,199,218,417
THIES,M’BOUR,SESSENE,SANDIARA,"H1 KEUR SALIOU THIAW",8,13,79,51,130
THIES,M’BOUR,SESSENE,SANDIARA,NGOMENE,45,60,310,295,605
THIES,M’BOUR,SESSENE,SANDIARA,NIANAR,63,108,724,614,1338
THIES,M’BOUR,SESSENE,SANDIARA,SAMANE,20,24,91,92,183
THIES,M’BOUR,SESSENE,SANDIARA,"H1 SAMANE GANDIOL",9,11,47,49,96
THIES,M’BOUR,SESSENE,SANDIARA,"SANDIARA OUOLOF",431,522,2411,2279,4690
THIES,M’BOUR,SESSENE,SANDIARA,"SANDIARA SERERE",519,629,3064,3026,6090
THIES,M’BOUR,SESSENE,SANDIARA,"H2 GARAGE DIAKHERE",33,41,230,220,450
THIES,M’BOUR,SESSENE,SANDIARA,GODAGUENE,83,220,1562,1557,3119
THIES,M’BOUR,SESSENE,SANDIARA,SOUKHEME,47,164,1204,1112,2316
THIES,M’BOUR,SESSENE,SANDIARA,SOUSSANE,91,161,906,771,1677
THIES,M’BOUR,SESSENE,SESSENE,"DIOKHAR (NGOULEME)",14,48,227,231,458
THIES,M’BOUR,SESSENE,SESSENE,"H1 NGOURBOUYE",20,39,195,215,410
THIES,M’BOUR,SESSENE,SESSENE,"H2 DIOKHAR OUOLOF",10,19,92,106,198
THIES,M’BOUR,SESSENE,SESSENE,"H3 KEUR DOKOR",21,38,182,194,376
THIES,M’BOUR,SESSENE,SESSENE,"H4 DIOKHAR NDIANE",11,44,199,212,411
THIES,M’BOUR,SESSENE,SESSENE,GOHE,5,17,92,105,197
THIES,M’BOUR,SESSENE,SESSENE,"H2 SOROKH",5,11,74,77,151
THIES,M’BOUR,SESSENE,SESSENE,"H3 NGOULTOUNE",13,34,168,188,356
THIES,M’BOUR,SESSENE,SESSENE,"H4 TOKOURAK",17,25,110,123,233
THIES,M’BOUR,SESSENE,SESSENE,"H5 NDIOBENE",6,33,208,206,414
THIES,M’BOUR,SESSENE,SESSENE,"H6 SIME",3,14,75,82,157
THIES,M’BOUR,SESSENE,SESSENE,"H7 SIPANE",1,3,14,17,31
THIES,M’BOUR,SESSENE,SESSENE,"H8 MBELANE",10,18,98,91,189
THIES,M’BOUR,SESSENE,SESSENE,"H9 WAKHALDIAM",2,6,29,36,65
THIES,M’BOUR,SESSENE,SESSENE,GOROU,9,12,51,41,92
THIES,M’BOUR,SESSENE,SESSENE,"H1 NDOFFANE",20,37,180,139,319
THIES,M’BOUR,SESSENE,SESSENE,"H2 NDIMAGUE (GOROU NDIMAGUE)",16,21,120,99,219
THIES,M’BOUR,SESSENE,SESSENE,"H3 PEULGA",3,3,27,14,41
THIES,M’BOUR,SESSENE,SESSENE,"H4 KEUR MBANE NDOUR",6,15,61,58,119
THIES,M’BOUR,SESSENE,SESSENE,"H5 GOROU NDIOUDIOUF",14,24,115,112,227
THIES,M’BOUR,SESSENE,SESSENE,"H7 KEUR BALLE NGOM",1,14,86,60,146
THIES,M’BOUR,SESSENE,SESSENE,"KEUR EL HADJI",15,29,150,144,294
THIES,M’BOUR,SESSENE,SESSENE,"H1 FOMAL",25,64,337,389,726
THIES,M’BOUR,SESSENE,SESSENE,"H2 KEUR GUEDJI DIOP",3,13,114,122,236
THIES,M’BOUR,SESSENE,SESSENE,"KEUR YERIM",23,34,180,214,394
THIES,M’BOUR,SESSENE,SESSENE,"H1 KEUR SIGA",3,3,15,14,29
THIES,M’BOUR,SESSENE,SESSENE,"H2 KEUR DETHIE (NDIOUGNE NDIAREME)",18,39,196,225,421
THIES,M’BOUR,SESSENE,SESSENE,"H3 KEUR NDIOGOU SENE",8,11,56,66,122
THIES,M’BOUR,SESSENE,SESSENE,"H4 KEUR BIRAME NIAMAR",11,22,131,128,259
THIES,M’BOUR,SESSENE,SESSENE,"KHEME (NGUEME)",26,41,297,240,537
THIES,M’BOUR,SESSENE,SESSENE,"H1 MBOURAYE SECK",9,23,120,122,242
THIES,M’BOUR,SESSENE,SESSENE,"H2 NGASKOR",20,51,250,313,563
THIES,M’BOUR,SESSENE,SESSENE,"H3 NGATHIE",21,69,318,358,676
THIES,M’BOUR,SESSENE,SESSENE,LALLAM,15,79,463,403,866
THIES,M’BOUR,SESSENE,SESSENE,NDIADIANE,48,52,303,258,561
THIES,M’BOUR,SESSENE,SESSENE,"H1 BEFEL",11,25,201,215,416
THIES,M’BOUR,SESSENE,SESSENE,"H5 NDIADIANE MOURIDE",10,13,58,66,124
THIES,M’BOUR,SESSENE,SESSENE,"NDIEFFER (NGOLEYE)",9,33,195,184,379
THIES,M’BOUR,SESSENE,SESSENE,"H1 NDIEFFER (MBAR)",20,46,388,303,691
THIES,M’BOUR,SESSENE,SESSENE,"H2 NGARY NEBANE",16,31,275,207,482
THIES,M’BOUR,SESSENE,SESSENE,"H3 PANE POUYE",13,29,181,174,355
THIES,M’BOUR,SESSENE,SESSENE,"H4 NDIANE MBAL",12,27,170,143,313
THIES,M’BOUR,SESSENE,SESSENE,"H5 LOUKOUK",3,9,58,61,119
THIES,M’BOUR,SESSENE,SESSENE,"H6 NGOTHIEME",15,37,252,258,510
THIES,M’BOUR,SESSENE,SESSENE,"H7 DAFF",9,33,231,206,437
THIES,M’BOUR,SESSENE,SESSENE,NDIOUDIOUF,21,28,139,113,252
THIES,M’BOUR,SESSENE,SESSENE,"H1 NDIOUDIOUF SERERE",12,20,141,111,252
THIES,M’BOUR,SESSENE,SESSENE,"H2 PEULGA",7,9,76,67,143
THIES,M’BOUR,SESSENE,SESSENE,"H3 KEUR DJIRE",9,16,80,83,163
THIES,M’BOUR,SESSENE,SESSENE,"H4 NDIOB",22,30,174,163,337
THIES,M’BOUR,SESSENE,SESSENE,"H5 KEUR LAME",3,6,25,28,53
THIES,M’BOUR,SESSENE,SESSENE,NGUEDIANE,8,16,112,93,205
THIES,M’BOUR,SESSENE,SESSENE,"H1 NDINGLER",15,39,240,249,489
THIES,M’BOUR,SESSENE,SESSENE,"H2 DADAK",11,29,195,180,375
THIES,M’BOUR,SESSENE,SESSENE,"H3 NGUEDIANE NDET",14,27,205,194,399
THIES,M’BOUR,SESSENE,SESSENE,NIOMAR,40,68,288,297,585
THIES,M’BOUR,SESSENE,SESSENE,"H1 NGOFAO",8,19,95,92,187
THIES,M’BOUR,SESSENE,SESSENE,"H2 SOUEME",6,30,128,114,242
THIES,M’BOUR,SESSENE,SESSENE,"H3 NDIAMBOUR",5,13,79,74,153
THIES,M’BOUR,SESSENE,SESSENE,"H4 KOR DIALLY",17,31,184,170,354
THIES,M’BOUR,SESSENE,SESSENE,"H5 NGAGANE",7,20,91,84,175
THIES,M’BOUR,SESSENE,SESSENE,"H6 KOR DIALLY",4,10,45,49,94
THIES,M’BOUR,SESSENE,SESSENE,SAO,56,133,737,704,1441
THIES,M’BOUR,SESSENE,SESSENE,"SAOKOM 1",24,52,307,271,578
THIES,M’BOUR,SESSENE,SESSENE,"SAOKOM 2 (COPE)",38,49,158,183,341
THIES,M’BOUR,SESSENE,SESSENE,"H2 NENEF",14,23,172,133,305
THIES,M’BOUR,SESSENE,SESSENE,"H3 SA SARR",3,8,46,32,78
THIES,M’BOUR,SESSENE,SESSENE,"H4 SINDIANE",29,48,281,248,529
THIES,M’BOUR,SESSENE,SESSENE,"H5 NDIOUDIOUF",17,37,175,176,351
THIES,M’BOUR,SESSENE,SESSENE,SESSENE,106,120,486,510,996
THIES,M’BOUR,SESSENE,SESSENE,"H1 MAMARONE",7,14,64,62,126
THIES,M’BOUR,SESSENE,SESSENE,"H2 SANTHIE",11,11,48,37,85
THIES,M’BOUR,SESSENE,SESSENE,"H3 CAMPEMENT",34,37,231,148,379
THIES,M’BOUR,SESSENE,SESSENE,"H4 MBAFAYE",28,45,248,253,501
THIES,M’BOUR,SESSENE,SESSENE,"TATTAGUINE BAMBARA",78,159,929,862,1791
THIES,M’BOUR,SESSENE,SESSENE,"TATTAGUINE SERERE",26,53,319,270,589
THIES,M’BOUR,SESSENE,SESSENE,"H1 NDAYAME",11,20,115,141,256
THIES,M’BOUR,SESSENE,SESSENE,"H2 DOME",20,42,252,280,532
THIES,M’BOUR,SESSENE,SESSENE,"H3 NDIAROP",10,24,154,133,287
THIES,M’BOUR,SESSENE,SESSENE,"YABO YABO",64,133,861,776,1637
THIES,M’BOUR,SESSENE,SESSENE,"H1 NDAMBALE",9,18,136,103,239
THIES,M’BOUR,SESSENE,SESSENE,"DIOKHAR (NDIANE)",6,7,54,41,95
THIES,M’BOUR,SESSENE,SESSENE,"FAYELAR 2",7,9,51,47,98
THIES,M’BOUR,SESSENE,SESSENE,"KEUR NDOLANE",11,15,84,73,157
THIES,M’BOUR,SESSENE,SESSENE,"NDIEMANE NDIADIANE",21,38,305,289,594
THIES,M’BOUR,SESSENE,SESSENE,"H1 NDIADIANE KEUR COULY",9,29,163,150,313
THIES,M’BOUR,SESSENE,THIADIAYE,CENTRE,212,294,1149,1171,2320
THIES,M’BOUR,SESSENE,THIADIAYE,"CHAMPS DE COURSE EST",235,278,1205,1179,2384
THIES,M’BOUR,SESSENE,THIADIAYE,"CHAMPS DE COURSE OUEST",309,357,1402,1423,2825
THIES,M’BOUR,SESSENE,THIADIAYE,"ESCALE NORD",227,274,1046,1074,2120
THIES,M’BOUR,SESSENE,THIADIAYE,"ESCALE SUD",135,179,727,814,1541
THIES,M’BOUR,SESSENE,THIADIAYE,FOUDJ,64,88,459,464,923
THIES,M’BOUR,SESSENE,THIADIAYE,KHAKHAM,274,328,1342,1370,2712
THIES,M’BOUR,SESSENE,THIADIAYE,MEDINE,217,292,1114,1173,2287
THIES,M’BOUR,SESSENE,THIADIAYE,"THIADIAYE SERERE",100,116,619,624,1243
THIES,M’BOUR,SESSENE,THIADIAYE,WALO,163,216,869,944,1813
THIES,M’BOUR,SINDIA,MALICOUNDA,"FALOKH OUOLOF",2913,3098,11767,11239,23006
THIES,M’BOUR,SINDIA,MALICOUNDA,"FALOKH SERERE",85,92,457,368,825
THIES,M’BOUR,SINDIA,MALICOUNDA,"FANDANE OUOLOF",34,40,211,202,413
THIES,M’BOUR,SINDIA,MALICOUNDA,"H1 PEULHGA de FANDANE OUOLOF",132,147,675,539,1214
THIES,M’BOUR,SINDIA,MALICOUNDA,"H2 KEUR IBRAHIMA KA (ISSA KA)",4,5,26,24,50
THIES,M’BOUR,SINDIA,MALICOUNDA,"H3 KEUR MBAYE KA",6,9,37,39,76
THIES,M’BOUR,SINDIA,MALICOUNDA,"H4 ISSA KA",2,2,9,11,20
THIES,M’BOUR,SINDIA,MALICOUNDA,"FANDANE SERERE",52,63,329,274,603
THIES,M’BOUR,SINDIA,MALICOUNDA,"H1 THIAWENE",4,8,69,49,118
THIES,M’BOUR,SINDIA,MALICOUNDA,"H2 FANDANE BOULE",36,40,213,185,398
THIES,M’BOUR,SINDIA,MALICOUNDA,"H3 KEUR GANA",12,14,89,64,153
THIES,M’BOUR,SINDIA,MALICOUNDA,"H4 FANDANE NDIOUFENE",33,61,328,323,651
THIES,M’BOUR,SINDIA,MALICOUNDA,"KEUR BALLA LO (KEUR MASSYLA)",138,141,845,699,1544
THIES,M’BOUR,SINDIA,MALICOUNDA,"H1 TOUBA CARRIERE",153,177,740,691,1431
THIES,M’BOUR,SINDIA,MALICOUNDA,"MALICOUNDA BAMBARA",175,200,905,975,1880
THIES,M’BOUR,SINDIA,MALICOUNDA,"H1 KARFABOUGOU",68,81,838,295,1133
THIES,M’BOUR,SINDIA,MALICOUNDA,"MALICOUNDA EXTENSION",1179,1347,4327,4331,8658
THIES,M’BOUR,SINDIA,MALICOUNDA,"MALICOUNDA OUOLOF (KEUR MEISSA)",1889,2017,8106,7570,15676
THIES,M’BOUR,SINDIA,MALICOUNDA,"H1 KEUR MASSAHIBE",41,55,304,346,650
THIES,M’BOUR,SINDIA,MALICOUNDA,"H2 DAROU THIOUBENE ET NDIEYE",44,54,274,250,524
THIES,M’BOUR,SINDIA,MALICOUNDA,"H3 KEUR DAOUR",33,35,209,154,363
THIES,M’BOUR,SINDIA,MALICOUNDA,"H4 TOUCOULEUR",7,7,37,23,60
THIES,M’BOUR,SINDIA,MALICOUNDA,"H5 KEUR MALICK BA",15,16,84,75,159
THIES,M’BOUR,SINDIA,MALICOUNDA,"H6 KEUR SAMBA LAOBE",97,116,587,319,906
THIES,M’BOUR,SINDIA,MALICOUNDA,"MALICOUNDA SERERE",398,450,2063,1917,3980
THIES,M’BOUR,SINDIA,MALICOUNDA,"H2 KEUR WALY",48,63,238,221,459
THIES,M’BOUR,SINDIA,MALICOUNDA,"H3 NGUERIGNE",111,130,661,682,1343
THIES,M’BOUR,SINDIA,MALICOUNDA,"H4 NGOGOME",96,118,643,641,1284
THIES,M’BOUR,SINDIA,MALICOUNDA,"H5 KEUR NDOURENE",17,30,160,149,309
THIES,M’BOUR,SINDIA,MALICOUNDA,MBALLING,740,893,3929,3554,7483
THIES,M’BOUR,SINDIA,MALICOUNDA,MBOULEME,86,113,602,582,1184
THIES,M’BOUR,SINDIA,MALICOUNDA,"H1 DOUGOUDALA",7,7,35,24,59
THIES,M’BOUR,SINDIA,MALICOUNDA,"H3 KEUR DIEGANE DIOME",30,41,250,242,492
THIES,M’BOUR,SINDIA,MALICOUNDA,"H4 KEUR MADY NDIAKHATE",9,12,39,27,66
THIES,M’BOUR,SINDIA,MALICOUNDA,"H5 KEUR YOPANE (KEURY KAW)",19,22,95,83,178
THIES,M’BOUR,SINDIA,MALICOUNDA,NIANING,965,2017,4864,4765,9629
THIES,M’BOUR,SINDIA,MALICOUNDA,"H1 GANDIOL MANGO (GANDIOL 1)",37,45,220,238,458
THIES,M’BOUR,SINDIA,MALICOUNDA,"H2 GANDIOL 2",36,42,200,176,376
THIES,M’BOUR,SINDIA,MALICOUNDA,"H3 SINTHIOU KEITA ( PEULH)",44,54,357,297,654
THIES,M’BOUR,SINDIA,MALICOUNDA,"H4 NIANING GOREE",97,105,661,601,1262
THIES,M’BOUR,SINDIA,MALICOUNDA,"H5  GOUREL",35,44,181,148,329
THIES,M’BOUR,SINDIA,MALICOUNDA,"H6 GANDIOL 3",14,20,97,89,186
THIES,M’BOUR,SINDIA,MALICOUNDA,"H7 NIANING RESIDENCE",25,25,25,20,45
THIES,M’BOUR,SINDIA,MALICOUNDA,"POINTE SARENE",331,476,2270,2005,4275
THIES,M’BOUR,SINDIA,MALICOUNDA,"H1 KEUR NOUDY BA",92,184,511,443,954
THIES,M’BOUR,SINDIA,MALICOUNDA,"H2 KEUR COLY SARR",64,73,406,352,758
THIES,M’BOUR,SINDIA,MALICOUNDA,"H3 PEULGA CROISEMENT",39,93,276,240,516
THIES,M’BOUR,SINDIA,MALICOUNDA,ROFF,19,24,130,120,250
THIES,M’BOUR,SINDIA,MALICOUNDA,"H1 PEULGA (KEUR MOKY DIALLO)",19,21,129,131,260
THIES,M’BOUR,SINDIA,MALICOUNDA,"H2 KEUR NGARY DIALLO",10,12,66,65,131
THIES,M’BOUR,SINDIA,MALICOUNDA,"H3 KEUR KOUTE",9,10,72,66,138
THIES,M’BOUR,SINDIA,MALICOUNDA,"H4 KEUR SECK FAYE",41,65,287,285,572
THIES,M’BOUR,SINDIA,MALICOUNDA,SIDIBOUGOU,47,48,229,197,426
THIES,M’BOUR,SINDIA,MALICOUNDA,"H1 MBANDY",20,20,73,59,132
THIES,M’BOUR,SINDIA,MALICOUNDA,"SINTHIOU MBADANE SERERE",21,37,165,158,323
THIES,M’BOUR,SINDIA,MALICOUNDA,"H6 MODIANE BAKHOUM",21,30,176,146,322
THIES,M’BOUR,SINDIA,MALICOUNDA,"SOUSSANE SARENE BAMBARA (GANIABOUGOU)",51,55,259,251,510
THIES,M’BOUR,SINDIA,MALICOUNDA,"SOUSSANE SARENE SERERE",38,41,241,221,462
THIES,M’BOUR,SINDIA,MALICOUNDA,"TAKHOUM OUOLOF (KEUR MORY )",39,42,190,177,367
THIES,M’BOUR,SINDIA,MALICOUNDA,"H1 AIMEROU NDIAYE",59,74,420,390,810
THIES,M’BOUR,SINDIA,MALICOUNDA,"H2 DAROU TIDIANE",23,28,125,134,259
THIES,M’BOUR,SINDIA,MALICOUNDA,"H3 DAROU MOURIDE",44,51,311,264,575
THIES,M’BOUR,SINDIA,MALICOUNDA,"H4 DAROU MOURIDE KEUR IBRA",15,18,86,89,175
THIES,M’BOUR,SINDIA,MALICOUNDA,"TAKHOUM SERERE",1,3,14,12,26
THIES,M’BOUR,SINDIA,MALICOUNDA,"H1 KEUR COLY",5,14,109,76,185
THIES,M’BOUR,SINDIA,MALICOUNDA,"H2 KEUR BIRANE NDIARRA",19,22,146,123,269
THIES,M’BOUR,SINDIA,MALICOUNDA,"H3 KEUR MODOU TINE",10,17,110,82,192
THIES,M’BOUR,SINDIA,MALICOUNDA,"H4 KEUR MAYIDE",6,12,69,65,134
THIES,M’BOUR,SINDIA,MALICOUNDA,"H6 KEUR MALLE",8,11,86,82,168
THIES,M’BOUR,SINDIA,MALICOUNDA,"H7 KEUR DIADJI",8,17,130,131,261
THIES,M’BOUR,SINDIA,MALICOUNDA,"H8 KEUR SAMBEL",15,16,118,116,234
THIES,M’BOUR,SINDIA,MALICOUNDA,"H9 KEUR LAMANE",15,28,162,150,312
THIES,M’BOUR,SINDIA,MALICOUNDA,"WARANG SERERE",256,314,890,835,1725
THIES,M’BOUR,SINDIA,MALICOUNDA,"WARANG SOCE",285,346,1469,1246,2715
THIES,M’BOUR,SINDIA,MALICOUNDA,"H1 DARA SERIGNE CHEIKH A. TIDIANE WADE",50,61,340,320,660
THIES,M’BOUR,SINDIA,MALICOUNDA,"FALOKH MBOUR",87,92,364,334,698
THIES,M’BOUR,SINDIA,MALICOUNDA,"FANDANE EXTENSION",1,1,5,1,6
THIES,M’BOUR,SINDIA,MALICOUNDA,"FANDANE SARENE",9,12,62,51,113
THIES,M’BOUR,SINDIA,MALICOUNDA,"FANDANE SECKENE",11,12,70,50,120
THIES,M’BOUR,SINDIA,MALICOUNDA,"KEUR GOR",9,9,53,58,111
THIES,M’BOUR,SINDIA,MALICOUNDA,KHELCOM,132,133,505,476,981
THIES,M’BOUR,SINDIA,MALICOUNDA,"LIBERTE 2 EXTENSION",92,95,371,387,758
THIES,M’BOUR,SINDIA,MALICOUNDA,"SALY DOUTE",187,202,964,897,1861
THIES,M’BOUR,SINDIA,MALICOUNDA,"SINTHIOU MBADANE PEULH",135,158,752,649,1401
THIES,M’BOUR,SINDIA,MALICOUNDA,"H1 PEULHGA de SINTHIOU MBADANE PEULH",5,6,39,34,73
THIES,M’BOUR,SINDIA,MALICOUNDA,"SOUSSANE SARENE SERERE (GANIABOUGOU )",42,54,313,280,593
THIES,M’BOUR,SINDIA,MALICOUNDA,"H1 SINTHIOU KEITA SERERE",55,80,406,425,831
THIES,M’BOUR,SINDIA,MALICOUNDA,"TAKHOUM NGOGOM",44,63,337,324,661
THIES,M’BOUR,SINDIA,DIASS,"BANDIA BAMBARA",68,74,368,345,713
THIES,M’BOUR,SINDIA,DIASS,"H1 BANDIA PEULH",20,23,129,122,251
THIES,M’BOUR,SINDIA,DIASS,"BANDIA SESSENE",63,97,449,388,837
THIES,M’BOUR,SINDIA,DIASS,"H5 KEUR MOMAR POUYE",2,6,23,26,49
THIES,M’BOUR,SINDIA,DIASS,BOUKHOU,225,359,1576,1558,3134
THIES,M’BOUR,SINDIA,DIASS,DAGGA,134,238,976,886,1862
THIES,M’BOUR,SINDIA,DIASS,"H1 DIALAW",8,17,57,44,101
THIES,M’BOUR,SINDIA,DIASS,DIASS,574,765,3149,3141,6290
THIES,M’BOUR,SINDIA,DIASS,"H1 KOUBITE",55,74,334,407,741
THIES,M’BOUR,SINDIA,DIASS,"H2 NGAM",105,172,833,793,1626
THIES,M’BOUR,SINDIA,DIASS,GANDOUL,119,163,651,631,1282
THIES,M’BOUR,SINDIA,DIASS,KANDAM,51,68,178,234,412
THIES,M’BOUR,SINDIA,DIASS,KHOLPA,93,176,679,621,1300
THIES,M’BOUR,SINDIA,DIASS,KIRENE,66,95,470,409,879
THIES,M’BOUR,SINDIA,DIASS,"H1 TEPRENG",41,72,327,319,646
THIES,M’BOUR,SINDIA,DIASS,"H2 DOBOURE",34,64,323,297,620
THIES,M’BOUR,SINDIA,DIASS,"H3 KEUR NDIAYE",27,50,244,253,497
THIES,M’BOUR,SINDIA,DIASS,"H4 KIRENE PHARMACIE",7,13,66,27,93
THIES,M’BOUR,SINDIA,DIASS,"H5 FOUK",26,67,311,262,573
THIES,M’BOUR,SINDIA,DIASS,"H6 TACK",17,28,190,219,409
THIES,M’BOUR,SINDIA,DIASS,"H7 USINE KIRENE",1,18,34,39,73
THIES,M’BOUR,SINDIA,DIASS,MBAYARD,90,128,609,561,1170
THIES,M’BOUR,SINDIA,DIASS,"H2 KHABANE",25,26,135,131,266
THIES,M’BOUR,SINDIA,DIASS,"NDIOROKH NDOUTANE",23,56,336,324,660
THIES,M’BOUR,SINDIA,DIASS,"H1 DIAMAGUENE",5,6,29,36,65
THIES,M’BOUR,SINDIA,DIASS,PACKY,118,216,1104,1125,2229
THIES,M’BOUR,SINDIA,DIASS,RAFFO,20,68,351,321,672
THIES,M’BOUR,SINDIA,DIASS,SAMEKEDJ,121,211,1018,937,1955
THIES,M’BOUR,SINDIA,DIASS,THICKY,276,466,2485,2322,4807
THIES,M’BOUR,SINDIA,DIASS,"H1 ALTOU WEL",14,16,64,59,123
THIES,M’BOUR,SINDIA,DIASS,"TOGLOU OUOLOF",233,288,1178,1118,2296
THIES,M’BOUR,SINDIA,DIASS,"TOGLOU SERERE",216,345,1720,1511,3231
THIES,M’BOUR,SINDIA,DIASS,"H2 MBIRDIAM",91,133,568,531,1099
THIES,M’BOUR,SINDIA,DIASS,KAWSARA,12,12,37,39,76
THIES,M’BOUR,SINDIA,DIASS,"MBOUROKH BAMBARA",19,19,64,42,106
THIES,M’BOUR,SINDIA,DIASS,"H1 MBOUROKH SERERE (KEUR NDIOBENE FAYE)",31,34,156,134,290
THIES,M’BOUR,SINDIA,SINDIA,"COP GOYANE (NDIOGOYE)",64,78,379,267,646
THIES,M’BOUR,SINDIA,SINDIA,"H1 KEUR SERIGNE M’BACKE",3,3,190,21,211
THIES,M’BOUR,SINDIA,SINDIA,"H2 NDIOGOYE",23,36,183,166,349
THIES,M’BOUR,SINDIA,SINDIA,GANDIGAL,674,803,3102,2665,5767
THIES,M’BOUR,SINDIA,SINDIA,"H2 PROJET CARITAS",65,72,231,216,447
THIES,M’BOUR,SINDIA,SINDIA,GUEREO,605,898,4039,4331,8370
THIES,M’BOUR,SINDIA,SINDIA,"KEUR MASSOUKA",49,55,404,405,809
THIES,M’BOUR,SINDIA,SINDIA,"H1 TH1ARE",15,15,134,135,269
THIES,M’BOUR,SINDIA,SINDIA,"H2 NDIOUFENE",3,3,15,14,29
THIES,M’BOUR,SINDIA,SINDIA,"H3 KEUR IBRA NDOUMBE",11,14,94,70,164
THIES,M’BOUR,SINDIA,SINDIA,"H4 KEUR ABDOU GUEYE",10,10,43,48,91
THIES,M’BOUR,SINDIA,SINDIA,"H5 KEUR MOUSSA HANE",22,27,185,180,365
THIES,M’BOUR,SINDIA,SINDIA,"KINIABOUR 1",146,189,976,935,1911
THIES,M’BOUR,SINDIA,SINDIA,"KINIABOUR 2",188,257,1269,1226,2495
THIES,M’BOUR,SINDIA,SINDIA,NDIARMEO,27,34,240,211,451
THIES,M’BOUR,SINDIA,SINDIA,"H1 KEUR KHALY",9,11,61,62,123
THIES,M’BOUR,SINDIA,SINDIA,"NDIOROTH MBOTH",187,212,612,484,1096
THIES,M’BOUR,SINDIA,SINDIA,"H1 THIERERE (NDRIOROTH SERERE)",48,53,245,187,432
THIES,M’BOUR,SINDIA,SINDIA,"H2 KEUR GUITE",22,25,173,131,304
THIES,M’BOUR,SINDIA,SINDIA,"NGUERIGNE (NGUERIGNE BAMBARA)",323,477,1989,1756,3745
THIES,M’BOUR,SINDIA,SINDIA,"H1 FERME DE NGAPAROU",25,30,70,70,140
THIES,M’BOUR,SINDIA,SINDIA,"H3 NGUERIGNE SERERE",133,153,661,591,1252
THIES,M’BOUR,SINDIA,SINDIA,"H4 NGUERIGNE PEUL",52,59,202,163,365
THIES,M’BOUR,SINDIA,SINDIA,SINDIA,1039,1549,5611,4707,10318
THIES,M’BOUR,SINDIA,SINDIA,"H1 SINDIA SERERE (SINDIA LOROM)",73,85,429,375,804
THIES,M’BOUR,SINDIA,SINDIA,"H2 SINDIA KAFNGOUNE",75,86,434,323,757
THIES,M’BOUR,SINDIA,SINDIA,"H3 ISRA",1,1,1,1,2
THIES,M’BOUR,SINDIA,SINDIA,"H5 KHONKOMA",27,34,190,182,372
THIES,M’BOUR,SINDIA,SINDIA,"H7 SINTHIANE SERERE",17,20,137,100,237
THIES,M’BOUR,SINDIA,SINDIA,"SINTHIANE TOUCOULEUR",48,56,217,203,420
THIES,M’BOUR,SINDIA,SINDIA,"H1 KEUR DIP",24,31,104,99,203
THIES,M’BOUR,SINDIA,SINDIA,SOROKHASSAP,22,45,210,208,418
THIES,M’BOUR,SINDIA,SINDIA,"H1 KHASSAP",137,176,855,790,1645
THIES,M’BOUR,SINDIA,SINDIA,"TENE TOUBAB",59,71,341,318,659
THIES,M’BOUR,SINDIA,SINDIA,"H1 KEUR DIADIA NDIAYE",12,13,86,66,152
THIES,M’BOUR,SINDIA,SINDIA,"H2 NDIOP",24,25,188,164,352
THIES,M’BOUR,SINDIA,SINDIA,"H4 KEUR MBAYE DIEYE",9,11,64,56,120
THIES,M’BOUR,SINDIA,SINDIA,"H5 SIW",13,24,115,124,239
THIES,M’BOUR,SINDIA,SINDIA,"H7 TANGUIS PEULH",6,6,11,15,26
THIES,M’BOUR,SINDIA,SINDIA,"H8 BABEL 1",12,18,113,112,225
THIES,M’BOUR,SINDIA,SINDIA,"H9 KEUR DIEGANE (BABEL 2)",31,38,213,163,376
THIES,M’BOUR,SINDIA,SINDIA,"H10 CARITAS",5,9,53,44,97
THIES,M’BOUR,SINDIA,SINDIA,THIAFOURA,95,146,923,848,1771
THIES,M’BOUR,SINDIA,SINDIA,THIOMBOLODJI,144,179,922,948,1870
THIES,M’BOUR,SINDIA,SINDIA,"H1 TANGUIS DANGOR",48,68,458,389,847
THIES,M’BOUR,SINDIA,SINDIA,"H3 TANGUIS NGOGOM",91,117,860,772,1632
THIES,M’BOUR,SINDIA,SINDIA,"H6 KEUR SONGHO",16,22,125,120,245
THIES,M’BOUR,SINDIA,SINDIA,"DAROU SALAM DIASS",64,65,323,194,517
THIES,M’BOUR,SINDIA,SINDIA,"DJILAKH (KEUR ALASSANE)",7,7,57,50,107
THIES,M’BOUR,SINDIA,SINDIA,"H1 KEUR BOGUEL (SANGHAI 2)",22,29,197,208,405
THIES,M’BOUR,SINDIA,SINDIA,"H2 KEUR MALAMINE TIDIANE",18,21,90,92,182
THIES,M’BOUR,SINDIA,SINDIA,"H3 KEUR NDOUNE",18,24,140,122,262
THIES,M’BOUR,SINDIA,SINDIA,"H4 MBAFAYE 1",19,23,171,131,302
THIES,M’BOUR,SINDIA,SINDIA,"H5 SHANGHAI 1",15,16,99,62,161
THIES,M’BOUR,SINDIA,SINDIA,"DJILAKH (LAMANE)",9,11,74,50,124
THIES,M’BOUR,SINDIA,SINDIA,"H1 KEUR DEMBA DIAGNE",5,7,40,35,75
THIES,M’BOUR,SINDIA,SINDIA,"H2 NGAGAM 1",27,37,258,202,460
THIES,M’BOUR,SINDIA,SINDIA,"H3 NKAAK",15,21,148,124,272
THIES,M’BOUR,SINDIA,SINDIA,"H4 PASSOUM KEUR NDICK",15,26,158,158,316
THIES,M’BOUR,SINDIA,SINDIA,"H5 PASSOUM KHODE",11,14,135,120,255
THIES,M’BOUR,SINDIA,NGUEKHOKH,DIAMAGUENE,1639,2006,7921,7427,15348
THIES,M’BOUR,SINDIA,NGUEKHOKH,"KEUR SIDY",773,926,3943,3865,7808
THIES,M’BOUR,SINDIA,NGUEKHOKH,NDALOR,1378,1771,7441,6859,14300
THIES,M’BOUR,SINDIA,NGUEKHOKH,PIKINE,930,1114,5519,4989,10508
THIES,M’BOUR,SINDIA,NGAPAROU,DIAMAGUEUNE,299,352,930,859,1789
THIES,M’BOUR,SINDIA,NGAPAROU,ESCALE,220,445,1899,2032,3931
THIES,M’BOUR,SINDIA,NGAPAROU,MEDINE,249,341,999,1082,2081
THIES,M’BOUR,SINDIA,NGAPAROU,NGAMROUKH,451,609,1720,1441,3161
THIES,M’BOUR,SINDIA,NGAPAROU,NGANE,304,354,901,825,1726
THIES,M’BOUR,SINDIA,NGAPAROU,SANTHIABA,200,228,608,448,1056
THIES,M’BOUR,SINDIA,POPENGUINE,"HLM FIRNDAWSI",277,321,1648,1550,3198
THIES,M’BOUR,SINDIA,POPENGUINE,"HLM GRAND MEDINE",79,95,595,569,1164
THIES,M’BOUR,SINDIA,POPENGUINE,"HLM TILENE",137,180,884,775,1659
THIES,M’BOUR,SINDIA,POPENGUINE,"KEURY KAO",78,165,808,865,1673
THIES,M’BOUR,SINDIA,POPENGUINE,"LERO GAMBOULENE",71,98,395,418,813
THIES,M’BOUR,SINDIA,POPENGUINE,MEDINE,224,263,1018,953,1971
THIES,M’BOUR,SINDIA,POPENGUINE,THIAMBOTH,17,41,179,157,336
THIES,M’BOUR,SINDIA,POPENGUINE,THIOUPAM,93,119,358,325,683
THIES,M’BOUR,SINDIA,POPENGUINE,TONGOR,78,144,614,632,1246
THIES,M’BOUR,SINDIA,"SALY PORTUDAL","SALY BAMBARA",377,479,1392,1271,2663
THIES,M’BOUR,SINDIA,"SALY PORTUDAL","SALY CARREFOUR",844,1135,3031,3052,6083
THIES,M’BOUR,SINDIA,"SALY PORTUDAL","SALY CARREFOUR MALICOUNDA",116,120,485,350,835
THIES,M’BOUR,SINDIA,"SALY PORTUDAL","SALY COULANG",136,182,658,628,1286
THIES,M’BOUR,SINDIA,"SALY PORTUDAL","SALY DAROU",349,446,1425,1361,2786
THIES,M’BOUR,SINDIA,"SALY PORTUDAL","SALY DAROU EXTENSION",640,926,2658,2770,5428
THIES,M’BOUR,SINDIA,"SALY PORTUDAL","SALY DAROU SALAM",497,737,2053,1839,3892
THIES,M’BOUR,SINDIA,"SALY PORTUDAL","SALY DIACKSAO",429,572,1534,1554,3088
THIES,M’BOUR,SINDIA,"SALY PORTUDAL","SALY GOLF",138,202,566,532,1098
THIES,M’BOUR,SINDIA,"SALY PORTUDAL","SALY JOSEPH",447,640,2005,1728,3733
THIES,M’BOUR,SINDIA,"SALY PORTUDAL","SALY NIAKH EXTENSION",343,472,1037,892,1929
THIES,M’BOUR,SINDIA,"SALY PORTUDAL","SALY NIAKHNIAKHAL",261,324,830,747,1577
THIES,M’BOUR,SINDIA,"SALY PORTUDAL","SALY STATION",269,369,856,808,1664
THIES,M’BOUR,SINDIA,"SALY PORTUDAL","SALY TAPEE",194,333,1156,1135,2291
THIES,M’BOUR,SINDIA,"SALY PORTUDAL","SALY VELINGARA",312,436,1220,1289,2509
THIES,M’BOUR,SINDIA,"SALY PORTUDAL","ZONE HOTELIERE (SAPCO)",14,18,20,20,40
THIES,M’BOUR,SINDIA,"SALY PORTUDAL","KEUR YOUNGAR",106,114,520,389,909
THIES,M’BOUR,SINDIA,SOMONE,ESCALE,56,87,392,435,827
THIES,M’BOUR,SINDIA,SOMONE,"GUINAW RAIL",326,417,1397,1364,2761
THIES,M’BOUR,SINDIA,SOMONE,KANDA,341,422,877,776,1653
THIES,M’BOUR,SINDIA,SOMONE,MBOTT,83,113,433,466,899
THIES,M’BOUR,SINDIA,SOMONE,SEANE,104,110,250,207,457
THIES,M’BOUR,SINDIA,SOMONE,TEFESS,94,209,843,926,1769
THIES,M’BOUR,SINDIA,SOMONE,TORINO,139,143,233,163,396
THIES,THIES,KHOMBOLE,KHOMBOLE,"GUINAW RAIL",447,529,2448,2615,5063
THIES,THIES,KHOMBOLE,KHOMBOLE,HANENE,360,492,1847,2349,4196
THIES,THIES,KHOMBOLE,KHOMBOLE,"KEUR MACODOU",177,241,1017,936,1953
THIES,THIES,KHOMBOLE,KHOMBOLE,"NDIAYENE GOUYE",291,340,1509,1582,3091
THIES,THIES,KHOMBOLE,KHOMBOLE,NGANDIOLE,416,574,1857,1989,3846
THIES,THIES,KHOMBOLE,KHOMBOLE,NGHAYE,202,226,993,1179,2172
THIES,THIES,POUT,POUT,ALWAR,128,185,862,767,1629
THIES,THIES,POUT,POUT,GARAGE,113,169,691,658,1349
THIES,THIES,POUT,POUT,HLM,127,137,568,572,1140
THIES,THIES,POUT,POUT,"KEUR SEYDOU",237,315,1329,1365,2694
THIES,THIES,POUT,POUT,MBAMBARA,188,270,1343,1093,2436
THIES,THIES,POUT,POUT,MBAYENE,229,338,1410,1407,2817
THIES,THIES,POUT,POUT,SANTHIE,153,197,952,947,1899
THIES,THIES,POUT,POUT,THIEKENE,224,316,1214,1318,2532
THIES,THIES,POUT,POUT,THERIGNE,188,264,1136,1045,2181
THIES,THIES,POUT,POUT,"TOUBA POUT",376,495,1898,1787,3685
THIES,THIES,POUT,POUT,TOUCOULEUR,469,628,2760,2602,5362
THIES,THIES,POUT,POUT,"SANTE YALLA",284,322,1122,1028,2150
THIES,THIES,NOTTO,NOTTO,"BABACK OUOLOF",5,5,51,43,94
THIES,THIES,NOTTO,NOTTO,"BABACK SERERE",31,67,419,339,758
THIES,THIES,NOTTO,NOTTO,"H1 NDIODIONE",29,61,403,371,774
THIES,THIES,NOTTO,NOTTO,"H2 NGOKHOTHIE",22,41,229,189,418
THIES,THIES,NOTTO,NOTTO,"H3 DIAMAGUENE",27,50,323,259,582
THIES,THIES,NOTTO,NOTTO,BIRBIRANE,12,38,160,169,329
THIES,THIES,NOTTO,NOTTO,"H1 DAFKA",1,8,38,25,63
THIES,THIES,NOTTO,NOTTO,"H2 DANGHAM",2,6,30,22,52
THIES,THIES,NOTTO,NOTTO,"H3 KAMBOUSKA",2,10,51,45,96
THIES,THIES,NOTTO,NOTTO,"DIASS PALAM",10,28,203,186,389
THIES,THIES,NOTTO,NOTTO,"H3 KEUR MBATE",4,11,44,39,83
THIES,THIES,NOTTO,NOTTO,DIOUNGANE,95,143,690,687,1377
THIES,THIES,NOTTO,NOTTO,"H1 SINTHIANE",7,10,76,67,143
THIES,THIES,NOTTO,NOTTO,"H2 CISSIS",6,6,36,38,74
THIES,THIES,NOTTO,NOTTO,"GOTTE 1",22,25,144,106,250
THIES,THIES,NOTTO,NOTTO,"H1 KEUR SERIGNE SALIOU",1,3,95,8,103
THIES,THIES,NOTTO,NOTTO,"H2 DAROU DIA",2,2,13,16,29
THIES,THIES,NOTTO,NOTTO,"GOTTE 2",16,21,150,148,298
THIES,THIES,NOTTO,NOTTO,HANENE,237,256,1752,1696,3448
THIES,THIES,NOTTO,NOTTO,"KEUR AMAR DIAKHOU",21,26,142,140,282
THIES,THIES,NOTTO,NOTTO,"H1 WOUROOGOL",7,7,33,29,62
THIES,THIES,NOTTO,NOTTO,"KEUR AMAR MANE",18,30,188,175,363
THIES,THIES,NOTTO,NOTTO,"KEUR BANDA GUEYE (KEUR MAMOUR)",29,37,258,264,522
THIES,THIES,NOTTO,NOTTO,"KEUR BANDA SAMB (SAMBENE)",7,7,51,39,90
THIES,THIES,NOTTO,NOTTO,"KEUR BARA KAIRE",36,45,294,246,540
THIES,THIES,NOTTO,NOTTO,"H1 PEULGA",74,97,356,380,736
THIES,THIES,NOTTO,NOTTO,"KEUR BIRIMA KOURA",7,8,32,36,68
THIES,THIES,NOTTO,NOTTO,"H1 TOUBA DIOBASS",14,14,64,36,100
THIES,THIES,NOTTO,NOTTO,"KEUR DEMBA KEBE",20,22,133,132,265
THIES,THIES,NOTTO,NOTTO,"KEUR DIATTA",26,26,228,222,450
THIES,THIES,NOTTO,NOTTO,"KEUR DIEMBE NDIAYE",31,48,265,266,531
THIES,THIES,NOTTO,NOTTO,"KEUR IBRA FALL",62,84,742,692,1434
THIES,THIES,NOTTO,NOTTO,"KEUR IBRA MATY GUEYE (GUEYENE)",40,44,206,223,429
THIES,THIES,NOTTO,NOTTO,"KEUR MADARO NIANG",331,372,2025,1896,3921
THIES,THIES,NOTTO,NOTTO,"H1 KEUR MADARO PEULH",5,6,33,26,59
THIES,THIES,NOTTO,NOTTO,"H2 KEUR MADARO NIANG",2,2,38,11,49
THIES,THIES,NOTTO,NOTTO,"KEUR MADIAMA WADE",23,29,171,182,353
THIES,THIES,NOTTO,NOTTO,"KEUR MAGUEYE NDAO",73,82,404,351,755
THIES,THIES,NOTTO,NOTTO,"KEUR MALICK FATMA",4,7,29,21,50
THIES,THIES,NOTTO,NOTTO,"KEUR MAMOUR MBENGUE (MBENGUENE)",6,9,78,42,120
THIES,THIES,NOTTO,NOTTO,"KEUR MAMOUR NGOUNDJI",20,21,92,81,173
THIES,THIES,NOTTO,NOTTO,"KEUR MASSYLLA DIEYE",17,35,188,150,338
THIES,THIES,NOTTO,NOTTO,"H1 KEUR MAMOUR GALLO",4,8,46,50,96
THIES,THIES,NOTTO,NOTTO,"KEUR MATAR DARO DIA (NDIA)",17,17,117,115,232
THIES,THIES,NOTTO,NOTTO,"KEUR MATOURE GNING",53,65,436,385,821
THIES,THIES,NOTTO,NOTTO,"KEUR MORY FALL",33,38,197,210,407
THIES,THIES,NOTTO,NOTTO,"KEUR NDIOL DIENG",5,5,9,14,23
THIES,THIES,NOTTO,NOTTO,"KEUR SADARO FAME",30,33,209,221,430
THIES,THIES,NOTTO,NOTTO,"KEUR SANGONE HANNE",9,9,93,73,166
THIES,THIES,NOTTO,NOTTO,"H1 KEUR KANE",8,19,138,158,296
THIES,THIES,NOTTO,NOTTO,"H2 MBEYE",3,6,48,42,90
THIES,THIES,NOTTO,NOTTO,"KEUR WADE GUEYE",6,12,115,88,203
THIES,THIES,NOTTO,NOTTO,KISSANE,42,78,487,429,916
THIES,THIES,NOTTO,NOTTO,"H1 NGORRICK",7,42,169,154,323
THIES,THIES,NOTTO,NOTTO,"H2 SESSENE",11,28,129,143,272
THIES,THIES,NOTTO,NOTTO,"H4 THIAMBY",11,49,259,234,493
THIES,THIES,NOTTO,NOTTO,"H4 DIARAO",2,9,35,25,60
THIES,THIES,NOTTO,NOTTO,"MANDANGRI OUOLOF",41,49,210,224,434
THIES,THIES,NOTTO,NOTTO,"H1 MBOUFOUDJI",13,22,148,147,295
THIES,THIES,NOTTO,NOTTO,"MANDANGRI TOUCOULEUR",4,4,22,21,43
THIES,THIES,NOTTO,NOTTO,"H1 DIAMAGUENE PEULH",20,28,179,141,320
THIES,THIES,NOTTO,NOTTO,"MBAMBARA CHERIF",35,39,241,214,455
THIES,THIES,NOTTO,NOTTO,MBODIENE,67,78,409,358,767
THIES,THIES,NOTTO,NOTTO,MBOMBOYE,19,44,299,285,584
THIES,THIES,NOTTO,NOTTO,"H1 NGANE NGANE",13,18,77,81,158
THIES,THIES,NOTTO,NOTTO,"H2 MASSAL",16,21,210,207,417
THIES,THIES,NOTTO,NOTTO,"H3 TAHACK",8,19,103,90,193
THIES,THIES,NOTTO,NOTTO,"H4 KEDEMBOKH",16,20,98,78,176
THIES,THIES,NOTTO,NOTTO,"H5 NGAGATHIE",19,38,275,260,535
THIES,THIES,NOTTO,NOTTO,"H6 NDANDOUCK",8,10,45,38,83
THIES,THIES,NOTTO,NOTTO,"MBOUSNAKH NGOR",32,133,677,669,1346
THIES,THIES,NOTTO,NOTTO,"H2 DAROU SENE",14,27,166,199,365
THIES,THIES,NOTTO,NOTTO,NAFAR,12,20,115,130,245
THIES,THIES,NOTTO,NOTTO,"H3 KEUR DIDAR",9,16,119,121,240
THIES,THIES,NOTTO,NOTTO,"H4 NAFAR NDOURENE",1,3,40,38,78
THIES,THIES,NOTTO,NOTTO,"NDAKHAR MBAYE",59,67,306,338,644
THIES,THIES,NOTTO,NOTTO,"H2 NDAKHAR MBAYE PEUL",7,8,45,45,90
THIES,THIES,NOTTO,NOTTO,NDIOUFENE,10,13,101,87,188
THIES,THIES,NOTTO,NOTTO,"NDIOUKHANE PEULH",9,16,78,67,145
THIES,THIES,NOTTO,NOTTO,"H1 KEUR DEMBA BA",10,14,69,46,115
THIES,THIES,NOTTO,NOTTO,"H2 KEUR IBRA KA",3,4,23,23,46
THIES,THIES,NOTTO,NOTTO,"H3 KEUR AMADOU NITAL",7,11,41,34,75
THIES,THIES,NOTTO,NOTTO,"H4 KEUR BOUBACAR NDIAYE",7,9,47,41,88
THIES,THIES,NOTTO,NOTTO,"NDIOUKHANE SERERE",29,60,410,396,806
THIES,THIES,NOTTO,NOTTO,"H1 SINDIANE",2,9,89,58,147
THIES,THIES,NOTTO,NOTTO,NDIRENE,69,88,553,640,1193
THIES,THIES,NOTTO,NOTTO,"NGOLAR SERERE",61,161,906,871,1777
THIES,THIES,NOTTO,NOTTO,"H1 DIAKHA",1,2,18,25,43
THIES,THIES,NOTTO,NOTTO,"H2 SINE SINE",3,7,40,40,80
THIES,THIES,NOTTO,NOTTO,"NGOLAR TOUCOULEUR",4,5,45,48,93
THIES,THIES,NOTTO,NOTTO,"H1 DIGUENTE",3,9,91,81,172
THIES,THIES,NOTTO,NOTTO,NGOLFAGNICK,9,36,150,162,312
THIES,THIES,NOTTO,NOTTO,"H1 MBELA",7,16,71,61,132
THIES,THIES,NOTTO,NOTTO,NGOMBEL,26,32,275,232,507
THIES,THIES,NOTTO,NOTTO,"H1 KEUR MODOU KANE",5,6,66,15,81
THIES,THIES,NOTTO,NOTTO,NOTTO,70,75,377,375,752
THIES,THIES,NOTTO,NOTTO,PAKALA,1,2,8,27,35
THIES,THIES,NOTTO,NOTTO,"PALAM THIOYANE",15,33,210,199,409
THIES,THIES,NOTTO,NOTTO,"H2 THIATHIAW",1,2,7,9,16
THIES,THIES,NOTTO,NOTTO,"H3 NDENDERE",1,4,12,8,20
THIES,THIES,NOTTO,NOTTO,"PELEO SERERE",5,28,57,57,114
THIES,THIES,NOTTO,NOTTO,"H1 NDINDERE",8,19,46,33,79
THIES,THIES,NOTTO,NOTTO,"H2 YOUYOUM",3,3,8,5,13
THIES,THIES,NOTTO,NOTTO,"PELEO TOUCOULEUR",10,13,38,38,76
THIES,THIES,NOTTO,NOTTO,"H1 KEUR OUSMANE",2,8,24,24,48
THIES,THIES,NOTTO,NOTTO,"POUT DIACK",69,147,807,816,1623
THIES,THIES,NOTTO,NOTTO,"H1 POUT NDACKNE",20,45,289,229,518
THIES,THIES,NOTTO,NOTTO,"SANGHANE OUOLOF",3,3,18,10,28
THIES,THIES,NOTTO,NOTTO,"H1 KOURE",4,6,44,38,82
THIES,THIES,NOTTO,NOTTO,"H2 DIOUDOM SERERE",3,3,17,21,38
THIES,THIES,NOTTO,NOTTO,"H3 DIOUDOM TOUCOULEUR",1,2,11,5,16
THIES,THIES,NOTTO,NOTTO,"H6 KEUR DINGANE",6,9,92,67,159
THIES,THIES,NOTTO,NOTTO,"H7 KEUR NDIAME",1,1,5,6,11
THIES,THIES,NOTTO,NOTTO,"SANGHANE SERERE",16,17,110,106,216
THIES,THIES,NOTTO,NOTTO,"H1 BALTA",1,6,43,45,88
THIES,THIES,NOTTO,NOTTO,"H2 KEUR MODOU NGOM",6,9,32,36,68
THIES,THIES,NOTTO,NOTTO,"H3 THIAKRY",11,23,119,135,254
THIES,THIES,NOTTO,NOTTO,SANGUE,47,143,564,554,1118
THIES,THIES,NOTTO,NOTTO,"H1 SITHIA",9,29,147,76,223
THIES,THIES,NOTTO,NOTTO,"H2 KEUR MBANGAR",2,4,36,29,65
THIES,THIES,NOTTO,NOTTO,"H3 KEUR YAKHAM",14,34,183,187,370
THIES,THIES,NOTTO,NOTTO,"H4 NDOUNOUTE",18,22,128,116,244
THIES,THIES,NOTTO,NOTTO,"H5 DOUKA",41,61,290,281,571
THIES,THIES,NOTTO,NOTTO,"H6 KAHAN HINE",42,81,375,370,745
THIES,THIES,NOTTO,NOTTO,"H7 TANGUIS",27,34,186,185,371
THIES,THIES,NOTTO,NOTTO,"H8 PEULGA",6,10,42,40,82
THIES,THIES,NOTTO,NOTTO,SESSENE,41,67,390,348,738
THIES,THIES,NOTTO,NOTTO,"H1 NGOMENE",10,18,171,145,316
THIES,THIES,NOTTO,NOTTO,"TATENE BAMBARA",63,79,484,480,964
THIES,THIES,NOTTO,NOTTO,"H1 SENEFO COUNDA",16,20,95,103,198
THIES,THIES,NOTTO,NOTTO,"TATENE SERERE",31,110,639,608,1247
THIES,THIES,NOTTO,NOTTO,"H1 NDIAMBOUR",17,39,238,215,453
THIES,THIES,NOTTO,NOTTO,"H4 NGARIGNE NDOUPANE",7,14,102,100,202
THIES,THIES,NOTTO,NOTTO,"TATENE TOUCOULEUR",5,5,43,36,79
THIES,THIES,NOTTO,NOTTO,"H1 GOUREL NIARY",16,25,148,154,302
THIES,THIES,NOTTO,NOTTO,"TEUB DALL",12,16,135,123,258
THIES,THIES,NOTTO,NOTTO,THIEO,5,24,113,130,243
THIES,THIES,NOTTO,NOTTO,"H1 NGOGOP",9,16,89,75,164
THIES,THIES,NOTTO,NOTTO,"H2 BOKH",6,6,38,42,80
THIES,THIES,NOTTO,NOTTO,"H3 NDOUNGOUMOU",15,24,125,114,239
THIES,THIES,NOTTO,NOTTO,"H4 SANTHIE",4,23,82,78,160
THIES,THIES,NOTTO,NOTTO,"H5 NGOMBOLE",10,14,73,79,152
THIES,THIES,NOTTO,NOTTO,THIOKHOL,22,30,273,217,490
THIES,THIES,NOTTO,NOTTO,"H1 KEUR WADE",21,21,141,140,281
THIES,THIES,NOTTO,NOTTO,"H2 VERGER TOUBA TAWFEKH",5,5,12,12,24
THIES,THIES,NOTTO,NOTTO,"CITE MOR GUEYE",4,4,7,10,17
THIES,THIES,NOTTO,NOTTO,"KEUR ATOU NGOM",9,13,77,69,146
THIES,THIES,NOTTO,NOTTO,"H1 KEUR ASSANE GNINGUE",1,7,44,44,88
THIES,THIES,NOTTO,NOTTO,TATENE,22,79,690,638,1328
THIES,THIES,NOTTO,TASSETE,BAHE,10,12,73,92,165
THIES,THIES,NOTTO,TASSETE,DIELING,2,3,12,10,22
THIES,THIES,NOTTO,TASSETE,"H1 KEUR BALLA",1,1,8,6,14
THIES,THIES,NOTTO,TASSETE,"H2 KEUR ASSANE WELE",3,9,54,44,98
THIES,THIES,NOTTO,TASSETE,"H3 DIELING SERERE",6,13,79,58,137
THIES,THIES,NOTTO,TASSETE,DOUNGUEL,3,3,41,43,84
THIES,THIES,NOTTO,TASSETE,"H1 KEUR LEMBE",1,1,5,8,13
THIES,THIES,NOTTO,TASSETE,"H2 KEUR LAYE",6,12,116,61,177
THIES,THIES,NOTTO,TASSETE,"H3 NDIOLOFENE",3,6,29,25,54
THIES,THIES,NOTTO,TASSETE,GUELOR,3,8,56,31,87
THIES,THIES,NOTTO,TASSETE,"H1 THIANGAYE",8,29,148,122,270
THIES,THIES,NOTTO,TASSETE,"H2 BOULAL",2,11,57,49,106
THIES,THIES,NOTTO,TASSETE,"KEUR  MANGARI KA",7,8,43,47,90
THIES,THIES,NOTTO,TASSETE,"H1 NGANDIOLE",4,9,88,73,161
THIES,THIES,NOTTO,TASSETE,"H2 KEUR ABDOU DIONE",2,5,22,30,52
THIES,THIES,NOTTO,TASSETE,"KEUR ABDOULAYE DIAW (KEUR LAYE)",30,48,227,238,465
THIES,THIES,NOTTO,TASSETE,"KEUR AMADOU MATAR WADE",10,16,83,85,168
THIES,THIES,NOTTO,TASSETE,"KEUR CHEIKH MADIOP",11,22,100,103,203
THIES,THIES,NOTTO,TASSETE,"KEUR CHEIKH MADOUMBE",6,6,41,42,83
THIES,THIES,NOTTO,TASSETE,"KEUR DAO MBOR",8,13,98,107,205
THIES,THIES,NOTTO,TASSETE,"KEUR DEMBA ANTA",19,22,135,138,273
THIES,THIES,NOTTO,TASSETE,"H1 KEUR SAMBA BA",1,1,22,13,35
THIES,THIES,NOTTO,TASSETE,"KEUR IBRA DIENG",5,5,47,34,81
THIES,THIES,NOTTO,TASSETE,"H1 KEUR SEYDOU BA",2,2,17,10,27
THIES,THIES,NOTTO,TASSETE,"H2 KEUR MANGOU",1,6,42,28,70
THIES,THIES,NOTTO,TASSETE,"H3 KEUR MAMADOU SOW",1,1,10,11,21
THIES,THIES,NOTTO,TASSETE,"H4 KEUR NDIANA",2,2,4,9,13
THIES,THIES,NOTTO,TASSETE,"H5 KEUR CHEIKH DIOUF",1,6,37,33,70
THIES,THIES,NOTTO,TASSETE,"KEUR ISSA DIENE (NDIENE)",10,11,61,75,136
THIES,THIES,NOTTO,TASSETE,"KEUR MACOUMBA DIOP",16,19,176,158,334
THIES,THIES,NOTTO,TASSETE,"H1 PEULGA",29,45,338,275,613
THIES,THIES,NOTTO,TASSETE,"KEUR MACOUMBA KEBE (CASAMANCE)",8,22,142,152,294
THIES,THIES,NOTTO,TASSETE,"KEUR MAGOROM SALL",2,4,33,21,54
THIES,THIES,NOTTO,TASSETE,"KEUR MAKEBE KEBE",4,5,33,36,69
THIES,THIES,NOTTO,TASSETE,"H1 DARADIA",2,2,138,24,162
THIES,THIES,NOTTO,TASSETE,"KEUR MALAMINE NDIAYE",44,57,355,348,703
THIES,THIES,NOTTO,TASSETE,"KEUR MALICK GUEYE",2,2,9,14,23
THIES,THIES,NOTTO,TASSETE,"KEUR MASSAMBA NGOUNDJ",4,4,22,15,37
THIES,THIES,NOTTO,TASSETE,"KEUR MBAYE SEYNI",16,31,184,208,392
THIES,THIES,NOTTO,TASSETE,"KEUR NDIOGOU NDIAYE",48,67,342,306,648
THIES,THIES,NOTTO,TASSETE,"H1 KEUR NDAWLENE DIONE",1,1,14,18,32
THIES,THIES,NOTTO,TASSETE,"H2 YOUNGAR TINE MANAR",2,9,54,61,115
THIES,THIES,NOTTO,TASSETE,"KEUR NGOUNDA SAMB",7,19,79,83,162
THIES,THIES,NOTTO,TASSETE,"KEUR SOULEYE",4,7,41,47,88
THIES,THIES,NOTTO,TASSETE,"KEUR YORO DIA",7,8,40,31,71
THIES,THIES,NOTTO,TASSETE,"MBOUSNACK NGATHIE",47,155,804,711,1515
THIES,THIES,NOTTO,TASSETE,"MBOUSNACK NGOTTE",38,77,365,366,731
THIES,THIES,NOTTO,TASSETE,"H1 DIAMAGUENE SERERE",3,9,62,71,133
THIES,THIES,NOTTO,TASSETE,"MBOUSNAKH NGOURBANE",69,125,659,603,1262
THIES,THIES,NOTTO,TASSETE,NDJITTE,7,16,112,114,226
THIES,THIES,NOTTO,TASSETE,NDOYENE,27,38,212,180,392
THIES,THIES,NOTTO,TASSETE,"H1 KEUR BIRANE",18,64,349,337,686
THIES,THIES,NOTTO,TASSETE,"H2 NDIAYENE",11,11,50,41,91
THIES,THIES,NOTTO,TASSETE,"H3 KEUR ABLAYE NGONE",1,1,17,16,33
THIES,THIES,NOTTO,TASSETE,"NGAYE NGAYE",8,10,55,58,113
THIES,THIES,NOTTO,TASSETE,"H1 NGAYE NGAYE",3,4,16,13,29
THIES,THIES,NOTTO,TASSETE,"NGUINTHE OUOLOF",6,10,65,54,119
THIES,THIES,NOTTO,TASSETE,"H1 NGUINTHE KEUR YOUGA",1,1,2,7,9
THIES,THIES,NOTTO,TASSETE,"NGUINTHE SERERE",10,20,105,93,198
THIES,THIES,NOTTO,TASSETE,"H1 KEUR NDIARRA SENE",2,2,43,30,73
THIES,THIES,NOTTO,TASSETE,"H2 KEUR YORO BA",1,3,7,8,15
THIES,THIES,NOTTO,TASSETE,"H3 KHAYGUI",1,10,43,34,77
THIES,THIES,NOTTO,TASSETE,"NGUINTHE TOUCOULEUR",6,10,75,54,129
THIES,THIES,NOTTO,TASSETE,"PALAM ROCK",9,30,176,163,339
THIES,THIES,NOTTO,TASSETE,"H1 MBAFAR",6,13,63,71,134
THIES,THIES,NOTTO,TASSETE,"PAMENE 1",24,25,117,114,231
THIES,THIES,NOTTO,TASSETE,"H1 SERERE de PAMENE 1",18,47,262,284,546
THIES,THIES,NOTTO,TASSETE,"PAMENE 2",20,26,145,110,255
THIES,THIES,NOTTO,TASSETE,"H1 SERERE de PAMENE 2",2,6,27,27,54
THIES,THIES,NOTTO,TASSETE,"PARIS DIEYE",18,22,200,165,365
THIES,THIES,NOTTO,TASSETE,"H1 PARIS GOUYE",10,13,107,124,231
THIES,THIES,NOTTO,TASSETE,"H2 PARIS PEULH",2,2,20,11,31
THIES,THIES,NOTTO,TASSETE,"POUT NDOF",14,44,232,242,474
THIES,THIES,NOTTO,TASSETE,"H1 NGOGOL",15,29,208,228,436
THIES,THIES,NOTTO,TASSETE,"SESSENE DIACK",17,49,222,175,397
THIES,THIES,NOTTO,TASSETE,"H1 NGALENE",10,34,256,227,483
THIES,THIES,NOTTO,TASSETE,"H2 KOUNOUNE",5,23,184,161,345
THIES,THIES,NOTTO,TASSETE,SIPANE,23,78,327,307,634
THIES,THIES,NOTTO,TASSETE,"H1 SIPANE NGUEME",9,25,99,115,214
THIES,THIES,NOTTO,TASSETE,"H2 SESSECK",5,32,110,111,221
THIES,THIES,NOTTO,TASSETE,"H3 SIPANE PEULH",12,18,72,76,148
THIES,THIES,NOTTO,TASSETE,"TASSETTE OUOLOF",188,230,1158,1088,2246
THIES,THIES,NOTTO,TASSETE,"H1 KEUR NDIARGA KA",9,9,42,28,70
THIES,THIES,NOTTO,TASSETE,"H2 PALAM PEULH",5,10,43,37,80
THIES,THIES,NOTTO,TASSETE,"TASSETTE PEULH",17,17,129,84,213
THIES,THIES,NOTTO,TASSETE,"H1 KEUR BOUNAMA KA",5,6,228,13,241
THIES,THIES,NOTTO,TASSETE,"TASSETTE SERERE",37,96,629,631,1260
THIES,THIES,NOTTO,TASSETE,"H1 BAHE PEULH",3,4,27,24,51
THIES,THIES,NOTTO,TASSETE,"H2 KEUR ADAMA DIONE",1,3,20,16,36
THIES,THIES,NOTTO,TASSETE,"TASSETTE TOUCOULEUR",15,21,94,78,172
THIES,THIES,NOTTO,TASSETE,THIALLE,10,18,140,119,259
THIES,THIES,NOTTO,TASSETE,"H1 THIECKENE",4,6,57,74,131
THIES,THIES,NOTTO,TASSETE,"THIENABA DIOP (THIENABA KHABANE)",13,22,115,131,246
THIES,THIES,NOTTO,TASSETE,"H1 KEUR MBAGNIK",14,40,285,241,526
THIES,THIES,NOTTO,TASSETE,"H2 KHAYGA",3,5,32,21,53
THIES,THIES,NOTTO,TASSETE,"H3 KEUR ANDALA",4,9,56,42,98
THIES,THIES,NOTTO,TASSETE,"H4 NDIA",21,36,234,170,404
THIES,THIES,NOTTO,TASSETE,"H5 KEUR OUSMANE NGOM",4,19,124,104,228
THIES,THIES,NOTTO,TASSETE,"H6 GUEDJ DJIBANE",5,19,139,118,257
THIES,THIES,NOTTO,TASSETE,"H7 KEUR MOR NIOM",1,5,76,61,137
THIES,THIES,NOTTO,TASSETE,"H8 KEUR GAYKI",3,24,184,176,360
THIES,THIES,NOTTO,TASSETE,"H9 THIENEBA SERERE",1,12,87,55,142
THIES,THIES,NOTTO,TASSETE,THIEYENE,15,17,133,133,266
THIES,THIES,NOTTO,TASSETE,"H1 KEUR MALIKHASS",1,6,67,64,131
THIES,THIES,NOTTO,TASSETE,"TOUBA DIENG",19,19,207,164,371
THIES,THIES,NOTTO,TASSETE,BAKHDAS,3,4,34,38,72
THIES,THIES,NOTTO,TASSETE,"DAROU DIAW",5,7,97,91,188
THIES,THIES,NOTTO,TASSETE,"DOUNGUEL TOUCOULEUR",7,7,62,48,110
THIES,THIES,THIENABA,"NDIEYENE SIRAKH","DIOKOUL BANEKH",18,29,220,154,374
THIES,THIES,THIENABA,"NDIEYENE SIRAKH","H1 NGAYOHENE",14,19,73,141,214
THIES,THIES,THIENABA,"NDIEYENE SIRAKH","H2 DAROU NDIAYE",1,1,4,7,11
THIES,THIES,THIENABA,"NDIEYENE SIRAKH","DIOKOUL MBOULOUKH",26,27,192,176,368
THIES,THIES,THIENABA,"NDIEYENE SIRAKH","DIOKOUL NDIALIGUE",83,105,554,557,1111
THIES,THIES,THIENABA,"NDIEYENE SIRAKH","DIOKOUL NDIONGUENE",29,34,171,152,323
THIES,THIES,THIENABA,"NDIEYENE SIRAKH","DIOKOUL NDIOUFENE",33,45,349,353,702
THIES,THIES,THIENABA,"NDIEYENE SIRAKH","DIOKOUL POUFOUGNE",26,29,238,193,431
THIES,THIES,THIENABA,"NDIEYENE SIRAKH","GOUYE KOULI",39,48,416,448,864
THIES,THIES,THIENABA,"NDIEYENE SIRAKH","KABA DIACK (NDIOTHE)",78,91,663,606,1269
THIES,THIES,THIENABA,"NDIEYENE SIRAKH","H1 MBAYENE",117,128,844,788,1632
THIES,THIES,THIENABA,"NDIEYENE SIRAKH","KABA FANDENE",179,204,1343,1378,2721
THIES,THIES,THIENABA,"NDIEYENE SIRAKH","KEUR MANDIAYE MBAR",31,45,234,228,462
THIES,THIES,THIENABA,"NDIEYENE SIRAKH",MBARDIACK,45,66,398,516,914
THIES,THIES,THIENABA,"NDIEYENE SIRAKH","MBEWANE MBAFAYE",64,76,411,445,856
THIES,THIES,THIENABA,"NDIEYENE SIRAKH","MBEWANE NDORONG",85,121,672,687,1359
THIES,THIES,THIENABA,"NDIEYENE SIRAKH","H1 BOURDING",20,29,212,216,428
THIES,THIES,THIENABA,"NDIEYENE SIRAKH","MBEWANE THIATHIAO",115,151,885,947,1832
THIES,THIES,THIENABA,"NDIEYENE SIRAKH","HI MBADIANE",8,12,45,46,91
THIES,THIES,THIENABA,"NDIEYENE SIRAKH","H2 PEULGA",6,8,54,46,100
THIES,THIES,THIENABA,"NDIEYENE SIRAKH",MBOULOUKHTENE,90,105,613,631,1244
THIES,THIES,THIENABA,"NDIEYENE SIRAKH","H1 KANDJI",5,6,111,46,157
THIES,THIES,THIENABA,"NDIEYENE SIRAKH","H2 NDIOBENE",7,9,61,67,128
THIES,THIES,THIENABA,"NDIEYENE SIRAKH",NDIARGA,24,40,234,201,435
THIES,THIES,THIENABA,"NDIEYENE SIRAKH","H1 NDOF",10,12,97,108,205
THIES,THIES,THIENABA,"NDIEYENE SIRAKH","NDIE NGOM",49,62,250,284,534
THIES,THIES,THIENABA,"NDIEYENE SIRAKH","NDIEYENE BACKO",15,17,104,150,254
THIES,THIES,THIENABA,"NDIEYENE SIRAKH","NDIEYENE SIRAKH",220,315,1991,2238,4229
THIES,THIES,THIENABA,"NDIEYENE SIRAKH","H1 KEUR MAISSA",15,18,79,133,212
THIES,THIES,THIENABA,"NDIEYENE SIRAKH","NDIMB MATHIMBANE",18,25,189,175,364
THIES,THIES,THIENABA,"NDIEYENE SIRAKH","H1 DIAMAYE TATE",10,13,78,80,158
THIES,THIES,THIENABA,"NDIEYENE SIRAKH","NDIMBE DIOL",21,24,138,141,279
THIES,THIES,THIENABA,"NDIEYENE SIRAKH","H1 THIARENE",15,21,61,56,117
THIES,THIES,THIENABA,"NDIEYENE SIRAKH","NDINGLER BALL",159,213,1522,1569,3091
THIES,THIES,THIENABA,"NDIEYENE SIRAKH","NDINGLER NGOGOM",68,101,745,743,1488
THIES,THIES,THIENABA,"NDIEYENE SIRAKH","DIOL NDIAYE",36,49,319,320,639
THIES,THIES,THIENABA,"NDIEYENE SIRAKH","H2 DIOL DAKHAR",19,22,146,137,283
THIES,THIES,THIENABA,"NDIEYENE SIRAKH",NDOUF,179,217,1323,1502,2825
THIES,THIES,THIENABA,"NDIEYENE SIRAKH",NGODIANE,27,33,260,155,415
THIES,THIES,THIENABA,"NDIEYENE SIRAKH","NGUIDIANE KHALY",21,23,209,179,388
THIES,THIES,THIENABA,"NDIEYENE SIRAKH","H1 MARNANE",30,31,273,162,435
THIES,THIES,THIENABA,"NDIEYENE SIRAKH","NGUIDIANE PARBA",20,21,148,126,274
THIES,THIES,THIENABA,"NDIEYENE SIRAKH",NIAMA,16,19,97,112,209
THIES,THIES,THIENABA,"NDIEYENE SIRAKH",PARARE,14,20,137,124,261
THIES,THIES,THIENABA,"NDIEYENE SIRAKH","H1 MBOBOP",19,23,175,129,304
THIES,THIES,THIENABA,"NDIEYENE SIRAKH","H2 MBAFAYE",25,33,228,228,456
THIES,THIES,THIENABA,"NDIEYENE SIRAKH",SANGHAYE,34,43,328,375,703
THIES,THIES,THIENABA,"NDIEYENE SIRAKH",THIANDIGUE,34,37,235,194,429
THIES,THIES,THIENABA,"NDIEYENE SIRAKH","TOUBE DIACK",4,4,18,16,34
THIES,THIES,THIENABA,"NDIEYENE SIRAKH",KAIRE,5,5,37,30,67
THIES,THIES,THIENABA,"NDIEYENE SIRAKH","KEUR FARANG FALL",9,14,117,117,234
THIES,THIES,THIENABA,"NDIEYENE SIRAKH","KEUR SAMBA FALL",4,4,19,9,28
THIES,THIES,THIENABA,"NDIEYENE SIRAKH","KEUR THIEKOM",7,8,42,57,99
THIES,THIES,THIENABA,"NDIEYENE SIRAKH",KHOMBOLE,16,17,93,73,166
THIES,THIES,THIENABA,"NDIEYENE SIRAKH","MBARI DIAM",7,9,45,44,89
THIES,THIES,THIENABA,NGOUDIANE,"DIACK MBODOKHANE 1",83,151,1159,1128,2287
THIES,THIES,THIENABA,NGOUDIANE,"DIACK MBODOKHANE II (MBODOKHANE2)",85,154,1271,1160,2431
THIES,THIES,THIENABA,NGOUDIANE,"DIACK NIONIOL",41,60,380,373,753
THIES,THIES,THIENABA,NGOUDIANE,"H1 MARNANE",1,5,37,39,76
THIES,THIES,THIENABA,NGOUDIANE,"KAM DIACK",75,117,823,770,1593
THIES,THIES,THIENABA,NGOUDIANE,"H1 DAROU DIACK",2,13,132,128,260
THIES,THIES,THIENABA,NGOUDIANE,"H2 KEUR DIBOR",20,32,241,229,470
THIES,THIES,THIENABA,NGOUDIANE,"KEUR IBRA KANE",20,21,167,195,362
THIES,THIES,THIENABA,NGOUDIANE,"H1 SANTHIE",3,4,28,25,53
THIES,THIES,THIENABA,NGOUDIANE,"H2 KEUR TOUBA KANE",5,5,27,26,53
THIES,THIES,THIENABA,NGOUDIANE,"MBAYENE DIACK",26,44,418,437,855
THIES,THIES,THIENABA,NGOUDIANE,"H1 NGARIGNE",2,8,59,64,123
THIES,THIES,THIENABA,NGOUDIANE,"H2 MBALOKH",21,40,430,404,834
THIES,THIES,THIENABA,NGOUDIANE,"H3 MBAYENE FAYE",12,15,148,130,278
THIES,THIES,THIENABA,NGOUDIANE,"H4 MBAYENE NGOM",5,15,97,106,203
THIES,THIES,THIENABA,NGOUDIANE,MBOURVAILLE,183,259,2054,2086,4140
THIES,THIES,THIENABA,NGOUDIANE,"H1 KHOURWA DE MBOURWAILLE",8,30,196,169,365
THIES,THIES,THIENABA,NGOUDIANE,"H2 MBAFAYE",13,21,111,131,242
THIES,THIES,THIENABA,NGOUDIANE,"H3 NDIANE",4,6,46,54,100
THIES,THIES,THIENABA,NGOUDIANE,"H4 BANGA",28,39,214,232,446
THIES,THIES,THIENABA,NGOUDIANE,"NGOUDIANE DIOR",107,184,1229,1288,2517
THIES,THIES,THIENABA,NGOUDIANE,"H1 KEUR NDIOUR",5,6,44,40,84
THIES,THIES,THIENABA,NGOUDIANE,"H2 KEUR LATYR FAYE",1,4,32,28,60
THIES,THIES,THIENABA,NGOUDIANE,"NGOUNDIANE NIAKH",7,24,188,176,364
THIES,THIES,THIENABA,NGOUDIANE,"NGOUNDIANE PEYE",151,233,1543,1377,2920
THIES,THIES,THIENABA,NGOUDIANE,"H1 KHOURWA DE NGOUDIANE PEYE",10,12,137,117,254
THIES,THIES,THIENABA,NGOUDIANE,"NGOUNDIANE SAMEL ( KEUR SAMBA NIAKH)",75,110,968,944,1912
THIES,THIES,THIENABA,NGOUDIANE,"H1 MANDRY",1,4,33,25,58
THIES,THIES,THIENABA,NGOUDIANE,"NGOUDIANE THIANGHAYE",151,279,1921,1963,3884
THIES,THIES,THIENABA,NGOUDIANE,"H1 KEUR SONGO",21,40,389,342,731
THIES,THIES,THIENABA,NGOUDIANE,"H2 MBAFAYE ALIOU FAYE",7,13,82,82,164
THIES,THIES,THIENABA,NGOUDIANE,SEOKHAYE,302,392,1958,1788,3746
THIES,THIES,THIENABA,NGOUDIANE,"H1 SERIGNE M’BACKE MADINA",30,35,172,139,311
THIES,THIES,THIENABA,NGOUDIANE,SINE,13,16,139,120,259
THIES,THIES,THIENABA,NGOUDIANE,CARRIERE,1,1,13,13,26
THIES,THIES,THIENABA,NGOUDIANE,THIALLE,4,11,70,66,136
THIES,THIES,THIENABA,THIENABA,BANGADJI,49,69,418,434,852
THIES,THIES,THIENABA,THIENABA,"H1 KEUR MALICK DIENG",11,12,59,78,137
THIES,THIES,THIENABA,THIENABA,"H2 NDAME LO",6,11,43,53,96
THIES,THIES,THIENABA,THIENABA,"H3 MBAYENE",16,18,138,125,263
THIES,THIES,THIENABA,THIENABA,"H4 DAROU SAMB",17,21,76,83,159
THIES,THIES,THIENABA,THIENABA,"H5 KEUR MBOUDOU",4,4,25,18,43
THIES,THIES,THIENABA,THIENABA,DALDIAM,23,31,226,182,408
THIES,THIES,THIENABA,THIENABA,"H1 MBALENE",43,65,347,353,700
THIES,THIES,THIENABA,THIENABA,"H2 KEUR MOR SOUWARE",2,2,13,9,22
THIES,THIES,THIENABA,THIENABA,DEMODIO,2,4,13,14,27
THIES,THIES,THIENABA,THIENABA,"H1 KEUR ABDOU DIEYE",13,13,114,119,233
THIES,THIES,THIENABA,THIENABA,DIAYANE,96,138,1008,1063,2071
THIES,THIES,THIENABA,THIENABA,"H1 KEUR BALLA",5,5,42,36,78
THIES,THIES,THIENABA,THIENABA,"KAIRE HALL",66,73,400,427,827
THIES,THIES,THIENABA,THIENABA,"KEUR AMADOU NDARY",14,19,174,175,349
THIES,THIES,THIENABA,THIENABA,"KEUR ASSANE LO",17,28,127,103,230
THIES,THIES,THIENABA,THIENABA,"H1 KEUR BIRANE",1,1,10,4,14
THIES,THIES,THIENABA,THIENABA,"KEUR BANDA NIANG",11,11,65,53,118
THIES,THIES,THIENABA,THIENABA,"H1 KEUR ALIOU DIONE",2,10,72,63,135
THIES,THIES,THIENABA,THIENABA,"H2 KEUR BARRA SARR",11,16,98,88,186
THIES,THIES,THIENABA,THIENABA,"H3 KEUR ALIOU THIAW",7,11,67,73,140
THIES,THIES,THIENABA,THIENABA,"H4 KEUR YABA DIOP",1,1,27,14,41
THIES,THIES,THIENABA,THIENABA,"KEUR DEMBA ANTA",15,31,128,126,254
THIES,THIES,THIENABA,THIENABA,"KEUR IBRA FALL",3,4,20,16,36
THIES,THIES,THIENABA,THIENABA,"H1 NDIOBENE",7,7,56,40,96
THIES,THIES,THIENABA,THIENABA,"H2 KEUR YATMA",18,21,191,169,360
THIES,THIES,THIENABA,THIENABA,"H3 DAROU MBENGUE",15,18,225,88,313
THIES,THIES,THIENABA,THIENABA,"KEUR KHAR DIEYE",4,5,25,12,37
THIES,THIES,THIENABA,THIENABA,"KEUR KHOLE",1,14,95,86,181
THIES,THIES,THIENABA,THIENABA,"H1 KEUR KHOLE (DIOUFFENE)",1,1,9,4,13
THIES,THIES,THIENABA,THIENABA,"KEUR MALAMINE NDIAYE",38,43,374,321,695
THIES,THIES,THIENABA,THIENABA,"KEUR MATABARA (NGUEMBE)",14,28,165,186,351
THIES,THIES,THIENABA,THIENABA,"KEUR MATAR FALL",23,32,204,193,397
THIES,THIES,THIENABA,THIENABA,"H1 MBABA PEULH",17,19,121,102,223
THIES,THIES,THIENABA,THIENABA,"MBABA FALL",21,30,247,206,453
THIES,THIES,THIENABA,THIENABA,"KEUR MEISSA NDIACKE (TOUBA GUEYE)",108,129,749,696,1445
THIES,THIES,THIENABA,THIENABA,"H1 KEUR IBRA NIANE",22,23,124,132,256
THIES,THIES,THIENABA,THIENABA,"H2 DAROU MBODJI",19,19,141,130,271
THIES,THIES,THIENABA,THIENABA,"H3 KEUR NDIACK KA",2,4,27,31,58
THIES,THIES,THIENABA,THIENABA,"H4 KEUR MEISSA DIACK",17,17,190,176,366
THIES,THIES,THIENABA,THIENABA,"KEUR MORY DIONE",21,32,149,132,281
THIES,THIES,THIENABA,THIENABA,"KEUR YABA DIOP",35,41,311,268,579
THIES,THIES,THIENABA,THIENABA,"H1 KEUR SERIGNE BALLA",5,8,64,44,108
THIES,THIES,THIENABA,THIENABA,"KEUR YORO SADIO",29,40,232,219,451
THIES,THIES,THIENABA,THIENABA,"KHAYE BABACK",55,67,407,289,696
THIES,THIES,THIENABA,THIENABA,KIELLE,50,67,441,396,837
THIES,THIES,THIENABA,THIENABA,"H1 KEUR MADIOP FALL",6,6,62,43,105
THIES,THIES,THIENABA,THIENABA,LOMBE,3,3,23,19,42
THIES,THIES,THIENABA,THIENABA,MBABOU,6,8,51,46,97
THIES,THIES,THIENABA,THIENABA,"H1 PEULGA (POURY)",20,29,112,113,225
THIES,THIES,THIENABA,THIENABA,MBAMBARA,11,13,90,73,163
THIES,THIES,THIENABA,THIENABA,NDANE,35,39,215,221,436
THIES,THIES,THIENABA,THIENABA,"H1 KEUR IBRA SENE",6,6,39,30,69
THIES,THIES,THIENABA,THIENABA,NDIAGNE,31,39,238,230,468
THIES,THIES,THIENABA,THIENABA,NDIANE,7,16,114,153,267
THIES,THIES,THIENABA,THIENABA,"H2 PALENE",9,9,50,67,117
THIES,THIES,THIENABA,THIENABA,"H3 NGOMENE",14,22,142,174,316
THIES,THIES,THIENABA,THIENABA,"H4 PAYENE",1,4,34,37,71
THIES,THIES,THIENABA,THIENABA,"H5 THIAWENE",9,14,87,115,202
THIES,THIES,THIENABA,THIENABA,"NDINDY HANE",35,42,329,260,589
THIES,THIES,THIENABA,THIENABA,"H1 KEUR MBAYE GUEYE",36,51,384,389,773
THIES,THIES,THIENABA,THIENABA,"NGOMENE BALLA",18,25,153,132,285
THIES,THIES,THIENABA,THIENABA,"H1 MBOULEL",5,7,29,23,52
THIES,THIES,THIENABA,THIENABA,"H2 DAROU NGOMENE",30,47,250,249,499
THIES,THIES,THIENABA,THIENABA,"SANTHIOU NGOMENE (KEUR MOR CODOU)",9,13,93,100,193
THIES,THIES,THIENABA,THIENABA,"TAIBA NDAO",22,26,186,200,386
THIES,THIES,THIENABA,THIENABA,THIAWARE,53,59,296,308,604
THIES,THIES,THIENABA,THIENABA,THIEKHAO,6,6,33,38,71
THIES,THIES,THIENABA,THIENABA,"THIENABA 1 (THIENABA SECK)",554,684,4438,4167,8605
THIES,THIES,THIENABA,THIENABA,"THIENABA 2 (THIENABA GARE)",307,332,1659,1630,3289
THIES,THIES,THIENABA,THIENABA,"KEUR DIADIE DIOP (KEUR NDIAMBE NDIAYE)",8,9,69,39,108
THIES,THIES,THIENABA,"TOUBA TOUL",BOKH,113,121,921,841,1762
THIES,THIES,THIENABA,"TOUBA TOUL",BOURFA,23,31,171,187,358
THIES,THIES,THIENABA,"TOUBA TOUL",DIAKHAO,30,38,238,193,431
THIES,THIES,THIENABA,"TOUBA TOUL","H1 NGATHIE",14,17,100,102,202
THIES,THIES,THIENABA,"TOUBA TOUL","DIOKOUL ALI NGONE",43,49,260,230,490
THIES,THIES,THIENABA,"TOUBA TOUL","H1 DAROU SOUGUERE",21,22,150,126,276
THIES,THIES,THIENABA,"TOUBA TOUL",DOUDOUL,50,63,282,329,611
THIES,THIES,THIENABA,"TOUBA TOUL",FIAYE,38,39,235,281,516
THIES,THIES,THIENABA,"TOUBA TOUL","GADE KHAYE",172,194,1026,1118,2144
THIES,THIES,THIENABA,"TOUBA TOUL",GOUYAR,8,13,73,61,134
THIES,THIES,THIENABA,"TOUBA TOUL","KANDJI KANENE",5,10,51,60,111
THIES,THIES,THIENABA,"TOUBA TOUL",KANENE,10,10,39,40,79
THIES,THIES,THIENABA,"TOUBA TOUL","KEUR ALIOU DIOUF",38,48,200,241,441
THIES,THIES,THIENABA,"TOUBA TOUL","KEUR DIOMAYE",27,32,172,213,385
THIES,THIES,THIENABA,"TOUBA TOUL","KEUR IBRA GUEYE",75,88,715,693,1408
THIES,THIES,THIENABA,"TOUBA TOUL","KEUR LAMANE",225,299,1527,1742,3269
THIES,THIES,THIENABA,"TOUBA TOUL","H2 DAROU FAYE",36,44,307,211,518
THIES,THIES,THIENABA,"TOUBA TOUL","KEUR MACODOU (KEUR NDIAO)",28,41,211,203,414
THIES,THIES,THIENABA,"TOUBA TOUL","KEUR MACOUMBA GUEYE",16,21,111,117,228
THIES,THIES,THIENABA,"TOUBA TOUL","KEUR MADIA",38,45,272,346,618
THIES,THIES,THIENABA,"TOUBA TOUL","KEUR MADIOP SAMB",14,16,49,64,113
THIES,THIES,THIENABA,"TOUBA TOUL","H1 KEUR MADIOP DIOR",7,11,39,34,73
THIES,THIES,THIENABA,"TOUBA TOUL","KEUR MAHABDOU",6,6,21,25,46
THIES,THIES,THIENABA,"TOUBA TOUL","H1 KEUR MAFAYE",2,2,9,16,25
THIES,THIES,THIENABA,"TOUBA TOUL","KEUR MAMOUR NGONE",37,43,223,213,436
THIES,THIES,THIENABA,"TOUBA TOUL","KEUR MBAYE SALL",34,40,233,238,471
THIES,THIES,THIENABA,"TOUBA TOUL","KEUR MEISSA NGONE",4,4,20,22,42
THIES,THIES,THIENABA,"TOUBA TOUL","KEUR NDIAGA SARR",46,63,384,337,721
THIES,THIES,THIENABA,"TOUBA TOUL","H1 NGUOULE",13,13,83,97,180
THIES,THIES,THIENABA,"TOUBA TOUL","KEUR NGAGNE GUEYE",20,30,146,136,282
THIES,THIES,THIENABA,"TOUBA TOUL","H1 NDIOUDIOUF",30,36,182,167,349
THIES,THIES,THIENABA,"TOUBA TOUL","KEUR THIAF",160,207,1077,1107,2184
THIES,THIES,THIENABA,"TOUBA TOUL","KEUR THIONE TINE",25,27,104,137,241
THIES,THIES,THIENABA,"TOUBA TOUL","KEUR YAKHAM ROUBA",17,19,103,111,214
THIES,THIES,THIENABA,"TOUBA TOUL","KEUR YORO SOFI",37,43,254,246,500
THIES,THIES,THIENABA,"TOUBA TOUL",KOLONG,7,7,32,39,71
THIES,THIES,THIENABA,"TOUBA TOUL",LAMBANE,9,14,85,98,183
THIES,THIES,THIENABA,"TOUBA TOUL",MBAMPANA,54,60,285,388,673
THIES,THIES,THIENABA,"TOUBA TOUL","H2 KEUR DAME GAYE",3,3,20,15,35
THIES,THIES,THIENABA,"TOUBA TOUL","H3 KEUR NDIAGA DIOUF",10,11,55,78,133
THIES,THIES,THIENABA,"TOUBA TOUL",MBANGOUR,80,107,531,544,1075
THIES,THIES,THIENABA,"TOUBA TOUL",MBAYENE,5,5,48,44,92
THIES,THIES,THIENABA,"TOUBA TOUL","H1 PALENE",5,5,38,26,64
THIES,THIES,THIENABA,"TOUBA TOUL",MBEDIE,51,68,353,390,743
THIES,THIES,THIENABA,"TOUBA TOUL",MBOKHOSSENE,2,3,13,16,29
THIES,THIES,THIENABA,"TOUBA TOUL","H1 NGOMENE",27,29,170,176,346
THIES,THIES,THIENABA,"TOUBA TOUL",MBOLTOGNE,32,42,350,253,603
THIES,THIES,THIENABA,"TOUBA TOUL","H1 NDIOUFENE",7,9,55,27,82
THIES,THIES,THIENABA,"TOUBA TOUL",MBOSS,116,130,931,929,1860
THIES,THIES,THIENABA,"TOUBA TOUL","NAKH NEKH",15,19,145,161,306
THIES,THIES,THIENABA,"TOUBA TOUL","H1 TOUBA TEUGUE",7,12,64,46,110
THIES,THIES,THIENABA,"TOUBA TOUL","H2 THIENENE",10,10,61,48,109
THIES,THIES,THIENABA,"TOUBA TOUL","H3 KEUR GOUMACK",12,21,121,99,220
THIES,THIES,THIENABA,"TOUBA TOUL",NDADENE,56,74,488,455,943
THIES,THIES,THIENABA,"TOUBA TOUL",NDIABAKHALI,64,78,528,492,1020
THIES,THIES,THIENABA,"TOUBA TOUL","NDIAKHATIL BABOU",7,9,39,44,83
THIES,THIES,THIENABA,"TOUBA TOUL","NDIAKHATIL MARAME",33,46,241,240,481
THIES,THIES,THIENABA,"TOUBA TOUL",NDIAKHOU,41,54,352,328,680
THIES,THIES,THIENABA,"TOUBA TOUL",NDIANDIAR,66,81,615,604,1219
THIES,THIES,THIENABA,"TOUBA TOUL",NDIARAO,27,35,111,144,255
THIES,THIES,THIENABA,"TOUBA TOUL",NDIAWRIGNE,16,17,114,88,202
THIES,THIES,THIENABA,"TOUBA TOUL","NDIEFOUGNE PAL",79,90,592,514,1106
THIES,THIES,THIENABA,"TOUBA TOUL","H1 SANTHIE",8,8,74,76,150
THIES,THIES,THIENABA,"TOUBA TOUL","NDIEFOUNE KHALALENE",5,6,29,18,47
THIES,THIES,THIENABA,"TOUBA TOUL","NDIEFOUNE PARBA",48,56,314,297,611
THIES,THIES,THIENABA,"TOUBA TOUL","NDIEFOUNE THIANDIGUE",20,21,169,174,343
THIES,THIES,THIENABA,"TOUBA TOUL","H1 DAROU NDIAYE",21,29,184,207,391
THIES,THIES,THIENABA,"TOUBA TOUL",NDIENENE,42,55,439,328,767
THIES,THIES,THIENABA,"TOUBA TOUL","NDIERY MBENGUE",21,23,197,197,394
THIES,THIES,THIENABA,"TOUBA TOUL","H1 KEUR MBAYE COUMBA",3,4,23,14,37
THIES,THIES,THIENABA,"TOUBA TOUL","H2 KEUR KETHIE",4,4,25,30,55
THIES,THIES,THIENABA,"TOUBA TOUL","NDIERY NDIAYE",9,11,71,51,122
THIES,THIES,THIENABA,"TOUBA TOUL","NDIERY PACK",6,10,40,39,79
THIES,THIES,THIENABA,"TOUBA TOUL","NDIOBEL NGAYENE",43,54,269,292,561
THIES,THIES,THIENABA,"TOUBA TOUL","NDIOBEL PAYENE",42,53,214,260,474
THIES,THIES,THIENABA,"TOUBA TOUL",NDIOBENE,44,57,276,345,621
THIES,THIES,THIENABA,"TOUBA TOUL",NDIONE,40,42,168,213,381
THIES,THIES,THIENABA,"TOUBA TOUL",NDIOTHIE,8,12,66,65,131
THIES,THIES,THIENABA,"TOUBA TOUL",NDONDOL,145,192,902,1014,1916
THIES,THIES,THIENABA,"TOUBA TOUL",NDOUCOUMANE,118,135,755,749,1504
THIES,THIES,THIENABA,"TOUBA TOUL","H1 KEUR YORO ASTA",5,5,16,16,32
THIES,THIES,THIENABA,"TOUBA TOUL",NEOURANE,150,167,1208,1217,2425
THIES,THIES,THIENABA,"TOUBA TOUL","H2 KEUR ABLAYE THIAW",18,21,158,166,324
THIES,THIES,THIENABA,"TOUBA TOUL",NGAKHERE,11,12,56,84,140
THIES,THIES,THIENABA,"TOUBA TOUL","NGANE NGANE",39,54,186,242,428
THIES,THIES,THIENABA,"TOUBA TOUL","NGATHIE FANDENE",1,1,3,6,9
THIES,THIES,THIENABA,"TOUBA TOUL",NGHABANE,18,32,284,204,488
THIES,THIES,THIENABA,"TOUBA TOUL","H1 NGHABANE GUEYE",13,14,130,125,255
THIES,THIES,THIENABA,"TOUBA TOUL",NGHASS,31,42,248,251,499
THIES,THIES,THIENABA,"TOUBA TOUL",NGOGOM,84,92,656,730,1386
THIES,THIES,THIENABA,"TOUBA TOUL","H1 NGOGOM KEUR MEISSA",39,44,294,297,591
THIES,THIES,THIENABA,"TOUBA TOUL",NGOUGOUSS,17,19,146,145,291
THIES,THIES,THIENABA,"TOUBA TOUL","H1 NGOBENE",7,7,56,51,107
THIES,THIES,THIENABA,"TOUBA TOUL","H2 NGOMENE",19,21,143,140,283
THIES,THIES,THIENABA,"TOUBA TOUL",NGUEMBE,10,10,63,59,122
THIES,THIES,THIENABA,"TOUBA TOUL","H1 KHOURWA (KEUR DIBOCOR)",16,17,116,97,213
THIES,THIES,THIENABA,"TOUBA TOUL","NIANGUE NDAKHAR",14,21,89,108,197
THIES,THIES,THIENABA,"TOUBA TOUL",PABENE,9,16,69,73,142
THIES,THIES,THIENABA,"TOUBA TOUL",PALENE,11,12,77,41,118
THIES,THIES,THIENABA,"TOUBA TOUL",PEULH,2,3,30,28,58
THIES,THIES,THIENABA,"TOUBA TOUL","PIROUM NDARY",139,171,1022,1040,2062
THIES,THIES,THIENABA,"TOUBA TOUL",SAMBAYE,20,27,99,142,241
THIES,THIES,THIENABA,"TOUBA TOUL","SAMEL NDOUR",95,113,892,956,1848
THIES,THIES,THIENABA,"TOUBA TOUL","SINDIANE 1",77,101,480,484,964
THIES,THIES,THIENABA,"TOUBA TOUL","SINDIANE 2",25,28,132,164,296
THIES,THIES,THIENABA,"TOUBA TOUL","SINTHIOU GADE",8,11,43,54,97
THIES,THIES,THIENABA,"TOUBA TOUL",SOTHIANE,21,29,205,154,359
THIES,THIES,THIENABA,"TOUBA TOUL","THIAR DENDEL",8,10,86,69,155
THIES,THIES,THIENABA,"TOUBA TOUL","THIAR FIAYE",27,38,181,198,379
THIES,THIES,THIENABA,"TOUBA TOUL",THIARENE,22,30,138,176,314
THIES,THIES,THIENABA,"TOUBA TOUL",THIATHIAO,101,126,578,740,1318
THIES,THIES,THIENABA,"TOUBA TOUL","THILLA BOUBOU",82,102,485,605,1090
THIES,THIES,THIENABA,"TOUBA TOUL","THILLA BOUL",26,34,132,178,310
THIES,THIES,THIENABA,"TOUBA TOUL","THILLA NDAKHAR",25,31,131,179,310
THIES,THIES,THIENABA,"TOUBA TOUL","THILLA OUNTE",64,86,449,447,896
THIES,THIES,THIENABA,"TOUBA TOUL",THISSE,2,3,8,3,11
THIES,THIES,THIENABA,"TOUBA TOUL","TOUBA TOUL",159,190,834,1076,1910
THIES,THIES,THIENABA,"TOUBA TOUL",WAKHOU,3,3,7,15,22
THIES,THIES,THIENABA,"TOUBA TOUL","YARY DAKHAR",9,11,93,92,185
THIES,THIES,THIENABA,"TOUBA TOUL","H1 KANENE",1,1,12,8,20
THIES,THIES,THIENABA,"TOUBA TOUL","KEUR IBRA NGOM",11,13,45,73,118
THIES,THIES,THIENABA,"TOUBA TOUL","KEUR MAYIB",1,3,17,10,27
THIES,THIES,THIENABA,"TOUBA TOUL","KEUR NIOKHOR FALL",22,28,162,147,309
THIES,THIES,THIENABA,"TOUBA TOUL","KEUR WALY( DIT NGASS SERERE)",50,61,327,372,699
THIES,THIES,THIENABA,"TOUBA TOUL","NDIEFOUNE TIDIAR",2,3,11,10,21
THIES,THIES,THIENABA,"TOUBA TOUL","NDIONE KAW",10,12,76,78,154
THIES,THIES,THIENABA,"TOUBA TOUL","SENI FAYE",3,3,10,25,35
THIES,THIES,"KEUR MOUSSA",DIENDER,"BAYAKH 1",956,1199,4552,4188,8740
THIES,THIES,"KEUR MOUSSA",DIENDER,"BEER THIALANE",271,346,1813,1773,3586
THIES,THIES,"KEUR MOUSSA",DIENDER,"H1 KHAR YALLA",46,54,278,249,527
THIES,THIES,"KEUR MOUSSA",DIENDER,"DAROU BAYAKH (BAYAKH 2)",85,92,303,246,549
THIES,THIES,"KEUR MOUSSA",DIENDER,"DIENDER GUEDJI",206,286,1633,1790,3423
THIES,THIES,"KEUR MOUSSA",DIENDER,GOLLAM,118,145,949,880,1829
THIES,THIES,"KEUR MOUSSA",DIENDER,KANIACK,18,20,82,76,158
THIES,THIES,"KEUR MOUSSA",DIENDER,"KEUR MATAR GUEYE",340,416,2891,2619,5510
THIES,THIES,"KEUR MOUSSA",DIENDER,"MBIDIEUM LEBOU",62,104,746,759,1505
THIES,THIES,"KEUR MOUSSA",DIENDER,"MBIDIEUM OUOLOF",29,38,273,276,549
THIES,THIES,"KEUR MOUSSA",DIENDER,MBISSAO,112,132,796,791,1587
THIES,THIES,"KEUR MOUSSA",DIENDER,"NDAME LO",98,119,596,605,1201
THIES,THIES,"KEUR MOUSSA",DIENDER,"NDIAR MOURIDE (DAROU NDIAR)",100,117,815,814,1629
THIES,THIES,"KEUR MOUSSA",DIENDER,"H1 NDIONNENE",3,3,18,22,40
THIES,THIES,"KEUR MOUSSA",DIENDER,"NDIAR TIDIANE",161,195,1277,1101,2378
THIES,THIES,"KEUR MOUSSA",DIENDER,NDIEUGUENE,92,127,764,808,1572
THIES,THIES,"KEUR MOUSSA",DIENDER,"NGAYENE NGARY",3,3,22,9,31
THIES,THIES,"KEUR MOUSSA",DIENDER,"SANTHIOU DARA",149,187,1122,1048,2170
THIES,THIES,"KEUR MOUSSA",DIENDER,"SANTHIOU MAME GOR",46,59,325,264,589
THIES,THIES,"KEUR MOUSSA",DIENDER,THIEUDEME,129,193,1179,1051,2230
THIES,THIES,"KEUR MOUSSA",DIENDER,"THOR DIENDER",206,374,2061,2111,4172
THIES,THIES,"KEUR MOUSSA",DIENDER,"WAKHAL DIAM",25,31,195,188,383
THIES,THIES,"KEUR MOUSSA",FANDENE,"DAROU TOURE",50,53,431,454,885
THIES,THIES,"KEUR MOUSSA",FANDENE,DIACKSAO,178,206,596,604,1200
THIES,THIES,"KEUR MOUSSA",FANDENE,"DIEMOYE GAYE",23,36,136,117,253
THIES,THIES,"KEUR MOUSSA",FANDENE,"EXTENSION KEUR MASSAMBA GUEYE",367,507,1608,1572,3180
THIES,THIES,"KEUR MOUSSA",FANDENE,"FANDENE DIAW (TONGOL)",22,22,59,36,95
THIES,THIES,"KEUR MOUSSA",FANDENE,"H1 TENE TENE",5,5,19,20,39
THIES,THIES,"KEUR MOUSSA",FANDENE,"H2 DIOP DIOP 2",9,9,31,34,65
THIES,THIES,"KEUR MOUSSA",FANDENE,"H3 THIAW THIAW",7,8,30,21,51
THIES,THIES,"KEUR MOUSSA",FANDENE,"H4 DIOP DIOP I",22,24,75,91,166
THIES,THIES,"KEUR MOUSSA",FANDENE,"H5 MBAYENE",30,31,90,87,177
THIES,THIES,"KEUR MOUSSA",FANDENE,"FANDENE DIAYANE",69,70,218,257,475
THIES,THIES,"KEUR MOUSSA",FANDENE,"FANDENE NDIOUR",67,197,274,217,491
THIES,THIES,"KEUR MOUSSA",FANDENE,"FANDENE THIATHIE",80,93,295,308,603
THIES,THIES,"KEUR MOUSSA",FANDENE,"H1 KEUR YOUNGAR",8,13,38,49,87
THIES,THIES,"KEUR MOUSSA",FANDENE,"FANDENE YABOYE",41,49,145,162,307
THIES,THIES,"KEUR MOUSSA",FANDENE,"H1 KEUR NGAGNE THIAW",3,4,12,12,24
THIES,THIES,"KEUR MOUSSA",FANDENE,"FOUTA GOL",28,31,141,117,258
THIES,THIES,"KEUR MOUSSA",FANDENE,"H1 TENE BALLA",10,27,87,70,157
THIES,THIES,"KEUR MOUSSA",FANDENE,"KAIRE DJANDER",18,22,134,112,246
THIES,THIES,"KEUR MOUSSA",FANDENE,"KEUR ABDOU NDIAYE",20,20,111,137,248
THIES,THIES,"KEUR MOUSSA",FANDENE,"KEUR ASSANE NDIAYE",47,51,296,313,609
THIES,THIES,"KEUR MOUSSA",FANDENE,"KEUR DAOUDA CISSE",36,40,152,141,293
THIES,THIES,"KEUR MOUSSA",FANDENE,"KEUR DEMBA NGOYE",110,131,681,740,1421
THIES,THIES,"KEUR MOUSSA",FANDENE,"H1 PEULGA (KEUR DEMBA PEUL)",1,1,4,1,5
THIES,THIES,"KEUR MOUSSA",FANDENE,"H2 PEULGA",26,34,165,172,337
THIES,THIES,"KEUR MOUSSA",FANDENE,"KEUR FRANCOIS GUEYE",4,4,50,44,94
THIES,THIES,"KEUR MOUSSA",FANDENE,"KEUR KARAMOKO",57,136,327,319,646
THIES,THIES,"KEUR MOUSSA",FANDENE,"KEUR LIKA",33,78,109,115,224
THIES,THIES,"KEUR MOUSSA",FANDENE,"H1 KEUR DAOUDA",2,3,8,9,17
THIES,THIES,"KEUR MOUSSA",FANDENE,"KEUR MAME MARAME",62,74,483,468,951
THIES,THIES,"KEUR MOUSSA",FANDENE,"KEUR MASSAMA GUEYE 1",58,58,355,235,590
THIES,THIES,"KEUR MOUSSA",FANDENE,"KEUR MASSAMBA GUEYE 2",16,17,89,115,204
THIES,THIES,"KEUR MOUSSA",FANDENE,"KEUR MOCTAR ARAM",25,36,241,135,376
THIES,THIES,"KEUR MOUSSA",FANDENE,"H1 DARADJI",12,21,33,34,67
THIES,THIES,"KEUR MOUSSA",FANDENE,"KEUR MOR NDIAYE",96,118,747,788,1535
THIES,THIES,"KEUR MOUSSA",FANDENE,"H1 KEUR BABACAR MBAYE",13,13,105,81,186
THIES,THIES,"KEUR MOUSSA",FANDENE,"KEUR MORY MBAYE",16,16,111,93,204
THIES,THIES,"KEUR MOUSSA",FANDENE,"KEUR SARA BADIANE",83,85,353,326,679
THIES,THIES,"KEUR MOUSSA",FANDENE,"KEUR SIMBARA",20,25,74,48,122
THIES,THIES,"KEUR MOUSSA",FANDENE,"KEUR THIEME SOUARE",103,220,576,571,1147
THIES,THIES,"KEUR MOUSSA",FANDENE,KOUNDANE,89,97,491,333,824
THIES,THIES,"KEUR MOUSSA",FANDENE,LALANE,97,164,293,290,583
THIES,THIES,"KEUR MOUSSA",FANDENE,"H1 KEUR NDIOUKOUNE",27,53,98,89,187
THIES,THIES,"KEUR MOUSSA",FANDENE,LELO,68,72,360,306,666
THIES,THIES,"KEUR MOUSSA",FANDENE,"H1 KEUR MBARICK SY",2,2,11,9,20
THIES,THIES,"KEUR MOUSSA",FANDENE,"LEONA NIANG",197,205,727,874,1601
THIES,THIES,"KEUR MOUSSA",FANDENE,"H1 LEONA THIAW",82,86,314,276,590
THIES,THIES,"KEUR MOUSSA",FANDENE,"MBAYENE PEULH",20,24,122,129,251
THIES,THIES,"KEUR MOUSSA",FANDENE,NDIOBENE,84,104,452,473,925
THIES,THIES,"KEUR MOUSSA",FANDENE,"H1 THIAOUANE",44,45,134,147,281
THIES,THIES,"KEUR MOUSSA",FANDENE,NDOUFFOUCK,650,686,3188,2932,6120
THIES,THIES,"KEUR MOUSSA",FANDENE,"H2 TAWFEEKH",46,46,175,148,323
THIES,THIES,"KEUR MOUSSA",FANDENE,NGOUMSANE,296,321,1553,1414,2967
THIES,THIES,"KEUR MOUSSA",FANDENE,PEYCOUCK,101,106,438,485,923
THIES,THIES,"KEUR MOUSSA",FANDENE,"PEYCOUCK SERERE",739,1337,3453,3448,6901
THIES,THIES,"KEUR MOUSSA",FANDENE,"SAME NDIAYE",34,40,235,257,492
THIES,THIES,"KEUR MOUSSA",FANDENE,"SANTHIE YORO SADIO",302,309,1079,883,1962
THIES,THIES,"KEUR MOUSSA",FANDENE,"TAWA FALL",49,54,278,170,448
THIES,THIES,"KEUR MOUSSA",FANDENE,THIALE,25,28,136,141,277
THIES,THIES,"KEUR MOUSSA",FANDENE,"TOUBA PEYCOUCK",214,218,1025,1019,2044
THIES,THIES,"KEUR MOUSSA",FANDENE,"TOUBA SAMB",8,8,26,14,40
THIES,THIES,"KEUR MOUSSA","KEUR MOUSSA","DARAL PEULH",71,91,364,371,735
THIES,THIES,"KEUR MOUSSA","KEUR MOUSSA","H1 KEUR THIERNO BA",1,1,7,8,15
THIES,THIES,"KEUR MOUSSA","KEUR MOUSSA","H2 KEUR DIARRA BA",1,1,11,7,18
THIES,THIES,"KEUR MOUSSA","KEUR MOUSSA","H3 SDE POUT SUD",3,3,7,2,9
THIES,THIES,"KEUR MOUSSA","KEUR MOUSSA","H5 KEUR ADIOUMA KA",2,2,11,11,22
THIES,THIES,"KEUR MOUSSA","KEUR MOUSSA","H6 KEUR OMAR BA",1,1,8,9,17
THIES,THIES,"KEUR MOUSSA","KEUR MOUSSA",GAD,28,39,214,194,408
THIES,THIES,"KEUR MOUSSA","KEUR MOUSSA","H1 NDIOUFFENE",51,56,264,277,541
THIES,THIES,"KEUR MOUSSA","KEUR MOUSSA",GALANE,52,53,197,181,378
THIES,THIES,"KEUR MOUSSA","KEUR MOUSSA",GUER,47,51,314,301,615
THIES,THIES,"KEUR MOUSSA","KEUR MOUSSA",KAYEL,71,91,578,554,1132
THIES,THIES,"KEUR MOUSSA","KEUR MOUSSA",KESSOUKHATE,59,61,309,263,572
THIES,THIES,"KEUR MOUSSA","KEUR MOUSSA","H2 KATHIALICK",42,61,355,309,664
THIES,THIES,"KEUR MOUSSA","KEUR MOUSSA","KEUR GUILAYE",77,94,393,350,743
THIES,THIES,"KEUR MOUSSA","KEUR MOUSSA","KEUR MOUSSEU (KEUR MOUSSA)",881,1108,4889,4817,9706
THIES,THIES,"KEUR MOUSSA","KEUR MOUSSA","H7 KEUR LEMOU",44,46,265,259,524
THIES,THIES,"KEUR MOUSSA","KEUR MOUSSA","KEUR SEGA",241,270,1310,1158,2468
THIES,THIES,"KEUR MOUSSA","KEUR MOUSSA","H1 KEUR ABLAYE BA",13,14,63,48,111
THIES,THIES,"KEUR MOUSSA","KEUR MOUSSA","KEUR YAKHAM",167,220,1242,1234,2476
THIES,THIES,"KEUR MOUSSA","KEUR MOUSSA","KHAYE SERERE",46,51,256,234,490
THIES,THIES,"KEUR MOUSSA","KEUR MOUSSA","H1 KEUR IBRAHIMA DIOUF",33,49,245,242,487
THIES,THIES,"KEUR MOUSSA","KEUR MOUSSA","H2 MERINA",12,12,53,46,99
THIES,THIES,"KEUR MOUSSA","KEUR MOUSSA",KHININE,72,107,732,707,1439
THIES,THIES,"KEUR MOUSSA","KEUR MOUSSA",KHODEBA,138,188,896,918,1814
THIES,THIES,"KEUR MOUSSA","KEUR MOUSSA","H1 NGOR",28,31,131,152,283
THIES,THIES,"KEUR MOUSSA","KEUR MOUSSA","H2 SANTHIE",40,46,216,221,437
THIES,THIES,"KEUR MOUSSA","KEUR MOUSSA","H2 DIAMAGUENE",9,14,88,99,187
THIES,THIES,"KEUR MOUSSA","KEUR MOUSSA",LANDOU,81,95,546,547,1093
THIES,THIES,"KEUR MOUSSA","KEUR MOUSSA","H1 TOUTOUTHIE",16,20,128,144,272
THIES,THIES,"KEUR MOUSSA","KEUR MOUSSA","H2 NOUNGHIN",20,22,143,128,271
THIES,THIES,"KEUR MOUSSA","KEUR MOUSSA","H3 DIAMAGUENE",11,11,41,44,85
THIES,THIES,"KEUR MOUSSA","KEUR MOUSSA","H4 HLM",4,7,40,38,78
THIES,THIES,"KEUR MOUSSA","KEUR MOUSSA","H3 LOLAYENE",31,42,232,229,461
THIES,THIES,"KEUR MOUSSA","KEUR MOUSSA","LELO OUOLOF",5,10,25,33,58
THIES,THIES,"KEUR MOUSSA","KEUR MOUSSA","H1 SANTHIE",10,14,77,80,157
THIES,THIES,"KEUR MOUSSA","KEUR MOUSSA","H1 PEULGA MONTAGNE",10,25,122,100,222
THIES,THIES,"KEUR MOUSSA","KEUR MOUSSA","LELO SERERE",101,112,491,472,963
THIES,THIES,"KEUR MOUSSA","KEUR MOUSSA","H2 BOKHTOL",18,24,89,131,220
THIES,THIES,"KEUR MOUSSA","KEUR MOUSSA","H2 KHONGOLANE",31,36,164,165,329
THIES,THIES,"KEUR MOUSSA","KEUR MOUSSA",LENE,60,70,379,351,730
THIES,THIES,"KEUR MOUSSA","KEUR MOUSSA","MBIRDIAM (SOULOUF)",74,104,402,438,840
THIES,THIES,"KEUR MOUSSA","KEUR MOUSSA","H2 POUYENE",46,50,226,230,456
THIES,THIES,"KEUR MOUSSA","KEUR MOUSSA","H3 KM 50",200,237,1078,1032,2110
THIES,THIES,"KEUR MOUSSA","KEUR MOUSSA","H4 PEULGA",6,6,45,43,88
THIES,THIES,"KEUR MOUSSA","KEUR MOUSSA","H5 GUINAW RAIL",36,39,148,131,279
THIES,THIES,"KEUR MOUSSA","KEUR MOUSSA","H6 KEUR MEDOUNE",10,10,61,58,119
THIES,THIES,"KEUR MOUSSA","KEUR MOUSSA",MBOUL,40,46,401,355,756
THIES,THIES,"KEUR MOUSSA","KEUR MOUSSA","H1 BEIGNE",23,25,131,132,263
THIES,THIES,"KEUR MOUSSA","KEUR MOUSSA","H2 THIAYA",9,19,85,84,169
THIES,THIES,"KEUR MOUSSA","KEUR MOUSSA","H3 NGOLOL",17,32,197,190,387
THIES,THIES,"KEUR MOUSSA","KEUR MOUSSA","H4 BARETE",49,55,348,401,749
THIES,THIES,"KEUR MOUSSA","KEUR MOUSSA",NDEUYE,49,53,382,390,772
THIES,THIES,"KEUR MOUSSA","KEUR MOUSSA","H1 DAROU SARR",13,21,153,132,285
THIES,THIES,"KEUR MOUSSA","KEUR MOUSSA","H2 NDEMENE",14,14,101,96,197
THIES,THIES,"KEUR MOUSSA","KEUR MOUSSA","NDIAKHATE MADARO",69,72,329,239,568
THIES,THIES,"KEUR MOUSSA","KEUR MOUSSA","H1 EMAAP",8,8,16,14,30
THIES,THIES,"KEUR MOUSSA","KEUR MOUSSA","H2 SEEMAAP",3,4,6,5,11
THIES,THIES,"KEUR MOUSSA","KEUR MOUSSA",NDIRENE,68,81,426,405,831
THIES,THIES,"KEUR MOUSSA","KEUR MOUSSA","NDOYENE PEULH",63,69,252,191,443
THIES,THIES,"KEUR MOUSSA","KEUR MOUSSA","H1 NDOYENE DIORGA",23,26,149,113,262
THIES,THIES,"KEUR MOUSSA","KEUR MOUSSA","NIAKHIP (NIAKHIP SERERE)",58,78,509,506,1015
THIES,THIES,"KEUR MOUSSA","KEUR MOUSSA","H1 KEUR YAGA THIOMBANE",9,10,92,114,206
THIES,THIES,"KEUR MOUSSA","KEUR MOUSSA","H2 NIAKHIP PEULH",6,6,33,27,60
THIES,THIES,"KEUR MOUSSA","KEUR MOUSSA","H3 KEUR MANIANG SOW",5,7,38,22,60
THIES,THIES,"KEUR MOUSSA","KEUR MOUSSA","H4 NIAKHIP OUOLOF",8,8,56,48,104
THIES,THIES,"KEUR MOUSSA","KEUR MOUSSA",PALAL,106,125,644,610,1254
THIES,THIES,"KEUR MOUSSA","KEUR MOUSSA","H1 KEUR BABACAR BA",1,1,16,6,22
THIES,THIES,"KEUR MOUSSA","KEUR MOUSSA","H2 BAYOUF",27,29,151,153,304
THIES,THIES,"KEUR MOUSSA","KEUR MOUSSA","H3 VERGER",1,1,1,2,3
THIES,THIES,"KEUR MOUSSA","KEUR MOUSSA",SAGNAFIL,206,246,1135,1070,2205
THIES,THIES,"KEUR MOUSSA","KEUR MOUSSA","SANTHIE SERERE",46,60,358,354,712
THIES,THIES,"KEUR MOUSSA","KEUR MOUSSA","H1 KHININE",79,119,535,526,1061
THIES,THIES,"KEUR MOUSSA","KEUR MOUSSA","H2 TAGO",78,96,399,372,771
THIES,THIES,"KEUR MOUSSA","KEUR MOUSSA","SEUNE OUOLOF",36,42,237,223,460
THIES,THIES,"KEUR MOUSSA","KEUR MOUSSA","H1 DARADJI",1,1,3,0,3
THIES,THIES,"KEUR MOUSSA","KEUR MOUSSA","H2 MANKOU",10,11,97,66,163
THIES,THIES,"KEUR MOUSSA","KEUR MOUSSA","SEUNE SERERE",6,23,190,171,361
THIES,THIES,"KEUR MOUSSA","KEUR MOUSSA","H2 CAMP COMMANDANT BAILO DIONE",1,1,39,0,39
THIES,THIES,"KEUR MOUSSA","KEUR MOUSSA","SOUNE OUOLOF",10,14,51,57,108
THIES,THIES,"KEUR MOUSSA","KEUR MOUSSA","SOUNE SERERE",62,68,390,413,803
THIES,THIES,"KEUR MOUSSA","KEUR MOUSSA","H1 BAGALA",96,130,651,616,1267
THIES,THIES,"KEUR MOUSSA","KEUR MOUSSA","H2 SOUNE",18,51,244,171,415
THIES,THIES,"KEUR MOUSSA","KEUR MOUSSA",THIAMBOKH,22,39,221,182,403
THIES,THIES,"KEUR MOUSSA","KEUR MOUSSA","H1 KEUR MBAL",31,50,265,287,552
THIES,THIES,"KEUR MOUSSA","KEUR MOUSSA","TOUBA NGOMENE",78,85,605,565,1170
THIES,THIES,"KEUR MOUSSA","KEUR MOUSSA","H1 NGOMENE PEULH",7,10,41,36,77
THIES,THIES,"KEUR MOUSSA","KEUR MOUSSA","H2 KEUR YOUSSOU",16,24,136,155,291
THIES,THIES,"KEUR MOUSSA","KEUR MOUSSA","H3 NGUENT BOUBOU",8,9,55,60,115
THIES,THIES,"KEUR MOUSSA","KEUR MOUSSA",TOULY,6,16,64,57,121
THIES,THIES,"KEUR MOUSSA","KEUR MOUSSA","H1 POUGOULOUGUINE",59,81,391,390,781
THIES,THIES,"KEUR MOUSSA","KEUR MOUSSA","H2 HIRA",40,44,236,242,478
THIES,THIES,"KEUR MOUSSA","KEUR MOUSSA","H3 TOULY PINE",16,28,209,205,414
THIES,THIES,"KEUR MOUSSA","KEUR MOUSSA","H1 SOUTENANG",16,35,263,246,509
THIES,THIES,"KEUR MOUSSA","KEUR MOUSSA",TOUGOUNY,88,110,417,418,835
THIES,THIES,"KEUR MOUSSA","KEUR MOUSSA","H1 LELO WOLOF",24,29,80,72,152
THIES,THIES,"KEUR MOUSSA","KEUR MOUSSA",YADE,56,78,386,389,775
THIES,THIES,"KEUR MOUSSA","KEUR MOUSSA","KESSOU KHATE (RECASEMENT)",134,148,656,682,1338
THIES,THIES,"KEUR MOUSSA","KEUR MOUSSA","H2 KATHIALICK (RECASEMENT)",106,201,410,343,753
THIES,THIES,"KEUR MOUSSA","KEUR MOUSSA","H1 MBADATE (RECASEMENT)",56,58,293,310,603
THIES,THIES,"KEUR MOUSSA",KAYAR,"DAROU SALAM",938,1252,6280,5956,12236
THIES,THIES,"KEUR MOUSSA",KAYAR,"KEUR ABDOU NDOYE 2",135,206,980,1046,2026
THIES,THIES,"KEUR MOUSSA",KAYAR,MBAWANE,111,151,839,880,1719
THIES,THIES,"KEUR MOUSSA",KAYAR,"NDIOKHOP GUEDJI",63,73,304,285,589
THIES,THIES,"KEUR MOUSSA",KAYAR,"POINT ROND",378,478,2805,2812,5617
THIES,THIES,"KEUR MOUSSA",KAYAR,"TANTY YOFF",432,547,2215,2012,4227
THIES,THIES,"KEUR MOUSSA",KAYAR,"THIOSSANE (PINTHIE)",177,300,1537,1617,3154
THIES,THIES,"KEUR MOUSSA",KAYAR,DIAMAGUENE,21,32,129,120,249
THIES,THIES,"KEUR MOUSSA",KAYAR,"KEUR ABDOU NDOYE 1",48,82,433,412,845
THIES,THIES,"KEUR MOUSSA",KAYAR,"THIOSSANE (MEDINA DIOP)",136,205,1339,1272,2611
THIES,THIES,"VILLE DE THIES","THIES NORD",DIAKHAO,1107,1608,5715,5786,11501
THIES,THIES,"VILLE DE THIES","THIES NORD","DIAKHAO THIALY",900,1263,5441,5529,10970
THIES,THIES,"VILLE DE THIES","THIES NORD",DIASSAP,96,124,569,360,929
THIES,THIES,"VILLE DE THIES","THIES NORD","EPT (ECOLE POLYTECHNIQUE DE THIES)",75,108,1442,431,1873
THIES,THIES,"VILLE DE THIES","THIES NORD","ESCALE NORD",57,91,350,318,668
THIES,THIES,"VILLE DE THIES","THIES NORD","KAWSARA FALL",950,1185,5778,5661,11439
THIES,THIES,"VILLE DE THIES","THIES NORD","KEUR CHEIKH",148,216,1013,1083,2096
THIES,THIES,"VILLE DE THIES","THIES NORD","KEUR ISSA (BAMBARA)",388,444,1627,1632,3259
THIES,THIES,"VILLE DE THIES","THIES NORD","KEUR MAME ELHADJI",425,588,2656,2821,5477
THIES,THIES,"VILLE DE THIES","THIES NORD","KEUR MBAYE DIAKHATE",10,10,96,81,177
THIES,THIES,"VILLE DE THIES","THIES NORD","KEUR MODOU NDIAYE",76,81,420,382,802
THIES,THIES,"VILLE DE THIES","THIES NORD","KEUR SAIB NDOYE",293,321,1500,1551,3051
THIES,THIES,"VILLE DE THIES","THIES NORD","MEDINA FALL",3057,3799,18339,18941,37280
THIES,THIES,"VILLE DE THIES","THIES NORD",NGUINTH,1155,1444,5931,5744,11675
THIES,THIES,"VILLE DE THIES","THIES NORD",POGNIENE,156,164,713,625,1338
THIES,THIES,"VILLE DE THIES","THIES NORD",TAKHIKAO,631,897,4315,4623,8938
THIES,THIES,"VILLE DE THIES","THIES NORD",THIAPONG,344,390,1299,1360,2659
THIES,THIES,"VILLE DE THIES","THIES NORD",THIONAKH,303,352,1141,1263,2404
THIES,THIES,"VILLE DE THIES","THIES NORD","ZAC DE THIES",207,217,639,667,1306
THIES,THIES,"VILLE DE THIES","THIES NORD","THIALY (GRAND THIALY)",1197,1577,5827,5666,11493
THIES,THIES,"VILLE DE THIES","THIES NORD","MEDINA FALL EXTENSION",784,854,3574,3229,6803
THIES,THIES,"VILLE DE THIES","THIES EST","AYNINA FALL",102,139,606,642,1248
THIES,THIES,"VILLE DE THIES","THIES EST","CITE BALABEY (CITE 1)",155,158,621,710,1331
THIES,THIES,"VILLE DE THIES","THIES EST","CITE LAMY",1227,1554,7495,7482,14977
THIES,THIES,"VILLE DE THIES","THIES EST","CITE MAURICE PILLOT",99,116,456,514,970
THIES,THIES,"VILLE DE THIES","THIES EST","CITE OUVRIERE",696,728,2530,2448,4978
THIES,THIES,"VILLE DE THIES","THIES EST","CITE SENGHOR 1",760,957,4714,4546,9260
THIES,THIES,"VILLE DE THIES","THIES EST","CITE SENGHOR 2",917,1108,5422,5382,10804
THIES,THIES,"VILLE DE THIES","THIES EST","DAROU SALAM 1",1262,1494,7241,7004,14245
THIES,THIES,"VILLE DE THIES","THIES EST","DAROU SALAM 2",911,1007,4761,4624,9385
THIES,THIES,"VILLE DE THIES","THIES EST",DIAMAGUENE,961,1256,5995,6081,12076
THIES,THIES,"VILLE DE THIES","THIES EST","DVF (AIGLON)",292,394,1422,1601,3023
THIES,THIES,"VILLE DE THIES","THIES EST","DVF (BAYAL)",102,128,454,520,974
THIES,THIES,"VILLE DE THIES","THIES EST","DVF (CITE NIAKH)",465,574,2814,2875,5689
THIES,THIES,"VILLE DE THIES","THIES EST","DVF (PINTHIE ALI NGUER)",98,133,442,505,947
THIES,THIES,"VILLE DE THIES","THIES EST","FAHU 2",1678,2144,6810,7173,13983
THIES,THIES,"VILLE DE THIES","THIES EST","HERSENT 1",1104,1327,5690,6069,11759
THIES,THIES,"VILLE DE THIES","THIES EST","HERSENT 2",433,496,1689,1594,3283
THIES,THIES,"VILLE DE THIES","THIES EST","KEUR SERIGNE ABDOULAYE YAKHINE",891,1185,5234,5149,10383
THIES,THIES,"VILLE DE THIES","THIES EST",MBAMBARA,357,524,1990,2129,4119
THIES,THIES,"VILLE DE THIES","THIES EST","PARCELLES ASSAINIES UNITE 1",504,615,2257,2354,4611
THIES,THIES,"VILLE DE THIES","THIES EST",SAMPATHE,813,1006,4341,4325,8666
THIES,THIES,"VILLE DE THIES","THIES EST","SILMANG (KEUR DAGO)",1116,1449,5809,5357,11166
THIES,THIES,"VILLE DE THIES","THIES EST",DIOUNG,160,202,1086,1138,2224
THIES,THIES,"VILLE DE THIES","THIES EST","FAHU 1",184,218,644,710,1354
THIES,THIES,"VILLE DE THIES","THIES EST","PARCELLES ASSAINIES UNITE 2",417,518,1787,1936,3723
THIES,THIES,"VILLE DE THIES","THIES EST","PARCELLES ASSAINIES UNITE 3",146,171,528,550,1078
THIES,THIES,"VILLE DE THIES","THIES OUEST",CARRIERE,211,240,692,807,1499
THIES,THIES,"VILLE DE THIES","THIES OUEST","CITE MALICK SY",261,337,1916,981,2897
THIES,THIES,"VILLE DE THIES","THIES OUEST","CITE SOFRACO",195,210,606,637,1243
THIES,THIES,"VILLE DE THIES","THIES OUEST",DIXIEME,344,521,1509,1688,3197
THIES,THIES,"VILLE DE THIES","THIES OUEST","ESCALE SUD",81,98,331,296,627
THIES,THIES,"VILLE DE THIES","THIES OUEST","GRAND STANDING",763,1060,3142,3369,6511
THIES,THIES,"VILLE DE THIES","THIES OUEST","HLM DIXIEME",108,115,407,480,887
THIES,THIES,"VILLE DE THIES","THIES OUEST","HLM ROUTE DE DAKAR",179,219,868,768,1636
THIES,THIES,"VILLE DE THIES","THIES OUEST","HLM ROUTE DE MBOUR",134,196,458,581,1039
THIES,THIES,"VILLE DE THIES","THIES OUEST","MBOUR 1",1236,1651,6261,6680,12941
THIES,THIES,"VILLE DE THIES","THIES OUEST","MBOUR 2",355,455,1479,1577,3056
THIES,THIES,"VILLE DE THIES","THIES OUEST","MBOUR 3 (AMITIE)",809,999,2877,3237,6114
THIES,THIES,"VILLE DE THIES","THIES OUEST","MBOUR 4",762,866,3298,2958,6256
THIES,THIES,"VILLE DE THIES","THIES OUEST","RANDOULENE NORD",479,675,2719,3066,5785
THIES,THIES,"VILLE DE THIES","THIES OUEST","RANDOULENE SUD (GRAND THIES)",1010,1456,6045,6113,12158
THIES,THIES,"VILLE DE THIES","THIES OUEST","ROUTE DE DAKAR 2",232,263,851,823,1674
THIES,THIES,"VILLE DE THIES","THIES OUEST",SOM,764,1089,4247,4534,8781
THIES,THIES,"VILLE DE THIES","THIES OUEST","CITE OUSMANE NGOM",221,287,1099,1200,2299
THIES,THIES,"VILLE DE THIES","THIES OUEST","SUD STADE",240,279,801,938,1739
THIES,THIES,"VILLE DE THIES","THIES OUEST","THIES NONE",167,213,853,877,1730
THIES,THIES,"VILLE DE THIES","THIES OUEST",WANGO,62,94,443,369,812
THIES,THIES,"VILLE DE THIES","THIES OUEST","ROUTE DE DAKAR 1",469,562,1792,1919,3711
THIES,THIES,"VILLE DE THIES","THIES OUEST","ZONE INDUSTRIELLE",254,362,1168,1099,2267
THIES,TIVAOUANE,MEKHE,MEKHE,HLM,247,271,1412,1584,2996
THIES,TIVAOUANE,MEKHE,MEKHE,"LEBOU EST",230,293,1453,1483,2936
THIES,TIVAOUANE,MEKHE,MEKHE,"LEBOU OUEST",326,382,1572,1799,3371
THIES,TIVAOUANE,MEKHE,MEKHE,MBAMBARA,311,364,2240,1798,4038
THIES,TIVAOUANE,MEKHE,MEKHE,NDIOB,515,609,2892,3146,6038
THIES,TIVAOUANE,MEKHE,MEKHE,"NGAYE DIAGNE",345,399,1974,2162,4136
THIES,TIVAOUANE,MEKHE,MEKHE,"NGAYE DJITE",324,371,2044,2007,4051
THIES,TIVAOUANE,TIVAOUANE,TIVAOUANE,"BAITY BALLA DIA",92,95,551,359,910
THIES,TIVAOUANE,TIVAOUANE,TIVAOUANE,BITIWE,233,247,1272,1056,2328
THIES,TIVAOUANE,TIVAOUANE,TIVAOUANE,COMMERCIAL,68,84,337,360,697
THIES,TIVAOUANE,TIVAOUANE,TIVAOUANE,"DAROU SALAM",304,352,1523,1721,3244
THIES,TIVAOUANE,TIVAOUANE,TIVAOUANE,"DIALLO NGUIDIANE",110,157,766,803,1569
THIES,TIVAOUANE,TIVAOUANE,TIVAOUANE,"EL HADJI MALICK SY",594,676,4430,3040,7470
THIES,TIVAOUANE,TIVAOUANE,TIVAOUANE,FOGNY,601,701,3604,3325,6929
THIES,TIVAOUANE,TIVAOUANE,TIVAOUANE,GOUMOUNE,664,726,3659,3436,7095
THIES,TIVAOUANE,TIVAOUANE,TIVAOUANE,HLM,265,347,1129,1025,2154
THIES,TIVAOUANE,TIVAOUANE,TIVAOUANE,"KEUR BABA ALIMA",186,235,1651,1408,3059
THIES,TIVAOUANE,TIVAOUANE,TIVAOUANE,"KEUR BABA SEYE",10,10,53,48,101
THIES,TIVAOUANE,TIVAOUANE,TIVAOUANE,"KEUR BAKAR",206,252,1416,1465,2881
THIES,TIVAOUANE,TIVAOUANE,TIVAOUANE,"KEUR BIRIMA DIOR",35,36,260,139,399
THIES,TIVAOUANE,TIVAOUANE,TIVAOUANE,"KEUR CHEIKH MAROUBA",433,488,2340,2276,4616
THIES,TIVAOUANE,TIVAOUANE,TIVAOUANE,"KEUR KHALY",194,255,1234,1284,2518
THIES,TIVAOUANE,TIVAOUANE,TIVAOUANE,"KEUR MACOUMBA DIOP",12,15,80,79,159
THIES,TIVAOUANE,TIVAOUANE,TIVAOUANE,"KEUR MAGUEYE",83,104,466,484,950
THIES,TIVAOUANE,TIVAOUANE,TIVAOUANE,"KEUR MALAMINE GUEYE",37,46,273,266,539
THIES,TIVAOUANE,TIVAOUANE,TIVAOUANE,"KEUR MASSAMBA DEGUENE",91,96,403,408,811
THIES,TIVAOUANE,TIVAOUANE,TIVAOUANE,"MINAME MAODO TOURE",86,111,522,457,979
THIES,TIVAOUANE,TIVAOUANE,TIVAOUANE,"KEUR MATAR KHALY",51,52,280,276,556
THIES,TIVAOUANE,TIVAOUANE,TIVAOUANE,"KEUR MATAR NDACK",683,836,3214,3421,6635
THIES,TIVAOUANE,TIVAOUANE,TIVAOUANE,"KEUR MATAR NGONE",17,23,109,98,207
THIES,TIVAOUANE,TIVAOUANE,TIVAOUANE,"KEUR MAWA DIOP",9,12,71,50,121
THIES,TIVAOUANE,TIVAOUANE,TIVAOUANE,"KEUR NDIOBO",391,421,2165,2161,4326
THIES,TIVAOUANE,TIVAOUANE,TIVAOUANE,"KEUR SALLA DEUGUENE",25,33,210,182,392
THIES,TIVAOUANE,TIVAOUANE,TIVAOUANE,"KEUR SALLA MBATTA",60,76,415,400,815
THIES,TIVAOUANE,TIVAOUANE,TIVAOUANE,"KOULY NGUIDIANE",237,318,1607,1596,3203
THIES,TIVAOUANE,TIVAOUANE,TIVAOUANE,MBODIENE,35,41,188,182,370
THIES,TIVAOUANE,TIVAOUANE,TIVAOUANE,MEDINE,232,271,1461,1204,2665
THIES,TIVAOUANE,TIVAOUANE,TIVAOUANE,"NDIA GAMOU",9,9,65,54,119
THIES,TIVAOUANE,TIVAOUANE,TIVAOUANE,NDIAGNE,27,32,194,164,358
THIES,TIVAOUANE,TIVAOUANE,TIVAOUANE,NDIANDAKHOUM,676,735,3628,3040,6668
THIES,TIVAOUANE,TIVAOUANE,TIVAOUANE,NDIENE,13,14,90,48,138
THIES,TIVAOUANE,TIVAOUANE,TIVAOUANE,NDINDY,87,104,627,461,1088
THIES,TIVAOUANE,TIVAOUANE,TIVAOUANE,NDOUTTE,265,359,1579,1714,3293
THIES,TIVAOUANE,TIVAOUANE,TIVAOUANE,PARBA,26,32,183,161,344
THIES,TIVAOUANE,TIVAOUANE,TIVAOUANE,"SANTHIOU PIRE",128,137,811,797,1608
THIES,TIVAOUANE,TIVAOUANE,TIVAOUANE,"SANTHIOU THIANDE",42,45,208,200,408
THIES,TIVAOUANE,TIVAOUANE,TIVAOUANE,SELCO,125,141,770,720,1490
THIES,TIVAOUANE,TIVAOUANE,TIVAOUANE,"SINOU KHALY",65,72,404,376,780
THIES,TIVAOUANE,TIVAOUANE,TIVAOUANE,TAMBA,101,115,550,523,1073
THIES,TIVAOUANE,TIVAOUANE,TIVAOUANE,"TIVAOUANE MOURIDE (KEUR CHEIKH)",495,624,2836,2696,5532
THIES,TIVAOUANE,TIVAOUANE,TIVAOUANE,"TIVAOUANE OUOLOF",394,445,2060,1970,4030
THIES,TIVAOUANE,TIVAOUANE,TIVAOUANE,"TORO MALICK",65,73,338,385,723
THIES,TIVAOUANE,TIVAOUANE,TIVAOUANE,"WAKHALDIAM (KEUR MAS)",579,662,2728,2432,5160
THIES,TIVAOUANE,TIVAOUANE,TIVAOUANE,WELA,19,23,139,95,234
THIES,TIVAOUANE,TIVAOUANE,TIVAOUANE,"YADJINE 1",54,58,230,181,411
THIES,TIVAOUANE,TIVAOUANE,TIVAOUANE,"YADJINE 2",66,73,259,244,503
THIES,TIVAOUANE,MEOUANE,MEOUANE,AINOUMANE,30,34,193,242,435
THIES,TIVAOUANE,MEOUANE,MEOUANE,"BAITY ARONA",8,9,41,64,105
THIES,TIVAOUANE,MEOUANE,MEOUANE,BELLY,23,32,125,162,287
THIES,TIVAOUANE,MEOUANE,MEOUANE,"DAKHAR MBAYE",31,33,223,199,422
THIES,TIVAOUANE,MEOUANE,MEOUANE,"H1 SANTHIE DAKHAR",5,5,23,19,42
THIES,TIVAOUANE,MEOUANE,MEOUANE,"DAROU DIAGNE (NDIAGNE)",4,6,53,37,90
THIES,TIVAOUANE,MEOUANE,MEOUANE,"DAROU MINAME (DAROU DIOUF )",9,11,66,50,116
THIES,TIVAOUANE,MEOUANE,MEOUANE,"DAROU MBAYE",5,6,44,28,72
THIES,TIVAOUANE,MEOUANE,MEOUANE,"DAROU SOW (SAM SOW)",10,15,109,98,207
THIES,TIVAOUANE,MEOUANE,MEOUANE,"DAYAMBER (DAYA DAKHAR)",19,22,141,122,263
THIES,TIVAOUANE,MEOUANE,MEOUANE,"H1 DAGA DIOP",13,14,72,82,154
THIES,TIVAOUANE,MEOUANE,MEOUANE,"H2 DAYA DIOP",17,19,142,149,291
THIES,TIVAOUANE,MEOUANE,MEOUANE,"H3 DAYA MADA",24,30,277,229,506
THIES,TIVAOUANE,MEOUANE,MEOUANE,"H4 KEUR BILAL SOW",1,3,16,12,28
THIES,TIVAOUANE,MEOUANE,MEOUANE,"H5 KEUR CHEIKH AMADOU SOW",7,9,48,40,88
THIES,TIVAOUANE,MEOUANE,MEOUANE,"H6 NGATTY THILLA",10,11,62,81,143
THIES,TIVAOUANE,MEOUANE,MEOUANE,"DIAMA THIENE",55,77,521,473,994
THIES,TIVAOUANE,MEOUANE,MEOUANE,"DIATTY MBAYE",19,35,243,204,447
THIES,TIVAOUANE,MEOUANE,MEOUANE,"H1 NDIOP",4,9,88,95,183
THIES,TIVAOUANE,MEOUANE,MEOUANE,DIOKOUL,32,40,225,236,461
THIES,TIVAOUANE,MEOUANE,MEOUANE,DJINAKH,9,10,61,68,129
THIES,TIVAOUANE,MEOUANE,MEOUANE,DOGONDOU,8,9,73,51,124
THIES,TIVAOUANE,MEOUANE,MEOUANE,"FASS NIANG (NIANGUE)",20,22,119,121,240
THIES,TIVAOUANE,MEOUANE,MEOUANE,"FEMBOUL NDOYE",16,20,130,180,310
THIES,TIVAOUANE,MEOUANE,MEOUANE,"GADE BOUGLE",15,15,82,89,171
THIES,TIVAOUANE,MEOUANE,MEOUANE,"GOUYE SAMBA",17,23,80,121,201
THIES,TIVAOUANE,MEOUANE,MEOUANE,"H1 DEUK BOUMACK",12,17,70,98,168
THIES,TIVAOUANE,MEOUANE,MEOUANE,GOUYETTE,44,47,388,305,693
THIES,TIVAOUANE,MEOUANE,MEOUANE,KAHONE,12,15,84,72,156
THIES,TIVAOUANE,MEOUANE,MEOUANE,"KAW DEUR",8,9,50,57,107
THIES,TIVAOUANE,MEOUANE,MEOUANE,"KEUR ALLE NAR",31,46,210,183,393
THIES,TIVAOUANE,MEOUANE,MEOUANE,"KEUR KHAR DIOP (NDIOBENE)",25,31,173,199,372
THIES,TIVAOUANE,MEOUANE,MEOUANE,"KEUR MADIEYE MAR (MBADIENE)",3,3,25,37,62
THIES,TIVAOUANE,MEOUANE,MEOUANE,"KEUR MALICK DIARRA",6,8,29,33,62
THIES,TIVAOUANE,MEOUANE,MEOUANE,"KEUR MBAYE NDOMBOUR",17,19,119,108,227
THIES,TIVAOUANE,MEOUANE,MEOUANE,"KEUR MORY NDIAYE",27,31,174,130,304
THIES,TIVAOUANE,MEOUANE,MEOUANE,"KEUR NDIAGA MBAYE",20,31,190,175,365
THIES,TIVAOUANE,MEOUANE,MEOUANE,KHAYMBAR,30,37,257,251,508
THIES,TIVAOUANE,MEOUANE,MEOUANE,"KHEWAL (NGUEWEL)",54,71,303,356,659
THIES,TIVAOUANE,MEOUANE,MEOUANE,KITHIANE,10,12,72,73,145
THIES,TIVAOUANE,MEOUANE,MEOUANE,"LEONA MBAYE",43,56,396,445,841
THIES,TIVAOUANE,MEOUANE,MEOUANE,LOYENNE,9,11,95,93,188
THIES,TIVAOUANE,MEOUANE,MEOUANE,"MAKA DIOP",39,46,252,245,497
THIES,TIVAOUANE,MEOUANE,MEOUANE,MASSAR,33,42,241,237,478
THIES,TIVAOUANE,MEOUANE,MEOUANE,"H1 THIARENE",6,6,42,32,74
THIES,TIVAOUANE,MEOUANE,MEOUANE,"MBAYE BACAR",24,34,197,200,397
THIES,TIVAOUANE,MEOUANE,MEOUANE,"MBAYE DIALLO",11,13,70,68,138
THIES,TIVAOUANE,MEOUANE,MEOUANE,"MBAYENE 1",25,40,240,281,521
THIES,TIVAOUANE,MEOUANE,MEOUANE,"MBAYENE 2",25,28,212,227,439
THIES,TIVAOUANE,MEOUANE,MEOUANE,MBELGOR,8,9,94,85,179
THIES,TIVAOUANE,MEOUANE,MEOUANE,MBENGUENE,5,7,60,39,99
THIES,TIVAOUANE,MEOUANE,MEOUANE,MBORINE,102,116,836,776,1612
THIES,TIVAOUANE,MEOUANE,MEOUANE,MBOUKHEKHE,16,19,179,158,337
THIES,TIVAOUANE,MEOUANE,MEOUANE,"H1 TOUBA FALL",42,50,283,295,578
THIES,TIVAOUANE,MEOUANE,MEOUANE,"MEKHE VILLAGE",175,192,1113,1081,2194
THIES,TIVAOUANE,MEOUANE,MEOUANE,MEOUANE,184,217,1209,1309,2518
THIES,TIVAOUANE,MEOUANE,MEOUANE,"H1 DIANGUAR",15,15,219,85,304
THIES,TIVAOUANE,MEOUANE,MEOUANE,"H2 TONGHOR",18,18,113,107,220
THIES,TIVAOUANE,MEOUANE,MEOUANE,"NDANDANTOU ( NDANDE )",22,32,198,132,330
THIES,TIVAOUANE,MEOUANE,MEOUANE,NDANKHE,67,77,473,438,911
THIES,TIVAOUANE,MEOUANE,MEOUANE,NDARY,15,24,169,148,317
THIES,TIVAOUANE,MEOUANE,MEOUANE,"NDATOU MBAYE",7,7,45,64,109
THIES,TIVAOUANE,MEOUANE,MEOUANE,NDEUCOU,1,1,16,7,23
THIES,TIVAOUANE,MEOUANE,MEOUANE,"H3 KIWI",19,22,130,140,270
THIES,TIVAOUANE,MEOUANE,MEOUANE,"H4 NDIAORIGNE",20,22,125,115,240
THIES,TIVAOUANE,MEOUANE,MEOUANE,"H6 KEBE",12,18,109,85,194
THIES,TIVAOUANE,MEOUANE,MEOUANE,NDEUR,22,30,196,199,395
THIES,TIVAOUANE,MEOUANE,MEOUANE,NDIAKHATE,7,9,71,66,137
THIES,TIVAOUANE,MEOUANE,MEOUANE,NDIANE,17,20,181,153,334
THIES,TIVAOUANE,MEOUANE,MEOUANE,NDIOMBASS,9,11,97,88,185
THIES,TIVAOUANE,MEOUANE,MEOUANE,NDIOUFFENE,26,30,264,236,500
THIES,TIVAOUANE,MEOUANE,MEOUANE,"H1 PEULGA",1,1,3,4,7
THIES,TIVAOUANE,MEOUANE,MEOUANE,NDIRENE,66,66,489,430,919
THIES,TIVAOUANE,MEOUANE,MEOUANE,NDOGAL,11,11,122,92,214
THIES,TIVAOUANE,MEOUANE,MEOUANE,NDOMBILE,73,96,716,686,1402
THIES,TIVAOUANE,MEOUANE,MEOUANE,NDOUCOURA,56,65,303,348,651
THIES,TIVAOUANE,MEOUANE,MEOUANE,NGADIAWANE,2,2,35,28,63
THIES,TIVAOUANE,MEOUANE,MEOUANE,"H1 NDIENE",6,10,81,85,166
THIES,TIVAOUANE,MEOUANE,MEOUANE,"NGAKHAM 1",126,150,896,922,1818
THIES,TIVAOUANE,MEOUANE,MEOUANE,"NGAKHAM 2",67,99,504,555,1059
THIES,TIVAOUANE,MEOUANE,MEOUANE,"NGUEYE NGUEYE",22,28,131,138,269
THIES,TIVAOUANE,MEOUANE,MEOUANE,"PALENE PONE",16,19,107,119,226
THIES,TIVAOUANE,MEOUANE,MEOUANE,"H1 TEUGUE 1",19,23,227,215,442
THIES,TIVAOUANE,MEOUANE,MEOUANE,"H2 NDIRENE",30,33,221,184,405
THIES,TIVAOUANE,MEOUANE,MEOUANE,"H3 KEUR SAKHAITA",24,28,171,144,315
THIES,TIVAOUANE,MEOUANE,MEOUANE,"SANTHIOU BOUNA",109,125,718,808,1526
THIES,TIVAOUANE,MEOUANE,MEOUANE,"SANTHIOU MEKHE",16,18,74,87,161
THIES,TIVAOUANE,MEOUANE,MEOUANE,"SINE KANE",21,21,103,110,213
THIES,TIVAOUANE,MEOUANE,MEOUANE,"SINE MANDIAGA",25,28,163,187,350
THIES,TIVAOUANE,MEOUANE,MEOUANE,"SINE MOUSSE ABDOU",88,109,778,582,1360
THIES,TIVAOUANE,MEOUANE,MEOUANE,"H1 THIAMBENE",23,38,211,174,385
THIES,TIVAOUANE,MEOUANE,MEOUANE,"SINOU MBARICK",57,62,452,472,924
THIES,TIVAOUANE,MEOUANE,MEOUANE,"TAIBA NDAO",4,5,28,37,65
THIES,TIVAOUANE,MEOUANE,MEOUANE,"TAWA MBAYE",26,31,258,240,498
THIES,TIVAOUANE,MEOUANE,MEOUANE,THIAKHREW,14,19,95,107,202
THIES,TIVAOUANE,MEOUANE,MEOUANE,THIAMBENE,24,28,185,182,367
THIES,TIVAOUANE,MEOUANE,MEOUANE,THIEMBE,25,29,224,192,416
THIES,TIVAOUANE,MEOUANE,MEOUANE,"THIOCKE KA",62,69,304,270,574
THIES,TIVAOUANE,MEOUANE,MEOUANE,"THIOCKE KHEWAR",63,71,346,390,736
THIES,TIVAOUANE,MEOUANE,MEOUANE,TOBENE,52,70,374,429,803
THIES,TIVAOUANE,MEOUANE,MEOUANE,TOFFY,2,6,48,28,76
THIES,TIVAOUANE,MEOUANE,MEOUANE,"H2 NDIOUFENE",7,11,84,75,159
THIES,TIVAOUANE,MEOUANE,MEOUANE,"H3 THIARENE",8,8,78,58,136
THIES,TIVAOUANE,MEOUANE,MEOUANE,"TOUNDE THIOUNE",61,81,427,484,911
THIES,TIVAOUANE,MEOUANE,MEOUANE,"H1 MABO",9,11,112,97,209
THIES,TIVAOUANE,MEOUANE,MEOUANE,"H3 THISSE",6,8,75,68,143
THIES,TIVAOUANE,MEOUANE,MEOUANE,WAKHALDIAME,35,41,234,252,486
THIES,TIVAOUANE,MEOUANE,MEOUANE,YEUMA,24,25,190,188,378
THIES,TIVAOUANE,MEOUANE,MEOUANE,DAROU,21,29,217,220,437
THIES,TIVAOUANE,MEOUANE,MEOUANE,"KEUR MBAYE DIOUF",10,15,98,98,196
THIES,TIVAOUANE,MEOUANE,MEOUANE,KOURE,1,2,12,6,18
THIES,TIVAOUANE,MEOUANE,MEOUANE,NDIAGNE,15,30,164,151,315
THIES,TIVAOUANE,MEOUANE,"TAIBA NDIAYE","BAITY GUEYE",62,80,492,476,968
THIES,TIVAOUANE,MEOUANE,"TAIBA NDIAYE","BAITY NDIAYE",59,74,596,454,1050
THIES,TIVAOUANE,MEOUANE,"TAIBA NDIAYE","DAF 1 (DAF OUOLOF)",33,37,189,234,423
THIES,TIVAOUANE,MEOUANE,"TAIBA NDIAYE","DAF 2 (DAF BAMBARA)",28,28,149,155,304
THIES,TIVAOUANE,MEOUANE,"TAIBA NDIAYE",DJINGUE,73,85,647,611,1258
THIES,TIVAOUANE,MEOUANE,"TAIBA NDIAYE","GADE NGOMENE",25,41,235,221,456
THIES,TIVAOUANE,MEOUANE,"TAIBA NDIAYE","KEUR ASSANE NDIAYE",29,31,208,232,440
THIES,TIVAOUANE,MEOUANE,"TAIBA NDIAYE","KEUR BIRAMA FATIM",5,5,32,31,63
THIES,TIVAOUANE,MEOUANE,"TAIBA NDIAYE","KEUR MADIAGNE",108,128,895,941,1836
THIES,TIVAOUANE,MEOUANE,"TAIBA NDIAYE","KEUR MAGUEYE",41,46,340,344,684
THIES,TIVAOUANE,MEOUANE,"TAIBA NDIAYE","KEUR MALLE NDIAYE",171,197,1434,1226,2660
THIES,TIVAOUANE,MEOUANE,"TAIBA NDIAYE","KEUR MAMBAYE KHARY",47,53,397,324,721
THIES,TIVAOUANE,MEOUANE,"TAIBA NDIAYE","KEUR MBAYE SENEBA",64,75,702,469,1171
THIES,TIVAOUANE,MEOUANE,"TAIBA NDIAYE","KEUR SAMBA AWA",45,56,396,350,746
THIES,TIVAOUANE,MEOUANE,"TAIBA NDIAYE","KHELCOM DE KEUR SERIGNE MOR DIOP",100,111,780,742,1522
THIES,TIVAOUANE,MEOUANE,"TAIBA NDIAYE","MAKA DIENG",35,49,327,310,637
THIES,TIVAOUANE,MEOUANE,"TAIBA NDIAYE","MAKA GUEYE BEYE",37,50,325,291,616
THIES,TIVAOUANE,MEOUANE,"TAIBA NDIAYE","H1 HADY PEULGUI",13,14,87,64,151
THIES,TIVAOUANE,MEOUANE,"TAIBA NDIAYE","MBAYENNE 3",126,151,1168,1086,2254
THIES,TIVAOUANE,MEOUANE,"TAIBA NDIAYE",MINAME,21,21,119,122,241
THIES,TIVAOUANE,MEOUANE,"TAIBA NDIAYE","NDIAMBA FALL",27,29,201,210,411
THIES,TIVAOUANE,MEOUANE,"TAIBA NDIAYE",NDOMOR,237,258,1294,1351,2645
THIES,TIVAOUANE,MEOUANE,"TAIBA NDIAYE","NDOYENE 2",60,63,298,321,619
THIES,TIVAOUANE,MEOUANE,"TAIBA NDIAYE",NGOMENE,44,53,345,299,644
THIES,TIVAOUANE,MEOUANE,"TAIBA NDIAYE","SAME NDIAYE",13,15,133,112,245
THIES,TIVAOUANE,MEOUANE,"TAIBA NDIAYE","TAIBA KHAB",37,38,227,185,412
THIES,TIVAOUANE,MEOUANE,"TAIBA NDIAYE","TAIBA MBAYE",300,359,2228,2357,4585
THIES,TIVAOUANE,MEOUANE,"TAIBA NDIAYE","TAIBA NDIAYE",396,493,2571,2784,5355
THIES,TIVAOUANE,MEOUANE,"TAIBA NDIAYE","TAIBA SANTHIE",108,139,1065,923,1988
THIES,TIVAOUANE,MEOUANE,"TAIBA NDIAYE",THIALLE,91,116,741,755,1496
THIES,TIVAOUANE,MEOUANE,"TAIBA NDIAYE","TAIBA KHAB ROUTE DE MBORO",4,4,111,9,120
THIES,TIVAOUANE,MEOUANE,"DAROU KHOUDOSS","ANDAL 1",71,159,397,396,793
THIES,TIVAOUANE,MEOUANE,"DAROU KHOUDOSS","H2 NAYLOU",34,37,180,172,352
THIES,TIVAOUANE,MEOUANE,"DAROU KHOUDOSS","H4 DAROU SALAM THIOUNE",64,70,454,366,820
THIES,TIVAOUANE,MEOUANE,"DAROU KHOUDOSS","H5 DAROU GUEYE",85,92,514,411,925
THIES,TIVAOUANE,MEOUANE,"DAROU KHOUDOSS","H6 DAROU KHOUDOSS THIOUNE",26,30,139,122,261
THIES,TIVAOUANE,MEOUANE,"DAROU KHOUDOSS","H7 DAROU NAIM",1,1,5,7,12
THIES,TIVAOUANE,MEOUANE,"DAROU KHOUDOSS","H8 KEUR EL HADJI SOW",6,6,24,22,46
THIES,TIVAOUANE,MEOUANE,"DAROU KHOUDOSS","H9 SANTH1OU ANDAL",67,91,349,306,655
THIES,TIVAOUANE,MEOUANE,"DAROU KHOUDOSS","ANDAL 2 (TOUBA NDIAYE)",111,157,948,814,1762
THIES,TIVAOUANE,MEOUANE,"DAROU KHOUDOSS","BALE GUEYE",18,24,147,152,299
THIES,TIVAOUANE,MEOUANE,"DAROU KHOUDOSS","BALE SAND",28,31,179,182,361
THIES,TIVAOUANE,MEOUANE,"DAROU KHOUDOSS","H1 WEUTA BEIGNE (H1 BEIGNE)",1,1,5,5,10
THIES,TIVAOUANE,MEOUANE,"DAROU KHOUDOSS","CHERIF SAMB",26,27,196,120,316
THIES,TIVAOUANE,MEOUANE,"DAROU KHOUDOSS","DAKHAR LAYE",13,16,120,129,249
THIES,TIVAOUANE,MEOUANE,"DAROU KHOUDOSS","DAROU DIA",18,18,166,153,319
THIES,TIVAOUANE,MEOUANE,"DAROU KHOUDOSS","DAROU DIOUF",36,41,317,336,653
THIES,TIVAOUANE,MEOUANE,"DAROU KHOUDOSS","H1 DAROU ALIM",40,50,338,322,660
THIES,TIVAOUANE,MEOUANE,"DAROU KHOUDOSS","H2 DAROU MBOYE",23,32,343,295,638
THIES,TIVAOUANE,MEOUANE,"DAROU KHOUDOSS","H3 DAROU SALAM DIOUF",74,74,455,425,880
THIES,TIVAOUANE,MEOUANE,"DAROU KHOUDOSS","H4 DAROU NDIAYE",81,89,556,564,1120
THIES,TIVAOUANE,MEOUANE,"DAROU KHOUDOSS","DAROU FALL",214,337,1700,1718,3418
THIES,TIVAOUANE,MEOUANE,"DAROU KHOUDOSS","H1 KAWSARA",12,16,82,68,150
THIES,TIVAOUANE,MEOUANE,"DAROU KHOUDOSS","H2 MBAYENNE",84,112,658,645,1303
THIES,TIVAOUANE,MEOUANE,"DAROU KHOUDOSS","DAROU GAYE",89,99,557,529,1086
THIES,TIVAOUANE,MEOUANE,"DAROU KHOUDOSS","DAROU KHOUDOSS",439,586,2466,2405,4871
THIES,TIVAOUANE,MEOUANE,"DAROU KHOUDOSS","H1 CITE DAROU (CITE ICS)",8,9,29,33,62
THIES,TIVAOUANE,MEOUANE,"DAROU KHOUDOSS","H2 CITE TAIBA",1,1,1,4,5
THIES,TIVAOUANE,MEOUANE,"DAROU KHOUDOSS","DAROU NDOYE",141,165,1029,836,1865
THIES,TIVAOUANE,MEOUANE,"DAROU KHOUDOSS",DIAMBALLO,13,16,106,98,204
THIES,TIVAOUANE,MEOUANE,"DAROU KHOUDOSS",DIOGO,153,180,1111,1087,2198
THIES,TIVAOUANE,MEOUANE,"DAROU KHOUDOSS","H1 DIOGO GUEDJI (SUR MER)",142,217,1347,1188,2535
THIES,TIVAOUANE,MEOUANE,"DAROU KHOUDOSS",DIOURMEL,128,163,623,550,1173
THIES,TIVAOUANE,MEOUANE,"DAROU KHOUDOSS","FASS BOYE",560,758,3605,3295,6900
THIES,TIVAOUANE,MEOUANE,"DAROU KHOUDOSS","H1 LITE",49,67,379,382,761
THIES,TIVAOUANE,MEOUANE,"DAROU KHOUDOSS","H3 TCHINTCHIE",91,107,600,511,1111
THIES,TIVAOUANE,MEOUANE,"DAROU KHOUDOSS",FOOT,214,278,1212,1174,2386
THIES,TIVAOUANE,MEOUANE,"DAROU KHOUDOSS","H1 KEUR AMADOU SOW (NDIALLOR)",25,39,408,414,822
THIES,TIVAOUANE,MEOUANE,"DAROU KHOUDOSS","NDIALLO (GOKHO)",27,30,128,68,196
THIES,TIVAOUANE,MEOUANE,"DAROU KHOUDOSS",GOLGAINDE,7,8,44,29,73
THIES,TIVAOUANE,MEOUANE,"DAROU KHOUDOSS","KEUR ALLE MAR",1,1,2,0,2
THIES,TIVAOUANE,MEOUANE,"DAROU KHOUDOSS","KEUR ASSANE MBAYE",25,25,186,186,372
THIES,TIVAOUANE,MEOUANE,"DAROU KHOUDOSS","KEUR BAKARY SARR",43,67,427,418,845
THIES,TIVAOUANE,MEOUANE,"DAROU KHOUDOSS","DIAMBALLO (KEUR DEMBA DIALLO)",19,21,137,111,248
THIES,TIVAOUANE,MEOUANE,"DAROU KHOUDOSS","KEUR DEMBA GAYE DIEYE",58,64,409,369,778
THIES,TIVAOUANE,MEOUANE,"DAROU KHOUDOSS","KEUR KHAR CISSE (NDIOP CISSE)",11,11,46,46,92
THIES,TIVAOUANE,MEOUANE,"DAROU KHOUDOSS","KEUR KHAR MBAYE (KEUR MBAYE)",5,5,41,42,83
THIES,TIVAOUANE,MEOUANE,"DAROU KHOUDOSS","H1 NDANGAR",4,4,20,15,35
THIES,TIVAOUANE,MEOUANE,"DAROU KHOUDOSS","KEUR MOR FALL",69,79,517,514,1031
THIES,TIVAOUANE,MEOUANE,"DAROU KHOUDOSS","KEUR SALIOU BA (DIAMBALLO)",34,47,294,221,515
THIES,TIVAOUANE,MEOUANE,"DAROU KHOUDOSS","KEUR YORO BA",9,12,64,58,122
THIES,TIVAOUANE,MEOUANE,"DAROU KHOUDOSS","MAKA THIOUNE",16,19,135,128,263
THIES,TIVAOUANE,MEOUANE,"DAROU KHOUDOSS","MBETETE 1",5,6,49,45,94
THIES,TIVAOUANE,MEOUANE,"DAROU KHOUDOSS","H3 KEUR SAGOR (DIALLO)",26,32,174,167,341
THIES,TIVAOUANE,MEOUANE,"DAROU KHOUDOSS","H4 THIARE",24,26,142,129,271
THIES,TIVAOUANE,MEOUANE,"DAROU KHOUDOSS","H6 DAROU SALAM WADE",27,32,267,191,458
THIES,TIVAOUANE,MEOUANE,"DAROU KHOUDOSS","MBETETE 2",19,23,161,152,313
THIES,TIVAOUANE,MEOUANE,"DAROU KHOUDOSS",MBIBASSE,38,42,259,216,475
THIES,TIVAOUANE,MEOUANE,"DAROU KHOUDOSS","H1 KHONKHYOYE",81,112,667,560,1227
THIES,TIVAOUANE,MEOUANE,"DAROU KHOUDOSS","H2 KEUR GAYE BA",3,13,56,45,101
THIES,TIVAOUANE,MEOUANE,"DAROU KHOUDOSS","H3 THIOKHMATE NIAYES",4,4,17,23,40
THIES,TIVAOUANE,MEOUANE,"DAROU KHOUDOSS","MBORO KONDIO",47,72,298,231,529
THIES,TIVAOUANE,MEOUANE,"DAROU KHOUDOSS","H3 KONDIO ECOLE",30,37,148,128,276
THIES,TIVAOUANE,MEOUANE,"DAROU KHOUDOSS","H4 MEDINA KONDIO",31,35,183,138,321
THIES,TIVAOUANE,MEOUANE,"DAROU KHOUDOSS","MBORO NDENDECATT",212,227,1321,954,2275
THIES,TIVAOUANE,MEOUANE,"DAROU KHOUDOSS","H2 KEUR ALIOU ARONA KA",11,13,46,35,81
THIES,TIVAOUANE,MEOUANE,"DAROU KHOUDOSS","H5 KEUR ABDOU MALICK",21,28,166,98,264
THIES,TIVAOUANE,MEOUANE,"DAROU KHOUDOSS","H6 KEUR DAOUDA BA",5,7,41,25,66
THIES,TIVAOUANE,MEOUANE,"DAROU KHOUDOSS","H7 KEUR DJIBY SOUKEYE",27,42,275,204,479
THIES,TIVAOUANE,MEOUANE,"DAROU KHOUDOSS","H8 KEUR MAMA KA",7,9,56,38,94
THIES,TIVAOUANE,MEOUANE,"DAROU KHOUDOSS","H9 KEUR POLEL",16,23,89,88,177
THIES,TIVAOUANE,MEOUANE,"DAROU KHOUDOSS","MBORO TOTAL",44,47,238,233,471
THIES,TIVAOUANE,MEOUANE,"DAROU KHOUDOSS","MERINA FALL",44,64,222,219,441
THIES,TIVAOUANE,MEOUANE,"DAROU KHOUDOSS","H1 KEUR DEMBA SOW",1,1,6,7,13
THIES,TIVAOUANE,MEOUANE,"DAROU KHOUDOSS","MERINA SAMB",14,16,96,90,186
THIES,TIVAOUANE,MEOUANE,"DAROU KHOUDOSS","MOUR DJIGUENE (KEUR NDONGO)",27,76,457,248,705
THIES,TIVAOUANE,MEOUANE,"DAROU KHOUDOSS","H1 TABLEAU BALE DIOP",7,9,69,18,87
THIES,TIVAOUANE,MEOUANE,"DAROU KHOUDOSS","H2 KEUR GALLO",13,22,104,80,184
THIES,TIVAOUANE,MEOUANE,"DAROU KHOUDOSS","NDAME LO (GOKHO)",13,16,92,79,171
THIES,TIVAOUANE,MEOUANE,"DAROU KHOUDOSS","H1 VERGER",2,2,5,4,9
THIES,TIVAOUANE,MEOUANE,"DAROU KHOUDOSS","H4 KEUR PATHE NDIAYE",22,30,177,152,329
THIES,TIVAOUANE,MEOUANE,"DAROU KHOUDOSS","H6 CENTRE",4,4,11,2,13
THIES,TIVAOUANE,MEOUANE,"DAROU KHOUDOSS","H7 CPFI",1,1,2,2,4
THIES,TIVAOUANE,MEOUANE,"DAROU KHOUDOSS","H8 KEUR LEMOU",10,15,76,63,139
THIES,TIVAOUANE,MEOUANE,"DAROU KHOUDOSS","H10 VERGER",1,1,4,1,5
THIES,TIVAOUANE,MEOUANE,"DAROU KHOUDOSS","H12 KEUR MAGUETTE GUEYE",22,31,145,131,276
THIES,TIVAOUANE,MEOUANE,"DAROU KHOUDOSS",NDENE,11,28,115,77,192
THIES,TIVAOUANE,MEOUANE,"DAROU KHOUDOSS",NDEUNOUTTE,19,31,163,152,315
THIES,TIVAOUANE,MEOUANE,"DAROU KHOUDOSS","NDIALCOUGNE KHABE",168,255,1477,1347,2824
THIES,TIVAOUANE,MEOUANE,"DAROU KHOUDOSS","NDIOP SAO",112,163,968,770,1738
THIES,TIVAOUANE,MEOUANE,"DAROU KHOUDOSS","H1 BEIGNE NDIOP SAO",47,91,445,360,805
THIES,TIVAOUANE,MEOUANE,"DAROU KHOUDOSS","H2 NDIAWRINE GUEDJI",23,48,224,191,415
THIES,TIVAOUANE,MEOUANE,"DAROU KHOUDOSS","NDJILIGNE (THIALLA)",99,126,681,745,1426
THIES,TIVAOUANE,MEOUANE,"DAROU KHOUDOSS",NDONG,106,120,665,656,1321
THIES,TIVAOUANE,MEOUANE,"DAROU KHOUDOSS","NGAYE DIAGNE",141,154,823,742,1565
THIES,TIVAOUANE,MEOUANE,"DAROU KHOUDOSS","NGAYE NGAYE",140,150,641,621,1262
THIES,TIVAOUANE,MEOUANE,"DAROU KHOUDOSS","NGOUYE WADE",188,243,1629,1530,3159
THIES,TIVAOUANE,MEOUANE,"DAROU KHOUDOSS","NGOUYE YAWOTE (DAROU BEYE)",55,69,463,421,884
THIES,TIVAOUANE,MEOUANE,"DAROU KHOUDOSS","H2 MBA",8,8,48,53,101
THIES,TIVAOUANE,MEOUANE,"DAROU KHOUDOSS","H3 KEUR AMADOU COR DIEYE",13,14,81,68,149
THIES,TIVAOUANE,MEOUANE,"DAROU KHOUDOSS","H4 KEUR MAGUEYE DIOP (NDEYE SOUF)",7,7,49,30,79
THIES,TIVAOUANE,MEOUANE,"DAROU KHOUDOSS","NIANGUE WADE",45,50,270,353,623
THIES,TIVAOUANE,MEOUANE,"DAROU KHOUDOSS",PEUPENE,74,82,590,553,1143
THIES,TIVAOUANE,MEOUANE,"DAROU KHOUDOSS","SANTHIOU NDONG",64,79,494,481,975
THIES,TIVAOUANE,MEOUANE,"DAROU KHOUDOSS","SANTHIOU SINE",22,38,297,238,535
THIES,TIVAOUANE,MEOUANE,"DAROU KHOUDOSS","H1 KEUR SAMBA SOW",4,4,27,14,41
THIES,TIVAOUANE,MEOUANE,"DAROU KHOUDOSS",SAO,205,317,2159,1910,4069
THIES,TIVAOUANE,MEOUANE,"DAROU KHOUDOSS","SAO MEKHE 1",16,19,105,103,208
THIES,TIVAOUANE,MEOUANE,"DAROU KHOUDOSS","SAO MEKHE 2",46,74,346,322,668
THIES,TIVAOUANE,MEOUANE,"DAROU KHOUDOSS","H1 NGUEYENE PEULH",17,27,117,122,239
THIES,TIVAOUANE,MEOUANE,"DAROU KHOUDOSS","SAO MEKHE PEULH (KEUR DEMBA LY)",23,67,263,239,502
THIES,TIVAOUANE,MEOUANE,"DAROU KHOUDOSS","H1 KEUR MODOU MAYE KA",9,55,207,224,431
THIES,TIVAOUANE,MEOUANE,"DAROU KHOUDOSS","H2 BROUSSE",14,39,184,110,294
THIES,TIVAOUANE,MEOUANE,"DAROU KHOUDOSS","SEGUEUL THIOUNE",27,32,185,177,362
THIES,TIVAOUANE,MEOUANE,"DAROU KHOUDOSS","H1 NGUINOP GUEYE",73,84,487,428,915
THIES,TIVAOUANE,MEOUANE,"DAROU KHOUDOSS","H2 KEUR SALIF",5,5,27,28,55
THIES,TIVAOUANE,MEOUANE,"DAROU KHOUDOSS","SINTHIOU NDAKHAR",84,93,507,486,993
THIES,TIVAOUANE,MEOUANE,"DAROU KHOUDOSS","SINTHIOU WAKHAL",277,341,1691,1590,3281
THIES,TIVAOUANE,MEOUANE,"DAROU KHOUDOSS",TANIME,21,22,166,127,293
THIES,TIVAOUANE,MEOUANE,"DAROU KHOUDOSS",THIAMROUSS,44,54,328,353,681
THIES,TIVAOUANE,MEOUANE,"DAROU KHOUDOSS","H1 PALENE",29,31,144,179,323
THIES,TIVAOUANE,MEOUANE,"DAROU KHOUDOSS","THIENO NDIAYE",3,6,30,19,49
THIES,TIVAOUANE,MEOUANE,"DAROU KHOUDOSS",THIOKHMATE,45,132,635,619,1254
THIES,TIVAOUANE,MEOUANE,"DAROU KHOUDOSS","THIOUCOUGNE PEULH",26,60,327,317,644
THIES,TIVAOUANE,MEOUANE,"DAROU KHOUDOSS",THISSE,47,63,242,225,467
THIES,TIVAOUANE,MEOUANE,"DAROU KHOUDOSS",WEUTA,21,36,117,132,249
THIES,TIVAOUANE,MEOUANE,"DAROU KHOUDOSS","H2 MBAGNE POUR",9,14,63,45,108
THIES,TIVAOUANE,MEOUANE,"DAROU KHOUDOSS","DAROU SALAM LINDIANE",50,53,266,179,445
THIES,TIVAOUANE,MEOUANE,"DAROU KHOUDOSS","GARAGE PATHE NDIAYE",26,31,150,127,277
THIES,TIVAOUANE,MEOUANE,"DAROU KHOUDOSS","GUEDJ LOBOR",1,3,15,7,22
THIES,TIVAOUANE,MEOUANE,"DAROU KHOUDOSS",GUEDJI,29,47,223,151,374
THIES,TIVAOUANE,MEOUANE,"DAROU KHOUDOSS","KEUR BATHIE",6,19,76,59,135
THIES,TIVAOUANE,MEOUANE,"DAROU KHOUDOSS","KEUR LEMOU",21,34,195,170,365
THIES,TIVAOUANE,MEOUANE,"DAROU KHOUDOSS","KEUR MBAYE NDAO",66,104,735,581,1316
THIES,TIVAOUANE,MEOUANE,"DAROU KHOUDOSS","LOUMPOUL SUR MER (REGION LOUGA)",194,278,1148,999,2147
THIES,TIVAOUANE,MEOUANE,"DAROU KHOUDOSS","MBORO BEUNO",38,98,431,385,816
THIES,TIVAOUANE,MEOUANE,"DAROU KHOUDOSS","H1 KEUR DAOUDA KA",20,31,141,132,273
THIES,TIVAOUANE,MEOUANE,"DAROU KHOUDOSS","MBORO 1",43,46,194,152,346
THIES,TIVAOUANE,MEOUANE,"DAROU KHOUDOSS","MEDINA FALL",151,175,878,868,1746
THIES,TIVAOUANE,MEOUANE,"DAROU KHOUDOSS",NDEUNE,29,32,167,139,306
THIES,TIVAOUANE,MEOUANE,"DAROU KHOUDOSS","NDEUNOUTE (THIENO NDIAYE)",27,70,268,259,527
THIES,TIVAOUANE,MEOUANE,"DAROU KHOUDOSS","NDIALKOUGNE DIOR",20,20,124,107,231
THIES,TIVAOUANE,MEOUANE,"DAROU KHOUDOSS",NGANGHAR,47,54,308,309,617
THIES,TIVAOUANE,MEOUANE,"DAROU KHOUDOSS","THISSE 2",50,69,452,410,862
THIES,TIVAOUANE,MEOUANE,"DAROU KHOUDOSS","H1 BEIGNE THISSE 2",17,43,154,158,312
THIES,TIVAOUANE,MEOUANE,"DAROU KHOUDOSS","WEUTA LOBOR",5,6,24,17,41
THIES,TIVAOUANE,MEOUANE,MBORO,"CITE MBAYE MBAYE",78,80,170,177,347
THIES,TIVAOUANE,MEOUANE,MBORO,"CITE OUVRIERE (MBORO 8)",277,313,1002,994,1996
THIES,TIVAOUANE,MEOUANE,MBORO,"KEUR DEMBA SOW",89,99,400,310,710
THIES,TIVAOUANE,MEOUANE,MBORO,"MBORO 1",589,646,3434,3104,6538
THIES,TIVAOUANE,MEOUANE,MBORO,"MBORO 2",373,425,2486,2389,4875
THIES,TIVAOUANE,MEOUANE,MBORO,"MBORO 3",249,313,1418,1517,2935
THIES,TIVAOUANE,MEOUANE,MBORO,"MBORO 4",261,342,1854,1675,3529
THIES,TIVAOUANE,MEOUANE,MBORO,"MBORO 5 (HLM LASSERE)",289,334,1384,1393,2777
THIES,TIVAOUANE,MEOUANE,MBORO,"MBORO 6",276,329,1460,1457,2917
THIES,TIVAOUANE,MEOUANE,MBORO,"MBORO 7",230,262,1772,1480,3252
THIES,TIVAOUANE,MEOUANE,MBORO,"MBORO 9",413,471,1652,1555,3207
THIES,TIVAOUANE,MEOUANE,MBORO,"MBORO 10",884,985,3919,3809,7728
THIES,TIVAOUANE,"MERINA DAKHAR",KOUL,BEGAL,25,29,147,170,317
THIES,TIVAOUANE,"MERINA DAKHAR",KOUL,DANGA,18,24,99,106,205
THIES,TIVAOUANE,"MERINA DAKHAR",KOUL,"H1 MESSERE",9,17,110,91,201
THIES,TIVAOUANE,"MERINA DAKHAR",KOUL,"DAROU GAYE ET KEUR MADIARA TALLA",45,49,292,424,716
THIES,TIVAOUANE,"MERINA DAKHAR",KOUL,"DAROU KANDJI",24,26,186,167,353
THIES,TIVAOUANE,"MERINA DAKHAR",KOUL,"DAROU NDIAYE GOLY",25,32,151,129,280
THIES,TIVAOUANE,"MERINA DAKHAR",KOUL,"DAROU NDIAYE SAMBA",13,15,81,58,139
THIES,TIVAOUANE,"MERINA DAKHAR",KOUL,"DAROU NGUER (NGUER II)",18,22,185,171,356
THIES,TIVAOUANE,"MERINA DAKHAR",KOUL,"DAROU SEYE",10,11,117,117,234
THIES,TIVAOUANE,"MERINA DAKHAR",KOUL,"DIACKSAO TAYE",18,20,153,139,292
THIES,TIVAOUANE,"MERINA DAKHAR",KOUL,"H1 NARGA",5,5,32,28,60
THIES,TIVAOUANE,"MERINA DAKHAR",KOUL,"DIAMA THIENDOU",56,72,380,446,826
THIES,TIVAOUANE,"MERINA DAKHAR",KOUL,FASS,94,141,858,966,1824
THIES,TIVAOUANE,"MERINA DAKHAR",KOUL,"FASS DIONE",29,32,133,169,302
THIES,TIVAOUANE,"MERINA DAKHAR",KOUL,"GADE KOUL",7,15,90,93,183
THIES,TIVAOUANE,"MERINA DAKHAR",KOUL,GOLOBE,42,46,253,265,518
THIES,TIVAOUANE,"MERINA DAKHAR",KOUL,"GOUYE NDIORO ALIOU",13,14,55,67,122
THIES,TIVAOUANE,"MERINA DAKHAR",KOUL,"KERY GAKOU",3,4,11,19,30
THIES,TIVAOUANE,"MERINA DAKHAR",KOUL,"KERY NDIOBENE",7,8,71,62,133
THIES,TIVAOUANE,"MERINA DAKHAR",KOUL,"KEUR ABDOU NDAO NDIAYE",9,15,54,68,122
THIES,TIVAOUANE,"MERINA DAKHAR",KOUL,"KEUR BABA NGOM",2,4,15,28,43
THIES,TIVAOUANE,"MERINA DAKHAR",KOUL,"KEUR KHASSAM",10,10,98,66,164
THIES,TIVAOUANE,"MERINA DAKHAR",KOUL,"H1 KEUR DIAM",4,4,11,15,26
THIES,TIVAOUANE,"MERINA DAKHAR",KOUL,"KEUR MADOCKY ABDOU",13,13,87,125,212
THIES,TIVAOUANE,"MERINA DAKHAR",KOUL,"KEUR MADOCKY DEURGEUNE",15,18,123,100,223
THIES,TIVAOUANE,"MERINA DAKHAR",KOUL,"KEUR MASSAMBA FATIM",34,36,294,290,584
THIES,TIVAOUANE,"MERINA DAKHAR",KOUL,"KEUR MOUTOUPHA",2,3,25,15,40
THIES,TIVAOUANE,"MERINA DAKHAR",KOUL,"KEUR NDIAGA MBAYE (KEUR MOR ARAME)",7,13,48,59,107
THIES,TIVAOUANE,"MERINA DAKHAR",KOUL,"KEUR WALY THIAW",21,24,109,131,240
THIES,TIVAOUANE,"MERINA DAKHAR",KOUL,KHANDANE,112,171,965,1001,1966
THIES,TIVAOUANE,"MERINA DAKHAR",KOUL,KILOU,8,15,106,96,202
THIES,TIVAOUANE,"MERINA DAKHAR",KOUL,KOUL,55,69,487,423,910
THIES,TIVAOUANE,"MERINA DAKHAR",KOUL,"KOURE DECK",63,71,378,607,985
THIES,TIVAOUANE,"MERINA DAKHAR",KOUL,"KOURE DIOR",52,60,482,563,1045
THIES,TIVAOUANE,"MERINA DAKHAR",KOUL,LAMDIANE,42,48,269,274,543
THIES,TIVAOUANE,"MERINA DAKHAR",KOUL,LISSAR,19,27,184,160,344
THIES,TIVAOUANE,"MERINA DAKHAR",KOUL,"LONKANE DIOP ET DIAMBOR",17,19,88,91,179
THIES,TIVAOUANE,"MERINA DAKHAR",KOUL,"LONKANE NGOM",25,29,231,187,418
THIES,TIVAOUANE,"MERINA DAKHAR",KOUL,"MABOUR 1",7,7,45,49,94
THIES,TIVAOUANE,"MERINA DAKHAR",KOUL,"MABOUR 2",2,2,14,4,18
THIES,TIVAOUANE,"MERINA DAKHAR",KOUL,"MACKA DIAW",2,6,53,43,96
THIES,TIVAOUANE,"MERINA DAKHAR",KOUL,"MBADIANE LACK",9,10,54,49,103
THIES,TIVAOUANE,"MERINA DAKHAR",KOUL,MBELLETHIE,16,18,84,134,218
THIES,TIVAOUANE,"MERINA DAKHAR",KOUL,MBEULEUKHE,1,1,3,0,3
THIES,TIVAOUANE,"MERINA DAKHAR",KOUL,MBOUFTA,19,21,132,118,250
THIES,TIVAOUANE,"MERINA DAKHAR",KOUL,"MEUME OUOLOF",41,41,307,303,610
THIES,TIVAOUANE,"MERINA DAKHAR",KOUL,"MEUME PEULH",28,32,176,197,373
THIES,TIVAOUANE,"MERINA DAKHAR",KOUL,NDAGNAR,10,12,97,85,182
THIES,TIVAOUANE,"MERINA DAKHAR",KOUL,"NDAME LO",9,10,23,55,78
THIES,TIVAOUANE,"MERINA DAKHAR",KOUL,"NDAME MOUSSEU",8,8,71,67,138
THIES,TIVAOUANE,"MERINA DAKHAR",KOUL,"NDAME NDIAGA",5,5,31,30,61
THIES,TIVAOUANE,"MERINA DAKHAR",KOUL,"H2 KEUR ADAMA DIA",19,29,181,157,338
THIES,TIVAOUANE,"MERINA DAKHAR",KOUL,"NDEUCKOU MAMOUR",9,12,67,76,143
THIES,TIVAOUANE,"MERINA DAKHAR",KOUL,"NDEUCKOU LAMANE ET LEWDOYE",20,20,163,171,334
THIES,TIVAOUANE,"MERINA DAKHAR",KOUL,"NDIA NDEUKOU",50,56,371,357,728
THIES,TIVAOUANE,"MERINA DAKHAR",KOUL,NDIAGNE,27,34,211,170,381
THIES,TIVAOUANE,"MERINA DAKHAR",KOUL,NDIAKHALANE,38,44,284,293,577
THIES,TIVAOUANE,"MERINA DAKHAR",KOUL,"NDIAKHATE SAER",17,24,85,154,239
THIES,TIVAOUANE,"MERINA DAKHAR",KOUL,"H1 KEUR CHEIKH DIAKHATE",5,5,33,30,63
THIES,TIVAOUANE,"MERINA DAKHAR",KOUL,NDIAWAR,8,8,50,43,93
THIES,TIVAOUANE,"MERINA DAKHAR",KOUL,"NDIAYENE LACK",21,26,187,162,349
THIES,TIVAOUANE,"MERINA DAKHAR",KOUL,NDIOURENE,4,8,41,31,72
THIES,TIVAOUANE,"MERINA DAKHAR",KOUL,"NDOUL NDOUL",8,9,59,57,116
THIES,TIVAOUANE,"MERINA DAKHAR",KOUL,"NDOMBOLOKH 1",20,20,170,127,297
THIES,TIVAOUANE,"MERINA DAKHAR",KOUL,"H1 NDOMBOLOKH 2",17,19,112,114,226
THIES,TIVAOUANE,"MERINA DAKHAR",KOUL,"NGADIAM NDIAYE",21,28,133,139,272
THIES,TIVAOUANE,"MERINA DAKHAR",KOUL,"NGADIAM SALL",8,9,42,45,87
THIES,TIVAOUANE,"MERINA DAKHAR",KOUL,NGANDECK,22,29,139,180,319
THIES,TIVAOUANE,"MERINA DAKHAR",KOUL,"H1 DARA AMAR",9,11,102,102,204
THIES,TIVAOUANE,"MERINA DAKHAR",KOUL,"H2 WAKHALDIAME",14,18,68,78,146
THIES,TIVAOUANE,"MERINA DAKHAR",KOUL,"H3 PEULGA",1,1,4,12,16
THIES,TIVAOUANE,"MERINA DAKHAR",KOUL,"NGARAF NDEUKOU",26,29,171,185,356
THIES,TIVAOUANE,"MERINA DAKHAR",KOUL,"NGAYE NGAYE NDIABAL",40,43,409,313,722
THIES,TIVAOUANE,"MERINA DAKHAR",KOUL,"NGAYE NGAYE ALY",9,9,40,42,82
THIES,TIVAOUANE,"MERINA DAKHAR",KOUL,"H3 KEUR ALY GAYE",12,12,53,57,110
THIES,TIVAOUANE,"MERINA DAKHAR",KOUL,"NGAYE NGAYE ASSANE",21,23,245,229,474
THIES,TIVAOUANE,"MERINA DAKHAR",KOUL,NGHASS,28,34,308,276,584
THIES,TIVAOUANE,"MERINA DAKHAR",KOUL,"NGIMBE DAROU DIOP",9,9,47,68,115
THIES,TIVAOUANE,"MERINA DAKHAR",KOUL,NGOSS,9,9,60,50,110
THIES,TIVAOUANE,"MERINA DAKHAR",KOUL,"GOUYE SOUKHE",13,15,91,92,183
THIES,TIVAOUANE,"MERINA DAKHAR",KOUL,"NGUER 1",35,42,245,182,427
THIES,TIVAOUANE,"MERINA DAKHAR",KOUL,"NIAKHENE (NDIAYENE)",19,29,197,131,328
THIES,TIVAOUANE,"MERINA DAKHAR",KOUL,NIAMINA,1,1,2,5,7
THIES,TIVAOUANE,"MERINA DAKHAR",KOUL,"NIASSE MOMAR",15,16,136,112,248
THIES,TIVAOUANE,"MERINA DAKHAR",KOUL,"NIASSE NDIAGA",3,7,69,53,122
THIES,TIVAOUANE,"MERINA DAKHAR",KOUL,PAYENE,18,23,142,153,295
THIES,TIVAOUANE,"MERINA DAKHAR",KOUL,"H1 NIANENE",6,6,30,38,68
THIES,TIVAOUANE,"MERINA DAKHAR",KOUL,RINDANG,8,14,81,63,144
THIES,TIVAOUANE,"MERINA DAKHAR",KOUL,"RISSO 1 (SANTHIE)",39,52,231,286,517
THIES,TIVAOUANE,"MERINA DAKHAR",KOUL,"RISSO 2 (GUEDE)",35,58,344,364,708
THIES,TIVAOUANE,"MERINA DAKHAR",KOUL,SAKHE,38,40,223,184,407
THIES,TIVAOUANE,"MERINA DAKHAR",KOUL,"SANTHIOU SINE ET GUEDJI",83,101,456,338,794
THIES,TIVAOUANE,"MERINA DAKHAR",KOUL,"H1 KEUR DARA SAM",12,13,111,90,201
THIES,TIVAOUANE,"MERINA DAKHAR",KOUL,"THINE SANDIOUGA",7,12,85,100,185
THIES,TIVAOUANE,"MERINA DAKHAR",KOUL,"TEUGUE MBAYE",2,2,10,6,16
THIES,TIVAOUANE,"MERINA DAKHAR",KOUL,"THIALLENE ET NDATTE",10,13,79,70,149
THIES,TIVAOUANE,"MERINA DAKHAR",KOUL,"THIAR BEYE",7,12,73,79,152
THIES,TIVAOUANE,"MERINA DAKHAR",KOUL,"THIARE KHANDANE",14,24,201,198,399
THIES,TIVAOUANE,"MERINA DAKHAR",KOUL,THIARENE,16,21,200,200,400
THIES,TIVAOUANE,"MERINA DAKHAR",KOUL,"TOUBA KANE",55,60,235,262,497
THIES,TIVAOUANE,"MERINA DAKHAR",KOUL,"TOUBA KHANDANE",7,7,61,53,114
THIES,TIVAOUANE,"MERINA DAKHAR",KOUL,"TOUBE FALL",9,9,134,57,191
THIES,TIVAOUANE,"MERINA DAKHAR",KOUL,NGOMENE,11,13,126,104,230
THIES,TIVAOUANE,"MERINA DAKHAR","MERINA DAKHAR",BAITY,8,8,88,104,192
THIES,TIVAOUANE,"MERINA DAKHAR","MERINA DAKHAR","BAKH DASS",7,9,55,85,140
THIES,TIVAOUANE,"MERINA DAKHAR","MERINA DAKHAR",BARDIAL,17,17,70,81,151
THIES,TIVAOUANE,"MERINA DAKHAR","MERINA DAKHAR","BATTAL 1",39,50,375,334,709
THIES,TIVAOUANE,"MERINA DAKHAR","MERINA DAKHAR","BATTAL 2",22,30,124,140,264
THIES,TIVAOUANE,"MERINA DAKHAR","MERINA DAKHAR","BEUDE (BEUDE DIENG)",73,78,340,508,848
THIES,TIVAOUANE,"MERINA DAKHAR","MERINA DAKHAR",BOUSSOURA,13,16,138,123,261
THIES,TIVAOUANE,"MERINA DAKHAR","MERINA DAKHAR","H1 KEUR MOR THIAMA",8,9,37,45,82
THIES,TIVAOUANE,"MERINA DAKHAR","MERINA DAKHAR","DALAKH 1",11,11,44,41,85
THIES,TIVAOUANE,"MERINA DAKHAR","MERINA DAKHAR","H1 NDIAKHA",8,9,39,42,81
THIES,TIVAOUANE,"MERINA DAKHAR","MERINA DAKHAR","DALAKH 2",13,18,92,112,204
THIES,TIVAOUANE,"MERINA DAKHAR","MERINA DAKHAR","DAROU DIOP",3,4,24,22,46
THIES,TIVAOUANE,"MERINA DAKHAR","MERINA DAKHAR","H1 PEULGA de DAROU DIOP",4,7,38,37,75
THIES,TIVAOUANE,"MERINA DAKHAR","MERINA DAKHAR","DAROU NDIOBENE",7,9,44,50,94
THIES,TIVAOUANE,"MERINA DAKHAR","MERINA DAKHAR","DAROU SALAM KEUR SAFARMA (DAROU SALAM CADIOR)",48,54,255,203,458
THIES,TIVAOUANE,"MERINA DAKHAR","MERINA DAKHAR","DAROU SALL",1,1,1,1,2
THIES,TIVAOUANE,"MERINA DAKHAR","MERINA DAKHAR","DAW GAYE (KEUR DAO GAYE)",11,16,79,102,181
THIES,TIVAOUANE,"MERINA DAKHAR","MERINA DAKHAR","DAWAKH BA",15,18,51,87,138
THIES,TIVAOUANE,"MERINA DAKHAR","MERINA DAKHAR","DAWAKH SOURANG",14,16,67,58,125
THIES,TIVAOUANE,"MERINA DAKHAR","MERINA DAKHAR","DIOKOUL SANTHIAM",23,23,187,140,327
THIES,TIVAOUANE,"MERINA DAKHAR","MERINA DAKHAR","DIOKOUL TABBY",41,51,298,303,601
THIES,TIVAOUANE,"MERINA DAKHAR","MERINA DAKHAR",DIOR,14,23,80,96,176
THIES,TIVAOUANE,"MERINA DAKHAR","MERINA DAKHAR","GADE NDIASS",18,22,147,118,265
THIES,TIVAOUANE,"MERINA DAKHAR","MERINA DAKHAR","GADE NIANDOUL",20,26,202,184,386
THIES,TIVAOUANE,"MERINA DAKHAR","MERINA DAKHAR","GANGOU (DIAKHATE GANGOU)",28,33,188,193,381
THIES,TIVAOUANE,"MERINA DAKHAR","MERINA DAKHAR",GATEIGNE,53,60,339,413,752
THIES,TIVAOUANE,"MERINA DAKHAR","MERINA DAKHAR",GATHIE,4,6,49,64,113
THIES,TIVAOUANE,"MERINA DAKHAR","MERINA DAKHAR",GATTY,47,58,273,386,659
THIES,TIVAOUANE,"MERINA DAKHAR","MERINA DAKHAR","GOUYE NDIORO BABACAR",7,7,47,43,90
THIES,TIVAOUANE,"MERINA DAKHAR","MERINA DAKHAR","KAHONE DIAGNE",9,11,80,70,150
THIES,TIVAOUANE,"MERINA DAKHAR","MERINA DAKHAR",KALENE,21,27,161,177,338
THIES,TIVAOUANE,"MERINA DAKHAR","MERINA DAKHAR",KANE,23,26,228,169,397
THIES,TIVAOUANE,"MERINA DAKHAR","MERINA DAKHAR","H1 KEUR MODOU SOW",2,2,12,13,25
THIES,TIVAOUANE,"MERINA DAKHAR","MERINA DAKHAR",KEBE,3,4,59,41,100
THIES,TIVAOUANE,"MERINA DAKHAR","MERINA DAKHAR",KELLE,215,255,1224,1431,2655
THIES,TIVAOUANE,"MERINA DAKHAR","MERINA DAKHAR","KEUR DIADIE (KEUR MASSAMBA)",39,43,282,236,518
THIES,TIVAOUANE,"MERINA DAKHAR","MERINA DAKHAR","KEUR MANDIEME",8,12,88,92,180
THIES,TIVAOUANE,"MERINA DAKHAR","MERINA DAKHAR","KEUR MEDOUNE GNING",13,31,125,135,260
THIES,TIVAOUANE,"MERINA DAKHAR","MERINA DAKHAR","KEUR THIAR",19,22,131,115,246
THIES,TIVAOUANE,"MERINA DAKHAR","MERINA DAKHAR","KHABONG (DAROU KANE)",9,9,57,59,116
THIES,TIVAOUANE,"MERINA DAKHAR","MERINA DAKHAR","KHAYE NGUISSAME",14,21,69,88,157
THIES,TIVAOUANE,"MERINA DAKHAR","MERINA DAKHAR",KOUDIANE,43,47,274,344,618
THIES,TIVAOUANE,"MERINA DAKHAR","MERINA DAKHAR","H1 NDJILIWENE",3,8,28,43,71
THIES,TIVAOUANE,"MERINA DAKHAR","MERINA DAKHAR","H2 KEUR NDIAGA",16,30,196,204,400
THIES,TIVAOUANE,"MERINA DAKHAR","MERINA DAKHAR","KOURE MBATAR 1",6,19,83,79,162
THIES,TIVAOUANE,"MERINA DAKHAR","MERINA DAKHAR","KOURE MBATAR 2",14,21,141,134,275
THIES,TIVAOUANE,"MERINA DAKHAR","MERINA DAKHAR","KOURE NDIAWAR",18,25,167,149,316
THIES,TIVAOUANE,"MERINA DAKHAR","MERINA DAKHAR","LOUKOUCK CISS",33,42,144,161,305
THIES,TIVAOUANE,"MERINA DAKHAR","MERINA DAKHAR","LOUKOUCK FALL",11,17,62,57,119
THIES,TIVAOUANE,"MERINA DAKHAR","MERINA DAKHAR","LOUKOUCK NDIAYE",5,6,20,24,44
THIES,TIVAOUANE,"MERINA DAKHAR","MERINA DAKHAR","LOYENE MBAR",22,30,190,165,355
THIES,TIVAOUANE,"MERINA DAKHAR","MERINA DAKHAR","H1 KEUR MOUSSE SOW",3,3,14,11,25
THIES,TIVAOUANE,"MERINA DAKHAR","MERINA DAKHAR","LOYENE NIOCK",28,30,153,162,315
THIES,TIVAOUANE,"MERINA DAKHAR","MERINA DAKHAR","H1 PEULGA de LOYENE NIOCK",3,3,23,17,40
THIES,TIVAOUANE,"MERINA DAKHAR","MERINA DAKHAR","LOYENE YIROU",40,50,246,295,541
THIES,TIVAOUANE,"MERINA DAKHAR","MERINA DAKHAR","H1 KOURE",13,17,106,105,211
THIES,TIVAOUANE,"MERINA DAKHAR","MERINA DAKHAR","MACKA SARR",36,46,374,386,760
THIES,TIVAOUANE,"MERINA DAKHAR","MERINA DAKHAR",MAICK,24,24,129,143,272
THIES,TIVAOUANE,"MERINA DAKHAR","MERINA DAKHAR","H1 KEUR MOR FARY",7,9,48,36,84
THIES,TIVAOUANE,"MERINA DAKHAR","MERINA DAKHAR",MBALLENE,12,12,123,94,217
THIES,TIVAOUANE,"MERINA DAKHAR","MERINA DAKHAR","MBAMBA TALL",29,32,223,225,448
THIES,TIVAOUANE,"MERINA DAKHAR","MERINA DAKHAR","MBERE (MBERE DIAGNE)",22,24,262,200,462
THIES,TIVAOUANE,"MERINA DAKHAR","MERINA DAKHAR","MBODIENE AMAR",12,13,77,49,126
THIES,TIVAOUANE,"MERINA DAKHAR","MERINA DAKHAR","H1 NGARAF",8,15,66,57,123
THIES,TIVAOUANE,"MERINA DAKHAR","MERINA DAKHAR","MBODIENE NDIAYE",16,17,82,137,219
THIES,TIVAOUANE,"MERINA DAKHAR","MERINA DAKHAR",MBOUKI,2,2,4,9,13
THIES,TIVAOUANE,"MERINA DAKHAR","MERINA DAKHAR","MERINA DAKHAR",50,62,344,308,652
THIES,TIVAOUANE,"MERINA DAKHAR","MERINA DAKHAR","MERINA NDIASS",14,18,87,106,193
THIES,TIVAOUANE,"MERINA DAKHAR","MERINA DAKHAR","MERINA THIOUNE",19,20,161,137,298
THIES,TIVAOUANE,"MERINA DAKHAR","MERINA DAKHAR","NDAKHMA (NDAKHMA DIAGNE)",12,14,100,68,168
THIES,TIVAOUANE,"MERINA DAKHAR","MERINA DAKHAR","H1 KEUR GALLO BA",4,4,51,36,87
THIES,TIVAOUANE,"MERINA DAKHAR","MERINA DAKHAR",NDAWENE,25,30,170,201,371
THIES,TIVAOUANE,"MERINA DAKHAR","MERINA DAKHAR","NDER NAR",27,31,201,169,370
THIES,TIVAOUANE,"MERINA DAKHAR","MERINA DAKHAR","NDER OUOLOF",19,20,190,165,355
THIES,TIVAOUANE,"MERINA DAKHAR","MERINA DAKHAR","NDIABY NDIAYE",12,13,51,57,108
THIES,TIVAOUANE,"MERINA DAKHAR","MERINA DAKHAR","NDIAKHATE BOUYA",23,24,192,133,325
THIES,TIVAOUANE,"MERINA DAKHAR","MERINA DAKHAR","NDIAKHATE GATEIGNE",18,19,90,125,215
THIES,TIVAOUANE,"MERINA DAKHAR","MERINA DAKHAR",NDIANDATE,10,11,110,91,201
THIES,TIVAOUANE,"MERINA DAKHAR","MERINA DAKHAR","NDIANDIAR (NDIANDIAR MAKHA)",16,19,155,122,277
THIES,TIVAOUANE,"MERINA DAKHAR","MERINA DAKHAR","NDIANDIAR SAMBA",18,23,190,172,362
THIES,TIVAOUANE,"MERINA DAKHAR","MERINA DAKHAR",NDIANKHANG,17,22,68,73,141
THIES,TIVAOUANE,"MERINA DAKHAR","MERINA DAKHAR",NDIARAM,13,17,92,65,157
THIES,TIVAOUANE,"MERINA DAKHAR","MERINA DAKHAR",NDIARIGNE,19,30,146,196,342
THIES,TIVAOUANE,"MERINA DAKHAR","MERINA DAKHAR",NDIASS,30,37,265,232,497
THIES,TIVAOUANE,"MERINA DAKHAR","MERINA DAKHAR","NDIAYE DIAMANIANE",32,37,200,200,400
THIES,TIVAOUANE,"MERINA DAKHAR","MERINA DAKHAR","H1 KEUR GORA FALL",1,4,20,12,32
THIES,TIVAOUANE,"MERINA DAKHAR","MERINA DAKHAR","NDIAYENE DALY",6,11,41,53,94
THIES,TIVAOUANE,"MERINA DAKHAR","MERINA DAKHAR","H1 THIAMBENE",2,2,17,18,35
THIES,TIVAOUANE,"MERINA DAKHAR","MERINA DAKHAR","H2 LAMBENE",3,3,11,17,28
THIES,TIVAOUANE,"MERINA DAKHAR","MERINA DAKHAR","NDIAYENE MBATAL",24,27,217,188,405
THIES,TIVAOUANE,"MERINA DAKHAR","MERINA DAKHAR",NDIE,6,6,43,48,91
THIES,TIVAOUANE,"MERINA DAKHAR","MERINA DAKHAR","NDIOB NGUELEUM",5,5,27,28,55
THIES,TIVAOUANE,"MERINA DAKHAR","MERINA DAKHAR","NDOGAL DIENG",9,9,67,56,123
THIES,TIVAOUANE,"MERINA DAKHAR","MERINA DAKHAR",NDOMBIL,19,21,80,107,187
THIES,TIVAOUANE,"MERINA DAKHAR","MERINA DAKHAR",NDOURENE,1,1,3,5,8
THIES,TIVAOUANE,"MERINA DAKHAR","MERINA DAKHAR","NDOURENE BATAL",7,7,70,63,133
THIES,TIVAOUANE,"MERINA DAKHAR","MERINA DAKHAR","NDOYENE NDIASS",27,36,207,238,445
THIES,TIVAOUANE,"MERINA DAKHAR","MERINA DAKHAR",NGADIAGA,46,58,535,442,977
THIES,TIVAOUANE,"MERINA DAKHAR","MERINA DAKHAR",NGAKENE,14,15,86,92,178
THIES,TIVAOUANE,"MERINA DAKHAR","MERINA DAKHAR",NGANCAL,22,22,123,140,263
THIES,TIVAOUANE,"MERINA DAKHAR","MERINA DAKHAR","NGUEOUL LOUTO",67,100,572,635,1207
THIES,TIVAOUANE,"MERINA DAKHAR","MERINA DAKHAR","NGUER 2",7,7,56,71,127
THIES,TIVAOUANE,"MERINA DAKHAR","MERINA DAKHAR",NGUESSERE,6,10,54,47,101
THIES,TIVAOUANE,"MERINA DAKHAR","MERINA DAKHAR","NGUEWAR DIENG",8,10,87,92,179
THIES,TIVAOUANE,"MERINA DAKHAR","MERINA DAKHAR","NGUIGUISE MOR (NDIOBENE)",8,9,38,43,81
THIES,TIVAOUANE,"MERINA DAKHAR","MERINA DAKHAR","H1 THIENENE",25,35,241,230,471
THIES,TIVAOUANE,"MERINA DAKHAR","MERINA DAKHAR","H2 GNINGUENE",15,19,125,124,249
THIES,TIVAOUANE,"MERINA DAKHAR","MERINA DAKHAR","H3 GALLO",3,5,40,33,73
THIES,TIVAOUANE,"MERINA DAKHAR","MERINA DAKHAR","H4 DAROU",11,13,101,67,168
THIES,TIVAOUANE,"MERINA DAKHAR","MERINA DAKHAR","H5 DIAMA",22,25,115,150,265
THIES,TIVAOUANE,"MERINA DAKHAR","MERINA DAKHAR","NGUIGUISSE PATHE",9,11,59,59,118
THIES,TIVAOUANE,"MERINA DAKHAR","MERINA DAKHAR",NGUISSAME,11,14,57,53,110
THIES,TIVAOUANE,"MERINA DAKHAR","MERINA DAKHAR",PALENE,1,1,4,4,8
THIES,TIVAOUANE,"MERINA DAKHAR","MERINA DAKHAR","SATTE 1",23,25,172,131,303
THIES,TIVAOUANE,"MERINA DAKHAR","MERINA DAKHAR","SATTE 2",6,7,69,58,127
THIES,TIVAOUANE,"MERINA DAKHAR","MERINA DAKHAR","SINE LEYE KANE",74,85,394,484,878
THIES,TIVAOUANE,"MERINA DAKHAR","MERINA DAKHAR","SINE MACOUMBA",35,38,231,206,437
THIES,TIVAOUANE,"MERINA DAKHAR","MERINA DAKHAR","H2 KOURE SINE",5,7,47,44,91
THIES,TIVAOUANE,"MERINA DAKHAR","MERINA DAKHAR","SINE YORO",35,40,154,162,316
THIES,TIVAOUANE,"MERINA DAKHAR","MERINA DAKHAR",TABBY,47,54,385,399,784
THIES,TIVAOUANE,"MERINA DAKHAR","MERINA DAKHAR",TELLY,39,46,205,182,387
THIES,TIVAOUANE,"MERINA DAKHAR","MERINA DAKHAR","H1 KEUR MODOU BA",6,7,30,30,60
THIES,TIVAOUANE,"MERINA DAKHAR","MERINA DAKHAR","TEUGUE DIOUMNEY",5,6,18,11,29
THIES,TIVAOUANE,"MERINA DAKHAR","MERINA DAKHAR","TEUGUE GATEIGNE",43,51,324,478,802
THIES,TIVAOUANE,"MERINA DAKHAR","MERINA DAKHAR","TEUGUE NDIASS",4,5,46,49,95
THIES,TIVAOUANE,"MERINA DAKHAR","MERINA DAKHAR","THIAR THYLOR",46,50,254,332,586
THIES,TIVAOUANE,"MERINA DAKHAR","MERINA DAKHAR","THIECKENE (KEUR ABDOU KHOUDIA)",15,18,138,117,255
THIES,TIVAOUANE,"MERINA DAKHAR","MERINA DAKHAR",THIEKERE,9,10,102,77,179
THIES,TIVAOUANE,"MERINA DAKHAR","MERINA DAKHAR",THIENGUE,47,82,358,264,622
THIES,TIVAOUANE,"MERINA DAKHAR","MERINA DAKHAR",THIEPPE,20,30,178,167,345
THIES,TIVAOUANE,"MERINA DAKHAR","MERINA DAKHAR",THILOR,21,22,187,135,322
THIES,TIVAOUANE,"MERINA DAKHAR","MERINA DAKHAR","H2 THIBO",11,11,75,65,140
THIES,TIVAOUANE,"MERINA DAKHAR","MERINA DAKHAR","THIOMBOTHIE NDIAYE",20,24,154,138,292
THIES,TIVAOUANE,"MERINA DAKHAR","MERINA DAKHAR",THIOUNENE,8,8,53,59,112
THIES,TIVAOUANE,"MERINA DAKHAR","MERINA DAKHAR",THIOUNGAGNE,12,13,47,88,135
THIES,TIVAOUANE,"MERINA DAKHAR","MERINA DAKHAR",TIBAR,8,9,77,74,151
THIES,TIVAOUANE,"MERINA DAKHAR","MERINA DAKHAR",TOUCOULEUR,16,17,102,125,227
THIES,TIVAOUANE,"MERINA DAKHAR","MERINA DAKHAR","DAROU KANE",8,9,83,66,149
THIES,TIVAOUANE,"MERINA DAKHAR",PEKESSE,"BAKHDASS 2",15,16,123,112,235
THIES,TIVAOUANE,"MERINA DAKHAR",PEKESSE,BARIDIAM,13,22,138,143,281
THIES,TIVAOUANE,"MERINA DAKHAR",PEKESSE,"COKY 1",11,14,93,76,169
THIES,TIVAOUANE,"MERINA DAKHAR",PEKESSE,"COKY MBACOLE",9,11,59,43,102
THIES,TIVAOUANE,"MERINA DAKHAR",PEKESSE,"DAROU SECK",9,14,78,76,154
THIES,TIVAOUANE,"MERINA DAKHAR",PEKESSE,"DAROU THYLLA",2,2,22,18,40
THIES,TIVAOUANE,"MERINA DAKHAR",PEKESSE,DIADJI,23,41,228,178,406
THIES,TIVAOUANE,"MERINA DAKHAR",PEKESSE,DIAMATYL,44,108,376,328,704
THIES,TIVAOUANE,"MERINA DAKHAR",PEKESSE,"DIOKOUL NDABE",32,39,222,218,440
THIES,TIVAOUANE,"MERINA DAKHAR",PEKESSE,FORBOTTE,31,45,318,342,660
THIES,TIVAOUANE,"MERINA DAKHAR",PEKESSE,"GADE AMADOU FALL",16,31,96,88,184
THIES,TIVAOUANE,"MERINA DAKHAR",PEKESSE,GOUFFO,17,20,148,129,277
THIES,TIVAOUANE,"MERINA DAKHAR",PEKESSE,"KALOME (KALOME LO)",8,10,49,49,98
THIES,TIVAOUANE,"MERINA DAKHAR",PEKESSE,"KANE KANE",13,19,181,146,327
THIES,TIVAOUANE,"MERINA DAKHAR",PEKESSE,"KEUR MOR BIRAME",8,9,49,44,93
THIES,TIVAOUANE,"MERINA DAKHAR",PEKESSE,"KEUR YAMAR",19,28,184,156,340
THIES,TIVAOUANE,"MERINA DAKHAR",PEKESSE,"H1 KEUR MOR NGONE",7,8,56,58,114
THIES,TIVAOUANE,"MERINA DAKHAR",PEKESSE,KHANDIANG,9,9,46,39,85
THIES,TIVAOUANE,"MERINA DAKHAR",PEKESSE,"KHATTA PALENE",15,19,120,128,248
THIES,TIVAOUANE,"MERINA DAKHAR",PEKESSE,KHELCOM,12,15,95,106,201
THIES,TIVAOUANE,"MERINA DAKHAR",PEKESSE,"KOURE KALOME",16,18,155,134,289
THIES,TIVAOUANE,"MERINA DAKHAR",PEKESSE,LEYENE,11,14,159,112,271
THIES,TIVAOUANE,"MERINA DAKHAR",PEKESSE,"H1 DAROU DIAKHATE",5,10,48,48,96
THIES,TIVAOUANE,"MERINA DAKHAR",PEKESSE,"LISLAM KANE",7,10,75,63,138
THIES,TIVAOUANE,"MERINA DAKHAR",PEKESSE,"MAKA NGALICK",10,15,66,54,120
THIES,TIVAOUANE,"MERINA DAKHAR",PEKESSE,MBAYLAR,42,50,249,219,468
THIES,TIVAOUANE,"MERINA DAKHAR",PEKESSE,MBEURLEUP,39,55,452,337,789
THIES,TIVAOUANE,"MERINA DAKHAR",PEKESSE,"MERINA DIOP",38,45,292,266,558
THIES,TIVAOUANE,"MERINA DAKHAR",PEKESSE,"MERINA SOUGUERE (NDOYENE)",7,7,54,46,100
THIES,TIVAOUANE,"MERINA DAKHAR",PEKESSE,MESSERE,2,3,42,22,64
THIES,TIVAOUANE,"MERINA DAKHAR",PEKESSE,"NDECK DIA",27,42,270,231,501
THIES,TIVAOUANE,"MERINA DAKHAR",PEKESSE,NDEUCKENE,9,9,70,51,121
THIES,TIVAOUANE,"MERINA DAKHAR",PEKESSE,"NDIAGNE SOUGUERE",3,4,15,16,31
THIES,TIVAOUANE,"MERINA DAKHAR",PEKESSE,"NDIAKHATE KHAYE",1,1,6,0,6
THIES,TIVAOUANE,"MERINA DAKHAR",PEKESSE,"NDIARGA DIENG",25,36,219,221,440
THIES,TIVAOUANE,"MERINA DAKHAR",PEKESSE,NDIEMEL,9,12,51,60,111
THIES,TIVAOUANE,"MERINA DAKHAR",PEKESSE,"NDIERE DIENG",14,15,154,152,306
THIES,TIVAOUANE,"MERINA DAKHAR",PEKESSE,"NDIMB DIOP",5,8,47,43,90
THIES,TIVAOUANE,"MERINA DAKHAR",PEKESSE,"NDIMB FALL",11,11,79,74,153
THIES,TIVAOUANE,"MERINA DAKHAR",PEKESSE,"NDIOCK NDIAYE",11,17,103,101,204
THIES,TIVAOUANE,"MERINA DAKHAR",PEKESSE,"NDIOCK PEULH",10,12,73,91,164
THIES,TIVAOUANE,"MERINA DAKHAR",PEKESSE,"NDIOGOMAYE 1 (NDIOGOMAYE SOUGUERE)",29,46,367,325,692
THIES,TIVAOUANE,"MERINA DAKHAR",PEKESSE,"NDIOGOMAYE 2",54,62,480,382,862
THIES,TIVAOUANE,"MERINA DAKHAR",PEKESSE,NDIOMBOBRANE,13,16,76,63,139
THIES,TIVAOUANE,"MERINA DAKHAR",PEKESSE,"H1 BRANE",3,7,29,42,71
THIES,TIVAOUANE,"MERINA DAKHAR",PEKESSE,"NDIOP BOTAL",21,51,105,131,236
THIES,TIVAOUANE,"MERINA DAKHAR",PEKESSE,"NDIOUCKY DAKHAR",22,26,171,155,326
THIES,TIVAOUANE,"MERINA DAKHAR",PEKESSE,"NDIOUCKY PEKESSE",85,113,784,586,1370
THIES,TIVAOUANE,"MERINA DAKHAR",PEKESSE,"NDIOUKH FALL",11,11,71,69,140
THIES,TIVAOUANE,"MERINA DAKHAR",PEKESSE,"NDJIGUENE OUOLOF",15,19,130,83,213
THIES,TIVAOUANE,"MERINA DAKHAR",PEKESSE,"NDJIGUENE PEULH",13,20,71,79,150
THIES,TIVAOUANE,"MERINA DAKHAR",PEKESSE,NEKHE,21,21,128,126,254
THIES,TIVAOUANE,"MERINA DAKHAR",PEKESSE,"NGALICK (NGALICK KHOUMA)",61,82,567,596,1163
THIES,TIVAOUANE,"MERINA DAKHAR",PEKESSE,"NGOL NGOL (MBAMBA TALL)",8,12,59,75,134
THIES,TIVAOUANE,"MERINA DAKHAR",PEKESSE,"NGUEYE NGUEYE",42,64,334,329,663
THIES,TIVAOUANE,"MERINA DAKHAR",PEKESSE,"PAYE PAYE",25,31,202,204,406
THIES,TIVAOUANE,"MERINA DAKHAR",PEKESSE,PEKESSE,322,373,1774,1847,3621
THIES,TIVAOUANE,"MERINA DAKHAR",PEKESSE,"H1 KHAGANE",23,24,183,145,328
THIES,TIVAOUANE,"MERINA DAKHAR",PEKESSE,RAMATOU,11,14,105,76,181
THIES,TIVAOUANE,"MERINA DAKHAR",PEKESSE,"SAM SAM",9,11,61,79,140
THIES,TIVAOUANE,"MERINA DAKHAR",PEKESSE,SAO,17,28,174,152,326
THIES,TIVAOUANE,"MERINA DAKHAR",PEKESSE,"SATTE 3",16,17,160,151,311
THIES,TIVAOUANE,"MERINA DAKHAR",PEKESSE,SOUGUERE,42,71,372,345,717
THIES,TIVAOUANE,"MERINA DAKHAR",PEKESSE,"TAIBA NIANG",31,38,342,300,642
THIES,TIVAOUANE,"MERINA DAKHAR",PEKESSE,"TENE BELLAKHO",11,11,55,44,99
THIES,TIVAOUANE,"MERINA DAKHAR",PEKESSE,"THIAW THIAW",2,2,13,15,28
THIES,TIVAOUANE,"MERINA DAKHAR",PEKESSE,"THIEYE THIEYE",37,40,307,360,667
THIES,TIVAOUANE,"MERINA DAKHAR",PEKESSE,THIOUMP,46,47,163,190,353
THIES,TIVAOUANE,"MERINA DAKHAR",PEKESSE,"THYLLE SATTE",11,16,162,128,290
THIES,TIVAOUANE,"MERINA DAKHAR",PEKESSE,"TIBAR FALL 2",12,14,89,74,163
THIES,TIVAOUANE,"MERINA DAKHAR",PEKESSE,YANDAKHENE,50,63,447,425,872
THIES,TIVAOUANE,"MERINA DAKHAR",PEKESSE,"COKY 2",1,1,21,11,32
THIES,TIVAOUANE,"MERINA DAKHAR",PEKESSE,GADE,23,31,194,211,405
THIES,TIVAOUANE,"MERINA DAKHAR",PEKESSE,"NGJINGUENE TEUGUE",5,5,24,15,39
THIES,TIVAOUANE,"MERINA DAKHAR",PEKESSE,TIOCK,4,7,38,45,83
THIES,TIVAOUANE,NIAKHENE,MBAYENE,"BEUL DAROU OUOLOF",5,6,34,33,67
THIES,TIVAOUANE,NIAKHENE,MBAYENE,"BEUL DAROU PEULH 1",10,11,51,50,101
THIES,TIVAOUANE,NIAKHENE,MBAYENE,"BEUL DAROU PEULH 2",4,4,16,11,27
THIES,TIVAOUANE,NIAKHENE,MBAYENE,"H2 NDIANE BEUL",3,3,40,30,70
THIES,TIVAOUANE,NIAKHENE,MBAYENE,"DAROU GOUYARD",4,4,15,9,24
THIES,TIVAOUANE,NIAKHENE,MBAYENE,"DAROU NDIMB",5,5,64,65,129
THIES,TIVAOUANE,NIAKHENE,MBAYENE,"DAROU WANIANE",6,9,41,50,91
THIES,TIVAOUANE,NIAKHENE,MBAYENE,"DIEMOUL OUOLOF",29,37,178,151,329
THIES,TIVAOUANE,NIAKHENE,MBAYENE,"DIEMOUL PEULH",38,43,202,161,363
THIES,TIVAOUANE,NIAKHENE,MBAYENE,"FASS TOURE",18,20,130,114,244
THIES,TIVAOUANE,NIAKHENE,MBAYENE,"H1 KHOUBOUTOU",6,6,25,22,47
THIES,TIVAOUANE,NIAKHENE,MBAYENE,"GADE NDIAKHAR",10,11,91,66,157
THIES,TIVAOUANE,NIAKHENE,MBAYENE,GONIO,21,24,124,106,230
THIES,TIVAOUANE,NIAKHENE,MBAYENE,"H1 KOURE",3,3,28,17,45
THIES,TIVAOUANE,NIAKHENE,MBAYENE,"H2 DAROU THIAM",2,2,19,10,29
THIES,TIVAOUANE,NIAKHENE,MBAYENE,"GOUYARD 1",9,9,41,38,79
THIES,TIVAOUANE,NIAKHENE,MBAYENE,"H1 GOUYARD PEULH",6,6,44,15,59
THIES,TIVAOUANE,NIAKHENE,MBAYENE,"GOUYARD 2 (DAROU RAHMANE)",2,2,14,5,19
THIES,TIVAOUANE,NIAKHENE,MBAYENE,"GOUYE DAGUE OUOLOF",15,20,137,113,250
THIES,TIVAOUANE,NIAKHENE,MBAYENE,"H2 GOUYE DAGUE PEULH",17,18,115,123,238
THIES,TIVAOUANE,NIAKHENE,MBAYENE,"KEUR DETHIE",1,1,16,13,29
THIES,TIVAOUANE,NIAKHENE,MBAYENE,"KEUR FARY OUOLOF",7,10,41,40,81
THIES,TIVAOUANE,NIAKHENE,MBAYENE,"KEUR GALLO",6,8,48,48,96
THIES,TIVAOUANE,NIAKHENE,MBAYENE,"KEUR MAGOUMBA",11,14,77,81,158
THIES,TIVAOUANE,NIAKHENE,MBAYENE,"KEUR MASSAMBA DIOME",2,3,10,8,18
THIES,TIVAOUANE,NIAKHENE,MBAYENE,"KEUR MASSAMBA KHOUMA",2,2,16,19,35
THIES,TIVAOUANE,NIAKHENE,MBAYENE,"KEUR MATAR NDOUMBE",4,5,64,59,123
THIES,TIVAOUANE,NIAKHENE,MBAYENE,"KEUR MBACKOL",20,22,126,120,246
THIES,TIVAOUANE,NIAKHENE,MBAYENE,"KEUR MBALLO 2",7,7,32,29,61
THIES,TIVAOUANE,NIAKHENE,MBAYENE,"KHATTRE WOLOOF",23,25,201,149,350
THIES,TIVAOUANE,NIAKHENE,MBAYENE,"KHATTRE PEULH",3,5,34,31,65
THIES,TIVAOUANE,NIAKHENE,MBAYENE,MARENE,6,7,41,33,74
THIES,TIVAOUANE,NIAKHENE,MBAYENE,MBADIE,11,11,55,37,92
THIES,TIVAOUANE,NIAKHENE,MBAYENE,"H1 PEULGA de MBADIE",10,11,53,48,101
THIES,TIVAOUANE,NIAKHENE,MBAYENE,MBAYENE,53,59,300,288,588
THIES,TIVAOUANE,NIAKHENE,MBAYENE,"H1 THIAMBENE",15,16,117,92,209
THIES,TIVAOUANE,NIAKHENE,MBAYENE,"MBAYENE PEULH",13,13,72,89,161
THIES,TIVAOUANE,NIAKHENE,MBAYENE,MBOUYA,1,1,8,9,17
THIES,TIVAOUANE,NIAKHENE,MBAYENE,NDIAO-NDIAO,4,5,24,13,37
THIES,TIVAOUANE,NIAKHENE,MBAYENE,"NDIAYENE PARIS 1",10,10,95,55,150
THIES,TIVAOUANE,NIAKHENE,MBAYENE,"NDIAYENE PARIS 2",1,1,11,3,14
THIES,TIVAOUANE,NIAKHENE,MBAYENE,"NDJIGAL WOLOOF",2,2,23,26,49
THIES,TIVAOUANE,NIAKHENE,MBAYENE,"H1 DARADJI",1,1,21,10,31
THIES,TIVAOUANE,NIAKHENE,MBAYENE,"NDIMB DIOR",13,15,114,81,195
THIES,TIVAOUANE,NIAKHENE,MBAYENE,"H1 NDIOBENE",6,7,49,40,89
THIES,TIVAOUANE,NIAKHENE,MBAYENE,NDIOURKY,32,36,195,168,363
THIES,TIVAOUANE,NIAKHENE,MBAYENE,"NDJIGAL PEULH 1",7,7,37,25,62
THIES,TIVAOUANE,NIAKHENE,MBAYENE,"NDJIGAL PEULH 2",8,8,58,46,104
THIES,TIVAOUANE,NIAKHENE,MBAYENE,"NDOUCOUMANE GUEYE",3,3,26,22,48
THIES,TIVAOUANE,NIAKHENE,MBAYENE,"NGALLAP 1",14,16,108,92,200
THIES,TIVAOUANE,NIAKHENE,MBAYENE,"NGALLAP 2",3,7,32,33,65
THIES,TIVAOUANE,NIAKHENE,MBAYENE,"NGAYE NGAYE",10,13,76,111,187
THIES,TIVAOUANE,NIAKHENE,MBAYENE,"NGOPPE 1 de NGOPPE 1",5,5,38,25,63
THIES,TIVAOUANE,NIAKHENE,MBAYENE,"H1 PEULGA de NGOPPE 1",12,14,49,55,104
THIES,TIVAOUANE,NIAKHENE,MBAYENE,"NGOPPE 2 de NGOPPE 1",8,11,72,54,126
THIES,TIVAOUANE,NIAKHENE,MBAYENE,"NIANDOUL OUOLOF",36,42,206,214,420
THIES,TIVAOUANE,NIAKHENE,MBAYENE,"NIANDOUL PEULH",12,17,79,85,164
THIES,TIVAOUANE,NIAKHENE,MBAYENE,"PARIS NDIAYE",25,26,278,183,461
THIES,TIVAOUANE,NIAKHENE,MBAYENE,"SANTHIOU MBAYENE PEULH",7,7,34,34,68
THIES,TIVAOUANE,NIAKHENE,MBAYENE,"SANTHIOU GUEMBE",6,7,28,48,76
THIES,TIVAOUANE,NIAKHENE,MBAYENE,"H1 PEULGA de SANTHIOU GUEMBE",4,4,20,26,46
THIES,TIVAOUANE,NIAKHENE,MBAYENE,"SANTHIOU PARIS(KEUR GALASS)",2,3,19,14,33
THIES,TIVAOUANE,NIAKHENE,MBAYENE,"SANTHIOU THIABALA",21,23,114,127,241
THIES,TIVAOUANE,NIAKHENE,MBAYENE,"H1 PEULGA de SANTHIOU THIABALA",8,9,45,58,103
THIES,TIVAOUANE,NIAKHENE,MBAYENE,SENO,38,44,166,164,330
THIES,TIVAOUANE,NIAKHENE,MBAYENE,"SINE AMAR",10,11,65,71,136
THIES,TIVAOUANE,NIAKHENE,MBAYENE,THIABALA,21,22,125,119,244
THIES,TIVAOUANE,NIAKHENE,MBAYENE,"THIOLANE 3",3,3,11,10,21
THIES,TIVAOUANE,NIAKHENE,MBAYENE,"THYLLA SENO",6,6,24,25,49
THIES,TIVAOUANE,NIAKHENE,MBAYENE,"THIARRE SADY",24,37,147,140,287
THIES,TIVAOUANE,NIAKHENE,MBAYENE,"THIDE DIAKHATE",5,6,19,19,38
THIES,TIVAOUANE,NIAKHENE,MBAYENE,"H1 PEULGA de THIDE DIAKHATE",6,8,27,21,48
THIES,TIVAOUANE,NIAKHENE,MBAYENE,"THINE NIANG",9,9,72,47,119
THIES,TIVAOUANE,NIAKHENE,MBAYENE,YOUYE,34,41,238,174,412
THIES,TIVAOUANE,NIAKHENE,MBAYENE,"H1 PEULGA de YOUYE",10,11,90,51,141
THIES,TIVAOUANE,NIAKHENE,MBAYENE,"NDIANE MBAYE",2,2,8,13,21
THIES,TIVAOUANE,NIAKHENE,NGANDIOUF,"BAYAKH 1",1,2,8,5,13
THIES,TIVAOUANE,NIAKHENE,NGANDIOUF,"BAYAKH 2 (NGASSAMA)",6,6,43,36,79
THIES,TIVAOUANE,NIAKHENE,NGANDIOUF,"BAYAKH 3",3,3,16,11,27
THIES,TIVAOUANE,NIAKHENE,NGANDIOUF,"H1 PEULGA de BAYAKH 3",8,8,37,37,74
THIES,TIVAOUANE,NIAKHENE,NGANDIOUF,"BAYAKH PEULH",18,19,89,70,159
THIES,TIVAOUANE,NIAKHENE,NGANDIOUF,BEGAL,53,69,397,409,806
THIES,TIVAOUANE,NIAKHENE,NGANDIOUF,BELLY,3,7,24,27,51
THIES,TIVAOUANE,NIAKHENE,NGANDIOUF,BITIVE,3,3,20,23,43
THIES,TIVAOUANE,NIAKHENE,NGANDIOUF,"H1 MBODIENE",13,13,123,91,214
THIES,TIVAOUANE,NIAKHENE,NGANDIOUF,"H2 PEULGA de BITIVE",8,12,78,71,149
THIES,TIVAOUANE,NIAKHENE,NGANDIOUF,BOUSSOURA,9,15,46,49,95
THIES,TIVAOUANE,NIAKHENE,NGANDIOUF,"BRICK (DAROU BRICK)",25,31,174,145,319
THIES,TIVAOUANE,NIAKHENE,NGANDIOUF,CAMBOURENE,1,3,18,14,32
THIES,TIVAOUANE,NIAKHENE,NGANDIOUF,"DAROU BEGAL",5,6,25,28,53
THIES,TIVAOUANE,NIAKHENE,NGANDIOUF,"DAROU MBAL KANE",1,1,13,2,15
THIES,TIVAOUANE,NIAKHENE,NGANDIOUF,"DAROU NDIARGA",16,17,81,84,165
THIES,TIVAOUANE,NIAKHENE,NGANDIOUF,"DAROU NDIAYE (KEUR SERIGNE MOR NDAYE TAGAR)",14,15,140,111,251
THIES,TIVAOUANE,NIAKHENE,NGANDIOUF,"DAROU SAM",27,28,174,171,345
THIES,TIVAOUANE,NIAKHENE,NGANDIOUF,"DAROU TANDINE (DAROU DIENE)",20,22,134,127,261
THIES,TIVAOUANE,NIAKHENE,NGANDIOUF,DAWAKH,33,35,167,188,355
THIES,TIVAOUANE,NIAKHENE,NGANDIOUF,"H1 PEULGA de DAWAKH",4,4,21,23,44
THIES,TIVAOUANE,NIAKHENE,NGANDIOUF,DIAMBAL,8,8,102,86,188
THIES,TIVAOUANE,NIAKHENE,NGANDIOUF,"DIOUKOUL 1 (DIOKOUL KAMBEL)",9,16,78,85,163
THIES,TIVAOUANE,NIAKHENE,NGANDIOUF,"DIOUNG SALL",16,27,183,144,327
THIES,TIVAOUANE,NIAKHENE,NGANDIOUF,DJIGAL,10,10,65,42,107
THIES,TIVAOUANE,NIAKHENE,NGANDIOUF,"GADE BITIVE",6,7,56,72,128
THIES,TIVAOUANE,NIAKHENE,NGANDIOUF,"GADE DIOR",1,1,6,6,12
THIES,TIVAOUANE,NIAKHENE,NGANDIOUF,"GADE YELLE",48,53,507,489,996
THIES,TIVAOUANE,NIAKHENE,NGANDIOUF,"H1 TAWFEKH",21,25,230,159,389
THIES,TIVAOUANE,NIAKHENE,NGANDIOUF,"GAL BEUTH",18,18,155,150,305
THIES,TIVAOUANE,NIAKHENE,NGANDIOUF,"H1 PEULGA de GAL BEUTH",2,2,19,21,40
THIES,TIVAOUANE,NIAKHENE,NGANDIOUF,"GATTY GNING",17,18,130,113,243
THIES,TIVAOUANE,NIAKHENE,NGANDIOUF,"H2 LEYENE",9,9,89,89,178
THIES,TIVAOUANE,NIAKHENE,NGANDIOUF,"H3 TOUCOULEUR ( KHASSIVE)",9,9,64,50,114
THIES,TIVAOUANE,NIAKHENE,NGANDIOUF,"GATTY GOUYE",22,34,176,160,336
THIES,TIVAOUANE,NIAKHENE,NGANDIOUF,"GATTY NDONGO",44,52,340,309,649
THIES,TIVAOUANE,NIAKHENE,NGANDIOUF,"H1 TILENE",4,4,42,30,72
THIES,TIVAOUANE,NIAKHENE,NGANDIOUF,"GATTY NEO",18,22,111,106,217
THIES,TIVAOUANE,NIAKHENE,NGANDIOUF,"GATTY NGARAFF",39,57,362,329,691
THIES,TIVAOUANE,NIAKHENE,NGANDIOUF,"GATTY YARAM 1",7,9,46,34,80
THIES,TIVAOUANE,NIAKHENE,NGANDIOUF,"GATTY YARAM 2",53,57,326,303,629
THIES,TIVAOUANE,NIAKHENE,NGANDIOUF,"KADE NDIAYE",22,25,127,121,248
THIES,TIVAOUANE,NIAKHENE,NGANDIOUF,"KEUR MBALLO ( NDIOP NDIAYE)",2,2,4,6,10
THIES,TIVAOUANE,NIAKHENE,NGANDIOUF,KHANDIRANE,12,17,128,107,235
THIES,TIVAOUANE,NIAKHENE,NGANDIOUF,KHASSINE,27,30,181,155,336
THIES,TIVAOUANE,NIAKHENE,NGANDIOUF,"KHAYE GOUNDIANG",29,32,152,150,302
THIES,TIVAOUANE,NIAKHENE,NGANDIOUF,"KHAYE TACKO",17,22,147,105,252
THIES,TIVAOUANE,NIAKHENE,NGANDIOUF,"KOUL (KOUL THIAW)",20,21,130,76,206
THIES,TIVAOUANE,NIAKHENE,NGANDIOUF,"KOUL SALL",9,10,64,62,126
THIES,TIVAOUANE,NIAKHENE,NGANDIOUF,"KOURE DIAL",17,23,176,150,326
THIES,TIVAOUANE,NIAKHENE,NGANDIOUF,LAKHASSO,18,21,130,134,264
THIES,TIVAOUANE,NIAKHENE,NGANDIOUF,"MACKA LEYE",16,21,138,133,271
THIES,TIVAOUANE,NIAKHENE,NGANDIOUF,MBAGUE,3,3,21,11,32
THIES,TIVAOUANE,NIAKHENE,NGANDIOUF,MBAKAR,16,19,118,126,244
THIES,TIVAOUANE,NIAKHENE,NGANDIOUF,"H1 GOUYE TENE",1,1,1,2,3
THIES,TIVAOUANE,NIAKHENE,NGANDIOUF,MBAKHENE(GUEYE),50,52,426,366,792
THIES,TIVAOUANE,NIAKHENE,NGANDIOUF,MBAKHISSE,53,71,529,468,997
THIES,TIVAOUANE,NIAKHENE,NGANDIOUF,"H1 DAROU NDIAYE",18,21,113,112,225
THIES,TIVAOUANE,NIAKHENE,NGANDIOUF,"H2 MAKA SANTHIE",8,8,58,56,114
THIES,TIVAOUANE,NIAKHENE,NGANDIOUF,"H3 SANTHIOU MBAKHISS",2,2,18,15,33
THIES,TIVAOUANE,NIAKHENE,NGANDIOUF,"MBAL BA",3,6,47,37,84
THIES,TIVAOUANE,NIAKHENE,NGANDIOUF,"MBAL FALL",11,15,87,89,176
THIES,TIVAOUANE,NIAKHENE,NGANDIOUF,"MBAL KANE",6,6,21,28,49
THIES,TIVAOUANE,NIAKHENE,NGANDIOUF,"H1 DAROU DIOP",3,3,20,21,41
THIES,TIVAOUANE,NIAKHENE,NGANDIOUF,MBIRINE,8,9,98,84,182
THIES,TIVAOUANE,NIAKHENE,NGANDIOUF,MBEYE,1,3,11,9,20
THIES,TIVAOUANE,NIAKHENE,NGANDIOUF,"MBOUBENE I (DAROU GUEYE)",4,5,31,15,46
THIES,TIVAOUANE,NIAKHENE,NGANDIOUF,"MBOUBENE II (TAGAR MBOUBENE)",40,46,255,272,527
THIES,TIVAOUANE,NIAKHENE,NGANDIOUF,MBOUL,31,43,329,298,627
THIES,TIVAOUANE,NIAKHENE,NGANDIOUF,"MERINA DIOP",8,9,56,71,127
THIES,TIVAOUANE,NIAKHENE,NGANDIOUF,MESSERE,9,15,80,78,158
THIES,TIVAOUANE,NIAKHENE,NGANDIOUF,"H1 MESSERE",1,1,6,5,11
THIES,TIVAOUANE,NIAKHENE,NGANDIOUF,NDAKH,26,29,172,173,345
THIES,TIVAOUANE,NIAKHENE,NGANDIOUF,"NDAL NGUER",24,39,289,278,567
THIES,TIVAOUANE,NIAKHENE,NGANDIOUF,"H1 PEULGA ( NDAL NGUER)",1,2,12,8,20
THIES,TIVAOUANE,NIAKHENE,NGANDIOUF,"NDAR SALL",17,19,108,84,192
THIES,TIVAOUANE,NIAKHENE,NGANDIOUF,NDEGLOU,4,4,43,27,70
THIES,TIVAOUANE,NIAKHENE,NGANDIOUF,NDIAGNE,3,3,39,18,57
THIES,TIVAOUANE,NIAKHENE,NGANDIOUF,"NDIAGNE GOUYE",1,1,15,7,22
THIES,TIVAOUANE,NIAKHENE,NGANDIOUF,NDIAKHERE,64,78,587,521,1108
THIES,TIVAOUANE,NIAKHENE,NGANDIOUF,"NDIALBER OUOLOF",17,19,103,94,197
THIES,TIVAOUANE,NIAKHENE,NGANDIOUF,"NDIALBER PEULH",17,22,104,77,181
THIES,TIVAOUANE,NIAKHENE,NGANDIOUF,NDIARNDE,8,10,75,43,118
THIES,TIVAOUANE,NIAKHENE,NGANDIOUF,"NDIAYENE DIOP",14,18,116,119,235
THIES,TIVAOUANE,NIAKHENE,NGANDIOUF,"H1 SABY",7,8,45,50,95
THIES,TIVAOUANE,NIAKHENE,NGANDIOUF,NDIEGNOU,18,19,154,143,297
THIES,TIVAOUANE,NIAKHENE,NGANDIOUF,"NDIENE RATTE (NDIENE SALL)",44,58,269,294,563
THIES,TIVAOUANE,NIAKHENE,NGANDIOUF,NDIENG,18,21,150,149,299
THIES,TIVAOUANE,NIAKHENE,NGANDIOUF,"NDIOBENE TAYE",33,49,321,238,559
THIES,TIVAOUANE,NIAKHENE,NGANDIOUF,"H1 KEUR IBRAHIMA NDIAYE",6,7,45,35,80
THIES,TIVAOUANE,NIAKHENE,NGANDIOUF,NDIOCKO,27,29,184,161,345
THIES,TIVAOUANE,NIAKHENE,NGANDIOUF,NDIOMPY,39,51,288,275,563
THIES,TIVAOUANE,NIAKHENE,NGANDIOUF,"NDIOTTE (NDIOTTE KHEUL)",12,15,89,77,166
THIES,TIVAOUANE,NIAKHENE,NGANDIOUF,"H1 NDIOTTE NDIAYE",12,13,114,111,225
THIES,TIVAOUANE,NIAKHENE,NGANDIOUF,"H2 PEULGA de NDIOTTE (NDIOTTE KHEUL)",7,10,60,44,104
THIES,TIVAOUANE,NIAKHENE,NGANDIOUF,"NDOB GADIAGA",60,76,479,481,960
THIES,TIVAOUANE,NIAKHENE,NGANDIOUF,"H1 NDABATOU (NDOB LEYE)",23,24,124,178,302
THIES,TIVAOUANE,NIAKHENE,NGANDIOUF,"H2 SINE",16,21,118,129,247
THIES,TIVAOUANE,NIAKHENE,NGANDIOUF,NDOUGOR,15,21,144,111,255
THIES,TIVAOUANE,NIAKHENE,NGANDIOUF,"H1 SANTHIE NDOUGOR SALL",12,17,96,94,190
THIES,TIVAOUANE,NIAKHENE,NGANDIOUF,"NEKHEDJ DIAMA",9,10,71,103,174
THIES,TIVAOUANE,NIAKHENE,NGANDIOUF,"NEKHEDJI PALENE",14,17,112,97,209
THIES,TIVAOUANE,NIAKHENE,NGANDIOUF,NEWA,13,24,165,159,324
THIES,TIVAOUANE,NIAKHENE,NGANDIOUF,NGADANTOU,15,18,95,86,181
THIES,TIVAOUANE,NIAKHENE,NGANDIOUF,NGANDIOUF,65,69,495,489,984
THIES,TIVAOUANE,NIAKHENE,NGANDIOUF,NGOUMBO,13,18,95,74,169
THIES,TIVAOUANE,NIAKHENE,NGANDIOUF,"NGUEDJI GUEYE ( NDIENE DAKHAR)",10,14,112,120,232
THIES,TIVAOUANE,NIAKHENE,NGANDIOUF,"H1 PEULGA de NGUEDJI GUEYE ( NDIENE DAKHAR)",6,6,32,24,56
THIES,TIVAOUANE,NIAKHENE,NGANDIOUF,NGUEMBE,68,84,322,494,816
THIES,TIVAOUANE,NIAKHENE,NGANDIOUF,"NGUEYE NGUEYE",64,90,650,548,1198
THIES,TIVAOUANE,NIAKHENE,NGANDIOUF,NIAGANE,8,8,42,50,92
THIES,TIVAOUANE,NIAKHENE,NGANDIOUF,NIANENE,9,9,45,30,75
THIES,TIVAOUANE,NIAKHENE,NGANDIOUF,"PALLENE 4",5,7,94,109,203
THIES,TIVAOUANE,NIAKHENE,NGANDIOUF,PAM,13,16,69,64,133
THIES,TIVAOUANE,NIAKHENE,NGANDIOUF,"SAM DIENG",14,15,131,106,237
THIES,TIVAOUANE,NIAKHENE,NGANDIOUF,"SAM SARR",6,6,44,40,84
THIES,TIVAOUANE,NIAKHENE,NGANDIOUF,"TEUB DAL",15,19,132,111,243
THIES,TIVAOUANE,NIAKHENE,NGANDIOUF,"TEUGUE NIANG",5,5,47,31,78
THIES,TIVAOUANE,NIAKHENE,NGANDIOUF,THIAMENE,3,3,10,16,26
THIES,TIVAOUANE,NIAKHENE,NGANDIOUF,THIATHIOUR,27,31,206,199,405
THIES,TIVAOUANE,NIAKHENE,NGANDIOUF,"H1 KEUR MODOU NGOM",5,6,46,37,83
THIES,TIVAOUANE,NIAKHENE,NGANDIOUF,THIAWENE,22,24,199,206,405
THIES,TIVAOUANE,NIAKHENE,NGANDIOUF,THIELLY,25,29,167,138,305
THIES,TIVAOUANE,NIAKHENE,NGANDIOUF,THIENATE,12,12,71,58,129
THIES,TIVAOUANE,NIAKHENE,NGANDIOUF,THIEYE,13,17,107,95,202
THIES,TIVAOUANE,NIAKHENE,NGANDIOUF,THIOWANE,35,42,237,230,467
THIES,TIVAOUANE,NIAKHENE,NGANDIOUF,"TOUBE (TOUBE NDAO)",14,22,115,96,211
THIES,TIVAOUANE,NIAKHENE,NGANDIOUF,YELLE,21,24,161,139,300
THIES,TIVAOUANE,NIAKHENE,NGANDIOUF,YESS,13,24,106,102,208
THIES,TIVAOUANE,NIAKHENE,NIAKHENE,BELLAKHO,5,5,14,16,30
THIES,TIVAOUANE,NIAKHENE,NIAKHENE,"H1 DAROU SECK",5,5,151,30,181
THIES,TIVAOUANE,NIAKHENE,NIAKHENE,"H2 NDIOBENE DIOP",5,5,73,69,142
THIES,TIVAOUANE,NIAKHENE,NIAKHENE,"COKY DIOP",12,12,89,57,146
THIES,TIVAOUANE,NIAKHENE,NIAKHENE,"DAROU LAMSING",4,4,19,17,36
THIES,TIVAOUANE,NIAKHENE,NIAKHENE,"DAROU MEOUNDOU",6,9,64,45,109
THIES,TIVAOUANE,NIAKHENE,NIAKHENE,"H1 KEUR BALLA",3,3,19,20,39
THIES,TIVAOUANE,NIAKHENE,NIAKHENE,"DAROU NDIANE (DAROU NDIAYE)",2,2,11,12,23
THIES,TIVAOUANE,NIAKHENE,NIAKHENE,"DAROU NIAKHENE",21,21,141,99,240
THIES,TIVAOUANE,NIAKHENE,NIAKHENE,DIOCKOUL,3,3,8,11,19
THIES,TIVAOUANE,NIAKHENE,NIAKHENE,KEBE,1,1,9,12,21
THIES,TIVAOUANE,NIAKHENE,NIAKHENE,"KEUR ALLE",23,26,202,177,379
THIES,TIVAOUANE,NIAKHENE,NIAKHENE,"KEUR GALLO 1",16,21,185,136,321
THIES,TIVAOUANE,NIAKHENE,NIAKHENE,"KEUR MACOUMBA",9,10,56,74,130
THIES,TIVAOUANE,NIAKHENE,NIAKHENE,"KEUR MADIOP TOURE",23,31,118,132,250
THIES,TIVAOUANE,NIAKHENE,NIAKHENE,"KEUR MAKALA",16,20,78,92,170
THIES,TIVAOUANE,NIAKHENE,NIAKHENE,"KEUR MEISSA NDIAYE",10,10,59,64,123
THIES,TIVAOUANE,NIAKHENE,NIAKHENE,"KEUR SYLLA MADIOR",2,2,16,17,33
THIES,TIVAOUANE,NIAKHENE,NIAKHENE,"KEUR YOUGA THIORO",10,10,59,45,104
THIES,TIVAOUANE,NIAKHENE,NIAKHENE,"KHAOULOU (KHAOULOU DIENG)",42,50,341,276,617
THIES,TIVAOUANE,NIAKHENE,NIAKHENE,"KHATTA NGUINTH",12,14,91,103,194
THIES,TIVAOUANE,NIAKHENE,NIAKHENE,"KHATTA YOUGA",15,16,82,105,187
THIES,TIVAOUANE,NIAKHENE,NIAKHENE,"KHEWAR (NGUEWAR)",7,7,75,58,133
THIES,TIVAOUANE,NIAKHENE,NIAKHENE,"KHOUMA GANA",20,24,126,106,232
THIES,TIVAOUANE,NIAKHENE,NIAKHENE,"KHOUMA KEBE",4,4,17,19,36
THIES,TIVAOUANE,NIAKHENE,NIAKHENE,"KHOUMA SAMANE 1",9,9,69,60,129
THIES,TIVAOUANE,NIAKHENE,NIAKHENE,"KHOUMA SAMANE 2",8,9,70,59,129
THIES,TIVAOUANE,NIAKHENE,NIAKHENE,LAMSING,26,34,137,159,296
THIES,TIVAOUANE,NIAKHENE,NIAKHENE,"LEYENE (LEYENE KHATTA)",4,4,8,31,39
THIES,TIVAOUANE,NIAKHENE,NIAKHENE,"MAKA KANE",6,7,29,22,51
THIES,TIVAOUANE,NIAKHENE,NIAKHENE,"MAKA MOR KHARY",12,12,99,60,159
THIES,TIVAOUANE,NIAKHENE,NIAKHENE,"MAKA NIANG",10,15,70,70,140
THIES,TIVAOUANE,NIAKHENE,NIAKHENE,MBANA,3,4,28,19,47
THIES,TIVAOUANE,NIAKHENE,NIAKHENE,"MEOUNDOU 1",10,15,92,65,157
THIES,TIVAOUANE,NIAKHENE,NIAKHENE,"MEOUNDOU 2 (KEUR DIAMBAR)",3,3,11,9,20
THIES,TIVAOUANE,NIAKHENE,NIAKHENE,"MEOUNDOU 3",1,1,1,6,7
THIES,TIVAOUANE,NIAKHENE,NIAKHENE,"MERINA AMAR",1,1,5,7,12
THIES,TIVAOUANE,NIAKHENE,NIAKHENE,"MERINA ASTA",41,46,492,349,841
THIES,TIVAOUANE,NIAKHENE,NIAKHENE,"H1 DAROU DIAKHATE",2,3,49,12,61
THIES,TIVAOUANE,NIAKHENE,NIAKHENE,"NDEMENE (NDEMENE DIAKHATE)",32,37,278,267,545
THIES,TIVAOUANE,NIAKHENE,NIAKHENE,"NDERE MBAYE",26,29,163,155,318
THIES,TIVAOUANE,NIAKHENE,NIAKHENE,"NDIAKHATE GOUYE",2,3,38,14,52
THIES,TIVAOUANE,NIAKHENE,NIAKHENE,NDILAKH,3,3,18,11,29
THIES,TIVAOUANE,NIAKHENE,NIAKHENE,NDINE,29,33,180,187,367
THIES,TIVAOUANE,NIAKHENE,NIAKHENE,"NDOME KHATTA",2,2,6,12,18
THIES,TIVAOUANE,NIAKHENE,NIAKHENE,"NGUEMBE NDILAKH",8,10,57,54,111
THIES,TIVAOUANE,NIAKHENE,NIAKHENE,"NGUEMBE THYLLA",13,18,82,77,159
THIES,TIVAOUANE,NIAKHENE,NIAKHENE,NIAKHENE,104,119,716,628,1344
THIES,TIVAOUANE,NIAKHENE,NIAKHENE,"NIAKHENE DIAMA",13,14,97,86,183
THIES,TIVAOUANE,NIAKHENE,NIAKHENE,"PALENE 1",1,1,5,2,7
THIES,TIVAOUANE,NIAKHENE,NIAKHENE,"PALENE 2",6,7,53,28,81
THIES,TIVAOUANE,NIAKHENE,NIAKHENE,RAMATOU,1,1,4,5,9
THIES,TIVAOUANE,NIAKHENE,NIAKHENE,"SANTHIOU NDILAKH",1,1,9,7,16
THIES,TIVAOUANE,NIAKHENE,NIAKHENE,"SANTHIOU THYLL",34,34,256,286,542
THIES,TIVAOUANE,NIAKHENE,NIAKHENE,THIAMBENE,9,11,58,48,106
THIES,TIVAOUANE,NIAKHENE,NIAKHENE,THIARENE,3,3,10,9,19
THIES,TIVAOUANE,NIAKHENE,NIAKHENE,"THILLA 1",15,15,158,91,249
THIES,TIVAOUANE,NIAKHENE,NIAKHENE,"THILLA 2",14,17,226,94,320
THIES,TIVAOUANE,NIAKHENE,NIAKHENE,THIOKOU,21,23,150,144,294
THIES,TIVAOUANE,NIAKHENE,NIAKHENE,THIOUMBOULENE,9,14,113,88,201
THIES,TIVAOUANE,NIAKHENE,NIAKHENE,BOPP,16,19,176,132,308
THIES,TIVAOUANE,NIAKHENE,NIAKHENE,"MEOUDOU KHATTA",3,3,19,15,34
THIES,TIVAOUANE,NIAKHENE,THILMAKHA,"AFFIA (AFIA SANTHIE)",4,4,20,15,35
THIES,TIVAOUANE,NIAKHENE,THILMAKHA,"H1 PEULGA ( WADJA)",10,11,72,41,113
THIES,TIVAOUANE,NIAKHENE,THILMAKHA,AINOUMANE,56,58,280,300,580
THIES,TIVAOUANE,NIAKHENE,THILMAKHA,BADEME,5,5,36,32,68
THIES,TIVAOUANE,NIAKHENE,THILMAKHA,BANGHATHIE,4,4,13,10,23
THIES,TIVAOUANE,NIAKHENE,THILMAKHA,"H1 KEUR MOR FATIMA BA",1,1,7,7,14
THIES,TIVAOUANE,NIAKHENE,THILMAKHA,"H2 DOUNYA",4,6,32,44,76
THIES,TIVAOUANE,NIAKHENE,THILMAKHA,"BOYE 1",22,23,171,152,323
THIES,TIVAOUANE,NIAKHENE,THILMAKHA,"H1 PEULGA de BOYE 1",7,7,67,42,109
THIES,TIVAOUANE,NIAKHENE,THILMAKHA,"H2 KEUR BIRANE DIOUF",2,2,25,21,46
THIES,TIVAOUANE,NIAKHENE,THILMAKHA,"BOYE 2",14,15,88,80,168
THIES,TIVAOUANE,NIAKHENE,THILMAKHA,"H2 KEUR KHALY",8,8,42,40,82
THIES,TIVAOUANE,NIAKHENE,THILMAKHA,"H3 KEUR MOUSSA DIOM( DIOMENE)",17,17,134,124,258
THIES,TIVAOUANE,NIAKHENE,THILMAKHA,"DAROU AFFIA",8,9,47,40,87
THIES,TIVAOUANE,NIAKHENE,THILMAKHA,"DAROU DIOP",5,5,53,30,83
THIES,TIVAOUANE,NIAKHENE,THILMAKHA,DEKHLE,10,12,108,80,188
THIES,TIVAOUANE,NIAKHENE,THILMAKHA,DIGNE,31,42,262,252,514
THIES,TIVAOUANE,NIAKHENE,THILMAKHA,"GUEDJI 1 ET 2",1,1,10,11,21
THIES,TIVAOUANE,NIAKHENE,THILMAKHA,"KEUR DEMBA",27,27,156,133,289
THIES,TIVAOUANE,NIAKHENE,THILMAKHA,"KEUR DIOUMA PEULH",17,25,149,125,274
THIES,TIVAOUANE,NIAKHENE,THILMAKHA,"KEUR MADIAMA (NIAKHAL)",15,17,76,73,149
THIES,TIVAOUANE,NIAKHENE,THILMAKHA,"H1 FAMA",4,4,19,23,42
THIES,TIVAOUANE,NIAKHENE,THILMAKHA,"KEUR MAKHOUDIA",4,4,14,8,22
THIES,TIVAOUANE,NIAKHENE,THILMAKHA,"KEUR MANDOUMBE KHARY",34,37,236,205,441
THIES,TIVAOUANE,NIAKHENE,THILMAKHA,"KEUR MANIAW",15,19,194,127,321
THIES,TIVAOUANE,NIAKHENE,THILMAKHA,"H1 MBADIANENE",7,8,71,53,124
THIES,TIVAOUANE,NIAKHENE,THILMAKHA,"H2 KEUR SERIGNE MODOU SYLLA(SYLLA KAD)",2,2,36,17,53
THIES,TIVAOUANE,NIAKHENE,THILMAKHA,"H1 DAROU KHAXAM",6,6,32,37,69
THIES,TIVAOUANE,NIAKHENE,THILMAKHA,"KEUR MATAR MASSOGUI",1,1,7,0,7
THIES,TIVAOUANE,NIAKHENE,THILMAKHA,"KEUR MOUSTAPH",22,26,166,137,303
THIES,TIVAOUANE,NIAKHENE,THILMAKHA,"H1 DAROU SALAM FAYLOU",1,2,10,10,20
THIES,TIVAOUANE,NIAKHENE,THILMAKHA,"KEUR YOUGA SAMB",12,12,69,66,135
THIES,TIVAOUANE,NIAKHENE,THILMAKHA,"KEUR YOUSSOU",8,10,54,54,108
THIES,TIVAOUANE,NIAKHENE,THILMAKHA,KHAMNANE,20,28,193,133,326
THIES,TIVAOUANE,NIAKHENE,THILMAKHA,"KHAYE GADIAGA 2",5,7,32,37,69
THIES,TIVAOUANE,NIAKHENE,THILMAKHA,"KHAYE NGADIAGA 1 (PEULGA)",5,5,35,36,71
THIES,TIVAOUANE,NIAKHENE,THILMAKHA,"H1 NGADIAGA PEULH",3,3,9,10,19
THIES,TIVAOUANE,NIAKHENE,THILMAKHA,LONGHOR,5,5,38,39,77
THIES,TIVAOUANE,NIAKHENE,THILMAKHA,"H1 KEUR AMAR",7,7,27,30,57
THIES,TIVAOUANE,NIAKHENE,THILMAKHA,"H3 LONGHOR",13,13,117,114,231
THIES,TIVAOUANE,NIAKHENE,THILMAKHA,MBARTIGNE,10,11,58,65,123
THIES,TIVAOUANE,NIAKHENE,THILMAKHA,MBOBA,9,9,40,44,84
THIES,TIVAOUANE,NIAKHENE,THILMAKHA,MBOUBENE,4,5,51,41,92
THIES,TIVAOUANE,NIAKHENE,THILMAKHA,"MERINA NDIAYE WOLOF (NDIAYENE)",6,6,38,49,87
THIES,TIVAOUANE,NIAKHENE,THILMAKHA,"MERINA NDIAYE PEUL",7,10,47,54,101
THIES,TIVAOUANE,NIAKHENE,THILMAKHA,NDEME,16,16,113,96,209
THIES,TIVAOUANE,NIAKHENE,THILMAKHA,"H1 PEULGA PENKOU",7,7,45,37,82
THIES,TIVAOUANE,NIAKHENE,THILMAKHA,"NDIA NDONGO",15,16,114,141,255
THIES,TIVAOUANE,NIAKHENE,THILMAKHA,NDIAKHO,4,4,29,25,54
THIES,TIVAOUANE,NIAKHENE,THILMAKHA,"NDIALBA 1",9,10,84,50,134
THIES,TIVAOUANE,NIAKHENE,THILMAKHA,"NDIALBA 2",5,5,30,23,53
THIES,TIVAOUANE,NIAKHENE,THILMAKHA,NDIANKANE,6,6,118,28,146
THIES,TIVAOUANE,NIAKHENE,THILMAKHA,"NDIAYENE WADIA",11,14,114,108,222
THIES,TIVAOUANE,NIAKHENE,THILMAKHA,NDIEUMB,9,10,37,38,75
THIES,TIVAOUANE,NIAKHENE,THILMAKHA,"NDIOL 1",13,19,127,81,208
THIES,TIVAOUANE,NIAKHENE,THILMAKHA,"NDIOL 2",9,12,104,114,218
THIES,TIVAOUANE,NIAKHENE,THILMAKHA,NDONGO,96,103,510,609,1119
THIES,TIVAOUANE,NIAKHENE,THILMAKHA,"H1 GOUYE MANAR",6,6,61,66,127
THIES,TIVAOUANE,NIAKHENE,THILMAKHA,"NDOUCOUMANE NDIAYE",47,51,313,440,753
THIES,TIVAOUANE,NIAKHENE,THILMAKHA,NGAYENE,6,6,40,27,67
THIES,TIVAOUANE,NIAKHENE,THILMAKHA,NGUEBEUL,15,18,78,95,173
THIES,TIVAOUANE,NIAKHENE,THILMAKHA,"NIAKHAL MATAR (KEUR LIBASSE)",14,18,86,87,173
THIES,TIVAOUANE,NIAKHENE,THILMAKHA,"PALLENE 3",2,2,12,12,24
THIES,TIVAOUANE,NIAKHENE,THILMAKHA,TALBAKHLE,16,25,111,116,227
THIES,TIVAOUANE,NIAKHENE,THILMAKHA,"H1 TALL",8,9,49,39,88
THIES,TIVAOUANE,NIAKHENE,THILMAKHA,"H2 TALL 3",3,3,13,8,21
THIES,TIVAOUANE,NIAKHENE,THILMAKHA,THIAFOURA,20,26,113,93,206
THIES,TIVAOUANE,NIAKHENE,THILMAKHA,"H1 KEUR SAMBA CISSE",4,4,34,48,82
THIES,TIVAOUANE,NIAKHENE,THILMAKHA,"THILMAKHA 1",72,81,469,497,966
THIES,TIVAOUANE,NIAKHENE,THILMAKHA,"H1 NDIABAYE",21,23,101,98,199
THIES,TIVAOUANE,NIAKHENE,THILMAKHA,"THILMAKHA 2",72,78,310,372,682
THIES,TIVAOUANE,NIAKHENE,THILMAKHA,"THIOLANE 1",15,19,91,112,203
THIES,TIVAOUANE,NIAKHENE,THILMAKHA,"THIOLANE 2",6,6,35,44,79
THIES,TIVAOUANE,NIAKHENE,THILMAKHA,"H1 SAM",8,8,64,59,123
THIES,TIVAOUANE,NIAKHENE,THILMAKHA,THIOURANGUENE,10,15,111,87,198
THIES,TIVAOUANE,NIAKHENE,THILMAKHA,"THYLLA GUEDJI",8,8,41,37,78
THIES,TIVAOUANE,NIAKHENE,THILMAKHA,"TOUNENE 1",13,13,69,59,128
THIES,TIVAOUANE,NIAKHENE,THILMAKHA,"TOUNENE 2",4,4,12,15,27
THIES,TIVAOUANE,NIAKHENE,THILMAKHA,WADJA,19,25,169,167,336
THIES,TIVAOUANE,NIAKHENE,THILMAKHA,"H1 PEULGA de WADJA",1,1,4,7,11
THIES,TIVAOUANE,NIAKHENE,THILMAKHA,YEO,11,11,80,69,149
THIES,TIVAOUANE,NIAKHENE,THILMAKHA,YOLMA,17,19,88,102,190
THIES,TIVAOUANE,NIAKHENE,THILMAKHA,"H1 KEUR SALIOU",6,6,31,31,62
THIES,TIVAOUANE,PAMBAL,"CHERIF LO",BALIGA,151,181,1023,1068,2091
THIES,TIVAOUANE,PAMBAL,"CHERIF LO","CHERIF LO",163,206,1381,1290,2671
THIES,TIVAOUANE,PAMBAL,"CHERIF LO","CHERIF MOULAYE",26,31,161,167,328
THIES,TIVAOUANE,PAMBAL,"CHERIF LO","CHERIF PINKOU",9,11,104,82,186
THIES,TIVAOUANE,PAMBAL,"CHERIF LO","KEUR AMARY COUMBA",50,56,373,277,650
THIES,TIVAOUANE,PAMBAL,"CHERIF LO","H2 YADOU",4,8,54,42,96
THIES,TIVAOUANE,PAMBAL,"CHERIF LO","KEUR DEMBA BA",12,14,70,67,137
THIES,TIVAOUANE,PAMBAL,"CHERIF LO","KEUR DEMBA DARO",12,12,68,51,119
THIES,TIVAOUANE,PAMBAL,"CHERIF LO","KEUR EL HADJI M’BACKE",16,21,136,116,252
THIES,TIVAOUANE,PAMBAL,"CHERIF LO","KEUR GALI SARR",10,17,68,66,134
THIES,TIVAOUANE,PAMBAL,"CHERIF LO","H1 KEUR MASSAER",17,23,142,107,249
THIES,TIVAOUANE,PAMBAL,"CHERIF LO","KEUR IBRA SARR",8,10,51,53,104
THIES,TIVAOUANE,PAMBAL,"CHERIF LO","KEUR ISSAKHA",3,3,16,14,30
THIES,TIVAOUANE,PAMBAL,"CHERIF LO","KEUR KAKOUNE",6,7,48,41,89
THIES,TIVAOUANE,PAMBAL,"CHERIF LO","KEUR KHALY SOKHNA (KEUR KHALY TEUGUI)",37,45,402,361,763
THIES,TIVAOUANE,PAMBAL,"CHERIF LO","KEUR MAGUEYE",26,36,225,198,423
THIES,TIVAOUANE,PAMBAL,"CHERIF LO","KEUR MAGUEYE NDAO",20,22,97,122,219
THIES,TIVAOUANE,PAMBAL,"CHERIF LO","KEUR MANDEME",5,5,21,30,51
THIES,TIVAOUANE,PAMBAL,"CHERIF LO","KEUR MASSAER DIENG",30,32,168,144,312
THIES,TIVAOUANE,PAMBAL,"CHERIF LO","KEUR MASSAMBA GUEYE",29,34,209,209,418
THIES,TIVAOUANE,PAMBAL,"CHERIF LO","KEUR MATHIEULENE",30,54,323,305,628
THIES,TIVAOUANE,PAMBAL,"CHERIF LO","KEUR MBAYE MATY",4,6,49,51,100
THIES,TIVAOUANE,PAMBAL,"CHERIF LO","KEUR MEDOUNE DIAW",5,8,78,66,144
THIES,TIVAOUANE,PAMBAL,"CHERIF LO","KEUR NGALGOU",2,3,11,23,34
THIES,TIVAOUANE,PAMBAL,"CHERIF LO","KEUR NGORE DIOP",17,24,121,130,251
THIES,TIVAOUANE,PAMBAL,"CHERIF LO","KEUR THIONE SARR",63,94,611,564,1175
THIES,TIVAOUANE,PAMBAL,"CHERIF LO","KEUR YORO SADIO",50,58,297,298,595
THIES,TIVAOUANE,PAMBAL,"CHERIF LO",KOUDIADIENE,48,51,223,210,433
THIES,TIVAOUANE,PAMBAL,"CHERIF LO","LAM LAM SERERE",26,34,110,122,232
THIES,TIVAOUANE,PAMBAL,"CHERIF LO","H1 LAM LAM CITE",37,44,214,221,435
THIES,TIVAOUANE,PAMBAL,"CHERIF LO","H2 LAM LAM ECOLE (CHATEAU D'EAU)",15,18,79,68,147
THIES,TIVAOUANE,PAMBAL,"CHERIF LO",MBAMPANA,95,96,468,347,815
THIES,TIVAOUANE,PAMBAL,"CHERIF LO",MBENGUENE,91,99,638,625,1263
THIES,TIVAOUANE,PAMBAL,"CHERIF LO",MBEYE,4,4,35,24,59
THIES,TIVAOUANE,PAMBAL,"CHERIF LO",MBOUBOU,5,10,53,57,110
THIES,TIVAOUANE,PAMBAL,"CHERIF LO","H1 KEUR MBAYE GUEYE",11,11,93,73,166
THIES,TIVAOUANE,PAMBAL,"CHERIF LO","NDIA KEUR AMADOU NAR",46,55,283,242,525
THIES,TIVAOUANE,PAMBAL,"CHERIF LO","NDIAKHATE AMAR",85,84,474,401,875
THIES,TIVAOUANE,PAMBAL,"CHERIF LO","NDIAKHATE NDIASSANE",231,280,1851,1800,3651
THIES,TIVAOUANE,PAMBAL,"CHERIF LO",NDIASSANE,470,563,2511,2414,4925
THIES,TIVAOUANE,PAMBAL,"CHERIF LO","NDJITE NDIASSANE",47,49,322,301,623
THIES,TIVAOUANE,PAMBAL,"CHERIF LO",NIAKHA,17,17,90,74,164
THIES,TIVAOUANE,PAMBAL,"CHERIF LO","H1 DAROU FALL",15,16,95,94,189
THIES,TIVAOUANE,PAMBAL,"CHERIF LO","TAWA FALL",14,18,70,82,152
THIES,TIVAOUANE,PAMBAL,"CHERIF LO",THIAFATHIE,52,54,219,222,441
THIES,TIVAOUANE,PAMBAL,"CHERIF LO","H1 LAM LAM CROISEMENT",9,9,44,53,97
THIES,TIVAOUANE,PAMBAL,"CHERIF LO","THIAOUNE BAMBARA",30,30,147,94,241
THIES,TIVAOUANE,PAMBAL,"CHERIF LO","THIAOUNE SERERE",60,66,262,249,511
THIES,TIVAOUANE,PAMBAL,"CHERIF LO","H1 THIAOUNE PEULH",26,50,211,171,382
THIES,TIVAOUANE,PAMBAL,"CHERIF LO","NDIANGANE KAW",8,9,31,31,62
THIES,TIVAOUANE,PAMBAL,"CHERIF LO","H1 NDIANGANE SOUF",2,2,6,6,12
THIES,TIVAOUANE,PAMBAL,"MONT ROLLAND","COLOBANE THIOMBANE",60,67,322,331,653
THIES,TIVAOUANE,PAMBAL,"MONT ROLLAND","H1 COLOBANE KAW",13,13,42,35,77
THIES,TIVAOUANE,PAMBAL,"MONT ROLLAND",FOULOUME,174,238,1191,1198,2389
THIES,TIVAOUANE,PAMBAL,"MONT ROLLAND","H1 THIOUROUKH",9,14,131,69,200
THIES,TIVAOUANE,PAMBAL,"MONT ROLLAND",FOULOUNE,46,59,175,196,371
THIES,TIVAOUANE,PAMBAL,"MONT ROLLAND",KEMAYE,51,104,410,407,817
THIES,TIVAOUANE,PAMBAL,"MONT ROLLAND","H1 MBENDI",5,5,19,13,32
THIES,TIVAOUANE,PAMBAL,"MONT ROLLAND","KEUR DAOUDA CISS",16,21,120,138,258
THIES,TIVAOUANE,PAMBAL,"MONT ROLLAND","H1 KEUR MACTAR GUEYE",10,10,50,49,99
THIES,TIVAOUANE,PAMBAL,"MONT ROLLAND","H2 KEUR ISMAILA NDIAYE",1,2,13,12,25
THIES,TIVAOUANE,PAMBAL,"MONT ROLLAND","KEUR LAT DIOP (PALLENE)",12,17,136,122,258
THIES,TIVAOUANE,PAMBAL,"MONT ROLLAND","KHAYE DIAGAL",20,26,70,85,155
THIES,TIVAOUANE,PAMBAL,"MONT ROLLAND","LOUKOUSS (DIORA)",63,76,402,442,844
THIES,TIVAOUANE,PAMBAL,"MONT ROLLAND","H1 DEDIASSA",31,34,216,210,426
THIES,TIVAOUANE,PAMBAL,"MONT ROLLAND","H2 KEUR YOUSSOU",5,5,20,25,45
THIES,TIVAOUANE,PAMBAL,"MONT ROLLAND","H3 DAROU LOUKHOUSS",40,49,187,209,396
THIES,TIVAOUANE,PAMBAL,"MONT ROLLAND","H4 KEUR PAUL CISSE",1,1,4,6,10
THIES,TIVAOUANE,PAMBAL,"MONT ROLLAND","H5 KEUR ASSANE KA",19,24,132,141,273
THIES,TIVAOUANE,PAMBAL,"MONT ROLLAND","NDIAYE BOPP",241,313,1498,1544,3042
THIES,TIVAOUANE,PAMBAL,"MONT ROLLAND","NGUICK FALL",80,115,672,691,1363
THIES,TIVAOUANE,PAMBAL,"MONT ROLLAND","PAKHAMKOUYE 1 (PONKOUYE)",53,63,344,344,688
THIES,TIVAOUANE,PAMBAL,"MONT ROLLAND","PAKHAMKOUYE 2",56,66,243,260,503
THIES,TIVAOUANE,PAMBAL,"MONT ROLLAND","H1 KEUR ALI SAMBA",2,5,22,12,34
THIES,TIVAOUANE,PAMBAL,"MONT ROLLAND","H2 DIORA",6,6,12,17,29
THIES,TIVAOUANE,PAMBAL,"MONT ROLLAND","PALO DIAL",14,24,55,48,103
THIES,TIVAOUANE,PAMBAL,"MONT ROLLAND","H1 PALO SOURANG",2,2,4,1,5
THIES,TIVAOUANE,PAMBAL,"MONT ROLLAND","H2 PALO DOUGOUNANE",36,40,145,123,268
THIES,TIVAOUANE,PAMBAL,"MONT ROLLAND","H3 FAM PONY",11,12,65,65,130
THIES,TIVAOUANE,PAMBAL,"MONT ROLLAND","PALO YOUGA",30,43,182,124,306
THIES,TIVAOUANE,PAMBAL,"MONT ROLLAND","H1 CITE GUILANG (CROISEMENT NDIASSANE)",7,7,23,18,41
THIES,TIVAOUANE,PAMBAL,"MONT ROLLAND","H2 CROISEMENT MAKA HAYE",11,11,62,65,127
THIES,TIVAOUANE,PAMBAL,"MONT ROLLAND","SAMBAYE KARANG",14,16,85,53,138
THIES,TIVAOUANE,PAMBAL,"MONT ROLLAND","H1 PAMWAKHA",13,15,67,58,125
THIES,TIVAOUANE,PAMBAL,"MONT ROLLAND",THIAYE,77,113,616,679,1295
THIES,TIVAOUANE,PAMBAL,"MONT ROLLAND","TIVIGNE DIASSA",85,88,267,254,521
THIES,TIVAOUANE,PAMBAL,"MONT ROLLAND","H1 KEUR THIAYA",31,36,133,113,246
THIES,TIVAOUANE,PAMBAL,"MONT ROLLAND","TIVIGNE TANGHOR",128,174,540,535,1075
THIES,TIVAOUANE,PAMBAL,"MONT ROLLAND","H1 MERE TIVIGNE TANGHOR",11,13,36,36,72
THIES,TIVAOUANE,PAMBAL,"NOTTO GOUYE DIAMA","BAITY BAKAR (BAITY SANTHIE)",78,120,655,750,1405
THIES,TIVAOUANE,PAMBAL,"NOTTO GOUYE DIAMA","H1 MBENGUENE de BAITY BAKAR (BAITY SANTHIE)",22,26,165,227,392
THIES,TIVAOUANE,PAMBAL,"NOTTO GOUYE DIAMA","BAITY DAKHAR",63,86,408,470,878
THIES,TIVAOUANE,PAMBAL,"NOTTO GOUYE DIAMA",DAGA,136,209,965,994,1959
THIES,TIVAOUANE,PAMBAL,"NOTTO GOUYE DIAMA","DAROU ALPHA",90,114,519,530,1049
THIES,TIVAOUANE,PAMBAL,"NOTTO GOUYE DIAMA","H1 KEUR MODOU THIONE",7,7,27,33,60
THIES,TIVAOUANE,PAMBAL,"NOTTO GOUYE DIAMA","H2 KEUR BAYE GORE GUEYE",6,6,35,35,70
THIES,TIVAOUANE,PAMBAL,"NOTTO GOUYE DIAMA","DIEULEUCK OUOLOF",40,59,328,321,649
THIES,TIVAOUANE,PAMBAL,"NOTTO GOUYE DIAMA","H1 KEUR DIAO BA",14,16,61,44,105
THIES,TIVAOUANE,PAMBAL,"NOTTO GOUYE DIAMA","DIEULEUCK PEULH",135,172,1263,1230,2493
THIES,TIVAOUANE,PAMBAL,"NOTTO GOUYE DIAMA","H1 KEUR OUSMANE SOW",2,2,16,14,30
THIES,TIVAOUANE,PAMBAL,"NOTTO GOUYE DIAMA","H2 KEUR SOULEY SOW",14,26,92,101,193
THIES,TIVAOUANE,PAMBAL,"NOTTO GOUYE DIAMA","H3 BEUREUP BA",41,57,303,282,585
THIES,TIVAOUANE,PAMBAL,"NOTTO GOUYE DIAMA",GAOUT,13,17,61,58,119
THIES,TIVAOUANE,PAMBAL,"NOTTO GOUYE DIAMA","H1 GAOUTT MOLE",11,16,70,74,144
THIES,TIVAOUANE,PAMBAL,"NOTTO GOUYE DIAMA","GOUYE DIAMA",66,86,475,477,952
THIES,TIVAOUANE,PAMBAL,"NOTTO GOUYE DIAMA",KERY,45,63,387,339,726
THIES,TIVAOUANE,PAMBAL,"NOTTO GOUYE DIAMA","KEUR MAR DIOP",1,2,11,17,28
THIES,TIVAOUANE,PAMBAL,"NOTTO GOUYE DIAMA","KEUR MBATTA",3,3,5,0,5
THIES,TIVAOUANE,PAMBAL,"NOTTO GOUYE DIAMA","KEUR MBIR NDAO",276,336,2483,2273,4756
THIES,TIVAOUANE,PAMBAL,"NOTTO GOUYE DIAMA","KEUR PATHE KHEWE",25,34,242,177,419
THIES,TIVAOUANE,PAMBAL,"NOTTO GOUYE DIAMA","KEUR SAMBA YACINE",48,61,339,311,650
THIES,TIVAOUANE,PAMBAL,"NOTTO GOUYE DIAMA","KEUR WORE GOR",70,85,696,618,1314
THIES,TIVAOUANE,PAMBAL,"NOTTO GOUYE DIAMA","KHAYE DAGA",21,24,100,96,196
THIES,TIVAOUANE,PAMBAL,"NOTTO GOUYE DIAMA",MBAYENE,25,35,226,164,390
THIES,TIVAOUANE,PAMBAL,"NOTTO GOUYE DIAMA",NGADIAGA,100,150,897,906,1803
THIES,TIVAOUANE,PAMBAL,"NOTTO GOUYE DIAMA","NOTTO GOUYE DIAMA",652,964,4596,4015,8611
THIES,TIVAOUANE,PAMBAL,"NOTTO GOUYE DIAMA",SEGUEL,111,146,848,823,1671
THIES,TIVAOUANE,PAMBAL,"NOTTO GOUYE DIAMA","SINE BAKAR",31,32,171,169,340
THIES,TIVAOUANE,PAMBAL,"NOTTO GOUYE DIAMA","THILANE DIOR",42,42,273,291,564
THIES,TIVAOUANE,PAMBAL,"NOTTO GOUYE DIAMA","THILANE TANGHOR",13,20,69,95,164
THIES,TIVAOUANE,PAMBAL,"NOTTO GOUYE DIAMA","H1 MBENGUENE de THILANE TANGHOR",16,19,67,101,168
THIES,TIVAOUANE,PAMBAL,"NOTTO GOUYE DIAMA","BEREUP DIA (KHOURMA)",24,49,252,188,440
THIES,TIVAOUANE,PAMBAL,"NOTTO GOUYE DIAMA","H1 TOULA",36,59,279,219,498
THIES,TIVAOUANE,PAMBAL,"NOTTO GOUYE DIAMA","BEREUP SOW",7,14,113,97,210
THIES,TIVAOUANE,PAMBAL,"PIRE GOUREYE","BAGNE FALL",23,26,207,205,412
THIES,TIVAOUANE,PAMBAL,"PIRE GOUREYE","BAITY DIENG",5,5,38,28,66
THIES,TIVAOUANE,PAMBAL,"PIRE GOUREYE","BAITY FALL (MALAO)",1,1,6,7,13
THIES,TIVAOUANE,PAMBAL,"PIRE GOUREYE","DAKHAR DODJI",14,16,123,89,212
THIES,TIVAOUANE,PAMBAL,"PIRE GOUREYE","DAROU CISSE",14,16,127,94,221
THIES,TIVAOUANE,PAMBAL,"PIRE GOUREYE",KA,73,92,442,471,913
THIES,TIVAOUANE,PAMBAL,"PIRE GOUREYE","KAYE YORO NDIAYE",4,5,26,19,45
THIES,TIVAOUANE,PAMBAL,"PIRE GOUREYE","KEUR ALIOU KANE",34,39,260,240,500
THIES,TIVAOUANE,PAMBAL,"PIRE GOUREYE","KEUR AMADOU YACINE",22,23,198,182,380
THIES,TIVAOUANE,PAMBAL,"PIRE GOUREYE","KEUR AMAR DIAO (NDIAWO)",12,16,119,96,215
THIES,TIVAOUANE,PAMBAL,"PIRE GOUREYE","KEUR AMATH PENDA",15,16,169,137,306
THIES,TIVAOUANE,PAMBAL,"PIRE GOUREYE","KEUR AMATH SOPHIE",9,15,105,80,185
THIES,TIVAOUANE,PAMBAL,"PIRE GOUREYE","KEUR ASSANE",18,20,134,95,229
THIES,TIVAOUANE,PAMBAL,"PIRE GOUREYE","KEUR BIRIMA FABE",11,12,133,115,248
THIES,TIVAOUANE,PAMBAL,"PIRE GOUREYE","KEUR DAW MANE",5,7,42,50,92
THIES,TIVAOUANE,PAMBAL,"PIRE GOUREYE","KEUR DAW NGONE (NGUIMBE)",3,3,30,20,50
THIES,TIVAOUANE,PAMBAL,"PIRE GOUREYE","KEUR GALLO KEBE",45,63,276,224,500
THIES,TIVAOUANE,PAMBAL,"PIRE GOUREYE","KEUR GOROM SALL",1,1,9,9,18
THIES,TIVAOUANE,PAMBAL,"PIRE GOUREYE","KEUR KHALY SARATA",38,48,305,324,629
THIES,TIVAOUANE,PAMBAL,"PIRE GOUREYE","KEUR MALICK NIANG",3,3,15,16,31
THIES,TIVAOUANE,PAMBAL,"PIRE GOUREYE","KEUR MASSAMBA DIENG",8,11,76,74,150
THIES,TIVAOUANE,PAMBAL,"PIRE GOUREYE","KEUR NDIAGA MBAYE",29,34,253,225,478
THIES,TIVAOUANE,PAMBAL,"PIRE GOUREYE",LEYENE,10,11,92,90,182
THIES,TIVAOUANE,PAMBAL,"PIRE GOUREYE","MAKA FALL",1,1,5,5,10
THIES,TIVAOUANE,PAMBAL,"PIRE GOUREYE",MBABA,14,25,129,106,235
THIES,TIVAOUANE,PAMBAL,"PIRE GOUREYE",MBANE,5,5,24,31,55
THIES,TIVAOUANE,PAMBAL,"PIRE GOUREYE","MBARAGLOU KHOULE",79,94,711,588,1299
THIES,TIVAOUANE,PAMBAL,"PIRE GOUREYE","H1 THIOCE KEUR CAMARA",2,2,5,10,15
THIES,TIVAOUANE,PAMBAL,"PIRE GOUREYE","MEDINA GOUTOUTE",20,21,109,86,195
THIES,TIVAOUANE,PAMBAL,"PIRE GOUREYE","MEDINA SALL (KEUR BASSY)",14,22,162,142,304
THIES,TIVAOUANE,PAMBAL,"PIRE GOUREYE","NDAME LO",26,31,177,153,330
THIES,TIVAOUANE,PAMBAL,"PIRE GOUREYE",NDIARY,3,3,35,33,68
THIES,TIVAOUANE,PAMBAL,"PIRE GOUREYE","NDIAYE SAGNAKHOR (KEUR SAMBA NAR)",8,8,44,41,85
THIES,TIVAOUANE,PAMBAL,"PIRE GOUREYE",NDIENGAL,4,6,40,32,72
THIES,TIVAOUANE,PAMBAL,"PIRE GOUREYE",NDIENGUE,4,7,76,74,150
THIES,TIVAOUANE,PAMBAL,"PIRE GOUREYE",NDIEYE,86,121,722,623,1345
THIES,TIVAOUANE,PAMBAL,"PIRE GOUREYE","H1 YENDOUNANE KADE",16,20,146,119,265
THIES,TIVAOUANE,PAMBAL,"PIRE GOUREYE",NDIMBY,4,6,35,28,63
THIES,TIVAOUANE,PAMBAL,"PIRE GOUREYE","H1 BAITY",1,1,25,22,47
THIES,TIVAOUANE,PAMBAL,"PIRE GOUREYE",NDJEGUEDJ,78,99,627,638,1265
THIES,TIVAOUANE,PAMBAL,"PIRE GOUREYE","H1 NGUERENE",46,65,361,311,672
THIES,TIVAOUANE,PAMBAL,"PIRE GOUREYE",NDJIFIFE,13,14,76,84,160
THIES,TIVAOUANE,PAMBAL,"PIRE GOUREYE","H1 KHOULE",4,8,30,37,67
THIES,TIVAOUANE,PAMBAL,"PIRE GOUREYE","NDJITE SAGNAKHOR",15,16,107,76,183
THIES,TIVAOUANE,PAMBAL,"PIRE GOUREYE",NDOGANDOU,20,22,190,171,361
THIES,TIVAOUANE,PAMBAL,"PIRE GOUREYE",NDOME,21,32,181,144,325
THIES,TIVAOUANE,PAMBAL,"PIRE GOUREYE","NGAYE NGAYE",16,19,109,102,211
THIES,TIVAOUANE,PAMBAL,"PIRE GOUREYE","NGUENTH ARDO (KEUR SAMBA LAO)",5,5,31,26,57
THIES,TIVAOUANE,PAMBAL,"PIRE GOUREYE",NGUEWAR,11,15,103,93,196
THIES,TIVAOUANE,PAMBAL,"PIRE GOUREYE","NGUEYENE MOMAR",14,14,117,81,198
THIES,TIVAOUANE,PAMBAL,"PIRE GOUREYE","PALLENE PIRE",43,58,285,280,565
THIES,TIVAOUANE,PAMBAL,"PIRE GOUREYE","PIRE GOUREYE",1113,1275,7364,7479,14843
THIES,TIVAOUANE,PAMBAL,"PIRE GOUREYE",SAMAEL,14,16,122,92,214
THIES,TIVAOUANE,PAMBAL,"PIRE GOUREYE","SATHIOU NDARY",12,18,111,84,195
THIES,TIVAOUANE,PAMBAL,"PIRE GOUREYE","SANTHIOU NDIEYE",5,7,44,31,75
THIES,TIVAOUANE,PAMBAL,"PIRE GOUREYE","TALLENE OUOLOF",11,15,97,57,154
THIES,TIVAOUANE,PAMBAL,"PIRE GOUREYE","TALLENE PEULH",2,3,11,10,21
THIES,TIVAOUANE,PAMBAL,"PIRE GOUREYE",THIALLE,5,7,26,27,53
THIES,TIVAOUANE,PAMBAL,"PIRE GOUREYE","THIAMENE (KEUR EL HADJI MOR THIAM)",11,15,112,106,218
THIES,TIVAOUANE,PAMBAL,"PIRE GOUREYE","H1 PEULGA",8,13,57,50,107
THIES,TIVAOUANE,PAMBAL,"PIRE GOUREYE",THIAWARE,34,36,233,196,429
THIES,TIVAOUANE,PAMBAL,"PIRE GOUREYE","TOUBA FALL",12,14,69,61,130
THIES,TIVAOUANE,PAMBAL,"PIRE GOUREYE","YENDOULNANE SANTHIE",3,3,16,21,37
THIES,TIVAOUANE,PAMBAL,"PIRE GOUREYE","MBAR DIOP",50,51,306,335,641
THIES,TIVAOUANE,PAMBAL,"PIRE GOUREYE","MBAR NDIAYE",49,49,289,275,564
THIES,TIVAOUANE,PAMBAL,"PIRE GOUREYE","NGUENTH ARDO",4,10,60,71,131
THIES,TIVAOUANE,PAMBAL,PAMBAL,DOUGNANE,89,109,498,578,1076
THIES,TIVAOUANE,PAMBAL,PAMBAL,"KEUR MASSONGO",14,17,106,103,209
THIES,TIVAOUANE,PAMBAL,PAMBAL,"KEUR MAYE SAMB",10,11,62,89,151
THIES,TIVAOUANE,PAMBAL,PAMBAL,KADANE,21,28,122,100,222
THIES,TIVAOUANE,PAMBAL,PAMBAL,KHACK,22,23,113,111,224
THIES,TIVAOUANE,PAMBAL,PAMBAL,KIWI,28,60,498,452,950
THIES,TIVAOUANE,PAMBAL,PAMBAL,LOFFE,13,16,120,110,230
THIES,TIVAOUANE,PAMBAL,PAMBAL,MBACIANE,56,66,368,325,693
THIES,TIVAOUANE,PAMBAL,PAMBAL,"MBARAGLOU BIRANE",51,68,325,340,665
THIES,TIVAOUANE,PAMBAL,PAMBAL,"MBARAGLOU COLOBANE",37,60,286,264,550
THIES,TIVAOUANE,PAMBAL,PAMBAL,"MBARAGLOU DALY",22,33,155,190,345
THIES,TIVAOUANE,PAMBAL,PAMBAL,"MBARAGLOU MOUSSA",37,46,292,237,529
THIES,TIVAOUANE,PAMBAL,PAMBAL,"H1 TOUBI",24,30,274,251,525
THIES,TIVAOUANE,PAMBAL,PAMBAL,"MBARAGLOU OGO",50,56,290,258,548
THIES,TIVAOUANE,PAMBAL,PAMBAL,NDIAFOUGNE,21,27,142,138,280
THIES,TIVAOUANE,PAMBAL,PAMBAL,"NDIAKHATE GORMONE",56,66,432,354,786
THIES,TIVAOUANE,PAMBAL,PAMBAL,NDIOUYE,18,23,98,86,184
THIES,TIVAOUANE,PAMBAL,PAMBAL,"PAMBAL AMAR",33,39,147,164,311
THIES,TIVAOUANE,PAMBAL,PAMBAL,"PAMBAL BOYE",61,76,452,424,876
THIES,TIVAOUANE,PAMBAL,PAMBAL,"SAM KEKE",6,7,24,45,69
THIES,TIVAOUANE,PAMBAL,PAMBAL,TEROKH,71,90,483,466,949
THIES,TIVAOUANE,PAMBAL,PAMBAL,YENDANE,47,54,159,170,329
THIES,TIVAOUANE,PAMBAL,PAMBAL,"DOUGNANE MBAYE DIOR",9,15,72,80,152
LOUGA,KEBEMER,KEBEMER,KEBEMER,"GALLA DAROU SALAM",460,537,2125,1940,4065
LOUGA,KEBEMER,KEBEMER,KEBEMER,MBABOU,421,483,1744,2134,3878
LOUGA,KEBEMER,KEBEMER,KEBEMER,MBASSINE,444,492,2250,2090,4340
LOUGA,KEBEMER,KEBEMER,KEBEMER,MEDINA,392,461,1864,1884,3748
LOUGA,KEBEMER,KEBEMER,KEBEMER,ESCALE,314,393,1267,1455,2722
LOUGA,KEBEMER,KEBEMER,KEBEMER,DIAMAGUENE,410,430,1740,1903,3643
LOUGA,KEBEMER,KEBEMER,KEBEMER,GALLA,227,293,1157,1218,2375
LOUGA,KEBEMER,KEBEMER,KEBEMER,NDAKHAR,172,192,854,953,1807
LOUGA,KEBEMER,KEBEMER,KEBEMER,"NDIABY FALL",65,70,361,366,727
LOUGA,KEBEMER,"DAROU MOUHTY","DAROU MARNANE","BABA LO",14,16,93,112,205
LOUGA,KEBEMER,"DAROU MOUHTY","DAROU MARNANE","BAYTI  MBERY BEYE",18,19,170,82,252
LOUGA,KEBEMER,"DAROU MOUHTY","DAROU MARNANE","BAYTI NGUERA 1",1,1,11,4,15
LOUGA,KEBEMER,"DAROU MOUHTY","DAROU MARNANE","KOKI DAKHAR",2,5,17,22,39
LOUGA,KEBEMER,"DAROU MOUHTY","DAROU MARNANE","KOKI KADE",16,19,123,112,235
LOUGA,KEBEMER,"DAROU MOUHTY","DAROU MARNANE","H1 BOUBOU BA",18,19,128,107,235
LOUGA,KEBEMER,"DAROU MOUHTY","DAROU MARNANE","H2 YALLENE",12,13,75,96,171
LOUGA,KEBEMER,"DAROU MOUHTY","DAROU MARNANE","DAROU DIOP",5,5,21,27,48
LOUGA,KEBEMER,"DAROU MOUHTY","DAROU MARNANE","H1 BIBE",5,5,23,22,45
LOUGA,KEBEMER,"DAROU MOUHTY","DAROU MARNANE","DAROU FASS",10,10,84,71,155
LOUGA,KEBEMER,"DAROU MOUHTY","DAROU MARNANE","DAROU MARNANE",479,600,2526,2954,5480
LOUGA,KEBEMER,"DAROU MOUHTY","DAROU MARNANE","H1 DAROU KHOUDOSS FETO",1,2,13,9,22
LOUGA,KEBEMER,"DAROU MOUHTY","DAROU MARNANE","H2 DAROU MARNANE FETO",27,32,240,189,429
LOUGA,KEBEMER,"DAROU MOUHTY","DAROU MARNANE",DEKHEULE,30,32,140,107,247
LOUGA,KEBEMER,"DAROU MOUHTY","DAROU MARNANE","H1 DEKHEULE PEULH",13,14,84,93,177
LOUGA,KEBEMER,"DAROU MOUHTY","DAROU MARNANE","DEKHOLE GUET",2,2,12,14,26
LOUGA,KEBEMER,"DAROU MOUHTY","DAROU MARNANE","DEKHOLE MBEYE PEULH",16,21,85,93,178
LOUGA,KEBEMER,"DAROU MOUHTY","DAROU MARNANE","FASS PEULH",6,6,35,36,71
LOUGA,KEBEMER,"DAROU MOUHTY","DAROU MARNANE","FASS TOURE",129,135,1081,717,1798
LOUGA,KEBEMER,"DAROU MOUHTY","DAROU MARNANE",KALOM,10,13,65,43,108
LOUGA,KEBEMER,"DAROU MOUHTY","DAROU MARNANE","KEUR MASSAMBA KHARY",16,21,109,84,193
LOUGA,KEBEMER,"DAROU MOUHTY","DAROU MARNANE","KEUR MATAR BINTA OUOLOF",13,14,136,84,220
LOUGA,KEBEMER,"DAROU MOUHTY","DAROU MARNANE","KEUR MATAR BINTA PEULH",18,25,148,122,270
LOUGA,KEBEMER,"DAROU MOUHTY","DAROU MARNANE","KEUR MATAR DIOP DE SAGATTA GUETH",3,3,31,33,64
LOUGA,KEBEMER,"DAROU MOUHTY","DAROU MARNANE",KHATARANE,15,17,91,94,185
LOUGA,KEBEMER,"DAROU MOUHTY","DAROU MARNANE","H1 SACOLY",2,4,35,18,53
LOUGA,KEBEMER,"DAROU MOUHTY","DAROU MARNANE","KIR SAMB",19,23,88,72,160
LOUGA,KEBEMER,"DAROU MOUHTY","DAROU MARNANE","MBARY WOROM",8,10,50,45,95
LOUGA,KEBEMER,"DAROU MOUHTY","DAROU MARNANE",MBERBOKHO,8,10,62,40,102
LOUGA,KEBEMER,"DAROU MOUHTY","DAROU MARNANE","H1 KEUR SAMBA ARAME PEULH",13,13,53,63,116
LOUGA,KEBEMER,"DAROU MOUHTY","DAROU MARNANE","BEUBEUNE (BOUBOULE)",7,8,96,56,152
LOUGA,KEBEMER,"DAROU MOUHTY","DAROU MARNANE","MERINA DIOP (KEUR BIRA GUEYE)",11,11,88,105,193
LOUGA,KEBEMER,"DAROU MOUHTY","DAROU MARNANE","H1 LEUDEUM(MERINA DIOP)",10,12,54,70,124
LOUGA,KEBEMER,"DAROU MOUHTY","DAROU MARNANE",NDEMBOLOGNE,16,19,98,90,188
LOUGA,KEBEMER,"DAROU MOUHTY","DAROU MARNANE","NDJINGUENE WOLOF",1,1,4,0,4
LOUGA,KEBEMER,"DAROU MOUHTY","DAROU MARNANE","NDJINGUENE PEULH",6,10,45,43,88
LOUGA,KEBEMER,"DAROU MOUHTY","DAROU MARNANE","GUELLE 1",4,4,26,22,48
LOUGA,KEBEMER,"DAROU MOUHTY","DAROU MARNANE","GUELLE 2",11,13,51,57,108
LOUGA,KEBEMER,"DAROU MOUHTY","DAROU MARNANE","NGUEMBE PEULH",6,8,46,39,85
LOUGA,KEBEMER,"DAROU MOUHTY","DAROU MARNANE","NGUER FACK 1",13,19,90,77,167
LOUGA,KEBEMER,"DAROU MOUHTY","DAROU MARNANE","NGUER FACK 2",9,9,47,30,77
LOUGA,KEBEMER,"DAROU MOUHTY","DAROU MARNANE",RAYAYE,22,25,137,93,230
LOUGA,KEBEMER,"DAROU MOUHTY","DAROU MARNANE",THIOTY,1,1,21,18,39
LOUGA,KEBEMER,"DAROU MOUHTY","DAROU MARNANE","TOUBA ROOF",34,35,187,226,413
LOUGA,KEBEMER,"DAROU MOUHTY","DAROU MARNANE","WALALANE WOLOF",22,28,134,126,260
LOUGA,KEBEMER,"DAROU MOUHTY","DAROU MARNANE","H2 WALALANE GADIAGA",4,4,12,14,26
LOUGA,KEBEMER,"DAROU MOUHTY","DAROU MARNANE","WANENE WOLOF",4,4,30,22,52
LOUGA,KEBEMER,"DAROU MOUHTY","DAROU MARNANE","H1 KEUR YORO DABIL",3,6,39,19,58
LOUGA,KEBEMER,"DAROU MOUHTY","DAROU MARNANE","WANENE PEULH",7,7,23,19,42
LOUGA,KEBEMER,"DAROU MOUHTY","DAROU MARNANE",WERECK,4,4,34,33,67
LOUGA,KEBEMER,"DAROU MOUHTY","DAROU MARNANE","H1 BOURTOU",10,10,48,49,97
LOUGA,KEBEMER,"DAROU MOUHTY","DAROU MARNANE",NGABA,4,4,46,23,69
LOUGA,KEBEMER,"DAROU MOUHTY","DAROU MARNANE","NGUERA LO",2,10,38,28,66
LOUGA,KEBEMER,"DAROU MOUHTY","DAROU MARNANE","WALALANE TENE",3,3,10,17,27
LOUGA,KEBEMER,"DAROU MOUHTY","DAROU MOUHTY",ARAFAT,56,57,228,235,463
LOUGA,KEBEMER,"DAROU MOUHTY","DAROU MOUHTY","H1 BIBI",6,7,67,57,124
LOUGA,KEBEMER,"DAROU MOUHTY","DAROU MOUHTY","H2 KEUR DETHIE NGOM",6,6,35,34,69
LOUGA,KEBEMER,"DAROU MOUHTY","DAROU MOUHTY","H3 KEUR MATAR KA",2,3,11,16,27
LOUGA,KEBEMER,"DAROU MOUHTY","DAROU MOUHTY","H4 KEUR DIERY SOW",3,3,21,14,35
LOUGA,KEBEMER,"DAROU MOUHTY","DAROU MOUHTY","H5 LOYENE",4,4,19,22,41
LOUGA,KEBEMER,"DAROU MOUHTY","DAROU MOUHTY","H6 SANTHIE (KEUR DAROU MBAYE)",6,7,41,22,63
LOUGA,KEBEMER,"DAROU MOUHTY","DAROU MOUHTY","H7 KEUR WALY SENE",5,5,40,27,67
LOUGA,KEBEMER,"DAROU MOUHTY","DAROU MOUHTY","H8 KEUR DIOCKEL KANE",7,8,67,51,118
LOUGA,KEBEMER,"DAROU MOUHTY","DAROU MOUHTY","H9 KEUR MBAYE DIOUF",2,2,22,12,34
LOUGA,KEBEMER,"DAROU MOUHTY","DAROU MOUHTY","H10 KEUR MBAKHAR",4,5,54,45,99
LOUGA,KEBEMER,"DAROU MOUHTY","DAROU MOUHTY","H11 KEUR NDOCK NIANG",3,3,22,10,32
LOUGA,KEBEMER,"DAROU MOUHTY","DAROU MOUHTY","H12 THIOF NGUEL",13,18,111,75,186
LOUGA,KEBEMER,"DAROU MOUHTY","DAROU MOUHTY","BELELE BETHIO",11,12,49,50,99
LOUGA,KEBEMER,"DAROU MOUHTY","DAROU MOUHTY",BEUBEUNNE,18,26,121,117,238
LOUGA,KEBEMER,"DAROU MOUHTY","DAROU MOUHTY","BOULEL SECK",24,27,132,87,219
LOUGA,KEBEMER,"DAROU MOUHTY","DAROU MOUHTY","H1 DJIB GALLO",1,1,94,96,190
LOUGA,KEBEMER,"DAROU MOUHTY","DAROU MOUHTY","H2 TAWFEKH",6,10,72,57,129
LOUGA,KEBEMER,"DAROU MOUHTY","DAROU MOUHTY","BOUSTANE DIAGNE",2,3,14,4,18
LOUGA,KEBEMER,"DAROU MOUHTY","DAROU MOUHTY","DAROU DIOP",2,2,14,21,35
LOUGA,KEBEMER,"DAROU MOUHTY","DAROU MOUHTY","DAROU DIOP 2",58,59,621,488,1109
LOUGA,KEBEMER,"DAROU MOUHTY","DAROU MOUHTY","H1 NDIAGUENE",10,10,90,78,168
LOUGA,KEBEMER,"DAROU MOUHTY","DAROU MOUHTY","H2 TATTE BEUGUEI",2,2,23,16,39
LOUGA,KEBEMER,"DAROU MOUHTY","DAROU MOUHTY","DAROU KRATHIEL",6,6,35,23,58
LOUGA,KEBEMER,"DAROU MOUHTY","DAROU MOUHTY","H1 BAILO",13,16,103,64,167
LOUGA,KEBEMER,"DAROU MOUHTY","DAROU MOUHTY","H2 NGUER",7,10,59,50,109
LOUGA,KEBEMER,"DAROU MOUHTY","DAROU MOUHTY","DAROU MOUHTY",3678,3971,18214,19791,38005
LOUGA,KEBEMER,"DAROU MOUHTY","DAROU MOUHTY","H2 SIKORY",2,2,77,6,83
LOUGA,KEBEMER,"DAROU MOUHTY","DAROU MOUHTY","DAROU RAHMANE 1",46,47,204,254,458
LOUGA,KEBEMER,"DAROU MOUHTY","DAROU MOUHTY","DAROU SALL 2",4,4,26,15,41
LOUGA,KEBEMER,"DAROU MOUHTY","DAROU MOUHTY","H1 IFRA BALE KA",6,6,46,14,60
LOUGA,KEBEMER,"DAROU MOUHTY","DAROU MOUHTY","DIATME DIOP",5,5,49,23,72
LOUGA,KEBEMER,"DAROU MOUHTY","DAROU MOUHTY",DIMIYATE,7,7,20,25,45
LOUGA,KEBEMER,"DAROU MOUHTY","DAROU MOUHTY","DIORY 1",1,1,2,8,10
LOUGA,KEBEMER,"DAROU MOUHTY","DAROU MOUHTY","H1 BOUKIRLO DE DAROU MOUSTY",6,6,45,35,80
LOUGA,KEBEMER,"DAROU MOUHTY","DAROU MOUHTY","DIORY 2",3,7,59,62,121
LOUGA,KEBEMER,"DAROU MOUHTY","DAROU MOUHTY","H1 LOUMINIAMA",11,12,79,91,170
LOUGA,KEBEMER,"DAROU MOUHTY","DAROU MOUHTY",DIWANE,38,41,299,266,565
LOUGA,KEBEMER,"DAROU MOUHTY","DAROU MOUHTY","H2 TATTE (SANDIOURGUETTE)",4,4,19,18,37
LOUGA,KEBEMER,"DAROU MOUHTY","DAROU MOUHTY",FANGUE,22,31,214,200,414
LOUGA,KEBEMER,"DAROU MOUHTY","DAROU MOUHTY",GOUDIPEYE,18,22,176,138,314
LOUGA,KEBEMER,"DAROU MOUHTY","DAROU MOUHTY",GUEMESSE,1,1,5,5,10
LOUGA,KEBEMER,"DAROU MOUHTY","DAROU MOUHTY","H1 GUEMESE 2",2,5,29,16,45
LOUGA,KEBEMER,"DAROU MOUHTY","DAROU MOUHTY",NGUIDITTE,9,15,110,83,193
LOUGA,KEBEMER,"DAROU MOUHTY","DAROU MOUHTY","KEUR BASSIROU THIAM",13,13,71,88,159
LOUGA,KEBEMER,"DAROU MOUHTY","DAROU MOUHTY","H1 TAWFEKH",19,22,94,112,206
LOUGA,KEBEMER,"DAROU MOUHTY","DAROU MOUHTY","KEUR IBRA SALL",15,20,128,106,234
LOUGA,KEBEMER,"DAROU MOUHTY","DAROU MOUHTY",MBARAKANE,13,13,95,98,193
LOUGA,KEBEMER,"DAROU MOUHTY","DAROU MOUHTY",MADINA,4,5,20,14,34
LOUGA,KEBEMER,"DAROU MOUHTY","DAROU MOUHTY","H1 MADINA SANTHIE",11,13,31,23,54
LOUGA,KEBEMER,"DAROU MOUHTY","DAROU MOUHTY","MASSAR DIOP",6,9,37,18,55
LOUGA,KEBEMER,"DAROU MOUHTY","DAROU MOUHTY","H1 MASSAR",5,5,19,13,32
LOUGA,KEBEMER,"DAROU MOUHTY","DAROU MOUHTY",MBAPPE,8,10,53,42,95
LOUGA,KEBEMER,"DAROU MOUHTY","DAROU MOUHTY","H1 MBOUKI",7,8,49,43,92
LOUGA,KEBEMER,"DAROU MOUHTY","DAROU MOUHTY","MBAYENE NGOULANGOULE",1,5,25,18,43
LOUGA,KEBEMER,"DAROU MOUHTY","DAROU MOUHTY","H1 BADADI",6,7,35,35,70
LOUGA,KEBEMER,"DAROU MOUHTY","DAROU MOUHTY","MBEYE THIABOUGUEL",4,6,20,23,43
LOUGA,KEBEMER,"DAROU MOUHTY","DAROU MOUHTY","NDAME LO",2,2,10,3,13
LOUGA,KEBEMER,"DAROU MOUHTY","DAROU MOUHTY","NDAME SANOSSY",3,3,20,13,33
LOUGA,KEBEMER,"DAROU MOUHTY","DAROU MOUHTY","NDANGOU OUOLOF",9,19,57,36,93
LOUGA,KEBEMER,"DAROU MOUHTY","DAROU MOUHTY","H1 DIABARKY",12,27,82,89,171
LOUGA,KEBEMER,"DAROU MOUHTY","DAROU MOUHTY","NDANGOU PEUL",16,22,131,111,242
LOUGA,KEBEMER,"DAROU MOUHTY","DAROU MOUHTY",NDIOBENE,41,40,178,200,378
LOUGA,KEBEMER,"DAROU MOUHTY","DAROU MOUHTY",NDOUGOR,16,20,117,119,236
LOUGA,KEBEMER,"DAROU MOUHTY","DAROU MOUHTY","NGANADO BIBY",18,24,113,112,225
LOUGA,KEBEMER,"DAROU MOUHTY","DAROU MOUHTY","H1 KEUR COUMBA KONTEYE",2,3,58,44,102
LOUGA,KEBEMER,"DAROU MOUHTY","DAROU MOUHTY","H2 NDIAYENE",1,2,8,8,16
LOUGA,KEBEMER,"DAROU MOUHTY","DAROU MOUHTY","PADEL OUOLOF (THIEYENE SEYE)",8,9,35,46,81
LOUGA,KEBEMER,"DAROU MOUHTY","DAROU MOUHTY","SEBERE FACK",23,24,102,93,195
LOUGA,KEBEMER,"DAROU MOUHTY","DAROU MOUHTY","SANTHIOU TATTE",7,8,41,36,77
LOUGA,KEBEMER,"DAROU MOUHTY","DAROU MOUHTY",SONGHANE,30,39,222,230,452
LOUGA,KEBEMER,"DAROU MOUHTY","DAROU MOUHTY","H1 LASSE  DE FASS TOURE",9,11,75,65,140
LOUGA,KEBEMER,"DAROU MOUHTY","DAROU MOUHTY","H2 LASSE",4,9,53,59,112
LOUGA,KEBEMER,"DAROU MOUHTY","DAROU MOUHTY","TAT TAL",15,18,89,100,189
LOUGA,KEBEMER,"DAROU MOUHTY","DAROU MOUHTY","H1 BEYE PEULH",7,7,60,42,102
LOUGA,KEBEMER,"DAROU MOUHTY","DAROU MOUHTY",TATTE,6,10,59,28,87
LOUGA,KEBEMER,"DAROU MOUHTY","DAROU MOUHTY","SARE SARA",52,56,282,265,547
LOUGA,KEBEMER,"DAROU MOUHTY","DAROU MOUHTY","H1 KHOUDIOUL",10,10,51,41,92
LOUGA,KEBEMER,"DAROU MOUHTY","DAROU MOUHTY",THIABOUGUEL,38,63,243,289,532
LOUGA,KEBEMER,"DAROU MOUHTY","DAROU MOUHTY",THIAMENE,9,9,38,50,88
LOUGA,KEBEMER,"DAROU MOUHTY","DAROU MOUHTY","H1 NDIAGUENE",8,9,54,50,104
LOUGA,KEBEMER,"DAROU MOUHTY","DAROU MOUHTY",THIOUKY,3,7,38,47,85
LOUGA,KEBEMER,"DAROU MOUHTY","DAROU MOUHTY","TOUBA GAYE",3,3,27,41,68
LOUGA,KEBEMER,"DAROU MOUHTY","DAROU MOUHTY","H1 TIREYE",37,52,407,366,773
LOUGA,KEBEMER,"DAROU MOUHTY","DAROU MOUHTY","TOUBA  PETEIGNE",9,16,90,96,186
LOUGA,KEBEMER,"DAROU MOUHTY","DAROU MOUHTY","H1 PETEGNE",8,8,32,61,93
LOUGA,KEBEMER,"DAROU MOUHTY","DAROU MOUHTY",WADENE,14,20,108,88,196
LOUGA,KEBEMER,"DAROU MOUHTY","DAROU MOUHTY","H1 THIERERE",9,11,80,79,159
LOUGA,KEBEMER,"DAROU MOUHTY","DAROU MOUHTY","H2 SOMBOLDOU",8,10,79,48,127
LOUGA,KEBEMER,"DAROU MOUHTY","DAROU MOUHTY","YARI DAKHAR",6,7,57,16,73
LOUGA,KEBEMER,"DAROU MOUHTY","DAROU MOUHTY","H2 NDIOURKY OUOLOF",1,2,5,5,10
LOUGA,KEBEMER,"DAROU MOUHTY","DAROU MOUHTY","H3 NDIOURKY PEULH",4,5,33,18,51
LOUGA,KEBEMER,"DAROU MOUHTY","DAROU MOUHTY",YEREW,8,11,37,45,82
LOUGA,KEBEMER,"DAROU MOUHTY","DAROU MOUHTY","KEUR SERIGNE BARA",1,1,25,11,36
LOUGA,KEBEMER,"DAROU MOUHTY","DAROU MOUHTY","H1 MAYANE",4,6,24,26,50
LOUGA,KEBEMER,"DAROU MOUHTY","DAROU MOUHTY",NDINGOLOGNE,18,28,99,91,190
LOUGA,KEBEMER,"DAROU MOUHTY","DAROU MOUHTY","H1 NDINGOLOGNE",8,8,34,35,69
LOUGA,KEBEMER,"DAROU MOUHTY",MBADIANE,"BELEL DAYE GUETE",55,57,281,278,559
LOUGA,KEBEMER,"DAROU MOUHTY",MBADIANE,"H2 LOYENE",14,14,91,53,144
LOUGA,KEBEMER,"DAROU MOUHTY",MBADIANE,"H3 TOUBA MOURIDE",8,8,82,14,96
LOUGA,KEBEMER,"DAROU MOUHTY",MBADIANE,"BELEL NDIASSAR",26,29,261,184,445
LOUGA,KEBEMER,"DAROU MOUHTY",MBADIANE,"BOUNDOU BALI",4,4,26,18,44
LOUGA,KEBEMER,"DAROU MOUHTY",MBADIANE,"DAROU KOSSO",68,70,376,316,692
LOUGA,KEBEMER,"DAROU MOUHTY",MBADIANE,"H1 KEUR BRAMA NDIAYE et KEUR MASSAER NIANG",6,6,30,32,62
LOUGA,KEBEMER,"DAROU MOUHTY",MBADIANE,"DAROU MARAME",13,13,73,61,134
LOUGA,KEBEMER,"DAROU MOUHTY",MBADIANE,"H1 KEUR GALLO BA",2,2,15,12,27
LOUGA,KEBEMER,"DAROU MOUHTY",MBADIANE,"DAROU MBAYE",5,5,35,22,57
LOUGA,KEBEMER,"DAROU MOUHTY",MBADIANE,"DAROU MINAME(PETTE)",33,35,288,181,469
LOUGA,KEBEMER,"DAROU MOUHTY",MBADIANE,"H1 KEUR THIERNO BA",1,2,11,7,18
LOUGA,KEBEMER,"DAROU MOUHTY",MBADIANE,"H3 NDIBA",1,1,6,8,14
LOUGA,KEBEMER,"DAROU MOUHTY",MBADIANE,"DAROU NDIAYE 1",7,7,33,16,49
LOUGA,KEBEMER,"DAROU MOUHTY",MBADIANE,"DAROU SALAM",9,10,35,28,63
LOUGA,KEBEMER,"DAROU MOUHTY",MBADIANE,"H1 TAWE",6,14,41,45,86
LOUGA,KEBEMER,"DAROU MOUHTY",MBADIANE,"DAROU SALL III (DOULOUNGUEL OUOLOF)",17,17,108,111,219
LOUGA,KEBEMER,"DAROU MOUHTY",MBADIANE,"DAROU WAHAB",97,99,560,557,1117
LOUGA,KEBEMER,"DAROU MOUHTY",MBADIANE,"DIAKHAW KEUR BIRANE GUEYE (NDJIKIW )",3,3,12,10,22
LOUGA,KEBEMER,"DAROU MOUHTY",MBADIANE,"DIAKHAW OUOLOF LO",3,3,13,7,20
LOUGA,KEBEMER,"DAROU MOUHTY",MBADIANE,"DOULOUNGUEL PEULH",9,12,49,73,122
LOUGA,KEBEMER,"DAROU MOUHTY",MBADIANE,"FASS THIAM",3,3,14,20,34
LOUGA,KEBEMER,"DAROU MOUHTY",MBADIANE,"H1 KEUR MATOP",2,2,16,18,34
LOUGA,KEBEMER,"DAROU MOUHTY",MBADIANE,FIRDAWSI,12,12,62,53,115
LOUGA,KEBEMER,"DAROU MOUHTY",MBADIANE,"GATY THIOUGNEL",3,3,8,7,15
LOUGA,KEBEMER,"DAROU MOUHTY",MBADIANE,"H1 DARA KEUR SERIGNE SEYE",3,3,45,2,47
LOUGA,KEBEMER,"DAROU MOUHTY",MBADIANE,KOBEL,10,13,35,43,78
LOUGA,KEBEMER,"DAROU MOUHTY",MBADIANE,"LALOYE NDIASSAR",30,35,133,134,267
LOUGA,KEBEMER,"DAROU MOUHTY",MBADIANE,"H1 LALOYE",10,10,45,43,88
LOUGA,KEBEMER,"DAROU MOUHTY",MBADIANE,"LOUMBOL BOCKY",14,24,142,104,246
LOUGA,KEBEMER,"DAROU MOUHTY",MBADIANE,"LOUMBOL LADE (KEUR NIAGA)",29,29,170,149,319
LOUGA,KEBEMER,"DAROU MOUHTY",MBADIANE,MAMBARA,11,16,55,53,108
LOUGA,KEBEMER,"DAROU MOUHTY",MBADIANE,MBADIANE,71,83,436,409,845
LOUGA,KEBEMER,"DAROU MOUHTY",MBADIANE,"H1 THIENE DE LOUMBOL DIATME",2,2,14,6,20
LOUGA,KEBEMER,"DAROU MOUHTY",MBADIANE,"MBAME BAWANE",13,18,114,68,182
LOUGA,KEBEMER,"DAROU MOUHTY",MBADIANE,"MBAME BODY",9,9,51,38,89
LOUGA,KEBEMER,"DAROU MOUHTY",MBADIANE,"MBAME OUOLOF 1",4,5,25,22,47
LOUGA,KEBEMER,"DAROU MOUHTY",MBADIANE,"NDIARE LOUGARE",3,4,21,14,35
LOUGA,KEBEMER,"DAROU MOUHTY",MBADIANE,"H1 PALENE",1,1,9,0,9
LOUGA,KEBEMER,"DAROU MOUHTY",MBADIANE,"NIOMRE LO",21,23,171,91,262
LOUGA,KEBEMER,"DAROU MOUHTY",MBADIANE,"H1 DEBELATE",2,2,14,8,22
LOUGA,KEBEMER,"DAROU MOUHTY",MBADIANE,"OUALO DIOP",4,4,20,18,38
LOUGA,KEBEMER,"DAROU MOUHTY",MBADIANE,"H1 NDIOBENE",7,7,26,22,48
LOUGA,KEBEMER,"DAROU MOUHTY",MBADIANE,"PETE SEYANE 1",2,4,17,16,33
LOUGA,KEBEMER,"DAROU MOUHTY",MBADIANE,"H1 KEUR SOULEY SENE",2,3,8,11,19
LOUGA,KEBEMER,"DAROU MOUHTY",MBADIANE,"PETE SEYANE 2",13,15,157,85,242
LOUGA,KEBEMER,"DAROU MOUHTY",MBADIANE,SACOLONGUEL,3,3,27,29,56
LOUGA,KEBEMER,"DAROU MOUHTY",MBADIANE,"TAIF DIOP",37,39,252,277,529
LOUGA,KEBEMER,"DAROU MOUHTY",MBADIANE,"H1 KEUR MALICK NGOM",8,8,35,39,74
LOUGA,KEBEMER,"DAROU MOUHTY",MBADIANE,"THIAMENE 2",24,27,118,104,222
LOUGA,KEBEMER,"DAROU MOUHTY",MBADIANE,"H1 THIAMENE",28,29,170,140,310
LOUGA,KEBEMER,"DAROU MOUHTY",MBADIANE,"THIAWOGNE LALOYE",23,25,117,118,235
LOUGA,KEBEMER,"DAROU MOUHTY",MBADIANE,"THIOTY THIOUGNEL",11,11,93,54,147
LOUGA,KEBEMER,"DAROU MOUHTY",MBADIANE,TINGUITY,42,51,275,247,522
LOUGA,KEBEMER,"DAROU MOUHTY",MBADIANE,"TOUBA GAYE",7,10,51,34,85
LOUGA,KEBEMER,"DAROU MOUHTY",MBADIANE,"H1 KEUR  ALDIOUMA FAYE",3,6,11,10,21
LOUGA,KEBEMER,"DAROU MOUHTY",MBADIANE,"WAWA FINGO",13,13,73,58,131
LOUGA,KEBEMER,"DAROU MOUHTY",MBADIANE,"YAMANE SYLLA",5,5,32,19,51
LOUGA,KEBEMER,"DAROU MOUHTY",MBADIANE,"MBAME OUALOF 1",8,13,92,64,156
LOUGA,KEBEMER,"DAROU MOUHTY",NDOYENE,BAOUR,1,1,10,8,18
LOUGA,KEBEMER,"DAROU MOUHTY",NDOYENE,"H1 BAOUR OUOLOF",2,2,14,6,20
LOUGA,KEBEMER,"DAROU MOUHTY",NDOYENE,"NIASSENE (DAROU NIASS)",14,14,69,55,124
LOUGA,KEBEMER,"DAROU MOUHTY",NDOYENE,"FARISS PEULH",16,17,84,81,165
LOUGA,KEBEMER,"DAROU MOUHTY",NDOYENE,"H1 MBATAR",2,2,12,15,27
LOUGA,KEBEMER,"DAROU MOUHTY",NDOYENE,"GAD NIASSENE",1,1,4,8,12
LOUGA,KEBEMER,"DAROU MOUHTY",NDOYENE,"GATTY NIASS 1",3,3,26,28,54
LOUGA,KEBEMER,"DAROU MOUHTY",NDOYENE,"H1 GOUYE NIASSENE",3,4,16,19,35
LOUGA,KEBEMER,"DAROU MOUHTY",NDOYENE,"GATTY NIASS 2",19,28,147,174,321
LOUGA,KEBEMER,"DAROU MOUHTY",NDOYENE,NIAMANE,7,7,30,31,61
LOUGA,KEBEMER,"DAROU MOUHTY",NDOYENE,"GOUYE DIAMA",15,16,68,69,137
LOUGA,KEBEMER,"DAROU MOUHTY",NDOYENE,"NGOUYE SIDIOR",6,7,30,24,54
LOUGA,KEBEMER,"DAROU MOUHTY",NDOYENE,KILIMANE,4,4,29,20,49
LOUGA,KEBEMER,"DAROU MOUHTY",NDOYENE,"DAROU MBASSINE (KEUR  DIOP SALL)",5,5,12,18,30
LOUGA,KEBEMER,"DAROU MOUHTY",NDOYENE,"KHOSS DJIKIW",11,12,93,100,193
LOUGA,KEBEMER,"DAROU MOUHTY",NDOYENE,KOULY,13,13,62,77,139
LOUGA,KEBEMER,"DAROU MOUHTY",NDOYENE,"H1 NGOL KHOYOYE DE TOUBA MERINA",15,16,62,90,152
LOUGA,KEBEMER,"DAROU MOUHTY",NDOYENE,LAMISSO,3,3,15,16,31
LOUGA,KEBEMER,"DAROU MOUHTY",NDOYENE,MBASSINE,57,65,271,297,568
LOUGA,KEBEMER,"DAROU MOUHTY",NDOYENE,"MBEYE 1",4,5,21,36,57
LOUGA,KEBEMER,"DAROU MOUHTY",NDOYENE,"H1 NIANGUI",11,15,65,82,147
LOUGA,KEBEMER,"DAROU MOUHTY",NDOYENE,"MBEYE 2",1,1,5,3,8
LOUGA,KEBEMER,"DAROU MOUHTY",NDOYENE,"H1 MBESOR",4,6,22,23,45
LOUGA,KEBEMER,"DAROU MOUHTY",NDOYENE,"H2 MBEYE BRANE",4,4,16,19,35
LOUGA,KEBEMER,"DAROU MOUHTY",NDOYENE,"H3 KEUR HARONA",1,3,16,20,36
LOUGA,KEBEMER,"DAROU MOUHTY",NDOYENE,"MBEYE PEULH",8,10,42,41,83
LOUGA,KEBEMER,"DAROU MOUHTY",NDOYENE,"H1 MBAYE NDIOUGA I",6,8,50,40,90
LOUGA,KEBEMER,"DAROU MOUHTY",NDOYENE,MBIRAMA,6,11,69,40,109
LOUGA,KEBEMER,"DAROU MOUHTY",NDOYENE,"H1 BELEL BETHIO",8,10,41,25,66
LOUGA,KEBEMER,"DAROU MOUHTY",NDOYENE,"H2 KOYLE",2,2,11,9,20
LOUGA,KEBEMER,"DAROU MOUHTY",NDOYENE,"H3 MBAYE NDIOUGA",12,13,64,58,122
LOUGA,KEBEMER,"DAROU MOUHTY",NDOYENE,"H4 THIALGOUF DE MBIRAMA",10,12,40,65,105
LOUGA,KEBEMER,"DAROU MOUHTY",NDOYENE,"H5 THIALLENE",5,5,22,23,45
LOUGA,KEBEMER,"DAROU MOUHTY",NDOYENE,"NDIAGNE MBASSINE",6,6,23,23,46
LOUGA,KEBEMER,"DAROU MOUHTY",NDOYENE,"NDINDIANE OUOLOF",10,11,69,47,116
LOUGA,KEBEMER,"DAROU MOUHTY",NDOYENE,"NDINDIANE PEULH",10,12,88,50,138
LOUGA,KEBEMER,"DAROU MOUHTY",NDOYENE,NDJIKIW,6,7,49,53,102
LOUGA,KEBEMER,"DAROU MOUHTY",NDOYENE,"NDOYENE 1",45,50,282,365,647
LOUGA,KEBEMER,"DAROU MOUHTY",NDOYENE,"NDOYENE 2",16,17,75,108,183
LOUGA,KEBEMER,"DAROU MOUHTY",NDOYENE,"NDOYENE 3",10,10,49,80,129
LOUGA,KEBEMER,"DAROU MOUHTY",NDOYENE,"NDOYENE PEULH",9,9,39,29,68
LOUGA,KEBEMER,"DAROU MOUHTY",NDOYENE,NGOMENE,9,9,39,35,74
LOUGA,KEBEMER,"DAROU MOUHTY",NDOYENE,"NGUETH  NDAKHAR",33,38,248,268,516
LOUGA,KEBEMER,"DAROU MOUHTY",NDOYENE,NGUEMBE,3,4,26,29,55
LOUGA,KEBEMER,"DAROU MOUHTY",NDOYENE,"H1 DIANKA",1,1,4,3,7
LOUGA,KEBEMER,"DAROU MOUHTY",NDOYENE,NIANGUENE,5,8,36,50,86
LOUGA,KEBEMER,"DAROU MOUHTY",NDOYENE,NIASSENE,4,6,21,17,38
LOUGA,KEBEMER,"DAROU MOUHTY",NDOYENE,"H1 KEUR CHEIKH DIANE DE NIASSENE",2,3,16,14,30
LOUGA,KEBEMER,"DAROU MOUHTY",NDOYENE,SAKAL,4,5,18,21,39
LOUGA,KEBEMER,"DAROU MOUHTY",NDOYENE,"H1 LASAR 1",8,8,36,25,61
LOUGA,KEBEMER,"DAROU MOUHTY",NDOYENE,"TAWA ET MBANGATHIE ET BARGA",42,48,220,208,428
LOUGA,KEBEMER,"DAROU MOUHTY",NDOYENE,TAYSIR,35,35,190,164,354
LOUGA,KEBEMER,"DAROU MOUHTY",NDOYENE,"H1 NGOULE",14,15,49,49,98
LOUGA,KEBEMER,"DAROU MOUHTY",NDOYENE,"TEUMB OUOLOF",2,2,6,9,15
LOUGA,KEBEMER,"DAROU MOUHTY",NDOYENE,"TEUMB PEULH",3,5,38,40,78
LOUGA,KEBEMER,"DAROU MOUHTY",NDOYENE,DEMECOCE,2,3,5,5,10
LOUGA,KEBEMER,"DAROU MOUHTY",NDOYENE,"MEROUT DE TOUBA MERINA",4,4,25,16,41
LOUGA,KEBEMER,"DAROU MOUHTY","SAM YABAL",ALAWOUWY,12,40,101,112,213
LOUGA,KEBEMER,"DAROU MOUHTY","SAM YABAL","H1 NGUETH ALAWOUWY (NGUETH THIATHEKH)",9,24,68,74,142
LOUGA,KEBEMER,"DAROU MOUHTY","SAM YABAL","BOUNDOU BABAREL",11,16,67,59,126
LOUGA,KEBEMER,"DAROU MOUHTY","SAM YABAL","H1 KAWAWE",5,7,34,27,61
LOUGA,KEBEMER,"DAROU MOUHTY","SAM YABAL","DAGA MORE",29,78,227,199,426
LOUGA,KEBEMER,"DAROU MOUHTY","SAM YABAL","H1 DEPEL",1,5,12,10,22
LOUGA,KEBEMER,"DAROU MOUHTY","SAM YABAL","H2 DOUROUR",10,22,64,76,140
LOUGA,KEBEMER,"DAROU MOUHTY","SAM YABAL","H3 GOUYE BAR",1,2,8,12,20
LOUGA,KEBEMER,"DAROU MOUHTY","SAM YABAL","H4 LOTHIE TORDJI",16,47,123,117,240
LOUGA,KEBEMER,"DAROU MOUHTY","SAM YABAL","H5 SINTHIOU NDIALAL",7,17,50,55,105
LOUGA,KEBEMER,"DAROU MOUHTY","SAM YABAL","DAROU MARNANE LOUGARE",4,5,43,11,54
LOUGA,KEBEMER,"DAROU MOUHTY","SAM YABAL","DAROU NDIAKHATE",18,54,172,131,303
LOUGA,KEBEMER,"DAROU MOUHTY","SAM YABAL","H1 BOUSRA DIAKHATE",2,4,13,14,27
LOUGA,KEBEMER,"DAROU MOUHTY","SAM YABAL","DAROU SALAM YABAL",20,26,114,64,178
LOUGA,KEBEMER,"DAROU MOUHTY","SAM YABAL","H1 THIERERE",9,16,59,42,101
LOUGA,KEBEMER,"DAROU MOUHTY","SAM YABAL","H2 KEUR SAMBA NDIOBO",5,12,26,20,46
LOUGA,KEBEMER,"DAROU MOUHTY","SAM YABAL","H3 KEUR ALPHA SOW",2,7,20,19,39
LOUGA,KEBEMER,"DAROU MOUHTY","SAM YABAL","H4 KEUR AMADY MBOYO",7,17,44,47,91
LOUGA,KEBEMER,"DAROU MOUHTY","SAM YABAL","DIORO DEMBA(LOUMBY DEFEDJI)",22,26,178,68,246
LOUGA,KEBEMER,"DAROU MOUHTY","SAM YABAL",GNOMDADE,26,34,144,115,259
LOUGA,KEBEMER,"DAROU MOUHTY","SAM YABAL",GOULADJI,42,128,307,272,579
LOUGA,KEBEMER,"DAROU MOUHTY","SAM YABAL","NGUETH BOCKY",5,16,23,22,45
LOUGA,KEBEMER,"DAROU MOUHTY","SAM YABAL","H1 MBENGUENE",24,55,158,184,342
LOUGA,KEBEMER,"DAROU MOUHTY","SAM YABAL","LOUGARE WOLOF (KEUR ALY PENDA)",6,18,50,62,112
LOUGA,KEBEMER,"DAROU MOUHTY","SAM YABAL","MBAKANDOU WOLOF",8,18,64,68,132
LOUGA,KEBEMER,"DAROU MOUHTY","SAM YABAL","MBAKANDOU PEULH",2,5,18,23,41
LOUGA,KEBEMER,"DAROU MOUHTY","SAM YABAL",MBAYERI,8,22,49,53,102
LOUGA,KEBEMER,"DAROU MOUHTY","SAM YABAL",NDIARAPPE,12,26,57,56,113
LOUGA,KEBEMER,"DAROU MOUHTY","SAM YABAL","H1 THIABOUGUE",14,29,68,82,150
LOUGA,KEBEMER,"DAROU MOUHTY","SAM YABAL","NDIAREME YABAL",35,53,191,147,338
LOUGA,KEBEMER,"DAROU MOUHTY","SAM YABAL",NDIOUROUCK,14,20,80,109,189
LOUGA,KEBEMER,"DAROU MOUHTY","SAM YABAL","H1 BOUSRA",22,36,137,118,255
LOUGA,KEBEMER,"DAROU MOUHTY","SAM YABAL","NDJIKY LARY",5,6,21,24,45
LOUGA,KEBEMER,"DAROU MOUHTY","SAM YABAL","H1 LOTHIE DE THIDE NGANADO",18,35,120,116,236
LOUGA,KEBEMER,"DAROU MOUHTY","SAM YABAL","NGANADO BASSALY",20,32,108,65,173
LOUGA,KEBEMER,"DAROU MOUHTY","SAM YABAL",NGOUNDIOURA,36,53,247,235,482
LOUGA,KEBEMER,"DAROU MOUHTY","SAM YABAL","H1 LOUMBEL BASSINABE",7,12,64,67,131
LOUGA,KEBEMER,"DAROU MOUHTY","SAM YABAL","SAM YABAL",247,443,1559,1574,3133
LOUGA,KEBEMER,"DAROU MOUHTY","SAM YABAL","H1 KEUR MODOU KHARY DIAGNE",10,15,40,32,72
LOUGA,KEBEMER,"DAROU MOUHTY","SAM YABAL","H2 KEUR SACOURA NDIAYE",4,10,28,20,48
LOUGA,KEBEMER,"DAROU MOUHTY","SAM YABAL","H3 MEDINA FALL",2,2,9,0,9
LOUGA,KEBEMER,"DAROU MOUHTY","SAM YABAL","TAIF NGANADO",15,21,136,59,195
LOUGA,KEBEMER,"DAROU MOUHTY","SAM YABAL","THIDE NGANADO",110,191,645,662,1307
LOUGA,KEBEMER,"DAROU MOUHTY","SAM YABAL","H1  NGANADO WENDOU",10,12,24,27,51
LOUGA,KEBEMER,"DAROU MOUHTY","SAM YABAL","H2 LOUMBOL ROULE",17,19,65,47,112
LOUGA,KEBEMER,"DAROU MOUHTY","SAM YABAL",THIORDY,3,8,33,31,64
LOUGA,KEBEMER,"DAROU MOUHTY","SAM YABAL","H1 GABOUDJI",3,8,25,21,46
LOUGA,KEBEMER,"DAROU MOUHTY","SAM YABAL","TOOLE (DAROU SALAM)",24,59,181,175,356
LOUGA,KEBEMER,"DAROU MOUHTY","SAM YABAL",YABAL,35,44,220,150,370
LOUGA,KEBEMER,"DAROU MOUHTY","SAM YABAL","LOUMBOUL MBABA",1,4,14,9,23
LOUGA,KEBEMER,"DAROU MOUHTY","SAM YABAL","NAMARY YABAL",5,16,42,34,76
LOUGA,KEBEMER,"DAROU MOUHTY","SAM YABAL","H1 DEGUE NAMARY",5,12,23,21,44
LOUGA,KEBEMER,"DAROU MOUHTY","TOUBA MERINA","BARIDIAM KHOUMA",40,66,198,199,397
LOUGA,KEBEMER,"DAROU MOUHTY","TOUBA MERINA","BELEL GOLOKI",70,114,365,388,753
LOUGA,KEBEMER,"DAROU MOUHTY","TOUBA MERINA","BOULEL PEULH",23,62,129,152,281
LOUGA,KEBEMER,"DAROU MOUHTY","TOUBA MERINA","DAROU DIOP (DEMBA YACINE)",4,8,53,42,95
LOUGA,KEBEMER,"DAROU MOUHTY","TOUBA MERINA","DAROU RAHMANE",18,26,105,91,196
LOUGA,KEBEMER,"DAROU MOUHTY","TOUBA MERINA","DEKH LARY",19,24,154,165,319
LOUGA,KEBEMER,"DAROU MOUHTY","TOUBA MERINA",DENDIAGA,16,41,97,95,192
LOUGA,KEBEMER,"DAROU MOUHTY","TOUBA MERINA","DIAMAGUENE PEULH",9,24,73,60,133
LOUGA,KEBEMER,"DAROU MOUHTY","TOUBA MERINA","H1 BELLA",9,14,31,47,78
LOUGA,KEBEMER,"DAROU MOUHTY","TOUBA MERINA","DIAMAGUENE WODABE",12,21,91,84,175
LOUGA,KEBEMER,"DAROU MOUHTY","TOUBA MERINA",KHOYOYE,21,56,158,155,313
LOUGA,KEBEMER,"DAROU MOUHTY","TOUBA MERINA","H1 DABEL",11,33,95,91,186
LOUGA,KEBEMER,"DAROU MOUHTY","TOUBA MERINA","H4 KOYEL",2,10,23,21,44
LOUGA,KEBEMER,"DAROU MOUHTY","TOUBA MERINA","H5 BARA",17,37,103,125,228
LOUGA,KEBEMER,"DAROU MOUHTY","TOUBA MERINA",KOBA,7,19,48,54,102
LOUGA,KEBEMER,"DAROU MOUHTY","TOUBA MERINA",KOBARENE,7,9,49,64,113
LOUGA,KEBEMER,"DAROU MOUHTY","TOUBA MERINA","LOTHIE 2",16,35,98,73,171
LOUGA,KEBEMER,"DAROU MOUHTY","TOUBA MERINA","LYNDIAM LAOBE",5,5,21,15,36
LOUGA,KEBEMER,"DAROU MOUHTY","TOUBA MERINA","LYNDIAM OUOLOF",5,8,18,26,44
LOUGA,KEBEMER,"DAROU MOUHTY","TOUBA MERINA","LYNDIAM PEULH",9,12,35,51,86
LOUGA,KEBEMER,"DAROU MOUHTY","TOUBA MERINA","MBAYENE NDIOUNDANE (DIAMAGUENE OUOLOF)",8,12,46,32,78
LOUGA,KEBEMER,"DAROU MOUHTY","TOUBA MERINA","H1 MAGAMOU",1,3,9,6,15
LOUGA,KEBEMER,"DAROU MOUHTY","TOUBA MERINA","MERINA PEULH",5,10,33,28,61
LOUGA,KEBEMER,"DAROU MOUHTY","TOUBA MERINA",MEROULE,16,32,102,114,216
LOUGA,KEBEMER,"DAROU MOUHTY","TOUBA MERINA","MOURO PEULH",32,39,254,154,408
LOUGA,KEBEMER,"DAROU MOUHTY","TOUBA MERINA","NAYLOUM MARAM 1",2,7,19,14,33
LOUGA,KEBEMER,"DAROU MOUHTY","TOUBA MERINA","H1 NDIANDAME",7,12,31,29,60
LOUGA,KEBEMER,"DAROU MOUHTY","TOUBA MERINA",NDELERE,36,51,172,240,412
LOUGA,KEBEMER,"DAROU MOUHTY","TOUBA MERINA","H1 NDELERE NDIAYE",34,49,165,212,377
LOUGA,KEBEMER,"DAROU MOUHTY","TOUBA MERINA","NDIAYENE BARIDIAM",9,14,39,50,89
LOUGA,KEBEMER,"DAROU MOUHTY","TOUBA MERINA","H2 KEUR MALICK SOW",3,4,20,24,44
LOUGA,KEBEMER,"DAROU MOUHTY","TOUBA MERINA","NDIMB DIOR",8,17,60,71,131
LOUGA,KEBEMER,"DAROU MOUHTY","TOUBA MERINA","H1 KEUR BIRAME COUMBA",8,11,43,46,89
LOUGA,KEBEMER,"DAROU MOUHTY","TOUBA MERINA",NIMZAT,5,7,18,21,39
LOUGA,KEBEMER,"DAROU MOUHTY","TOUBA MERINA","SINE NDIAYE",4,11,50,29,79
LOUGA,KEBEMER,"DAROU MOUHTY","TOUBA MERINA","H1 KHARAWANE",10,17,45,56,101
LOUGA,KEBEMER,"DAROU MOUHTY","TOUBA MERINA","H2 BOULEL SINE",4,9,19,33,52
LOUGA,KEBEMER,"DAROU MOUHTY","TOUBA MERINA","H3 BOULEL OUOLOF",1,2,6,8,14
LOUGA,KEBEMER,"DAROU MOUHTY","TOUBA MERINA",THIDE,65,92,346,271,617
LOUGA,KEBEMER,"DAROU MOUHTY","TOUBA MERINA","THIOBE DIOUWANABE",11,15,74,65,139
LOUGA,KEBEMER,"DAROU MOUHTY","TOUBA MERINA",THIOUSSE,9,11,90,59,149
LOUGA,KEBEMER,"DAROU MOUHTY","TOUBA MERINA","TOUBA MERINA",168,288,1060,941,2001
LOUGA,KEBEMER,"DAROU MOUHTY","TOUBA MERINA","YERWAYE (MBAME)",9,17,42,50,92
LOUGA,KEBEMER,"DAROU MOUHTY","TOUBA MERINA","YORO PEULH",12,17,93,79,172
LOUGA,KEBEMER,"DAROU MOUHTY","TOUBA MERINA",NDIOMPY,11,22,76,70,146
LOUGA,KEBEMER,"DAROU MOUHTY","M’BACKE CAJOR",DALAKH,11,14,78,65,143
LOUGA,KEBEMER,"DAROU MOUHTY","M’BACKE CAJOR","DIOKOUL LABA",3,3,10,4,14
LOUGA,KEBEMER,"DAROU MOUHTY","M’BACKE CAJOR","EUPEUL PEULH",34,43,208,251,459
LOUGA,KEBEMER,"DAROU MOUHTY","M’BACKE CAJOR","H1 TONGHOR",22,24,100,129,229
LOUGA,KEBEMER,"DAROU MOUHTY","M’BACKE CAJOR","KANENE NDIAKHAYE",10,13,73,75,148
LOUGA,KEBEMER,"DAROU MOUHTY","M’BACKE CAJOR","KERY GUETE",2,2,22,11,33
LOUGA,KEBEMER,"DAROU MOUHTY","M’BACKE CAJOR",LEONA,18,18,50,21,71
LOUGA,KEBEMER,"DAROU MOUHTY","M’BACKE CAJOR","H1 KEUR CHEIKH DIENG",2,5,15,4,19
LOUGA,KEBEMER,"DAROU MOUHTY","M’BACKE CAJOR","LOMENE (KEUR MATAR SOW)",1,1,2,4,6
LOUGA,KEBEMER,"DAROU MOUHTY","M’BACKE CAJOR","DAROU M’BACKE (M’BACKE 1)",60,63,276,272,548
LOUGA,KEBEMER,"DAROU MOUHTY","M’BACKE CAJOR","M’BACKE CAJOR (M’BACKE 2)",63,65,437,431,868
LOUGA,KEBEMER,"DAROU MOUHTY","M’BACKE CAJOR","MBOBO PEULH",7,7,23,16,39
LOUGA,KEBEMER,"DAROU MOUHTY","M’BACKE CAJOR","MERINA NGUENE OUOLOF (MERINA NGUENE DIOP)",2,2,7,12,19
LOUGA,KEBEMER,"DAROU MOUHTY","M’BACKE CAJOR","H1 KEUR MALICK MBARKA",12,16,60,60,120
LOUGA,KEBEMER,"DAROU MOUHTY","M’BACKE CAJOR","MERINA NGUENE PEULH (MERINA SALL)",7,11,35,43,78
LOUGA,KEBEMER,"DAROU MOUHTY","M’BACKE CAJOR","MOUYI NDIAYE (MOUYE DIACK)",3,6,18,24,42
LOUGA,KEBEMER,"DAROU MOUHTY","M’BACKE CAJOR","H1 MOUYI KASSE",1,1,1,0,1
LOUGA,KEBEMER,"DAROU MOUHTY","M’BACKE CAJOR","MOUYE NDIOBENNE",4,5,23,23,46
LOUGA,KEBEMER,"DAROU MOUHTY","M’BACKE CAJOR","NDER DIAMA",12,20,66,76,142
LOUGA,KEBEMER,"DAROU MOUHTY","M’BACKE CAJOR","NDER DIOP",13,15,70,64,134
LOUGA,KEBEMER,"DAROU MOUHTY","M’BACKE CAJOR","NDIAKHAYE  OUOLOF",11,11,44,36,80
LOUGA,KEBEMER,"DAROU MOUHTY","M’BACKE CAJOR","NDIAKHAYE PEULH",8,9,48,45,93
LOUGA,KEBEMER,"DAROU MOUHTY","M’BACKE CAJOR","NDIALIGUE NGHAYE (KEUR MBIDA)",8,8,17,9,26
LOUGA,KEBEMER,"DAROU MOUHTY","M’BACKE CAJOR","NDIALIGUE SARR PEULH",24,31,119,59,178
LOUGA,KEBEMER,"DAROU MOUHTY","M’BACKE CAJOR",NDIASSY,7,7,34,36,70
LOUGA,KEBEMER,"DAROU MOUHTY","M’BACKE CAJOR","NDIAW NDIAW",24,28,196,200,396
LOUGA,KEBEMER,"DAROU MOUHTY","M’BACKE CAJOR","NDIAW NDIAW PEULH",7,8,45,38,83
LOUGA,KEBEMER,"DAROU MOUHTY","M’BACKE CAJOR","H1 NDIAW NDIAW (NDIAW NDIAW WOLOF)",10,13,58,50,108
LOUGA,KEBEMER,"DAROU MOUHTY","M’BACKE CAJOR","NDIAYENE NGHAYE",4,4,11,11,22
LOUGA,KEBEMER,"DAROU MOUHTY","M’BACKE CAJOR",NDIOTE,7,15,45,36,81
LOUGA,KEBEMER,"DAROU MOUHTY","M’BACKE CAJOR",NGANKAL,7,7,31,29,60
LOUGA,KEBEMER,"DAROU MOUHTY","M’BACKE CAJOR","NGAR OUOLOF (NGAR NIANG)",25,28,135,139,274
LOUGA,KEBEMER,"DAROU MOUHTY","M’BACKE CAJOR","NGAY GASSAMA",10,11,37,38,75
LOUGA,KEBEMER,"DAROU MOUHTY","M’BACKE CAJOR","NGAY OUMOUL KHALA (NGAY DIAGNE)",7,7,25,12,37
LOUGA,KEBEMER,"DAROU MOUHTY","M’BACKE CAJOR","NGHAYE PEULH (KEUR MANGA)",22,23,94,87,181
LOUGA,KEBEMER,"DAROU MOUHTY","M’BACKE CAJOR","NGUEMBE OUOLOF",5,7,39,28,67
LOUGA,KEBEMER,"DAROU MOUHTY","M’BACKE CAJOR","NGUENE MOUSTAPHA PEULH",1,1,4,4,8
LOUGA,KEBEMER,"DAROU MOUHTY","M’BACKE CAJOR",THILLAWENE,10,11,104,53,157
LOUGA,KEBEMER,"DAROU MOUHTY","M’BACKE CAJOR","THINE GAYE",6,8,46,48,94
LOUGA,KEBEMER,"DAROU MOUHTY","M’BACKE CAJOR",THIOKEN,11,20,84,89,173
LOUGA,KEBEMER,"DAROU MOUHTY","M’BACKE CAJOR","THIOURANG PEULH",38,64,276,250,526
LOUGA,KEBEMER,"DAROU MOUHTY","M’BACKE CAJOR","H1 NGARE PEULH",25,29,115,107,222
LOUGA,KEBEMER,"DAROU MOUHTY","M’BACKE CAJOR","TOUBE DIEYE",12,13,32,32,64
LOUGA,KEBEMER,NDANDE,"BADEGNE OUOLOF","BADAR PEULH",13,14,74,56,130
LOUGA,KEBEMER,NDANDE,"BADEGNE OUOLOF","BADEGNE OUOLOF",62,66,323,448,771
LOUGA,KEBEMER,NDANDE,"BADEGNE OUOLOF","BADEGNE PEULH",28,47,206,201,407
LOUGA,KEBEMER,NDANDE,"BADEGNE OUOLOF","BAHISSE PEULH",9,20,54,71,125
LOUGA,KEBEMER,NDANDE,"BADEGNE OUOLOF","BAHISSE SECK",9,13,39,36,75
LOUGA,KEBEMER,NDANDE,"BADEGNE OUOLOF","BAKHDAR PEULH",19,30,108,110,218
LOUGA,KEBEMER,NDANDE,"BADEGNE OUOLOF","H1 BAKHDAR",9,14,44,47,91
LOUGA,KEBEMER,NDANDE,"BADEGNE OUOLOF","H1 FASS LO",22,29,243,191,434
LOUGA,KEBEMER,NDANDE,"BADEGNE OUOLOF","BOUKOUL DIOP",6,9,18,40,58
LOUGA,KEBEMER,NDANDE,"BADEGNE OUOLOF","CELLE DIAGNE",3,3,19,13,32
LOUGA,KEBEMER,NDANDE,"BADEGNE OUOLOF","DARA KHARA",46,55,244,267,511
LOUGA,KEBEMER,NDANDE,"BADEGNE OUOLOF","H1 DARA MBENGUE",7,10,26,35,61
LOUGA,KEBEMER,NDANDE,"BADEGNE OUOLOF","DAROU LEUNDEMANE",41,49,214,197,411
LOUGA,KEBEMER,NDANDE,"BADEGNE OUOLOF","DAROU NGARAF",9,14,60,51,111
LOUGA,KEBEMER,NDANDE,"BADEGNE OUOLOF","DAROU PARBA",45,61,235,363,598
LOUGA,KEBEMER,NDANDE,"BADEGNE OUOLOF","DAROU YATE",4,4,16,25,41
LOUGA,KEBEMER,NDANDE,"BADEGNE OUOLOF","DIALGANE GUEDJI",16,22,103,123,226
LOUGA,KEBEMER,NDANDE,"BADEGNE OUOLOF","DIALGANE KANE",14,19,80,97,177
LOUGA,KEBEMER,NDANDE,"BADEGNE OUOLOF","GOUYE MBAYE SALL",33,42,195,217,412
LOUGA,KEBEMER,NDANDE,"BADEGNE OUOLOF","GUEDJI SECK",5,8,31,43,74
LOUGA,KEBEMER,NDANDE,"BADEGNE OUOLOF","KEUR BACARY SALL",9,9,41,45,86
LOUGA,KEBEMER,NDANDE,"BADEGNE OUOLOF","KEUR MAHANTA SEYE",8,8,60,48,108
LOUGA,KEBEMER,NDANDE,"BADEGNE OUOLOF","KEUR MEDOUNE PENDA",2,2,10,9,19
LOUGA,KEBEMER,NDANDE,"BADEGNE OUOLOF","KEUR NDIAYE PEULH",35,56,212,200,412
LOUGA,KEBEMER,NDANDE,"BADEGNE OUOLOF","KEUR SIDY MBENGUE 1",9,11,55,73,128
LOUGA,KEBEMER,NDANDE,"BADEGNE OUOLOF","KEUR SIDY MBENGUE 2",9,20,81,94,175
LOUGA,KEBEMER,NDANDE,"BADEGNE OUOLOF","KHARA NDACK 1",8,13,61,54,115
LOUGA,KEBEMER,NDANDE,"BADEGNE OUOLOF","KHOUROUF 1",6,6,22,26,48
LOUGA,KEBEMER,NDANDE,"BADEGNE OUOLOF","KHOUROUF 2",10,14,62,41,103
LOUGA,KEBEMER,NDANDE,"BADEGNE OUOLOF","KIRE PEULH",11,14,74,71,145
LOUGA,KEBEMER,NDANDE,"BADEGNE OUOLOF",KORANE,28,28,131,168,299
LOUGA,KEBEMER,NDANDE,"BADEGNE OUOLOF",LEUNDEMANE,31,32,111,127,238
LOUGA,KEBEMER,NDANDE,"BADEGNE OUOLOF","MAHINA DIA (KEUR OMAR DIA)",4,7,33,50,83
LOUGA,KEBEMER,NDANDE,"BADEGNE OUOLOF","MAKA SALL",3,3,13,19,32
LOUGA,KEBEMER,NDANDE,"BADEGNE OUOLOF","MAKA SARR",9,12,59,58,117
LOUGA,KEBEMER,NDANDE,"BADEGNE OUOLOF","MBADIAR NDIAYE",56,70,419,494,913
LOUGA,KEBEMER,NDANDE,"BADEGNE OUOLOF","MBENGUENE OUOLOF",4,9,22,49,71
LOUGA,KEBEMER,NDANDE,"BADEGNE OUOLOF","MBENGUENE PEULH",9,19,91,113,204
LOUGA,KEBEMER,NDANDE,"BADEGNE OUOLOF","MBOUL 1",15,15,81,77,158
LOUGA,KEBEMER,NDANDE,"BADEGNE OUOLOF","DAROU MBOUL",7,9,45,61,106
LOUGA,KEBEMER,NDANDE,"BADEGNE OUOLOF","MERINA DAKHAR",19,31,122,158,280
LOUGA,KEBEMER,NDANDE,"BADEGNE OUOLOF","MERINA SALL",3,5,20,18,38
LOUGA,KEBEMER,NDANDE,"BADEGNE OUOLOF","MESSERE MBAYE",29,49,184,316,500
LOUGA,KEBEMER,NDANDE,"BADEGNE OUOLOF","MESSERE TEUGUE",16,20,108,136,244
LOUGA,KEBEMER,NDANDE,"BADEGNE OUOLOF","H1 DAROU NDOP",4,6,46,51,97
LOUGA,KEBEMER,NDANDE,"BADEGNE OUOLOF",MBAYENE,13,18,116,158,274
LOUGA,KEBEMER,NDANDE,"BADEGNE OUOLOF","NDAM NDAM OUOLOF",18,24,121,138,259
LOUGA,KEBEMER,NDANDE,"BADEGNE OUOLOF","NDAM NDAM PEULH",40,52,172,200,372
LOUGA,KEBEMER,NDANDE,"BADEGNE OUOLOF","NDANGOUR NDIAYE",46,51,233,270,503
LOUGA,KEBEMER,NDANDE,"BADEGNE OUOLOF",NDAWENE,3,3,24,22,46
LOUGA,KEBEMER,NDANDE,"BADEGNE OUOLOF",NDIAGNE,5,6,21,40,61
LOUGA,KEBEMER,NDANDE,"BADEGNE OUOLOF","NDIARNO DIOP",56,78,461,555,1016
LOUGA,KEBEMER,NDANDE,"BADEGNE OUOLOF","NDIARNO PEULH",7,13,47,40,87
LOUGA,KEBEMER,NDANDE,"BADEGNE OUOLOF","NDIEYE SEFOUR 1",4,4,27,34,61
LOUGA,KEBEMER,NDANDE,"BADEGNE OUOLOF","H1 NDIEYE PEULH",13,13,83,75,158
LOUGA,KEBEMER,NDANDE,"BADEGNE OUOLOF","NDIEYE SEFOUR 2",37,41,278,243,521
LOUGA,KEBEMER,NDANDE,"BADEGNE OUOLOF","NGARAF OUOLOF",11,26,88,88,176
LOUGA,KEBEMER,NDANDE,"BADEGNE OUOLOF","H1 DAROU NIANG",10,13,46,59,105
LOUGA,KEBEMER,NDANDE,"BADEGNE OUOLOF","NGARAF PEULH 2",25,34,147,122,269
LOUGA,KEBEMER,NDANDE,"BADEGNE OUOLOF","PALLENE CELLE DIAGNE",7,7,35,48,83
LOUGA,KEBEMER,NDANDE,"BADEGNE OUOLOF","PALLENE THIARY",3,3,12,16,28
LOUGA,KEBEMER,NDANDE,"BADEGNE OUOLOF","PARBA 1",34,44,210,283,493
LOUGA,KEBEMER,NDANDE,"BADEGNE OUOLOF","PARBA 2",31,47,209,315,524
LOUGA,KEBEMER,NDANDE,"BADEGNE OUOLOF","PEKH TALL",31,40,189,261,450
LOUGA,KEBEMER,NDANDE,"BADEGNE OUOLOF","H1 PEKH PEULH",26,31,131,148,279
LOUGA,KEBEMER,NDANDE,"BADEGNE OUOLOF","NDIEYE 1",27,31,167,213,380
LOUGA,KEBEMER,NDANDE,"BADEGNE OUOLOF","RACINE PEULH",12,16,88,66,154
LOUGA,KEBEMER,NDANDE,"BADEGNE OUOLOF","SANTHIOU DIOKOUL",21,30,139,176,315
LOUGA,KEBEMER,NDANDE,"BADEGNE OUOLOF","SANTHIOU MBENGUENE",27,34,177,176,353
LOUGA,KEBEMER,NDANDE,"BADEGNE OUOLOF","SINE NGUEOUL",2,2,5,10,15
LOUGA,KEBEMER,NDANDE,"BADEGNE OUOLOF","SIVAL PEULH",8,16,82,78,160
LOUGA,KEBEMER,NDANDE,"BADEGNE OUOLOF","SIVAL SECK",29,33,121,173,294
LOUGA,KEBEMER,NDANDE,"BADEGNE OUOLOF","H1 KEUR DIAM PEULGA",11,17,61,51,112
LOUGA,KEBEMER,NDANDE,"BADEGNE OUOLOF","SIVAL TALL",5,6,30,28,58
LOUGA,KEBEMER,NDANDE,"BADEGNE OUOLOF","H1 SIVAL NDARRY NAK",19,23,124,141,265
LOUGA,KEBEMER,NDANDE,"BADEGNE OUOLOF","TAIBA NDAO",24,31,120,177,297
LOUGA,KEBEMER,NDANDE,"BADEGNE OUOLOF","THIARY LAOBE",4,5,21,30,51
LOUGA,KEBEMER,NDANDE,"BADEGNE OUOLOF","THIARY LORO",37,37,262,248,510
LOUGA,KEBEMER,NDANDE,"BADEGNE OUOLOF","THIARY THIEURIGNE",7,8,30,39,69
LOUGA,KEBEMER,NDANDE,"BADEGNE OUOLOF","THIEDY NIANG",10,10,46,50,96
LOUGA,KEBEMER,NDANDE,"BADEGNE OUOLOF",THIOUBENE,5,6,31,21,52
LOUGA,KEBEMER,NDANDE,"BADEGNE OUOLOF","WAOULOU SALL",3,4,13,19,32
LOUGA,KEBEMER,NDANDE,"BADEGNE OUOLOF","KAWTARA LO",17,19,60,59,119
LOUGA,KEBEMER,NDANDE,"BADEGNE OUOLOF","THIEDY PEULH",17,25,140,119,259
LOUGA,KEBEMER,NDANDE,"DIOKOUL DIAWRIGNE","BADAR DIOP",22,32,181,196,377
LOUGA,KEBEMER,NDANDE,"DIOKOUL DIAWRIGNE","BADAR GUEYE 1",17,26,117,122,239
LOUGA,KEBEMER,NDANDE,"DIOKOUL DIAWRIGNE","BADAR GUEYE 2",25,37,169,169,338
LOUGA,KEBEMER,NDANDE,"DIOKOUL DIAWRIGNE","H1 GADIO",3,5,20,21,41
LOUGA,KEBEMER,NDANDE,"DIOKOUL DIAWRIGNE","BAITY FALL",5,9,62,60,122
LOUGA,KEBEMER,NDANDE,"DIOKOUL DIAWRIGNE","BAITY NDIAYE",20,30,174,189,363
LOUGA,KEBEMER,NDANDE,"DIOKOUL DIAWRIGNE","BAKHDAR MBENGUE",16,21,94,107,201
LOUGA,KEBEMER,NDANDE,"DIOKOUL DIAWRIGNE","DAKHAR DEMBA CODOU",18,22,148,144,292
LOUGA,KEBEMER,NDANDE,"DIOKOUL DIAWRIGNE","DARA ANDAL",42,61,427,395,822
LOUGA,KEBEMER,NDANDE,"DIOKOUL DIAWRIGNE","DAROU KEBE",18,18,118,89,207
LOUGA,KEBEMER,NDANDE,"DIOKOUL DIAWRIGNE","H1 DAROU KEBE PEULH",8,8,83,77,160
LOUGA,KEBEMER,NDANDE,"DIOKOUL DIAWRIGNE","DIAWRIGNE AMADOU BA",10,18,110,79,189
LOUGA,KEBEMER,NDANDE,"DIOKOUL DIAWRIGNE","DIAWRIGNE AMARY",54,65,291,297,588
LOUGA,KEBEMER,NDANDE,"DIOKOUL DIAWRIGNE","H2 NDIOUTOU",8,14,93,89,182
LOUGA,KEBEMER,NDANDE,"DIOKOUL DIAWRIGNE","H2 THIEWELI",1,23,119,108,227
LOUGA,KEBEMER,NDANDE,"DIOKOUL DIAWRIGNE","DIAWRIGNE DIALLO",7,8,49,42,91
LOUGA,KEBEMER,NDANDE,"DIOKOUL DIAWRIGNE","DIAWRIGNE GAYO",1,1,4,5,9
LOUGA,KEBEMER,NDANDE,"DIOKOUL DIAWRIGNE","DIAWRIGNE MAMOUSSE",14,22,116,114,230
LOUGA,KEBEMER,NDANDE,"DIOKOUL DIAWRIGNE","DIAWRIGNE MOR FALL",1,6,32,16,48
LOUGA,KEBEMER,NDANDE,"DIOKOUL DIAWRIGNE","DIAWRIGNE PATHE",3,5,26,22,48
LOUGA,KEBEMER,NDANDE,"DIOKOUL DIAWRIGNE","DIAWRIGNE SAMBA DIOKOUL",13,27,135,103,238
LOUGA,KEBEMER,NDANDE,"DIOKOUL DIAWRIGNE","DIOKOUL DIAWRIGNE",174,257,1187,1267,2454
LOUGA,KEBEMER,NDANDE,"DIOKOUL DIAWRIGNE","H1 DAROU NDIAYE",3,5,46,32,78
LOUGA,KEBEMER,NDANDE,"DIOKOUL DIAWRIGNE","DIOKOUL NDIAYE",28,49,309,313,622
LOUGA,KEBEMER,NDANDE,"DIOKOUL DIAWRIGNE","H1 NGAYE NGAYE",8,8,47,61,108
LOUGA,KEBEMER,NDANDE,"DIOKOUL DIAWRIGNE","DJIGNAKH BEYE",14,18,78,73,151
LOUGA,KEBEMER,NDANDE,"DIOKOUL DIAWRIGNE","GADE MBRAMA",71,88,372,463,835
LOUGA,KEBEMER,NDANDE,"DIOKOUL DIAWRIGNE","GADE KEBE",87,143,643,685,1328
LOUGA,KEBEMER,NDANDE,"DIOKOUL DIAWRIGNE","H1 DAGA AMAR",3,3,39,30,69
LOUGA,KEBEMER,NDANDE,"DIOKOUL DIAWRIGNE","KANENE KANE",23,25,206,148,354
LOUGA,KEBEMER,NDANDE,"DIOKOUL DIAWRIGNE","H1 MESSERE KANE",6,8,67,79,146
LOUGA,KEBEMER,NDANDE,"DIOKOUL DIAWRIGNE","KHARA NDACK",5,12,59,48,107
LOUGA,KEBEMER,NDANDE,"DIOKOUL DIAWRIGNE",LEYE,5,6,34,40,74
LOUGA,KEBEMER,NDANDE,"DIOKOUL DIAWRIGNE","LOMPOUL VILLAGE",21,33,124,107,231
LOUGA,KEBEMER,NDANDE,"DIOKOUL DIAWRIGNE","H1 NAWDAL",3,3,20,12,32
LOUGA,KEBEMER,NDANDE,"DIOKOUL DIAWRIGNE","MADINA KANE",13,14,188,141,329
LOUGA,KEBEMER,NDANDE,"DIOKOUL DIAWRIGNE","MAKA FALL",28,37,151,134,285
LOUGA,KEBEMER,NDANDE,"DIOKOUL DIAWRIGNE","MAKA LY",4,9,34,30,64
LOUGA,KEBEMER,NDANDE,"DIOKOUL DIAWRIGNE","MAKA MBOUBENE",20,20,206,218,424
LOUGA,KEBEMER,NDANDE,"DIOKOUL DIAWRIGNE","MAKA NDIAYE",27,48,191,186,377
LOUGA,KEBEMER,NDANDE,"DIOKOUL DIAWRIGNE",MBAMBARA,2,2,12,10,22
LOUGA,KEBEMER,NDANDE,"DIOKOUL DIAWRIGNE","H1 THIEMBENE",7,23,85,92,177
LOUGA,KEBEMER,NDANDE,"DIOKOUL DIAWRIGNE","MBATAR DIOP",5,5,37,45,82
LOUGA,KEBEMER,NDANDE,"DIOKOUL DIAWRIGNE",MBIRINE,10,15,48,34,82
LOUGA,KEBEMER,NDANDE,"DIOKOUL DIAWRIGNE","MERINA GUEYE",3,4,20,9,29
LOUGA,KEBEMER,NDANDE,"DIOKOUL DIAWRIGNE","MERINA MBOUBENE",17,19,110,124,234
LOUGA,KEBEMER,NDANDE,"DIOKOUL DIAWRIGNE","MERINA NDIEGUE 1",9,9,81,64,145
LOUGA,KEBEMER,NDANDE,"DIOKOUL DIAWRIGNE","MERINA SECK",36,37,252,231,483
LOUGA,KEBEMER,NDANDE,"DIOKOUL DIAWRIGNE","H1 MERINA SECK",10,11,82,80,162
LOUGA,KEBEMER,NDANDE,"DIOKOUL DIAWRIGNE","H2 PEULGA",5,6,37,23,60
LOUGA,KEBEMER,NDANDE,"DIOKOUL DIAWRIGNE","MESSERE TAYE",12,14,81,78,159
LOUGA,KEBEMER,NDANDE,"DIOKOUL DIAWRIGNE","NDAYE FALL",10,17,96,57,153
LOUGA,KEBEMER,NDANDE,"DIOKOUL DIAWRIGNE","NDIAKHA FALL",8,10,37,27,64
LOUGA,KEBEMER,NDANDE,"DIOKOUL DIAWRIGNE","NDIAKHA PEULH",13,22,125,92,217
LOUGA,KEBEMER,NDANDE,"DIOKOUL DIAWRIGNE","NDIARNO WADE",9,10,29,41,70
LOUGA,KEBEMER,NDANDE,"DIOKOUL DIAWRIGNE","NDIAWAGNE FALL",43,50,332,318,650
LOUGA,KEBEMER,NDANDE,"DIOKOUL DIAWRIGNE","NDIAWAGNE NDIAYE",11,12,69,63,132
LOUGA,KEBEMER,NDANDE,"DIOKOUL DIAWRIGNE","H1 KHARAM PEULH",1,1,9,6,15
LOUGA,KEBEMER,NDANDE,"DIOKOUL DIAWRIGNE","NGUER NGUER",39,68,377,416,793
LOUGA,KEBEMER,NDANDE,"DIOKOUL DIAWRIGNE","SINE MADEMBA LEYE",22,24,134,144,278
LOUGA,KEBEMER,NDANDE,"DIOKOUL DIAWRIGNE","TAIBA AMARY MBERY",47,70,441,454,895
LOUGA,KEBEMER,NDANDE,"DIOKOUL DIAWRIGNE","TAIBA MAR",11,15,72,48,120
LOUGA,KEBEMER,NDANDE,"DIOKOUL DIAWRIGNE","TAWA GUEYE",18,30,141,148,289
LOUGA,KEBEMER,NDANDE,"DIOKOUL DIAWRIGNE","TEUGUE NDOGUI 1",7,8,39,49,88
LOUGA,KEBEMER,NDANDE,"DIOKOUL DIAWRIGNE","H1 KEUR SOULEY BA",7,8,34,34,68
LOUGA,KEBEMER,NDANDE,"DIOKOUL DIAWRIGNE","H1 KIP",5,5,31,37,68
LOUGA,KEBEMER,NDANDE,"DIOKOUL DIAWRIGNE","TEUGUE NDOGUI 2",8,19,53,73,126
LOUGA,KEBEMER,NDANDE,"DIOKOUL DIAWRIGNE",THIENABA,15,27,121,144,265
LOUGA,KEBEMER,NDANDE,"DIOKOUL DIAWRIGNE","THIOUNE 1",18,28,147,148,295
LOUGA,KEBEMER,NDANDE,"DIOKOUL DIAWRIGNE","THIOUNE 2",11,12,70,56,126
LOUGA,KEBEMER,NDANDE,"DIOKOUL DIAWRIGNE","H1 DARAL",2,2,10,11,21
LOUGA,KEBEMER,NDANDE,"DIOKOUL DIAWRIGNE",YADIANA,33,42,266,259,525
LOUGA,KEBEMER,NDANDE,"DIOKOUL DIAWRIGNE","H1 YADIANA",13,14,134,132,266
LOUGA,KEBEMER,NDANDE,"DIOKOUL DIAWRIGNE","DARA GUEYE",18,23,130,125,255
LOUGA,KEBEMER,NDANDE,"DIOKOUL DIAWRIGNE","MERINA NDIEGUE 2",10,10,60,60,120
LOUGA,KEBEMER,NDANDE,"DIOKOUL DIAWRIGNE","IBA GAYE",28,50,219,211,430
LOUGA,KEBEMER,NDANDE,"KAB GAYE",BERCOME,16,23,131,113,244
LOUGA,KEBEMER,NDANDE,"KAB GAYE","H1 SELEW",7,16,95,101,196
LOUGA,KEBEMER,NDANDE,"KAB GAYE","DAROU DIA",15,25,161,124,285
LOUGA,KEBEMER,NDANDE,"KAB GAYE","FASS NDIAYE",17,23,130,123,253
LOUGA,KEBEMER,NDANDE,"KAB GAYE","GAD PEULH",29,57,308,292,600
LOUGA,KEBEMER,NDANDE,"KAB GAYE","GADE ROMNANE",5,5,22,11,33
LOUGA,KEBEMER,NDANDE,"KAB GAYE","GATY SAKE",15,18,167,125,292
LOUGA,KEBEMER,NDANDE,"KAB GAYE","H1 MBA",6,14,63,57,120
LOUGA,KEBEMER,NDANDE,"KAB GAYE","H2 MERINA NGUINTH",27,39,258,275,533
LOUGA,KEBEMER,NDANDE,"KAB GAYE","GOUYE BARA",5,10,41,40,81
LOUGA,KEBEMER,NDANDE,"KAB GAYE","H1 NDIANGANE KAB GAYE",15,19,136,90,226
LOUGA,KEBEMER,NDANDE,"KAB GAYE","KAB GAYE",56,70,568,363,931
LOUGA,KEBEMER,NDANDE,"KAB GAYE","KEUR MALEYE DIOP",19,26,171,138,309
LOUGA,KEBEMER,NDANDE,"KAB GAYE","KEUR MBAYE NDAO",17,31,205,154,359
LOUGA,KEBEMER,NDANDE,"KAB GAYE","LAMBANE TOURE",7,10,56,54,110
LOUGA,KEBEMER,NDANDE,"KAB GAYE","LAMBANE WILANE",31,35,256,227,483
LOUGA,KEBEMER,NDANDE,"KAB GAYE","MADINA BEYE",6,6,38,30,68
LOUGA,KEBEMER,NDANDE,"KAB GAYE","MERINA NDIAYE",19,24,153,127,280
LOUGA,KEBEMER,NDANDE,"KAB GAYE","H1 PALENE",11,13,80,75,155
LOUGA,KEBEMER,NDANDE,"KAB GAYE","MERINA NDIOL",18,21,166,167,333
LOUGA,KEBEMER,NDANDE,"KAB GAYE","H1 SANTHIE",2,4,15,19,34
LOUGA,KEBEMER,NDANDE,"KAB GAYE","NDIAKANE GAYE",6,6,63,43,106
LOUGA,KEBEMER,NDANDE,"KAB GAYE","NDIAKHATE BABA",10,11,80,100,180
LOUGA,KEBEMER,NDANDE,"KAB GAYE","NDIALACK 1",4,11,48,45,93
LOUGA,KEBEMER,NDANDE,"KAB GAYE","NDOB MBAYE",3,5,38,36,74
LOUGA,KEBEMER,NDANDE,"KAB GAYE","NGATTE OUOLOF",10,18,115,72,187
LOUGA,KEBEMER,NDANDE,"KAB GAYE","H1 NGUEMBE (DAROU DIENG)",10,11,117,113,230
LOUGA,KEBEMER,NDANDE,"KAB GAYE","NGATTE PEULH",7,17,98,84,182
LOUGA,KEBEMER,NDANDE,"KAB GAYE","H1 MABOUYE DIOP",13,18,83,95,178
LOUGA,KEBEMER,NDANDE,"KAB GAYE",NGUEBAL,32,42,321,273,594
LOUGA,KEBEMER,NDANDE,"KAB GAYE","NGUEUNE PEULH",4,6,37,26,63
LOUGA,KEBEMER,NDANDE,"KAB GAYE",PAM,16,24,147,131,278
LOUGA,KEBEMER,NDANDE,"KAB GAYE","ROMNANE SANTHIE",1,1,2,0,2
LOUGA,KEBEMER,NDANDE,"KAB GAYE","SAB KA",18,31,157,132,289
LOUGA,KEBEMER,NDANDE,"KAB GAYE","SAM GUEYE",9,9,64,64,128
LOUGA,KEBEMER,NDANDE,"KAB GAYE","SAM NGOM",12,15,95,69,164
LOUGA,KEBEMER,NDANDE,"KAB GAYE","SANTHIOUB GUEYE",17,23,176,134,310
LOUGA,KEBEMER,NDANDE,"KAB GAYE","SIWAL ROMNANE",9,17,140,98,238
LOUGA,KEBEMER,NDANDE,"KAB GAYE","TALLENE GAYE",53,57,304,440,744
LOUGA,KEBEMER,NDANDE,"KAB GAYE","TAWA FALL",20,28,152,149,301
LOUGA,KEBEMER,NDANDE,"KAB GAYE","TAWA MBA",35,39,206,181,387
LOUGA,KEBEMER,NDANDE,"KAB GAYE","TAWA PEULH",28,64,260,255,515
LOUGA,KEBEMER,NDANDE,"KAB GAYE","H1 NGUEUNE GOUDI",37,93,484,395,879
LOUGA,KEBEMER,NDANDE,"KAB GAYE","TEUGUE NGATTE (TEUGUE GUEYE)",19,27,170,153,323
LOUGA,KEBEMER,NDANDE,"KAB GAYE","TEUMBE MBAYE",43,67,329,300,629
LOUGA,KEBEMER,NDANDE,"KAB GAYE","TEURAL BA",17,30,205,212,417
LOUGA,KEBEMER,NDANDE,"KAB GAYE","THIAKHAO GAYE",61,66,412,375,787
LOUGA,KEBEMER,NDANDE,"KAB GAYE",THIALLE,5,5,34,27,61
LOUGA,KEBEMER,NDANDE,"KAB GAYE","TOURE NGUEUNE",21,25,166,130,296
LOUGA,KEBEMER,NDANDE,NDANDE,ANDOULAYE,59,65,381,390,771
LOUGA,KEBEMER,NDANDE,NDANDE,"BEUD FORAGE",53,58,281,357,638
LOUGA,KEBEMER,NDANDE,NDANDE,"CHERIF KA 1",23,26,244,205,449
LOUGA,KEBEMER,NDANDE,NDANDE,"CHERIF KA 2",9,20,127,89,216
LOUGA,KEBEMER,NDANDE,NDANDE,"COKI GUEYE",33,37,192,197,389
LOUGA,KEBEMER,NDANDE,NDANDE,"DAKHAR NGOGNE (NDIALENE)",43,48,198,276,474
LOUGA,KEBEMER,NDANDE,NDANDE,"DALE KA",14,16,93,96,189
LOUGA,KEBEMER,NDANDE,NDANDE,"DARA PALMEO",34,39,207,218,425
LOUGA,KEBEMER,NDANDE,NDANDE,"DAROU SAMB",7,8,57,59,116
LOUGA,KEBEMER,NDANDE,NDANDE,"DAROU SODE",26,27,121,115,236
LOUGA,KEBEMER,NDANDE,NDANDE,"DIE CODOU PANE",13,24,86,103,189
LOUGA,KEBEMER,NDANDE,NDANDE,"DIOKOUL MBAKA",11,12,65,63,128
LOUGA,KEBEMER,NDANDE,NDANDE,"GATY OUMAR",3,3,31,42,73
LOUGA,KEBEMER,NDANDE,NDANDE,"GATY RATE",100,113,598,668,1266
LOUGA,KEBEMER,NDANDE,NDANDE,"GOUYE MEO",37,56,384,357,741
LOUGA,KEBEMER,NDANDE,NDANDE,"KEUR IBRA SECK",4,4,30,42,72
LOUGA,KEBEMER,NDANDE,NDANDE,"MBAKA LO",30,32,241,276,517
LOUGA,KEBEMER,NDANDE,NDANDE,"MBAYE DJINIAKH",10,10,51,67,118
LOUGA,KEBEMER,NDANDE,NDANDE,MBEDIENE,84,96,413,506,919
LOUGA,KEBEMER,NDANDE,NDANDE,"MBERE DIENG",22,22,94,140,234
LOUGA,KEBEMER,NDANDE,NDANDE,"MERINA DIOP OUOLOF",16,20,109,126,235
LOUGA,KEBEMER,NDANDE,NDANDE,"MERINA DIOP PEULH",3,8,32,33,65
LOUGA,KEBEMER,NDANDE,NDANDE,NDANDE,853,920,4521,4996,9517
LOUGA,KEBEMER,NDANDE,NDANDE,"NDANDE (DAROU NDIENE)",110,118,565,706,1271
LOUGA,KEBEMER,NDANDE,NDANDE,"NDIAKHATE KHOURY",17,20,70,132,202
LOUGA,KEBEMER,NDANDE,NDANDE,"NDIAYE BOUMI",28,30,211,248,459
LOUGA,KEBEMER,NDANDE,NDANDE,"NDIAYE NGASSAMA",17,17,121,157,278
LOUGA,KEBEMER,NDANDE,NDANDE,"NDIAYE SANTHIE",24,25,124,139,263
LOUGA,KEBEMER,NDANDE,NDANDE,"NDIAYE THIORO",64,67,407,534,941
LOUGA,KEBEMER,NDANDE,NDANDE,"NDIENG DIAW (NDIENG MADIOR)",34,35,200,189,389
LOUGA,KEBEMER,NDANDE,NDANDE,"H1 MARONENE",9,11,59,71,130
LOUGA,KEBEMER,NDANDE,NDANDE,NDIOBOUGOUR,8,9,50,66,116
LOUGA,KEBEMER,NDANDE,NDANDE,"NDIOKHOUL MBIRMA",40,49,292,305,597
LOUGA,KEBEMER,NDANDE,NDANDE,"NDIOKHOUL NDIABA",58,59,411,376,787
LOUGA,KEBEMER,NDANDE,NDANDE,"NDIONGUE FALL",26,33,252,270,522
LOUGA,KEBEMER,NDANDE,NDANDE,"NGAYE NGAYE I (DAROU DIOP)",6,6,34,26,60
LOUGA,KEBEMER,NDANDE,NDANDE,"NGAYE NGAYE II",5,5,33,32,65
LOUGA,KEBEMER,NDANDE,NDANDE,"PALLENE DEDE",65,94,677,601,1278
LOUGA,KEBEMER,NDANDE,NDANDE,"H1 DAROU SEYE",6,6,60,63,123
LOUGA,KEBEMER,NDANDE,NDANDE,"H2 FASS BA",5,7,63,59,122
LOUGA,KEBEMER,NDANDE,NDANDE,PALMEO,101,118,682,783,1465
LOUGA,KEBEMER,NDANDE,NDANDE,"SANTHIOU MOUR",37,44,275,294,569
LOUGA,KEBEMER,NDANDE,NDANDE,"H1 DJIBY BA",6,8,50,54,104
LOUGA,KEBEMER,NDANDE,NDANDE,"SANTHIOU NAKHAR",4,4,23,25,48
LOUGA,KEBEMER,NDANDE,NDANDE,"SANTHIOU THYLL",7,7,35,15,50
LOUGA,KEBEMER,NDANDE,NDANDE,"SOUGUER MBAKA",43,62,350,347,697
LOUGA,KEBEMER,NDANDE,NDANDE,"THIARY MBAYE",7,7,31,48,79
LOUGA,KEBEMER,NDANDE,NDANDE,THIEUMBEUL,16,19,60,57,117
LOUGA,KEBEMER,NDANDE,NDANDE,"THIEYE THIEYE",48,61,272,436,708
LOUGA,KEBEMER,NDANDE,NDANDE,THYLL,26,30,250,236,486
LOUGA,KEBEMER,NDANDE,NDANDE,"H1 THYLL PEULH",19,27,88,97,185
LOUGA,KEBEMER,NDANDE,NDANDE,"TOURE MBAYE",41,48,268,263,531
LOUGA,KEBEMER,NDANDE,NDANDE,"WAKHAL DIAM",16,16,1034,76,1110
LOUGA,KEBEMER,NDANDE,NDANDE,WATEF,21,25,153,183,336
LOUGA,KEBEMER,NDANDE,THIEPPE,"ALI NDIAYE",1,6,18,19,37
LOUGA,KEBEMER,NDANDE,THIEPPE,BADEME,20,26,259,53,312
LOUGA,KEBEMER,NDANDE,THIEPPE,"BAYA DIENG",9,10,37,40,77
LOUGA,KEBEMER,NDANDE,THIEPPE,"H1 KEUR BAYA DIOP",12,14,80,92,172
LOUGA,KEBEMER,NDANDE,THIEPPE,"BAYA GORAM PEULH",5,11,43,30,73
LOUGA,KEBEMER,NDANDE,THIEPPE,"BAYA TOUTY PEULH",4,13,51,42,93
LOUGA,KEBEMER,NDANDE,THIEPPE,"BEIGNE NDIOUGA",3,4,34,26,60
LOUGA,KEBEMER,NDANDE,THIEPPE,"BEIGNE PENDA",7,7,43,34,77
LOUGA,KEBEMER,NDANDE,THIEPPE,"H1 SINE NDIAYE",17,21,118,97,215
LOUGA,KEBEMER,NDANDE,THIEPPE,"H2 BEIGNE PENDA",11,33,140,106,246
LOUGA,KEBEMER,NDANDE,THIEPPE,BOGUEL,10,11,73,64,137
LOUGA,KEBEMER,NDANDE,THIEPPE,"BOUNDOU MBALLA",6,14,84,51,135
LOUGA,KEBEMER,NDANDE,THIEPPE,"BOUNDOU NIEWA",4,4,21,20,41
LOUGA,KEBEMER,NDANDE,THIEPPE,"H1 BOULEL DE BOUNDOU NIEWA",4,5,24,24,48
LOUGA,KEBEMER,NDANDE,THIEPPE,"BOUNDOU OULA",5,7,44,34,78
LOUGA,KEBEMER,NDANDE,THIEPPE,"COKI DIOP",15,20,155,171,326
LOUGA,KEBEMER,NDANDE,THIEPPE,"DAROU BEYE",17,22,137,129,266
LOUGA,KEBEMER,NDANDE,THIEPPE,"DAROU DIOP",3,3,9,12,21
LOUGA,KEBEMER,NDANDE,THIEPPE,"DAROU FALL 1",17,21,75,120,195
LOUGA,KEBEMER,NDANDE,THIEPPE,"DAROU THIARE",12,14,72,46,118
LOUGA,KEBEMER,NDANDE,THIEPPE,"DIADJI PEULH",16,24,122,104,226
LOUGA,KEBEMER,NDANDE,THIEPPE,"H1 PAGAR SOW",12,21,90,81,171
LOUGA,KEBEMER,NDANDE,THIEPPE,"DIAMA BEYE 1",27,38,288,312,600
LOUGA,KEBEMER,NDANDE,THIEPPE,"DIAMA BEYE 2",21,23,118,88,206
LOUGA,KEBEMER,NDANDE,THIEPPE,"DIAMA PEULH",18,23,122,108,230
LOUGA,KEBEMER,NDANDE,THIEPPE,"DIOKOUL NDIARNO",14,26,85,142,227
LOUGA,KEBEMER,NDANDE,THIEPPE,"DIOKOUL NDIARNO PEULH",8,12,29,49,78
LOUGA,KEBEMER,NDANDE,THIEPPE,"DIWANE OUOLOF",5,5,51,38,89
LOUGA,KEBEMER,NDANDE,THIEPPE,"DIWANE PEULH",13,13,76,77,153
LOUGA,KEBEMER,NDANDE,THIEPPE,"FORDIOKH ABDOUL",7,7,39,28,67
LOUGA,KEBEMER,NDANDE,THIEPPE,"FORDIOKH BANDA",1,4,23,7,30
LOUGA,KEBEMER,NDANDE,THIEPPE,"H1 FORDIOKH BANDA",1,1,4,2,6
LOUGA,KEBEMER,NDANDE,THIEPPE,"FORDIOKH GALLO BA",8,13,70,45,115
LOUGA,KEBEMER,NDANDE,THIEPPE,"FORDIOKH OUOLOF",57,70,440,496,936
LOUGA,KEBEMER,NDANDE,THIEPPE,"FORDIOKH GALLO BOUSSO",3,3,21,11,32
LOUGA,KEBEMER,NDANDE,THIEPPE,"FORDIOKH MODY",6,15,59,49,108
LOUGA,KEBEMER,NDANDE,THIEPPE,"H1 SARE DAO GOUYE SEGUE( DE GOUYE SEGUE)",26,51,386,269,655
LOUGA,KEBEMER,NDANDE,THIEPPE,"GAL DAMEL AMATH",11,18,84,79,163
LOUGA,KEBEMER,NDANDE,THIEPPE,"H1 BEGNE BIRAHIM",19,45,232,211,443
LOUGA,KEBEMER,NDANDE,THIEPPE,"GAL DAMEL KALIDOU",27,79,340,301,641
LOUGA,KEBEMER,NDANDE,THIEPPE,"H1 GAL DAMEL NGOL BONDJI",1,1,5,2,7
LOUGA,KEBEMER,NDANDE,THIEPPE,"GAL DAMEL NEODI BOUYA",16,41,168,138,306
LOUGA,KEBEMER,NDANDE,THIEPPE,"GAL DAMEL SALIF (GAL DAMEL SADELBE)",7,22,92,68,160
LOUGA,KEBEMER,NDANDE,THIEPPE,"H1 GAL DAMEL BEIGNE NDIOUGA(DE BEIGNE NDIOUGA)",14,44,220,168,388
LOUGA,KEBEMER,NDANDE,THIEPPE,"GATY MORY",10,15,59,76,135
LOUGA,KEBEMER,NDANDE,THIEPPE,"GOUYE RENE",16,24,127,123,250
LOUGA,KEBEMER,NDANDE,THIEPPE,"GOUYE SEGUE",3,4,18,23,41
LOUGA,KEBEMER,NDANDE,THIEPPE,HIMBIL,6,6,35,38,73
LOUGA,KEBEMER,NDANDE,THIEPPE,"KEUR ALI NDIAYE",5,6,46,19,65
LOUGA,KEBEMER,NDANDE,THIEPPE,"H1 KEUR MAO KA",3,3,14,10,24
LOUGA,KEBEMER,NDANDE,THIEPPE,"KEUR BAKA MBAYE",6,11,69,56,125
LOUGA,KEBEMER,NDANDE,THIEPPE,"KEUR BAKARY DIOP",12,16,63,74,137
LOUGA,KEBEMER,NDANDE,THIEPPE,"KEUR BARA DIOP",5,9,43,43,86
LOUGA,KEBEMER,NDANDE,THIEPPE,"H1 NDIOGAYE",5,8,63,23,86
LOUGA,KEBEMER,NDANDE,THIEPPE,"KEUR SAMBA LAOBE (MAKA NDIAYE II)",15,20,110,107,217
LOUGA,KEBEMER,NDANDE,THIEPPE,"H1 MANGA DE KEUR SAMBA LAOBE",11,12,60,54,114
LOUGA,KEBEMER,NDANDE,THIEPPE,"H2 KEUR NDIAGA SENE",7,8,43,31,74
LOUGA,KEBEMER,NDANDE,THIEPPE,KHALIL,7,8,44,38,82
LOUGA,KEBEMER,NDANDE,THIEPPE,"KHARAM PEULH",3,3,32,22,54
LOUGA,KEBEMER,NDANDE,THIEPPE,"KHELERE NDIAYE",2,2,14,14,28
LOUGA,KEBEMER,NDANDE,THIEPPE,"KHININE ALASSANE",18,43,163,128,291
LOUGA,KEBEMER,NDANDE,THIEPPE,"KHININE AMADOU BA",2,3,15,10,25
LOUGA,KEBEMER,NDANDE,THIEPPE,"MAKA DIOP",46,49,315,409,724
LOUGA,KEBEMER,NDANDE,THIEPPE,"MAKA NDIAYE (MAKA THIECKENE)",7,8,62,61,123
LOUGA,KEBEMER,NDANDE,THIEPPE,"MBERE 1",5,5,44,36,80
LOUGA,KEBEMER,NDANDE,THIEPPE,"MBEYE 1",22,38,161,210,371
LOUGA,KEBEMER,NDANDE,THIEPPE,"MBEYE 2",13,24,125,119,244
LOUGA,KEBEMER,NDANDE,THIEPPE,"MERINA GAYE 1",8,12,48,37,85
LOUGA,KEBEMER,NDANDE,THIEPPE,"MERINA GAYE 2",5,5,26,16,42
LOUGA,KEBEMER,NDANDE,THIEPPE,"MERINA NDIAYE",51,75,518,476,994
LOUGA,KEBEMER,NDANDE,THIEPPE,"NDIAKHORA DIA",10,11,72,56,128
LOUGA,KEBEMER,NDANDE,THIEPPE,NDIANAOUR,16,18,86,87,173
LOUGA,KEBEMER,NDANDE,THIEPPE,"PAL MBAOR",18,35,133,175,308
LOUGA,KEBEMER,NDANDE,THIEPPE,PALLATOU,6,14,78,64,142
LOUGA,KEBEMER,NDANDE,THIEPPE,"RONY DEUGUE 1",16,35,157,106,263
LOUGA,KEBEMER,NDANDE,THIEPPE,"H1 BAYAKH",5,10,42,41,83
LOUGA,KEBEMER,NDANDE,THIEPPE,"H2 SALY",33,95,521,382,903
LOUGA,KEBEMER,NDANDE,THIEPPE,"H3 SELEGNERE",11,16,105,88,193
LOUGA,KEBEMER,NDANDE,THIEPPE,"H4 PAGAR KA",6,7,29,20,49
LOUGA,KEBEMER,NDANDE,THIEPPE,"RONY DEUGUE 2",1,1,6,7,13
LOUGA,KEBEMER,NDANDE,THIEPPE,"SAME GAYE",25,28,176,163,339
LOUGA,KEBEMER,NDANDE,THIEPPE,"SANTHIOU DJINAKH",43,54,280,285,565
LOUGA,KEBEMER,NDANDE,THIEPPE,"SANTHIOU KANENE(COMMUNE DE BANDEIGNE OUOLOF)",16,32,137,182,319
LOUGA,KEBEMER,NDANDE,THIEPPE,"SANTHIOU MEISSA",14,20,83,54,137
LOUGA,KEBEMER,NDANDE,THIEPPE,"SANTHIOU NDIOL",1,2,10,9,19
LOUGA,KEBEMER,NDANDE,THIEPPE,"SINTHIOU NIANI",15,25,121,138,259
LOUGA,KEBEMER,NDANDE,THIEPPE,"SANTHIOU THIEURIGNE",11,18,71,66,137
LOUGA,KEBEMER,NDANDE,THIEPPE,"SINE OUOLOF",9,11,64,72,136
LOUGA,KEBEMER,NDANDE,THIEPPE,"SINE ALTERE PEULH",7,7,59,50,109
LOUGA,KEBEMER,NDANDE,THIEPPE,"TAYE MBAOR",22,34,232,203,435
LOUGA,KEBEMER,NDANDE,THIEPPE,"TEBENE 1",14,15,94,68,162
LOUGA,KEBEMER,NDANDE,THIEPPE,"H1 NDIENCK PINTHIE",5,5,25,23,48
LOUGA,KEBEMER,NDANDE,THIEPPE,"TEBENE 2",25,42,174,174,348
LOUGA,KEBEMER,NDANDE,THIEPPE,"H1 GAL DAMEL SALIF",17,33,166,154,320
LOUGA,KEBEMER,NDANDE,THIEPPE,"THIARENE SARR",17,24,129,136,265
LOUGA,KEBEMER,NDANDE,THIEPPE,THIEMANE,2,3,25,6,31
LOUGA,KEBEMER,NDANDE,THIEPPE,THIEPPE,66,82,507,480,987
LOUGA,KEBEMER,NDANDE,THIEPPE,"H1 SINTHIOU BADEME",9,20,199,79,278
LOUGA,KEBEMER,NDANDE,THIEPPE,"H2 THIEPPE PEULH",3,3,13,11,24
LOUGA,KEBEMER,NDANDE,THIEPPE,THIEURIGNE,16,18,113,106,219
LOUGA,KEBEMER,NDANDE,THIEPPE,"TORO BEYE",23,33,200,172,372
LOUGA,KEBEMER,NDANDE,THIEPPE,TOUNDE,11,12,84,72,156
LOUGA,KEBEMER,NDANDE,THIEPPE,"H1 NDASSY DE TOUNDE MALEYE",16,26,114,76,190
LOUGA,KEBEMER,NDANDE,THIEPPE,"WINDOU TCHINGOLY",14,15,99,94,193
LOUGA,KEBEMER,NDANDE,THIEPPE,"H1 BOUNDOU NIEWA",1,1,9,7,16
LOUGA,KEBEMER,NDANDE,THIEPPE,"YODI DAO",17,39,133,112,245
LOUGA,KEBEMER,NDANDE,THIEPPE,"H1 YODI SAYORO",19,29,97,98,195
LOUGA,KEBEMER,NDANDE,THIEPPE,"YODI NDIAGA",6,35,67,65,132
LOUGA,KEBEMER,NDANDE,THIEPPE,"H1 TOUNDE MALEYE",22,107,233,199,432
LOUGA,KEBEMER,NDANDE,THIEPPE,"YODI SAROYO",10,14,57,37,94
LOUGA,KEBEMER,NDANDE,THIEPPE,"YODI TANOR",9,18,73,73,146
LOUGA,KEBEMER,NDANDE,THIEPPE,"FORDIOKH SAYORO",1,6,40,9,49
LOUGA,KEBEMER,NDANDE,THIEPPE,"GAL DAMEL ABDOUL",7,30,122,99,221
LOUGA,KEBEMER,NDANDE,THIEPPE,"MBERE 2",4,5,18,19,37
LOUGA,KEBEMER,NDANDE,THIEPPE,"TOUNDE MALEYE",7,24,110,105,215
LOUGA,KEBEMER,NDANDE,GUEOUL,"D. DIAGNE",188,208,971,1062,2033
LOUGA,KEBEMER,NDANDE,GUEOUL,"DAROU SALAM NIMZATT",140,161,664,768,1432
LOUGA,KEBEMER,NDANDE,GUEOUL,DVF,192,207,950,1061,2011
LOUGA,KEBEMER,NDANDE,GUEOUL,ESCALE,56,72,229,311,540
LOUGA,KEBEMER,NDANDE,GUEOUL,"GOUYE GAL",178,195,1043,1120,2163
LOUGA,KEBEMER,NDANDE,GUEOUL,NGUEOUL,26,27,169,176,345
LOUGA,KEBEMER,NDANDE,GUEOUL,THILLA,161,211,1006,1017,2023
LOUGA,KEBEMER,SAGATTA,"KANENE NDIOB","AFFE 1 (AFFE LEYE 1)",37,42,164,244,408
LOUGA,KEBEMER,SAGATTA,"KANENE NDIOB","AFFE 2 (AFFE LEYE 2)",18,21,135,144,279
LOUGA,KEBEMER,SAGATTA,"KANENE NDIOB","H1 PEULHOU",3,3,28,12,40
LOUGA,KEBEMER,SAGATTA,"KANENE NDIOB","H2 PEULHOU",4,4,16,9,25
LOUGA,KEBEMER,SAGATTA,"KANENE NDIOB","H3 AFFE 3",4,4,22,17,39
LOUGA,KEBEMER,SAGATTA,"KANENE NDIOB","H4 TALLENE TALL",3,3,16,12,28
LOUGA,KEBEMER,SAGATTA,"KANENE NDIOB","DAROU CISSE",12,13,130,101,231
LOUGA,KEBEMER,SAGATTA,"KANENE NDIOB","DAROU KANE",7,7,41,45,86
LOUGA,KEBEMER,SAGATTA,"KANENE NDIOB","DAROU DIAPATE",12,12,98,84,182
LOUGA,KEBEMER,SAGATTA,"KANENE NDIOB","DEGOUME SOW",18,19,117,74,191
LOUGA,KEBEMER,SAGATTA,"KANENE NDIOB","DEKHOLE ABDOUL",27,28,122,112,234
LOUGA,KEBEMER,SAGATTA,"KANENE NDIOB","DEKHOLE DEGOUME",7,7,32,24,56
LOUGA,KEBEMER,SAGATTA,"KANENE NDIOB","GOUYE GALLE",7,7,53,51,104
LOUGA,KEBEMER,SAGATTA,"KANENE NDIOB","KANENE NDIOB",195,211,1288,1369,2657
LOUGA,KEBEMER,SAGATTA,"KANENE NDIOB","KANENE NIERE",77,97,474,562,1036
LOUGA,KEBEMER,SAGATTA,"KANENE NDIOB","KEUR AMADOU MATAR BABOU",11,11,145,78,223
LOUGA,KEBEMER,SAGATTA,"KANENE NDIOB","KEUR AMADOU MOCTAR PEULH",1,1,15,6,21
LOUGA,KEBEMER,SAGATTA,"KANENE NDIOB","KHELLY THIOUB",68,75,503,445,948
LOUGA,KEBEMER,SAGATTA,"KANENE NDIOB","KHOUROUF SOW",31,32,104,117,221
LOUGA,KEBEMER,SAGATTA,"KANENE NDIOB",KOUREDIOUNOCK,2,2,20,23,43
LOUGA,KEBEMER,SAGATTA,"KANENE NDIOB","MBOREFOU LO",2,2,11,19,30
LOUGA,KEBEMER,SAGATTA,"KANENE NDIOB","H1 MBOREFOU",9,10,45,58,103
LOUGA,KEBEMER,SAGATTA,"KANENE NDIOB","NDAME MACTAR NAR",25,25,119,99,218
LOUGA,KEBEMER,SAGATTA,"KANENE NDIOB","NDIAMBOR FALL",12,15,54,62,116
LOUGA,KEBEMER,SAGATTA,"KANENE NDIOB","NDIAWENE NDIOB",11,11,78,65,143
LOUGA,KEBEMER,SAGATTA,"KANENE NDIOB","H1 KALANG",12,13,101,95,196
LOUGA,KEBEMER,SAGATTA,"KANENE NDIOB","NDIOB SAMB",9,9,41,31,72
LOUGA,KEBEMER,SAGATTA,"KANENE NDIOB","H1 THIOSSE PEULH",13,15,108,100,208
LOUGA,KEBEMER,SAGATTA,"KANENE NDIOB","NDIOP NDIAYE (NDIARE DIOP)",1,1,2,1,3
LOUGA,KEBEMER,SAGATTA,"KANENE NDIOB","NDIOUGUENE NDIOUCK",16,18,101,104,205
LOUGA,KEBEMER,SAGATTA,"KANENE NDIOB","NGUEMBE DIENG",8,10,39,39,78
LOUGA,KEBEMER,SAGATTA,"KANENE NDIOB","NGUEMBE PEULH",48,57,216,265,481
LOUGA,KEBEMER,SAGATTA,"KANENE NDIOB","NGUEMBE MANGO",17,20,85,79,164
LOUGA,KEBEMER,SAGATTA,"KANENE NDIOB","H2 THIOSSE PEULH",15,15,73,73,146
LOUGA,KEBEMER,SAGATTA,"KANENE NDIOB","H3 DIAMAGUENE PANEKH",8,8,48,62,110
LOUGA,KEBEMER,SAGATTA,"KANENE NDIOB","NGUEUNE CISSE",6,7,34,42,76
LOUGA,KEBEMER,SAGATTA,"KANENE NDIOB","H1 NGUIMBE (NDIAKHAR)",3,4,24,25,49
LOUGA,KEBEMER,SAGATTA,"KANENE NDIOB","NGUEUNE PEULH",4,5,21,21,42
LOUGA,KEBEMER,SAGATTA,"KANENE NDIOB","NGUEUNE SEYE",17,18,154,113,267
LOUGA,KEBEMER,SAGATTA,"KANENE NDIOB","H1 DAROU SEYE",9,9,41,54,95
LOUGA,KEBEMER,SAGATTA,"KANENE NDIOB","NIERE CISSE OUOLOF",24,25,181,147,328
LOUGA,KEBEMER,SAGATTA,"KANENE NDIOB","NIERE CISSE PEULH",18,18,86,89,175
LOUGA,KEBEMER,SAGATTA,"KANENE NDIOB","NOUFFLE (KEUR BAYLA)",13,17,93,94,187
LOUGA,KEBEMER,SAGATTA,"KANENE NDIOB","PAIDA FALL",3,3,21,19,40
LOUGA,KEBEMER,SAGATTA,"KANENE NDIOB",ROUMDERATTE,5,6,25,25,50
LOUGA,KEBEMER,SAGATTA,"KANENE NDIOB","H1 LEWE",6,6,25,23,48
LOUGA,KEBEMER,SAGATTA,"KANENE NDIOB","SANTHIOU NDIOB",8,9,65,50,115
LOUGA,KEBEMER,SAGATTA,"KANENE NDIOB","TAIBA BABOU",8,9,57,57,114
LOUGA,KEBEMER,SAGATTA,"KANENE NDIOB",TEUGUEMAGNEFOUL,1,1,7,4,11
LOUGA,KEBEMER,SAGATTA,"KANENE NDIOB",TEUMBEULDIABAYE,3,3,19,17,36
LOUGA,KEBEMER,SAGATTA,"KANENE NDIOB","THIEMBAR PEULH",11,13,49,64,113
LOUGA,KEBEMER,SAGATTA,"KANENE NDIOB","THIEMBAR SAMB",1,1,3,4,7
LOUGA,KEBEMER,SAGATTA,"KANENE NDIOB","THIAYTOU DIENG",3,3,27,23,50
LOUGA,KEBEMER,SAGATTA,"KANENE NDIOB","THIAYTOU PEULH",11,12,63,48,111
LOUGA,KEBEMER,SAGATTA,"KANENE NDIOB","THIEYENE SEYE",2,2,14,11,25
LOUGA,KEBEMER,SAGATTA,"KANENE NDIOB","TOUNDOU NDIOB",8,8,45,49,94
LOUGA,KEBEMER,SAGATTA,LORO,"BAITY NGOL",3,5,30,32,62
LOUGA,KEBEMER,SAGATTA,LORO,"BEITY KHAKHAM",21,23,114,118,232
LOUGA,KEBEMER,SAGATTA,LORO,"BEITY MBEUSSINE",17,20,101,118,219
LOUGA,KEBEMER,SAGATTA,LORO,"BOUNAKH GAYE (GAYENE GOUMACK)",19,20,98,70,168
LOUGA,KEBEMER,SAGATTA,LORO,"DAROU DIAW",13,14,54,71,125
LOUGA,KEBEMER,SAGATTA,LORO,"DAROU KHOUDOSS",18,20,140,119,259
LOUGA,KEBEMER,SAGATTA,LORO,"DIORO MAMA NDIAYE",46,59,343,269,612
LOUGA,KEBEMER,SAGATTA,LORO,KABDOU,51,55,284,278,562
LOUGA,KEBEMER,SAGATTA,LORO,"KEUR AMADOU YELLA",113,129,616,555,1171
LOUGA,KEBEMER,SAGATTA,LORO,"KEUR GORA DIOP",5,5,34,28,62
LOUGA,KEBEMER,SAGATTA,LORO,"KEUR SANOU DIENG",15,22,103,101,204
LOUGA,KEBEMER,SAGATTA,LORO,"H1 GOUYE PEULH DE MERINA KA TIDIANE",21,22,126,105,231
LOUGA,KEBEMER,SAGATTA,LORO,"LORO NDOKHOTAKH",5,6,26,27,53
LOUGA,KEBEMER,SAGATTA,LORO,"LORO THIECKENE",99,108,382,501,883
LOUGA,KEBEMER,SAGATTA,LORO,"MBAMBA NGUIRANE",20,21,105,94,199
LOUGA,KEBEMER,SAGATTA,LORO,"MBAR SECK",28,28,209,169,378
LOUGA,KEBEMER,SAGATTA,LORO,"MBARY SOW",17,21,81,83,164
LOUGA,KEBEMER,SAGATTA,LORO,"H1 PEULGA",8,9,56,36,92
LOUGA,KEBEMER,SAGATTA,LORO,"MBAYENE OUNTE",11,11,63,57,120
LOUGA,KEBEMER,SAGATTA,LORO,"MBAYENE SAMB",3,4,27,20,47
LOUGA,KEBEMER,SAGATTA,LORO,"MERINA KA TIDIANE",103,117,608,607,1215
LOUGA,KEBEMER,SAGATTA,LORO,"MERINA NDIAYE (NDIAYENE SELLE)",10,11,56,38,94
LOUGA,KEBEMER,SAGATTA,LORO,"NDAME THIALLA",11,13,83,78,161
LOUGA,KEBEMER,SAGATTA,LORO,"NDIAYENE MBAR",15,16,95,83,178
LOUGA,KEBEMER,SAGATTA,LORO,"NDIOBENE LORO",18,22,100,106,206
LOUGA,KEBEMER,SAGATTA,LORO,"NGAYE SAYORO (COM. TOUBA MERINA)",9,9,95,53,148
LOUGA,KEBEMER,SAGATTA,LORO,"NGOL GOUREYE",5,5,63,54,117
LOUGA,KEBEMER,SAGATTA,LORO,"NGOL PEULH",34,35,239,214,453
LOUGA,KEBEMER,SAGATTA,LORO,"NGUEYENE (LORO NGUEYENE)",35,37,213,295,508
LOUGA,KEBEMER,SAGATTA,LORO,"NGUIRO DIOP",12,16,92,94,186
LOUGA,KEBEMER,SAGATTA,LORO,"THILMAKHA NGOL",22,23,151,113,264
LOUGA,KEBEMER,SAGATTA,LORO,"THIONE KHOUMA",4,4,16,15,31
LOUGA,KEBEMER,SAGATTA,LORO,"THIOTY GUEYE",12,12,77,63,140
LOUGA,KEBEMER,SAGATTA,LORO,"YOTAL BABOU",3,3,15,16,31
LOUGA,KEBEMER,SAGATTA,LORO,"KEUR NDIAYE PEULH",7,8,59,57,116
LOUGA,KEBEMER,SAGATTA,LORO,"PALENE PATAR",1,1,11,6,17
LOUGA,KEBEMER,SAGATTA,"SAGATTA GUETH","BATTAL ATHIE",18,18,137,136,273
LOUGA,KEBEMER,SAGATTA,"SAGATTA GUETH","H1 PEULGA de BATTAL ATHIE",3,3,15,11,26
LOUGA,KEBEMER,SAGATTA,"SAGATTA GUETH","BEITY DAKHAR",5,5,39,23,62
LOUGA,KEBEMER,SAGATTA,"SAGATTA GUETH","BEITY DIOUM",9,9,64,50,114
LOUGA,KEBEMER,SAGATTA,"SAGATTA GUETH","DARA DIAKHATE",16,23,120,137,257
LOUGA,KEBEMER,SAGATTA,"SAGATTA GUETH","H1 SINTHIANE DARA PEULH",5,11,42,49,91
LOUGA,KEBEMER,SAGATTA,"SAGATTA GUETH","DARA PEULH",5,5,32,30,62
LOUGA,KEBEMER,SAGATTA,"SAGATTA GUETH","DARA SAER",8,8,38,39,77
LOUGA,KEBEMER,SAGATTA,"SAGATTA GUETH","DAROU ALIMOUL KHABIR",15,17,88,84,172
LOUGA,KEBEMER,SAGATTA,"SAGATTA GUETH","DAROU AMAR",7,7,50,45,95
LOUGA,KEBEMER,SAGATTA,"SAGATTA GUETH","DAROU MBAYE",3,3,31,20,51
LOUGA,KEBEMER,SAGATTA,"SAGATTA GUETH","KHELERE(DAROU NAHIME KHELRE TALL)",8,11,53,41,94
LOUGA,KEBEMER,SAGATTA,"SAGATTA GUETH","DEKHEULE OUOLOF",54,57,258,233,491
LOUGA,KEBEMER,SAGATTA,"SAGATTA GUETH","DEKHEULE PEULH DIOKH",51,63,477,364,841
LOUGA,KEBEMER,SAGATTA,"SAGATTA GUETH","DIOCKOUL BA (DIOKOUL II)",8,9,61,56,117
LOUGA,KEBEMER,SAGATTA,"SAGATTA GUETH","GADE PANGHAR",6,12,71,56,127
LOUGA,KEBEMER,SAGATTA,"SAGATTA GUETH","GUIRO KEBE",1,1,2,3,5
LOUGA,KEBEMER,SAGATTA,"SAGATTA GUETH","KALSANE DIOP",18,19,122,104,226
LOUGA,KEBEMER,SAGATTA,"SAGATTA GUETH","KANTAR DIAGNE",71,75,433,399,832
LOUGA,KEBEMER,SAGATTA,"SAGATTA GUETH","H1 KANTAR PEULH",14,15,80,96,176
LOUGA,KEBEMER,SAGATTA,"SAGATTA GUETH","KASSE NDIM",1,1,8,3,11
LOUGA,KEBEMER,SAGATTA,"SAGATTA GUETH","KEUR DIAOULY",27,30,154,160,314
LOUGA,KEBEMER,SAGATTA,"SAGATTA GUETH","KHANTIAKH DIAKHATE",8,8,32,24,56
LOUGA,KEBEMER,SAGATTA,"SAGATTA GUETH","KHANTIAKH MADEMBA",14,24,100,93,193
LOUGA,KEBEMER,SAGATTA,"SAGATTA GUETH","H1 PEULGA de KHANTIAKH MADEMBA",5,8,41,15,56
LOUGA,KEBEMER,SAGATTA,"SAGATTA GUETH","KHANTIAKH SIDY (AMAR)",16,27,139,113,252
LOUGA,KEBEMER,SAGATTA,"SAGATTA GUETH",KHARAGNE,4,10,40,49,89
LOUGA,KEBEMER,SAGATTA,"SAGATTA GUETH","KHELCOM KASSE",10,14,92,76,168
LOUGA,KEBEMER,SAGATTA,"SAGATTA GUETH","KHELCOM PEULH",45,48,270,240,510
LOUGA,KEBEMER,SAGATTA,"SAGATTA GUETH","MAKA SAMBA BABOU",6,7,39,33,72
LOUGA,KEBEMER,SAGATTA,"SAGATTA GUETH","MAYAYE 1",18,19,115,82,197
LOUGA,KEBEMER,SAGATTA,"SAGATTA GUETH","MAYAYE 2",19,24,161,120,281
LOUGA,KEBEMER,SAGATTA,"SAGATTA GUETH","MBABOU WOLOF (GUEYE)",6,7,61,30,91
LOUGA,KEBEMER,SAGATTA,"SAGATTA GUETH","MBABOU PEULH",8,9,51,44,95
LOUGA,KEBEMER,SAGATTA,"SAGATTA GUETH","MBAKHISSE PEULH",5,5,19,15,34
LOUGA,KEBEMER,SAGATTA,"SAGATTA GUETH","MBARO BABOU",3,4,21,10,31
LOUGA,KEBEMER,SAGATTA,"SAGATTA GUETH","MBARO PEULH",6,11,81,70,151
LOUGA,KEBEMER,SAGATTA,"SAGATTA GUETH","MBODIENE WOLOF (BODJI)",15,20,115,119,234
LOUGA,KEBEMER,SAGATTA,"SAGATTA GUETH","MBODIENE PEULH",2,5,19,19,38
LOUGA,KEBEMER,SAGATTA,"SAGATTA GUETH","MERINA MASSATA",8,14,69,76,145
LOUGA,KEBEMER,SAGATTA,"SAGATTA GUETH","MERINA YOUKHOUM",3,3,10,12,22
LOUGA,KEBEMER,SAGATTA,"SAGATTA GUETH","MESSERE BABOU",12,13,82,79,161
LOUGA,KEBEMER,SAGATTA,"SAGATTA GUETH","NAMENE AMAR",38,64,285,300,585
LOUGA,KEBEMER,SAGATTA,"SAGATTA GUETH","NDAME CIRE LO",6,6,12,24,36
LOUGA,KEBEMER,SAGATTA,"SAGATTA GUETH","NDANK BABOU",29,37,232,165,397
LOUGA,KEBEMER,SAGATTA,"SAGATTA GUETH","NDER BABOU",15,16,66,75,141
LOUGA,KEBEMER,SAGATTA,"SAGATTA GUETH","NDIAGNE SAGUEYE",31,35,240,203,443
LOUGA,KEBEMER,SAGATTA,"SAGATTA GUETH","NDIALIGUE (NDIALIGUE DIAGNE)",5,7,35,38,73
LOUGA,KEBEMER,SAGATTA,"SAGATTA GUETH","NDIAW ( NDIAO)",23,27,139,134,273
LOUGA,KEBEMER,SAGATTA,"SAGATTA GUETH","NDIAYE ALLE PATHE",1,1,1,0,1
LOUGA,KEBEMER,SAGATTA,"SAGATTA GUETH","NDIAYENE TOUNDE",8,11,79,57,136
LOUGA,KEBEMER,SAGATTA,"SAGATTA GUETH","NDIOBENE DIMBE",24,24,146,143,289
LOUGA,KEBEMER,SAGATTA,"SAGATTA GUETH",NDIOLFA,8,14,73,60,133
LOUGA,KEBEMER,SAGATTA,"SAGATTA GUETH","NDOMBY NDIAYE",4,4,12,8,20
LOUGA,KEBEMER,SAGATTA,"SAGATTA GUETH","NGUISS DIAM (WOLOF)",7,8,43,44,87
LOUGA,KEBEMER,SAGATTA,"SAGATTA GUETH","H1 NGUISS DIAM PEULH",14,14,59,78,137
LOUGA,KEBEMER,SAGATTA,"SAGATTA GUETH","NGUISS DIAM PEULH",2,2,14,15,29
LOUGA,KEBEMER,SAGATTA,"SAGATTA GUETH","NIOKHOUL DIOP OUOLOF",3,6,51,51,102
LOUGA,KEBEMER,SAGATTA,"SAGATTA GUETH","NIOKHOUL PEULH",2,2,6,7,13
LOUGA,KEBEMER,SAGATTA,"SAGATTA GUETH","NJIB NIASSE",42,47,279,301,580
LOUGA,KEBEMER,SAGATTA,"SAGATTA GUETH","OUARACK GUETH",10,10,58,58,116
LOUGA,KEBEMER,SAGATTA,"SAGATTA GUETH","PAKHA DIAW",6,6,21,19,40
LOUGA,KEBEMER,SAGATTA,"SAGATTA GUETH","SAGATTA GUETH",280,341,1794,1787,3581
LOUGA,KEBEMER,SAGATTA,"SAGATTA GUETH","SAME NDIAYE",5,14,82,67,149
LOUGA,KEBEMER,SAGATTA,"SAGATTA GUETH","SAM PEULH",10,10,41,37,78
LOUGA,KEBEMER,SAGATTA,"SAGATTA GUETH","TAWA (TAWA FALL)",29,34,116,135,251
LOUGA,KEBEMER,SAGATTA,"SAGATTA GUETH","THIEGNE SAGATTA",13,14,96,68,164
LOUGA,KEBEMER,SAGATTA,"SAGATTA GUETH","THISSE PEULH",11,11,44,55,99
LOUGA,KEBEMER,SAGATTA,"SAGATTA GUETH","THISSE SALL",16,18,67,67,134
LOUGA,KEBEMER,SAGATTA,"SAGATTA GUETH","WAKHAL DIAM WOLOF (DIOP)",2,3,9,7,16
LOUGA,KEBEMER,SAGATTA,"SAGATTA GUETH","WAKHAL DIAM PEULH",6,12,51,53,104
LOUGA,KEBEMER,SAGATTA,"SAGATTA GUETH","YEROU BABOU",20,22,114,161,275
LOUGA,KEBEMER,SAGATTA,"SAGATTA GUETH","DAROU KHAREGNE",1,1,5,3,8
LOUGA,KEBEMER,SAGATTA,"SAGATTA GUETH","KEUR NASSER DINE",1,1,18,0,18
LOUGA,KEBEMER,SAGATTA,"SAGATTA GUETH","MBAKHISS WOLOF",2,2,13,17,30
LOUGA,KEBEMER,SAGATTA,"SAGATTA GUETH","THIORY (THIORY NDIAYE)",60,69,368,296,664
LOUGA,KEBEMER,SAGATTA,"SAGATTA GUETH","TOUBA CAYOR",120,134,733,789,1522
LOUGA,KEBEMER,SAGATTA,"THIOLOM FALL","BELLOKHO HANN",203,252,1349,1579,2928
LOUGA,KEBEMER,SAGATTA,"THIOLOM FALL","BINDIW NDIAYE",7,7,50,38,88
LOUGA,KEBEMER,SAGATTA,"THIOLOM FALL","H1 BINDIW PEULH",12,14,84,71,155
LOUGA,KEBEMER,SAGATTA,"THIOLOM FALL","DAROU SALAM FALL",7,11,56,34,90
LOUGA,KEBEMER,SAGATTA,"THIOLOM FALL","DIAWAR LOUM",75,82,514,515,1029
LOUGA,KEBEMER,SAGATTA,"THIOLOM FALL","DJINOB GUEYE",5,6,58,54,112
LOUGA,KEBEMER,SAGATTA,"THIOLOM FALL","GADE AFFE",52,64,352,348,700
LOUGA,KEBEMER,SAGATTA,"THIOLOM FALL",GUIRANENE,12,15,107,102,209
LOUGA,KEBEMER,SAGATTA,"THIOLOM FALL","KATMANE AMAR GADE",17,21,89,80,169
LOUGA,KEBEMER,SAGATTA,"THIOLOM FALL","KATMANE PEULH",3,4,22,18,40
LOUGA,KEBEMER,SAGATTA,"THIOLOM FALL","KEUR BINTA MASSAMBA",7,7,35,26,61
LOUGA,KEBEMER,SAGATTA,"THIOLOM FALL","KEUR DAO",2,5,22,34,56
LOUGA,KEBEMER,SAGATTA,"THIOLOM FALL","KEUR MBAKARY MBOUP",13,16,87,95,182
LOUGA,KEBEMER,SAGATTA,"THIOLOM FALL","H1 GUEYENE",16,16,80,75,155
LOUGA,KEBEMER,SAGATTA,"THIOLOM FALL","KEUR MEDOUNE NDIAYE",26,33,189,215,404
LOUGA,KEBEMER,SAGATTA,"THIOLOM FALL","KEUR MOR LEYE",16,16,121,127,248
LOUGA,KEBEMER,SAGATTA,"THIOLOM FALL","KHALBANE NGANENE",18,21,119,107,226
LOUGA,KEBEMER,SAGATTA,"THIOLOM FALL","KHANDALA MBENGUE",44,60,317,299,616
LOUGA,KEBEMER,SAGATTA,"THIOLOM FALL","KHEUL NDIAYE",10,11,35,50,85
LOUGA,KEBEMER,SAGATTA,"THIOLOM FALL","KILIMANE 1",4,4,21,21,42
LOUGA,KEBEMER,SAGATTA,"THIOLOM FALL","H1 KILIMANE PEULH",13,16,95,77,172
LOUGA,KEBEMER,SAGATTA,"THIOLOM FALL","KILIMANE 2",4,6,28,22,50
LOUGA,KEBEMER,SAGATTA,"THIOLOM FALL","KOBOLE SOUGOU",5,7,31,32,63
LOUGA,KEBEMER,SAGATTA,"THIOLOM FALL","KOURE MBELGOR",24,28,170,178,348
LOUGA,KEBEMER,SAGATTA,"THIOLOM FALL","MAKA DIAGNE",19,22,160,132,292
LOUGA,KEBEMER,SAGATTA,"THIOLOM FALL","MASSAR DIOP",85,101,483,459,942
LOUGA,KEBEMER,SAGATTA,"THIOLOM FALL","MASSAR SANTHIE",22,26,105,102,207
LOUGA,KEBEMER,SAGATTA,"THIOLOM FALL","MATALE BANTE",4,4,20,28,48
LOUGA,KEBEMER,SAGATTA,"THIOLOM FALL","H1 MATALE BANTE 2",11,11,65,59,124
LOUGA,KEBEMER,SAGATTA,"THIOLOM FALL","H2 BAYE NDIAYE",5,6,31,25,56
LOUGA,KEBEMER,SAGATTA,"THIOLOM FALL","MBELGOR MBOUP",7,7,48,44,92
LOUGA,KEBEMER,SAGATTA,"THIOLOM FALL","MBENGUENE DIAWAR",159,186,742,872,1614
LOUGA,KEBEMER,SAGATTA,"THIOLOM FALL","MBENGUENE MBELGOR",19,21,120,119,239
LOUGA,KEBEMER,SAGATTA,"THIOLOM FALL","MBOLTOGNE LOUM",11,11,63,71,134
LOUGA,KEBEMER,SAGATTA,"THIOLOM FALL","MBOLTOGNE SOUGOU",9,10,64,63,127
LOUGA,KEBEMER,SAGATTA,"THIOLOM FALL","MOUSLADJI AMAR",14,14,50,43,93
LOUGA,KEBEMER,SAGATTA,"THIOLOM FALL","MOUSLADJI PEULH",15,15,68,73,141
LOUGA,KEBEMER,SAGATTA,"THIOLOM FALL","MOUYE DIAKHOUMPA",6,8,38,38,76
LOUGA,KEBEMER,SAGATTA,"THIOLOM FALL","MOUYE PEULH",2,4,18,14,32
LOUGA,KEBEMER,SAGATTA,"THIOLOM FALL","NDAKHAR BIRIMA",5,6,37,43,80
LOUGA,KEBEMER,SAGATTA,"THIOLOM FALL","NDAME BALLA LO",16,18,80,77,157
LOUGA,KEBEMER,SAGATTA,"THIOLOM FALL","NDAME GOUREYE",19,23,93,101,194
LOUGA,KEBEMER,SAGATTA,"THIOLOM FALL","H1 BOUSRA LO",10,12,47,46,93
LOUGA,KEBEMER,SAGATTA,"THIOLOM FALL","H2 DAROU SALAM LO",5,7,39,27,66
LOUGA,KEBEMER,SAGATTA,"THIOLOM FALL","NDAME MOR FADEMBA",25,32,172,184,356
LOUGA,KEBEMER,SAGATTA,"THIOLOM FALL","NDAME NDJINOB",12,12,64,54,118
LOUGA,KEBEMER,SAGATTA,"THIOLOM FALL","NDAME SANOSSY",39,54,356,325,681
LOUGA,KEBEMER,SAGATTA,"THIOLOM FALL","NDATTE DIAMA (NDATTE NDIAYE)",2,2,18,23,41
LOUGA,KEBEMER,SAGATTA,"THIOLOM FALL","NDATTE FALL (NDATTE DIOKOUL)",35,39,246,249,495
LOUGA,KEBEMER,SAGATTA,"THIOLOM FALL","NDATTE PEYE (NDATTE DIAGNE)",13,16,80,75,155
LOUGA,KEBEMER,SAGATTA,"THIOLOM FALL","NDEUGUENE FAYE",4,5,26,23,49
LOUGA,KEBEMER,SAGATTA,"THIOLOM FALL","NDIAKHOUMPA 1",13,13,64,53,117
LOUGA,KEBEMER,SAGATTA,"THIOLOM FALL","NDIAKHOUMPA 2",5,7,31,22,53
LOUGA,KEBEMER,SAGATTA,"THIOLOM FALL","NDIAKHOUMPA PEULH",12,12,68,44,112
LOUGA,KEBEMER,SAGATTA,"THIOLOM FALL","NDIALOR GUEYE",26,27,202,166,368
LOUGA,KEBEMER,SAGATTA,"THIOLOM FALL","NDIARE NDAKHAR",44,55,231,291,522
LOUGA,KEBEMER,SAGATTA,"THIOLOM FALL","H1 PEULGA",6,10,42,40,82
LOUGA,KEBEMER,SAGATTA,"THIOLOM FALL","NDIARGA BANGOYE",23,27,181,153,334
LOUGA,KEBEMER,SAGATTA,"THIOLOM FALL","H1 DAROU BANGOYE",13,14,78,63,141
LOUGA,KEBEMER,SAGATTA,"THIOLOM FALL","NDIATAR FALL",17,23,161,133,294
LOUGA,KEBEMER,SAGATTA,"THIOLOM FALL","H1 KEUR MAR GUILLE",3,3,18,14,32
LOUGA,KEBEMER,SAGATTA,"THIOLOM FALL","H2 WARACK NDIATAR",3,3,17,13,30
LOUGA,KEBEMER,SAGATTA,"THIOLOM FALL","NDIATAR PEULH",6,8,40,44,84
LOUGA,KEBEMER,SAGATTA,"THIOLOM FALL","NDIENGUE DIAW",35,45,281,265,546
LOUGA,KEBEMER,SAGATTA,"THIOLOM FALL","H1 NDIENGUE PEULH",23,28,142,132,274
LOUGA,KEBEMER,SAGATTA,"THIOLOM FALL","NDIOBENE MAYAMAR",27,38,330,211,541
LOUGA,KEBEMER,SAGATTA,"THIOLOM FALL","NDIOLOUYE MARONE",16,22,120,106,226
LOUGA,KEBEMER,SAGATTA,"THIOLOM FALL","NGANDECK AMAR",34,41,248,219,467
LOUGA,KEBEMER,SAGATTA,"THIOLOM FALL","NGAYE MBELGOR",4,4,22,12,34
LOUGA,KEBEMER,SAGATTA,"THIOLOM FALL","NGAYE NGAYE",23,25,201,158,359
LOUGA,KEBEMER,SAGATTA,"THIOLOM FALL","NGOR NGOR BAITY",1,1,8,5,13
LOUGA,KEBEMER,SAGATTA,"THIOLOM FALL",NGOUMBALA,44,47,223,181,404
LOUGA,KEBEMER,SAGATTA,"THIOLOM FALL","PALENE MASSAR",12,13,96,85,181
LOUGA,KEBEMER,SAGATTA,"THIOLOM FALL","TAIBA NDIAYE",9,11,70,60,130
LOUGA,KEBEMER,SAGATTA,"THIOLOM FALL","THIENO DIAO",32,44,249,227,476
LOUGA,KEBEMER,SAGATTA,"THIOLOM FALL","THIENO NDIAYE",15,18,130,82,212
LOUGA,KEBEMER,SAGATTA,"THIOLOM FALL","THIENO PEULH",20,22,135,115,250
LOUGA,KEBEMER,SAGATTA,"THIOLOM FALL","THIEULBATY NGOUMBALA",22,25,120,80,200
LOUGA,KEBEMER,SAGATTA,"THIOLOM FALL","THINE 1",4,5,43,54,97
LOUGA,KEBEMER,SAGATTA,"THIOLOM FALL","THINE 2",1,1,4,5,9
LOUGA,KEBEMER,SAGATTA,"THIOLOM FALL","THIOLOM FALL",123,174,790,919,1709
LOUGA,KEBEMER,SAGATTA,"THIOLOM FALL","H1 THIOLOM BA",12,21,87,102,189
LOUGA,KEBEMER,SAGATTA,"THIOLOM FALL","THIOLOM PEULH",25,27,109,119,228
LOUGA,KEBEMER,SAGATTA,"THIOLOM FALL","TOUBE FALL",41,43,310,215,525
LOUGA,KEBEMER,SAGATTA,"THIOLOM FALL","WADANE SOUGOU",37,48,251,211,462
LOUGA,KEBEMER,SAGATTA,"THIOLOM FALL","WARACK NDIATAR",6,12,34,38,72
LOUGA,KEBEMER,SAGATTA,"THIOLOM FALL","H1 WARACK PEULH",13,19,55,82,137
LOUGA,KEBEMER,SAGATTA,"THIOLOM FALL","H2 TOUBA GOUYOTTE",7,11,59,72,131
LOUGA,KEBEMER,SAGATTA,"THIOLOM FALL","WARGA LO",6,6,36,35,71
LOUGA,KEBEMER,SAGATTA,"NGOURANE OUOLOF","BAKHIA DIA",27,30,228,170,398
LOUGA,KEBEMER,SAGATTA,"NGOURANE OUOLOF","BAKHIA NDIAYE",16,20,99,67,166
LOUGA,KEBEMER,SAGATTA,"NGOURANE OUOLOF","DIOKOUL MALICOUMBA (DIOKOUL FALL)",20,24,147,124,271
LOUGA,KEBEMER,SAGATTA,"NGOURANE OUOLOF","DJINIAKH FALL",68,79,407,407,814
LOUGA,KEBEMER,SAGATTA,"NGOURANE OUOLOF","GATY NIANG",20,23,171,142,313
LOUGA,KEBEMER,SAGATTA,"NGOURANE OUOLOF","KEUR GOUMBA DIOP",22,28,145,132,277
LOUGA,KEBEMER,SAGATTA,"NGOURANE OUOLOF","KEUR MABINI NDIAYE",13,22,111,94,205
LOUGA,KEBEMER,SAGATTA,"NGOURANE OUOLOF","KEUR MANDIAYE PENDA",7,8,39,22,61
LOUGA,KEBEMER,SAGATTA,"NGOURANE OUOLOF","KEUR NDIARNO",13,18,79,91,170
LOUGA,KEBEMER,SAGATTA,"NGOURANE OUOLOF","KEUR THIAMBA SEYE",6,8,46,44,90
LOUGA,KEBEMER,SAGATTA,"NGOURANE OUOLOF","KHADJI GUEYE",38,58,281,227,508
LOUGA,KEBEMER,SAGATTA,"NGOURANE OUOLOF","KHADJI SOUGOU",17,27,129,141,270
LOUGA,KEBEMER,SAGATTA,"NGOURANE OUOLOF","KIRE DIOM",35,41,209,253,462
LOUGA,KEBEMER,SAGATTA,"NGOURANE OUOLOF","LOYENE PEULH",5,5,38,33,71
LOUGA,KEBEMER,SAGATTA,"NGOURANE OUOLOF","LOYENE SYLLA",46,59,308,276,584
LOUGA,KEBEMER,SAGATTA,"NGOURANE OUOLOF","MASSAR SEYE",11,13,79,50,129
LOUGA,KEBEMER,SAGATTA,"NGOURANE OUOLOF",MBAKAR,16,19,113,148,261
LOUGA,KEBEMER,SAGATTA,"NGOURANE OUOLOF","MBAROM DIOP",53,70,416,369,785
LOUGA,KEBEMER,SAGATTA,"NGOURANE OUOLOF","MBISSIS DIA OUOLOF",26,30,144,165,309
LOUGA,KEBEMER,SAGATTA,"NGOURANE OUOLOF","MBISSIS PEULH",3,9,48,30,78
LOUGA,KEBEMER,SAGATTA,"NGOURANE OUOLOF","MERINA TALL (KEUR MAKHARY TALL)",70,76,275,400,675
LOUGA,KEBEMER,SAGATTA,"NGOURANE OUOLOF","NDANGOUR NDIAYE (DIAM NDIAYE)",14,19,115,124,239
LOUGA,KEBEMER,SAGATTA,"NGOURANE OUOLOF",NDANGOURA,10,10,80,56,136
LOUGA,KEBEMER,SAGATTA,"NGOURANE OUOLOF","NDIAO NDIAO",13,16,77,50,127
LOUGA,KEBEMER,SAGATTA,"NGOURANE OUOLOF","NDIARNO NIANG",5,11,49,53,102
LOUGA,KEBEMER,SAGATTA,"NGOURANE OUOLOF","NDIARNO PEULH",7,8,55,43,98
LOUGA,KEBEMER,SAGATTA,"NGOURANE OUOLOF","NDIAYENE MBANGOYE",32,35,237,232,469
LOUGA,KEBEMER,SAGATTA,"NGOURANE OUOLOF","NDIENG NGOURANE",15,17,79,88,167
LOUGA,KEBEMER,SAGATTA,"NGOURANE OUOLOF","NGAYE DIAWAR",58,75,327,411,738
LOUGA,KEBEMER,SAGATTA,"NGOURANE OUOLOF","NGUEYENE GUEYE",8,12,109,97,206
LOUGA,KEBEMER,SAGATTA,"NGOURANE OUOLOF","NGOURANE OUOLOF",123,160,704,714,1418
LOUGA,KEBEMER,SAGATTA,"NGOURANE OUOLOF","NGOURANE PEUHLH",12,13,64,67,131
LOUGA,KEBEMER,SAGATTA,"NGOURANE OUOLOF","PAKY KEBE",15,16,90,118,208
LOUGA,KEBEMER,SAGATTA,"NGOURANE OUOLOF","PALENE NDIARNO",12,13,91,79,170
LOUGA,KEBEMER,SAGATTA,"NGOURANE OUOLOF","PALLENE MBABOUCK",21,27,155,177,332
LOUGA,KEBEMER,SAGATTA,"NGOURANE OUOLOF","SANTHIOU SADIAKHER",2,2,21,14,35
LOUGA,KEBEMER,SAGATTA,"NGOURANE OUOLOF","SINOU PEKH",22,24,119,112,231
LOUGA,KEBEMER,SAGATTA,"NGOURANE OUOLOF","SINTHIOU DIARAF 1",7,8,56,47,103
LOUGA,KEBEMER,SAGATTA,"NGOURANE OUOLOF","SINTHIOU DIARAF PEULH",3,4,26,21,47
LOUGA,KEBEMER,SAGATTA,"NGOURANE OUOLOF","THIECKENE SECK",31,37,231,219,450
LOUGA,KEBEMER,SAGATTA,"NGOURANE OUOLOF","WEURSEUK DIAKHATE",3,7,22,26,48
LOUGA,KEBEMER,SAGATTA,"NGOURANE OUOLOF","SINTHIOU DIARAF 2",1,1,9,5,14
LOUGA,LINGUERE,LINGUERE,LINGUERE,ABATTOIRS,271,300,1448,1390,2838
LOUGA,LINGUERE,LINGUERE,LINGUERE,"LINGUERE COUMBA 1",218,262,1026,1109,2135
LOUGA,LINGUERE,LINGUERE,LINGUERE,"LINGUERE NDIAMBOUR",293,328,1450,1290,2740
LOUGA,LINGUERE,LINGUERE,LINGUERE,NDIAYENE,245,266,1185,1161,2346
LOUGA,LINGUERE,LINGUERE,LINGUERE,"THIELY NORD",331,382,2040,1581,3621
LOUGA,LINGUERE,LINGUERE,LINGUERE,ESCALE,113,119,474,528,1002
LOUGA,LINGUERE,LINGUERE,LINGUERE,"LINGUERE COUMBA 2",263,290,1327,1294,2621
LOUGA,LINGUERE,LINGUERE,LINGUERE,"THIELY SUD",180,209,891,997,1888
LOUGA,LINGUERE,DAHRA,DAHRA,"DAHRA  MBAYENE",810,913,4433,4010,8443
LOUGA,LINGUERE,DAHRA,DAHRA,LOUMBEUL,447,490,2566,2809,5375
LOUGA,LINGUERE,DAHRA,DAHRA,"MEDINA NDIAYE",308,372,1547,1725,3272
LOUGA,LINGUERE,DAHRA,DAHRA,"NGOM DAHRA",253,307,1544,1363,2907
LOUGA,LINGUERE,DAHRA,DAHRA,"THIENGUE DAKHAR",200,219,1137,1182,2319
LOUGA,LINGUERE,DAHRA,DAHRA,"ANGLE ISLAM",927,996,4206,3953,8159
LOUGA,LINGUERE,DAHRA,DAHRA,MONTAGNE,479,518,2196,2123,4319
LOUGA,LINGUERE,DAHRA,DAHRA,NDIOBENE,413,468,2432,2114,4546
LOUGA,LINGUERE,DAHRA,DAHRA,NGUETTE,292,328,1624,1683,3307
LOUGA,LINGUERE,DAHRA,DAHRA,NGUEUNEUNENE,248,268,1653,1230,2883
LOUGA,LINGUERE,BARKEDJI,BARKEDJI,"BARKEDJI OUOLOF",91,109,460,562,1022
LOUGA,LINGUERE,BARKEDJI,BARKEDJI,"WOURO MODY",6,7,22,21,43
LOUGA,LINGUERE,BARKEDJI,BARKEDJI,"BELEL THIABOULY",10,13,45,49,94
LOUGA,LINGUERE,BARKEDJI,BARKEDJI,"H1 BELEL BARKEDJI",10,10,44,37,81
LOUGA,LINGUERE,BARKEDJI,BARKEDJI,"BELY BODO",5,6,20,21,41
LOUGA,LINGUERE,BARKEDJI,BARKEDJI,"H1 BOULLY KAGNAR",16,22,92,71,163
LOUGA,LINGUERE,BARKEDJI,BARKEDJI,"BOKI BOFFI 2",23,27,123,102,225
LOUGA,LINGUERE,BARKEDJI,BARKEDJI,BOUBACK,27,41,177,166,343
LOUGA,LINGUERE,BARKEDJI,BARKEDJI,"DAROU NAHIM",12,31,155,173,328
LOUGA,LINGUERE,BARKEDJI,BARKEDJI,"H1 BELEL LALAGAL",6,12,60,59,119
LOUGA,LINGUERE,BARKEDJI,BARKEDJI,"DEBODIOLA 2",5,5,24,25,49
LOUGA,LINGUERE,BARKEDJI,BARKEDJI,"DEYBA AMADOU",16,18,66,115,181
LOUGA,LINGUERE,BARKEDJI,BARKEDJI,DIABAL,7,8,50,41,91
LOUGA,LINGUERE,BARKEDJI,BARKEDJI,"DIAGALY NDIAO",29,47,164,171,335
LOUGA,LINGUERE,BARKEDJI,BARKEDJI,"H1 LOUMBI DOULO",22,44,146,98,244
LOUGA,LINGUERE,BARKEDJI,BARKEDJI,"DIALLA 1",6,11,50,46,96
LOUGA,LINGUERE,BARKEDJI,BARKEDJI,"DIALY LATHIE",14,14,63,63,126
LOUGA,LINGUERE,BARKEDJI,BARKEDJI,"DJIBANANE ARDO",8,10,30,41,71
LOUGA,LINGUERE,BARKEDJI,BARKEDJI,"BELEL KEEDE 1",20,42,205,179,384
LOUGA,LINGUERE,BARKEDJI,BARKEDJI,"DJIBANANE EL HADJI",31,58,293,119,412
LOUGA,LINGUERE,BARKEDJI,BARKEDJI,"DJIMBANAME AMADY AMATH",14,26,131,53,184
LOUGA,LINGUERE,BARKEDJI,BARKEDJI,"DIOUMANAME THIASKY II",18,26,119,90,209
LOUGA,LINGUERE,BARKEDJI,BARKEDJI,"DIAGALY OUOLOFF",64,77,337,349,686
LOUGA,LINGUERE,BARKEDJI,BARKEDJI,"H1 MBOWENE",22,32,135,129,264
LOUGA,LINGUERE,BARKEDJI,BARKEDJI,"FOUTHITY 1",18,38,121,131,252
LOUGA,LINGUERE,BARKEDJI,BARKEDJI,"H1 BELEL NDAO",11,19,49,75,124
LOUGA,LINGUERE,BARKEDJI,BARKEDJI,DOUBE,12,20,130,138,268
LOUGA,LINGUERE,BARKEDJI,BARKEDJI,"GASSEL OUROURBEH",21,38,144,156,300
LOUGA,LINGUERE,BARKEDJI,BARKEDJI,"GASSEL PEULH",12,26,82,90,172
LOUGA,LINGUERE,BARKEDJI,BARKEDJI,"GASSET I WOLOF",39,58,194,241,435
LOUGA,LINGUERE,BARKEDJI,BARKEDJI,"NDILLA ECOLE",7,9,34,37,71
LOUGA,LINGUERE,BARKEDJI,BARKEDJI,"BARKEDJI MONTAGNE 2",14,16,93,78,171
LOUGA,LINGUERE,BARKEDJI,BARKEDJI,KANGALEDJI,21,31,92,91,183
LOUGA,LINGUERE,BARKEDJI,BARKEDJI,"LOUMBEL LANA",27,63,214,203,417
LOUGA,LINGUERE,BARKEDJI,BARKEDJI,"H1 NGUENTH PATOUGUEL",2,3,14,10,24
LOUGA,LINGUERE,BARKEDJI,BARKEDJI,"LOUMBEL MBADA",10,18,71,81,152
LOUGA,LINGUERE,BARKEDJI,BARKEDJI,"LOUMBEL MBADA II",9,11,46,37,83
LOUGA,LINGUERE,BARKEDJI,BARKEDJI,"LOUMBY DEMBA NGAR",4,5,25,32,57
LOUGA,LINGUERE,BARKEDJI,BARKEDJI,"LOUMBY DOBE I",27,49,211,214,425
LOUGA,LINGUERE,BARKEDJI,BARKEDJI,"LOUMBY KOYLE",18,25,101,105,206
LOUGA,LINGUERE,BARKEDJI,BARKEDJI,"LOUMBY OUROURBE",14,19,96,101,197
LOUGA,LINGUERE,BARKEDJI,BARKEDJI,"MOGRE 2",20,29,159,164,323
LOUGA,LINGUERE,BARKEDJI,BARKEDJI,"MAYELLE GAGNOULENE",15,21,73,82,155
LOUGA,LINGUERE,BARKEDJI,BARKEDJI,"H1 MAYELLE 2",9,17,74,53,127
LOUGA,LINGUERE,BARKEDJI,BARKEDJI,"MBELCADJI 2",14,22,105,82,187
LOUGA,LINGUERE,BARKEDJI,BARKEDJI,"NDILLA ECOLE (NDILLA I)",4,6,24,23,47
LOUGA,LINGUERE,BARKEDJI,BARKEDJI,"NDILLA PEULH 1",16,22,97,92,189
LOUGA,LINGUERE,BARKEDJI,BARKEDJI,"NDILLA PEULH 3",20,41,192,213,405
LOUGA,LINGUERE,BARKEDJI,BARKEDJI,NECCO,6,14,53,52,105
LOUGA,LINGUERE,BARKEDJI,BARKEDJI,"NGAO GAGNOULENE 2",2,3,14,6,20
LOUGA,LINGUERE,BARKEDJI,BARKEDJI,"NGAO KANIAR",6,11,45,36,81
LOUGA,LINGUERE,BARKEDJI,BARKEDJI,"NIAKHA PEULH 2",6,8,38,46,84
LOUGA,LINGUERE,BARKEDJI,BARKEDJI,"NIAKHA PEULH 1",13,33,110,111,221
LOUGA,LINGUERE,BARKEDJI,BARKEDJI,"PATHE BOROU",20,25,87,71,158
LOUGA,LINGUERE,BARKEDJI,BARKEDJI,"SAMALY GAGNOULENE",21,28,97,105,202
LOUGA,LINGUERE,BARKEDJI,BARKEDJI,"H2 MAMAROU",4,9,26,19,45
LOUGA,LINGUERE,BARKEDJI,BARKEDJI,"H3 BELEL FOURE",3,6,20,12,32
LOUGA,LINGUERE,BARKEDJI,BARKEDJI,"SAMALY IDYNABE",23,33,111,134,245
LOUGA,LINGUERE,BARKEDJI,BARKEDJI,"SAMALY LATHIE",24,46,168,173,341
LOUGA,LINGUERE,BARKEDJI,BARKEDJI,"THIANA PAMBINANE",4,8,25,22,47
LOUGA,LINGUERE,BARKEDJI,BARKEDJI,"TORDIOL 1",36,47,186,190,376
LOUGA,LINGUERE,BARKEDJI,BARKEDJI,"TORDIOL 2",5,5,22,24,46
LOUGA,LINGUERE,BARKEDJI,BARKEDJI,"TOUBA KATMA",16,25,123,107,230
LOUGA,LINGUERE,BARKEDJI,BARKEDJI,"TOUBA LINGUERE",67,84,426,375,801
LOUGA,LINGUERE,BARKEDJI,BARKEDJI,"TOUBA NDAR FALL",10,10,41,29,70
LOUGA,LINGUERE,BARKEDJI,BARKEDJI,"H1 DIACKSAO THIANA",14,25,113,90,203
LOUGA,LINGUERE,BARKEDJI,BARKEDJI,"H2 OWANDOU THIEL",8,21,79,67,146
LOUGA,LINGUERE,BARKEDJI,BARKEDJI,"TOUBA SAMALY",44,46,165,145,310
LOUGA,LINGUERE,BARKEDJI,BARKEDJI,"TOUNG PEULH II",6,9,29,31,60
LOUGA,LINGUERE,BARKEDJI,BARKEDJI,"TOUNG HODIO",10,14,54,50,104
LOUGA,LINGUERE,BARKEDJI,BARKEDJI,"TOUNG PEULH",36,56,245,191,436
LOUGA,LINGUERE,BARKEDJI,BARKEDJI,"TOUNG POKOM",6,9,34,39,73
LOUGA,LINGUERE,BARKEDJI,BARKEDJI,YARALOPEH,30,40,134,136,270
LOUGA,LINGUERE,BARKEDJI,BARKEDJI,YOLY,10,14,100,67,167
LOUGA,LINGUERE,BARKEDJI,BARKEDJI,"BARKEDJI KAWRAL",48,62,243,271,514
LOUGA,LINGUERE,BARKEDJI,BARKEDJI,"BARKEDJI MAURE",177,233,1168,917,2085
LOUGA,LINGUERE,BARKEDJI,BARKEDJI,"BARKEDJI MONTAGNE 1",87,106,433,485,918
LOUGA,LINGUERE,BARKEDJI,BARKEDJI,"BARKEDJI PEULH 1",48,61,294,254,548
LOUGA,LINGUERE,BARKEDJI,BARKEDJI,"BARKEDJI PEULH 2",12,15,56,60,116
LOUGA,LINGUERE,BARKEDJI,BARKEDJI,"BARKEDJI PEULH 4",31,33,136,140,276
LOUGA,LINGUERE,BARKEDJI,BARKEDJI,"BELE BISNABE",10,16,59,66,125
LOUGA,LINGUERE,BARKEDJI,BARKEDJI,"BELE YAWARA",2,6,38,30,68
LOUGA,LINGUERE,BARKEDJI,BARKEDJI,"BELEL KEEDE 2",11,18,86,97,183
LOUGA,LINGUERE,BARKEDJI,BARKEDJI,"BELEL KODIOLY THIANA",13,23,69,63,132
LOUGA,LINGUERE,BARKEDJI,BARKEDJI,"BELEL SIROBEH THIANA",13,19,67,61,128
LOUGA,LINGUERE,BARKEDJI,BARKEDJI,"BELY BODA THIANOR",12,20,60,76,136
LOUGA,LINGUERE,BARKEDJI,BARKEDJI,"BELY BODO 1",10,10,39,45,84
LOUGA,LINGUERE,BARKEDJI,BARKEDJI,"BOWDE THIABOULY",5,9,41,44,85
LOUGA,LINGUERE,BARKEDJI,BARKEDJI,"DAROU NEMA 2",6,14,85,81,166
LOUGA,LINGUERE,BARKEDJI,BARKEDJI,"DAROU SALAM TOUNG",4,6,25,28,53
LOUGA,LINGUERE,BARKEDJI,BARKEDJI,"DIAGALY 3",5,7,23,15,38
LOUGA,LINGUERE,BARKEDJI,BARKEDJI,"DIAGALY MAURE",4,7,43,15,58
LOUGA,LINGUERE,BARKEDJI,BARKEDJI,"DIAGALY MBOW",19,20,65,85,150
LOUGA,LINGUERE,BARKEDJI,BARKEDJI,"DIAGALY MBOWENE",4,4,27,29,56
LOUGA,LINGUERE,BARKEDJI,BARKEDJI,"DIAGALY THIANOR",13,16,57,58,115
LOUGA,LINGUERE,BARKEDJI,BARKEDJI,"DIALLA 2",9,12,32,44,76
LOUGA,LINGUERE,BARKEDJI,BARKEDJI,"DIMO YEDA",8,17,74,86,160
LOUGA,LINGUERE,BARKEDJI,BARKEDJI,"DIOUMANANE THIASKY 1",6,9,21,22,43
LOUGA,LINGUERE,BARKEDJI,BARKEDJI,"DJIMBANAME ARDO 2",7,10,36,39,75
LOUGA,LINGUERE,BARKEDJI,BARKEDJI,"FOUTHITY 2",9,16,92,129,221
LOUGA,LINGUERE,BARKEDJI,BARKEDJI,"FOUTHITY WODABE 1",4,11,71,58,129
LOUGA,LINGUERE,BARKEDJI,BARKEDJI,"FOUTHITY WODABE 2",8,22,110,109,219
LOUGA,LINGUERE,BARKEDJI,BARKEDJI,HOJOLDE,2,2,6,6,12
LOUGA,LINGUERE,BARKEDJI,BARKEDJI,"KANIAR OUROUBE",5,6,28,21,49
LOUGA,LINGUERE,BARKEDJI,BARKEDJI,"KHAR YALLA",1,6,29,31,60
LOUGA,LINGUERE,BARKEDJI,BARKEDJI,"LOUMBEL LANA 2",16,28,121,115,236
LOUGA,LINGUERE,BARKEDJI,BARKEDJI,"LOUMBEL LANA 3",5,8,37,33,70
LOUGA,LINGUERE,BARKEDJI,BARKEDJI,"LOUMBOL BOKKI",6,13,35,28,63
LOUGA,LINGUERE,BARKEDJI,BARKEDJI,"LOUMBY DOBE 2",12,16,71,61,132
LOUGA,LINGUERE,BARKEDJI,BARKEDJI,MBELCADJI,7,9,35,37,72
LOUGA,LINGUERE,BARKEDJI,BARKEDJI,"MOGRE 1",10,13,62,69,131
LOUGA,LINGUERE,BARKEDJI,BARKEDJI,"H1 DAROU SALAM MOGURE",4,7,31,23,54
LOUGA,LINGUERE,BARKEDJI,BARKEDJI,"MOGRE DEBO DIOLA 1",5,5,55,33,88
LOUGA,LINGUERE,BARKEDJI,BARKEDJI,"NDILLA PEULH 2",6,15,82,66,148
LOUGA,LINGUERE,BARKEDJI,BARKEDJI,"NDILLA PEULH 4",5,10,47,35,82
LOUGA,LINGUERE,BARKEDJI,BARKEDJI,"NGAO GAGNOULENE 1",6,7,35,37,72
LOUGA,LINGUERE,BARKEDJI,BARKEDJI,"NGASSAMA BARKEDJI",11,14,60,54,114
LOUGA,LINGUERE,BARKEDJI,BARKEDJI,"PATOUKI LOUMBEL LANA",10,19,66,63,129
LOUGA,LINGUERE,BARKEDJI,BARKEDJI,"SAMALY OUROUBE",4,4,20,15,35
LOUGA,LINGUERE,BARKEDJI,BARKEDJI,"SINTHIOU CARRIERE",9,14,45,66,111
LOUGA,LINGUERE,BARKEDJI,BARKEDJI,"H1 MAHIL OUROURBE",4,6,30,29,59
LOUGA,LINGUERE,BARKEDJI,BARKEDJI,"H2 DIABAL",5,7,41,28,69
LOUGA,LINGUERE,BARKEDJI,BARKEDJI,"H3 DIAGALY NDIAO",5,10,63,39,102
LOUGA,LINGUERE,BARKEDJI,BARKEDJI,"SOUYE TOUBE",10,22,124,110,234
LOUGA,LINGUERE,BARKEDJI,BARKEDJI,THIENALE,7,10,34,44,78
LOUGA,LINGUERE,BARKEDJI,BARKEDJI,"TORDIOL 3",13,20,62,70,132
LOUGA,LINGUERE,BARKEDJI,BARKEDJI,"TOUBA BOUCHRA",4,6,35,26,61
LOUGA,LINGUERE,BARKEDJI,BARKEDJI,TOULAL,10,17,55,64,119
LOUGA,LINGUERE,BARKEDJI,BARKEDJI,"WOURO THILY",2,3,10,9,19
LOUGA,LINGUERE,BARKEDJI,GASSANE,ARAKE,7,8,41,36,77
LOUGA,LINGUERE,BARKEDJI,GASSANE,"BELEL DIAOBE SERERE",44,62,455,355,810
LOUGA,LINGUERE,BARKEDJI,GASSANE,"GASSANE DJOLOF",6,10,61,72,133
LOUGA,LINGUERE,BARKEDJI,GASSANE,"TOUBA AYDIEKHNA",8,8,97,73,170
LOUGA,LINGUERE,BARKEDJI,GASSANE,"GASSANE  WADIOUROU(BELEL DIOLE WADIOUROU)",12,24,139,118,257
LOUGA,LINGUERE,BARKEDJI,GASSANE,"BELEL NELBY",1,1,4,3,7
LOUGA,LINGUERE,BARKEDJI,GASSANE,"H1 SOTEDIA",4,10,47,41,88
LOUGA,LINGUERE,BARKEDJI,GASSANE,"MEDINA NGUEYENE",66,90,484,470,954
LOUGA,LINGUERE,BARKEDJI,GASSANE,"BELAL THIAW",10,14,65,74,139
LOUGA,LINGUERE,BARKEDJI,GASSANE,"BELTATY PEULH",13,22,115,98,213
LOUGA,LINGUERE,BARKEDJI,GASSANE,DANTHIALY,19,25,185,164,349
LOUGA,LINGUERE,BARKEDJI,GASSANE,"DAROU MARNANE SIBOLE",25,31,217,192,409
LOUGA,LINGUERE,BARKEDJI,GASSANE,"H1 DAROU MINAME TAIF",25,25,255,24,279
LOUGA,LINGUERE,BARKEDJI,GASSANE,"DAROU SALAM DIOP",52,56,363,349,712
LOUGA,LINGUERE,BARKEDJI,GASSANE,"H1 TOUBA TAWFEKH de DAROU SALAM DIOP",15,18,115,101,216
LOUGA,LINGUERE,BARKEDJI,GASSANE,"H2 TAWFEKH SERERE",11,17,96,93,189
LOUGA,LINGUERE,BARKEDJI,GASSANE,"DIAMAGUENE MBENGUENE",13,16,86,88,174
LOUGA,LINGUERE,BARKEDJI,GASSANE,"FASS AINOUMADY (FASS TOURE)",25,31,192,166,358
LOUGA,LINGUERE,BARKEDJI,GASSANE,"H1 DIAGA",2,9,23,16,39
LOUGA,LINGUERE,BARKEDJI,GASSANE,"FASS LOLI",67,69,378,410,788
LOUGA,LINGUERE,BARKEDJI,GASSANE,"H2 DAMAL SAMBA YERO",32,101,254,226,480
LOUGA,LINGUERE,BARKEDJI,GASSANE,FOGNY,5,5,13,25,38
LOUGA,LINGUERE,BARKEDJI,GASSANE,"H1 YOUGOU SOUNA",22,36,181,160,341
LOUGA,LINGUERE,BARKEDJI,GASSANE,"GASSANE NDAWENE",211,236,1250,1299,2549
LOUGA,LINGUERE,BARKEDJI,GASSANE,"H1 DIACKSAO AIDARA",5,5,33,26,59
LOUGA,LINGUERE,BARKEDJI,GASSANE,"GASSANE NDOL NDOL",7,12,60,63,123
LOUGA,LINGUERE,BARKEDJI,GASSANE,"H1 DIOLONGOL TOUBA BAGDAD",6,12,72,89,161
LOUGA,LINGUERE,BARKEDJI,GASSANE,"GASSANE PEULH",67,73,303,346,649
LOUGA,LINGUERE,BARKEDJI,GASSANE,"GASSANE SERERE",21,41,266,265,531
LOUGA,LINGUERE,BARKEDJI,GASSANE,"GASSANE SEYE",19,27,119,92,211
LOUGA,LINGUERE,BARKEDJI,GASSANE,"GUELODE DIOP",24,32,150,142,292
LOUGA,LINGUERE,BARKEDJI,GASSANE,"H1 THIAWENE GUELODE DIOP",3,3,10,6,16
LOUGA,LINGUERE,BARKEDJI,GASSANE,"H2 GUELODE DIAGNE",26,29,130,124,254
LOUGA,LINGUERE,BARKEDJI,GASSANE,"H3 TOUBA DAROU BAF",27,43,233,228,461
LOUGA,LINGUERE,BARKEDJI,GASSANE,"H5 BELTATY 2",20,33,136,103,239
LOUGA,LINGUERE,BARKEDJI,GASSANE,"H6 TAWFEKH",8,11,75,60,135
LOUGA,LINGUERE,BARKEDJI,GASSANE,GADIALY,40,47,290,278,568
LOUGA,LINGUERE,BARKEDJI,GASSANE,"H1 OUDALAYE",4,4,20,28,48
LOUGA,LINGUERE,BARKEDJI,GASSANE,"MEDINA BOWDE DIOYE",14,27,120,117,237
LOUGA,LINGUERE,BARKEDJI,GASSANE,"NGUELOBA 1",15,18,90,90,180
LOUGA,LINGUERE,BARKEDJI,GASSANE,"NGUELOBA 2",14,21,82,79,161
LOUGA,LINGUERE,BARKEDJI,GASSANE,"TOUBA OLDOU",37,67,408,323,731
LOUGA,LINGUERE,BARKEDJI,GASSANE,"H1 GASSANE DABE",30,39,173,157,330
LOUGA,LINGUERE,BARKEDJI,GASSANE,"H2 TOUBA BAGHDAD",10,11,105,74,179
LOUGA,LINGUERE,BARKEDJI,GASSANE,"H3 GASSANE NIMZAT",12,18,206,77,283
LOUGA,LINGUERE,BARKEDJI,GASSANE,"SANGHE 1",14,17,87,85,172
LOUGA,LINGUERE,BARKEDJI,GASSANE,"H1 TOUBA TAWFEKH de SANGHE 1",6,7,36,24,60
LOUGA,LINGUERE,BARKEDJI,GASSANE,"H2 MEDINA SANGHE",1,5,11,15,26
LOUGA,LINGUERE,BARKEDJI,GASSANE,"SANGHE 2",34,55,238,208,446
LOUGA,LINGUERE,BARKEDJI,GASSANE,"SANGHE NDOUR",22,32,132,145,277
LOUGA,LINGUERE,BARKEDJI,GASSANE,"H1 TODEL",22,31,163,151,314
LOUGA,LINGUERE,BARKEDJI,GASSANE,"SANGUE OUOLOF",13,16,73,71,144
LOUGA,LINGUERE,BARKEDJI,GASSANE,"SANTHIOU SANGUE",10,18,85,82,167
LOUGA,LINGUERE,BARKEDJI,GASSANE,"SIBOLE OUOLOF",1,1,2,7,9
LOUGA,LINGUERE,BARKEDJI,GASSANE,"SIBOLE MBANANE",5,8,70,44,114
LOUGA,LINGUERE,BARKEDJI,GASSANE,"TOUBA GASSANE",57,61,293,342,635
LOUGA,LINGUERE,BARKEDJI,GASSANE,"H1 BELAL SENO",14,18,115,86,201
LOUGA,LINGUERE,BARKEDJI,GASSANE,"H1 KEUR SERIGNE MOUSSA FAYE",3,3,16,17,33
LOUGA,LINGUERE,BARKEDJI,GASSANE,"KHAIRA GASSANE",4,4,28,20,48
LOUGA,LINGUERE,BARKEDJI,GASSANE,"TOUBA SANGHE",5,6,27,25,52
LOUGA,LINGUERE,BARKEDJI,GASSANE,"TOUBA TOURE SIBOLE",28,64,237,201,438
LOUGA,LINGUERE,BARKEDJI,GASSANE,"ARAKE CENTRE",6,8,34,42,76
LOUGA,LINGUERE,BARKEDJI,GASSANE,"ARAKE NDOUR",17,19,112,110,222
LOUGA,LINGUERE,BARKEDJI,GASSANE,"BELTATY 1",15,19,124,130,254
LOUGA,LINGUERE,BARKEDJI,GASSANE,"BELTATY SERERE",20,26,191,177,368
LOUGA,LINGUERE,BARKEDJI,GASSANE,"BIRI SANGUE",7,7,22,21,43
LOUGA,LINGUERE,BARKEDJI,GASSANE,BONTOGUEL,11,18,96,83,179
LOUGA,LINGUERE,BARKEDJI,GASSANE,"DAROU MINAME TAIF",66,68,484,390,874
LOUGA,LINGUERE,BARKEDJI,GASSANE,"DAROU SALAM THIEL",18,33,96,86,182
LOUGA,LINGUERE,BARKEDJI,GASSANE,"DAROU SALAME NIMA",12,17,116,77,193
LOUGA,LINGUERE,BARKEDJI,GASSANE,"DIAM WELLY",15,19,87,78,165
LOUGA,LINGUERE,BARKEDJI,GASSANE,FIDIOBALY,16,25,173,151,324
LOUGA,LINGUERE,BARKEDJI,GASSANE,"FIDIOBALY 2",1,1,1,2,3
LOUGA,LINGUERE,BARKEDJI,GASSANE,"GASSANE NDOFENE",2,2,14,11,25
LOUGA,LINGUERE,BARKEDJI,GASSANE,"GUEMA SERERE",1,3,26,12,38
LOUGA,LINGUERE,BARKEDJI,GASSANE,HORE,3,3,17,22,39
LOUGA,LINGUERE,BARKEDJI,GASSANE,LINGUEDJI,24,29,158,121,279
LOUGA,LINGUERE,BARKEDJI,GASSANE,"LOUMBEL MANGA",5,6,85,25,110
LOUGA,LINGUERE,BARKEDJI,GASSANE,"LOUMBI DOKI",11,12,50,49,99
LOUGA,LINGUERE,BARKEDJI,GASSANE,"LOUMBOUL BOBORY",19,23,95,82,177
LOUGA,LINGUERE,BARKEDJI,GASSANE,"NDINDY 1",14,22,117,103,220
LOUGA,LINGUERE,BARKEDJI,GASSANE,"NGUILO GASSANE",10,11,72,53,125
LOUGA,LINGUERE,BARKEDJI,GASSANE,"OLDOU SERERE",9,10,90,68,158
LOUGA,LINGUERE,BARKEDJI,GASSANE,"SANGUE BAWAMI",3,3,20,15,35
LOUGA,LINGUERE,BARKEDJI,GASSANE,"SANGUE FOGNY BOBORY",8,8,37,32,69
LOUGA,LINGUERE,BARKEDJI,GASSANE,"SANGUE TOULA",17,20,86,93,179
LOUGA,LINGUERE,BARKEDJI,GASSANE,"SANGUE WENDOU MOURTEKI",7,14,81,76,157
LOUGA,LINGUERE,BARKEDJI,GASSANE,"SIBOLE PEULH",14,19,96,96,192
LOUGA,LINGUERE,BARKEDJI,GASSANE,"TAWFEKH SANGHE",5,7,24,21,45
LOUGA,LINGUERE,BARKEDJI,GASSANE,"TOUBA BELEL",4,5,31,29,60
LOUGA,LINGUERE,BARKEDJI,GASSANE,"TOUBA FIDIOBALY",16,23,129,134,263
LOUGA,LINGUERE,BARKEDJI,GASSANE,"TOUBA GASSANE 3",10,10,58,27,85
LOUGA,LINGUERE,BARKEDJI,GASSANE,"TOUBA KANE",16,16,82,68,150
LOUGA,LINGUERE,BARKEDJI,THIARNY,"BALLA PEULH",49,69,259,208,467
LOUGA,LINGUERE,BARKEDJI,THIARNY,"BELEL NELBY",15,26,60,48,108
LOUGA,LINGUERE,BARKEDJI,THIARNY,"DAROU SALAM MAURE",18,24,95,97,192
LOUGA,LINGUERE,BARKEDJI,THIARNY,"GOUYE GUENE",7,20,68,62,130
LOUGA,LINGUERE,BARKEDJI,THIARNY,"GOUYE THIANGAL",9,12,54,45,99
LOUGA,LINGUERE,BARKEDJI,THIARNY,"GUELEWAR GUELY",14,17,88,70,158
LOUGA,LINGUERE,BARKEDJI,THIARNY,"GUELEWAR NAMASSE",7,13,53,49,102
LOUGA,LINGUERE,BARKEDJI,THIARNY,"GUELEWAR PAMPINABE",6,8,37,28,65
LOUGA,LINGUERE,BARKEDJI,THIARNY,GUIRODJI,7,10,44,39,83
LOUGA,LINGUERE,BARKEDJI,THIARNY,"KHOGUE TOBENE",40,64,253,215,468
LOUGA,LINGUERE,BARKEDJI,THIARNY,KODIOLELE,6,13,62,50,112
LOUGA,LINGUERE,BARKEDJI,THIARNY,"LEPPO LATHIE",9,9,46,28,74
LOUGA,LINGUERE,BARKEDJI,THIARNY,"LINDE MOURIDE",18,22,116,108,224
LOUGA,LINGUERE,BARKEDJI,THIARNY,"LINDE TIDIANE I (LINDE TIDIANE PEULH)",6,15,56,41,97
LOUGA,LINGUERE,BARKEDJI,THIARNY,"LOL LOL 1",25,32,140,130,270
LOUGA,LINGUERE,BARKEDJI,THIARNY,"LOL LOL 2",9,10,48,41,89
LOUGA,LINGUERE,BARKEDJI,THIARNY,"H1 KETOU",3,6,29,21,50
LOUGA,LINGUERE,BARKEDJI,THIARNY,"LOUMBOL DOUTAL",7,10,50,42,92
LOUGA,LINGUERE,BARKEDJI,THIARNY,"LOUMBY KEBE",10,18,71,69,140
LOUGA,LINGUERE,BARKEDJI,THIARNY,"LOUMBY TENDOU I",7,7,15,26,41
LOUGA,LINGUERE,BARKEDJI,THIARNY,"LOUMBY TENDOU II",28,42,193,184,377
LOUGA,LINGUERE,BARKEDJI,THIARNY,MARO,18,20,116,114,230
LOUGA,LINGUERE,BARKEDJI,THIARNY,"MARO MARO",1,3,15,11,26
LOUGA,LINGUERE,BARKEDJI,THIARNY,"MBANANE OUROUR",24,29,136,104,240
LOUGA,LINGUERE,BARKEDJI,THIARNY,NAIDE,12,16,58,67,125
LOUGA,LINGUERE,BARKEDJI,THIARNY,"NIERY THIOUNGANE",18,38,133,122,255
LOUGA,LINGUERE,BARKEDJI,THIARNY,"ONDOU GUELADIO",7,14,72,64,136
LOUGA,LINGUERE,BARKEDJI,THIARNY,"ONDOU GUELY",7,11,47,27,74
LOUGA,LINGUERE,BARKEDJI,THIARNY,"H1 MBOUNDOU MBABA",2,3,15,14,29
LOUGA,LINGUERE,BARKEDJI,THIARNY,"OWANDOU 2",31,42,189,163,352
LOUGA,LINGUERE,BARKEDJI,THIARNY,"ROUMDE THIARGNY",28,50,145,173,318
LOUGA,LINGUERE,BARKEDJI,THIARNY,"SAKATE GUILEL",11,18,57,57,114
LOUGA,LINGUERE,BARKEDJI,THIARNY,"SAM SAM KA",15,25,86,81,167
LOUGA,LINGUERE,BARKEDJI,THIARNY,SAMBANA,3,10,23,21,44
LOUGA,LINGUERE,BARKEDJI,THIARNY,"H1 BOWDE DIEDIDI",4,7,35,25,60
LOUGA,LINGUERE,BARKEDJI,THIARNY,"THIARGNY AIRANCOBE",7,17,67,60,127
LOUGA,LINGUERE,BARKEDJI,THIARNY,"THIARGNY 1",18,27,95,110,205
LOUGA,LINGUERE,BARKEDJI,THIARNY,"THIARGNY 2",6,13,29,32,61
LOUGA,LINGUERE,BARKEDJI,THIARNY,"THIARGNY 3",10,12,39,41,80
LOUGA,LINGUERE,BARKEDJI,THIARNY,"THIARGNY OWANDOU",8,8,21,27,48
LOUGA,LINGUERE,BARKEDJI,THIARNY,"THIEBE LINDE",4,5,23,25,48
LOUGA,LINGUERE,BARKEDJI,THIARNY,THIODORDE,12,19,103,84,187
LOUGA,LINGUERE,BARKEDJI,THIARNY,"THIOMBE GOUYE GUENE",7,16,59,60,119
LOUGA,LINGUERE,BARKEDJI,THIARNY,"WIS WIS 1 (NDOUROUNABÈ)",8,8,29,28,57
LOUGA,LINGUERE,BARKEDJI,THIARNY,"WIS WIS 2 (WODABE)",9,13,50,51,101
LOUGA,LINGUERE,BARKEDJI,THIARNY,"WENDOU DELLA",6,11,34,31,65
LOUGA,LINGUERE,BARKEDJI,THIARNY,"WENDOU MBABA",4,7,28,25,53
LOUGA,LINGUERE,BARKEDJI,THIARNY,"WENDOU SENO 1",22,42,166,172,338
LOUGA,LINGUERE,BARKEDJI,THIARNY,"WENDOU SENO 2",8,21,50,67,117
LOUGA,LINGUERE,BARKEDJI,THIARNY,"WENDOU SENO 3",4,5,18,21,39
LOUGA,LINGUERE,BARKEDJI,THIARNY,"WENDOU SENO 4",13,21,72,81,153
LOUGA,LINGUERE,BARKEDJI,THIARNY,YOUGOURE,2,12,48,48,96
LOUGA,LINGUERE,BARKEDJI,THIARNY,"BELEL BOKY",4,4,8,13,21
LOUGA,LINGUERE,BARKEDJI,THIARNY,"BELEL NELBY 4",11,13,56,46,102
LOUGA,LINGUERE,BARKEDJI,THIARNY,"BELLY NDIOYE",16,23,110,83,193
LOUGA,LINGUERE,BARKEDJI,THIARNY,"BOULOGNE ARDO 1",2,7,22,26,48
LOUGA,LINGUERE,BARKEDJI,THIARNY,"BOULOGNE ARDO 2",1,3,9,5,14
LOUGA,LINGUERE,BARKEDJI,THIARNY,"DAROU SALAM NDOGANDOU",2,4,10,15,25
LOUGA,LINGUERE,BARKEDJI,THIARNY,"DIDEL NIERY",6,13,62,51,113
LOUGA,LINGUERE,BARKEDJI,THIARNY,"GOUYE GUENE 2",5,17,56,58,114
LOUGA,LINGUERE,BARKEDJI,THIARNY,GUIHE,10,16,72,58,130
LOUGA,LINGUERE,BARKEDJI,THIARNY,"KHOGUE NDAWENE 2",33,61,239,276,515
LOUGA,LINGUERE,BARKEDJI,THIARNY,"LINDE TIDIANE 1",56,103,379,397,776
LOUGA,LINGUERE,BARKEDJI,THIARNY,"MEDINA SOWNABE WENDOU SENO",7,15,41,57,98
LOUGA,LINGUERE,BARKEDJI,THIARNY,"NDAR NDECK WENNDDOU SENO",1,3,7,7,14
LOUGA,LINGUERE,BARKEDJI,THIARNY,"NIERY GANGUEL",4,7,23,22,45
LOUGA,LINGUERE,BARKEDJI,THIARNY,"NIERY MOWDY SANARABE",3,8,32,33,65
LOUGA,LINGUERE,BARKEDJI,THIARNY,"NIOUKOUL LINDE WOURO ADAMA",4,4,22,21,43
LOUGA,LINGUERE,BARKEDJI,THIARNY,"SORINGA LINDE",6,7,31,31,62
LOUGA,LINGUERE,BARKEDJI,THIARNY,"SORINGA LINDE 2",6,10,43,32,75
LOUGA,LINGUERE,BARKEDJI,THIARNY,"THIEBE LINDE 2",10,24,79,73,152
LOUGA,LINGUERE,BARKEDJI,THIARNY,"TOUBA BELEL DJIOLOF",16,27,163,169,332
LOUGA,LINGUERE,BARKEDJI,THIARNY,"VELINGRA LINDE(LINDE NDIALAL)",5,10,43,49,92
LOUGA,LINGUERE,BARKEDJI,THIARNY,"WENDOU NODA",4,4,31,24,55
LOUGA,LINGUERE,BARKEDJI,THIARNY,"WITNDE DIOY NAMASSE",15,29,125,87,212
LOUGA,LINGUERE,BARKEDJI,THIARNY,"WITNDE DIOYA 2",2,3,8,12,20
LOUGA,LINGUERE,BARKEDJI,THIARNY,"WOURO BOCKI",5,6,35,40,75
LOUGA,LINGUERE,BARKEDJI,THIEL,"BELEL DOCKY",8,13,46,48,94
LOUGA,LINGUERE,BARKEDJI,THIEL,"BELEL NELBY KHOUBE",13,17,81,67,148
LOUGA,LINGUERE,BARKEDJI,THIEL,BODE,8,13,44,43,87
LOUGA,LINGUERE,BARKEDJI,THIEL,"H1 WENDOU GADA LADE",11,15,69,84,153
LOUGA,LINGUERE,BARKEDJI,THIEL,"BODE THIEL",25,31,169,147,316
LOUGA,LINGUERE,BARKEDJI,THIEL,BOULERY,10,12,46,54,100
LOUGA,LINGUERE,BARKEDJI,THIEL,"H1 BENGHERE",4,5,26,38,64
LOUGA,LINGUERE,BARKEDJI,THIEL,DANEDJI,14,15,71,60,131
LOUGA,LINGUERE,BARKEDJI,THIEL,"H1 TOUBA NDIAGNE",14,17,74,83,157
LOUGA,LINGUERE,BARKEDJI,THIEL,"DAROU KHOUDOSS",1,1,11,12,23
LOUGA,LINGUERE,BARKEDJI,THIEL,"DAROU NAHIM DANEDJI",12,31,96,70,166
LOUGA,LINGUERE,BARKEDJI,THIEL,"H1 WENDOU NAHE",9,14,54,55,109
LOUGA,LINGUERE,BARKEDJI,THIEL,"DAROU SALAM M’BACKE",11,12,71,56,127
LOUGA,LINGUERE,BARKEDJI,THIEL,"DAROU SALAM THIEL",20,34,199,174,373
LOUGA,LINGUERE,BARKEDJI,THIEL,"DEROUDOU DOLY",4,18,29,21,50
LOUGA,LINGUERE,BARKEDJI,THIEL,"TOUBA BELEL PATACOUR",4,4,32,27,59
LOUGA,LINGUERE,BARKEDJI,THIEL,"DIACK SAO TOURE",1,4,52,15,67
LOUGA,LINGUERE,BARKEDJI,THIEL,"DIAGA LONDE",8,24,57,60,117
LOUGA,LINGUERE,BARKEDJI,THIEL,"DIAGA DOLY",14,16,146,133,279
LOUGA,LINGUERE,BARKEDJI,THIEL,"DIALY FAFA",6,9,34,29,63
LOUGA,LINGUERE,BARKEDJI,THIEL,"H1 IDEYEUL",13,20,80,71,151
LOUGA,LINGUERE,BARKEDJI,THIEL,"DIAM WELY",20,33,119,117,236
LOUGA,LINGUERE,BARKEDJI,THIEL,DIOULKY,39,67,311,299,610
LOUGA,LINGUERE,BARKEDJI,THIEL,"H1 BELEL GOURODJI",14,24,126,118,244
LOUGA,LINGUERE,BARKEDJI,THIEL,"H3 LOUMBOUL DEMBA WOURY",1,1,6,4,10
LOUGA,LINGUERE,BARKEDJI,THIEL,"H5 BELEL GOUREDJI",2,3,13,8,21
LOUGA,LINGUERE,BARKEDJI,THIEL,"DOLY CENTRE",54,61,293,294,587
LOUGA,LINGUERE,BARKEDJI,THIEL,"DOLY 2",7,25,70,68,138
LOUGA,LINGUERE,BARKEDJI,THIEL,"H1 DOLY 2",3,4,65,34,99
LOUGA,LINGUERE,BARKEDJI,THIEL,"DOMOKE THIEL",7,14,84,63,147
LOUGA,LINGUERE,BARKEDJI,THIEL,"GOUMEL NAMASS",14,22,89,76,165
LOUGA,LINGUERE,BARKEDJI,THIEL,"BOUSTANOUL ARAFINA",13,15,92,82,174
LOUGA,LINGUERE,BARKEDJI,THIEL,"H2 YEDIRGA",2,3,13,11,24
LOUGA,LINGUERE,BARKEDJI,THIEL,KOUMOUCK,24,41,188,142,330
LOUGA,LINGUERE,BARKEDJI,THIEL,"KOUMOUCK KANGAL",9,23,81,73,154
LOUGA,LINGUERE,BARKEDJI,THIEL,"H3 BOLEDJI",6,14,48,35,83
LOUGA,LINGUERE,BARKEDJI,THIEL,"SOUMIGOURY 2",8,17,29,29,58
LOUGA,LINGUERE,BARKEDJI,THIEL,BAPEDJIE,5,10,159,123,282
LOUGA,LINGUERE,BARKEDJI,THIEL,"MBATHIOR (DOLY)",28,84,159,175,334
LOUGA,LINGUERE,BARKEDJI,THIEL,"MOLA 1",30,39,175,163,338
LOUGA,LINGUERE,BARKEDJI,THIEL,"MOLA 2",5,6,39,37,76
LOUGA,LINGUERE,BARKEDJI,THIEL,"NDRAME NDIENGAL",8,9,14,28,42
LOUGA,LINGUERE,BARKEDJI,THIEL,NGUER,4,7,15,10,25
LOUGA,LINGUERE,BARKEDJI,THIEL,"H2 WOURO SAWANABE",4,7,22,19,41
LOUGA,LINGUERE,BARKEDJI,THIEL,"ODIOLDE THIEL",9,15,55,55,110
LOUGA,LINGUERE,BARKEDJI,THIEL,"OGO DOLY",9,19,50,41,91
LOUGA,LINGUERE,BARKEDJI,THIEL,"OGO LAITIK",4,10,36,33,69
LOUGA,LINGUERE,BARKEDJI,THIEL,"TOUBA DAROU RAHMANE ODIOLDE",10,21,114,85,199
LOUGA,LINGUERE,BARKEDJI,THIEL,PATACOUR,44,69,302,230,532
LOUGA,LINGUERE,BARKEDJI,THIEL,"SIBOL THIEL",7,32,60,54,114
LOUGA,LINGUERE,BARKEDJI,THIEL,"SILATE WOLOF",22,53,158,130,288
LOUGA,LINGUERE,BARKEDJI,THIEL,"H1 DIAMAGUENE SILAT",9,12,39,30,69
LOUGA,LINGUERE,BARKEDJI,THIEL,"SILAT PEULH",6,16,31,29,60
LOUGA,LINGUERE,BARKEDJI,THIEL,"THIABOULY 2",2,4,20,7,27
LOUGA,LINGUERE,BARKEDJI,THIEL,"THIEL MAURE",8,10,46,39,85
LOUGA,LINGUERE,BARKEDJI,THIEL,"H2 ASRE",7,8,30,35,65
LOUGA,LINGUERE,BARKEDJI,THIEL,"H3 DABO",3,3,18,17,35
LOUGA,LINGUERE,BARKEDJI,THIEL,"THIEL SERERE",80,95,439,469,908
LOUGA,LINGUERE,BARKEDJI,THIEL,"THIEL TOUCOULEUR",16,18,105,108,213
LOUGA,LINGUERE,BARKEDJI,THIEL,"THILLA (TOUBA THILLA)",15,22,126,114,240
LOUGA,LINGUERE,BARKEDJI,THIEL,"TOUBA DAROU MINAME",12,12,82,87,169
LOUGA,LINGUERE,BARKEDJI,THIEL,"TOUBA ODIOLDE",1,1,10,2,12
LOUGA,LINGUERE,BARKEDJI,THIEL,"H1 TOUBA BOUSRA",2,2,15,9,24
LOUGA,LINGUERE,BARKEDJI,THIEL,"TOUBA PATACOUR",15,16,81,78,159
LOUGA,LINGUERE,BARKEDJI,THIEL,"TOUBA THIEL 2",10,11,64,45,109
LOUGA,LINGUERE,BARKEDJI,THIEL,"WADANE DJOLOF",27,28,179,133,312
LOUGA,LINGUERE,BARKEDJI,THIEL,"WENDOU BOUBOU",2,2,8,11,19
LOUGA,LINGUERE,BARKEDJI,THIEL,"WOURO NDIOBO",6,7,30,29,59
LOUGA,LINGUERE,BARKEDJI,THIEL,"BELEL DIATMI",13,15,46,68,114
LOUGA,LINGUERE,BARKEDJI,THIEL,"BODE BIRHIMA",11,12,45,37,82
LOUGA,LINGUERE,BARKEDJI,THIEL,"BODEDJI 1",16,19,74,71,145
LOUGA,LINGUERE,BARKEDJI,THIEL,"BOLEDJI 2",17,30,80,85,165
LOUGA,LINGUERE,BARKEDJI,THIEL,DABO,7,8,43,48,91
LOUGA,LINGUERE,BARKEDJI,THIEL,"DAROU MARNANE",6,7,63,65,128
LOUGA,LINGUERE,BARKEDJI,THIEL,"DAROU MARNANE THIEL",3,5,23,26,49
LOUGA,LINGUERE,BARKEDJI,THIEL,"DAROU NAHIM OUDALAYE",6,8,19,17,36
LOUGA,LINGUERE,BARKEDJI,THIEL,"DAROU NAHIM SILATE",3,11,35,27,62
LOUGA,LINGUERE,BARKEDJI,THIEL,"FASS BARRA TOURE",47,59,339,374,713
LOUGA,LINGUERE,BARKEDJI,THIEL,"KAWSARA NDONGUENE",6,9,39,40,79
LOUGA,LINGUERE,BARKEDJI,THIEL,"KOTHIEDIE ODIOLDE",7,15,68,63,131
LOUGA,LINGUERE,BARKEDJI,THIEL,"LALA GALHINDE",14,26,59,74,133
LOUGA,LINGUERE,BARKEDJI,THIEL,"LOUMBOL KOYLY",16,24,127,93,220
LOUGA,LINGUERE,BARKEDJI,THIEL,"LOUMBOUL ARDO",8,10,32,46,78
LOUGA,LINGUERE,BARKEDJI,THIEL,"LOUMBY THIARAMBITHIE",8,10,41,39,80
LOUGA,LINGUERE,BARKEDJI,THIEL,"MADIYANA THIEL",5,11,57,46,103
LOUGA,LINGUERE,BARKEDJI,THIEL,"MEDINATOUL SAM THIOBE",8,8,45,41,86
LOUGA,LINGUERE,BARKEDJI,THIEL,"MONTREAL THIEL",8,8,33,28,61
LOUGA,LINGUERE,BARKEDJI,THIEL,"NDIAYENE DJOLOF",16,34,110,126,236
LOUGA,LINGUERE,BARKEDJI,THIEL,"NGUER DIAW",19,26,101,105,206
LOUGA,LINGUERE,BARKEDJI,THIEL,"NGUER NELBE",5,8,30,39,69
LOUGA,LINGUERE,BARKEDJI,THIEL,"NGUER PEUL",2,2,14,18,32
LOUGA,LINGUERE,BARKEDJI,THIEL,"NIATH DOLLY",7,14,28,31,59
LOUGA,LINGUERE,BARKEDJI,THIEL,"H1 DIOBOUDOU NIATHIE",20,23,128,130,258
LOUGA,LINGUERE,BARKEDJI,THIEL,"ODIOLDE 2",3,5,14,15,29
LOUGA,LINGUERE,BARKEDJI,THIEL,"OGO POULEME",10,26,45,54,99
LOUGA,LINGUERE,BARKEDJI,THIEL,"RAWDOU RAYAHINE",4,4,16,7,23
LOUGA,LINGUERE,BARKEDJI,THIEL,"RICKOU BOGUEL",3,3,6,20,26
LOUGA,LINGUERE,BARKEDJI,THIEL,"RICKOU KOUMACK",5,6,25,38,63
LOUGA,LINGUERE,BARKEDJI,THIEL,"SAR SARA THIEL",10,22,110,90,200
LOUGA,LINGUERE,BARKEDJI,THIEL,"SOBOUNDOU SANGHARE",5,8,37,35,72
LOUGA,LINGUERE,BARKEDJI,THIEL,SORE,2,2,19,14,33
LOUGA,LINGUERE,BARKEDJI,THIEL,SORINGO,5,6,17,16,33
LOUGA,LINGUERE,BARKEDJI,THIEL,THIARAMBITHIE,8,13,44,54,98
LOUGA,LINGUERE,BARKEDJI,THIEL,"THIARAMBITHIE BELLY",12,32,80,69,149
LOUGA,LINGUERE,BARKEDJI,THIEL,"THIEL OUOLOF 1",106,123,492,486,978
LOUGA,LINGUERE,BARKEDJI,THIEL,"THIEL PEULL 2",3,5,22,17,39
LOUGA,LINGUERE,BARKEDJI,THIEL,THIOBE,7,10,43,39,82
LOUGA,LINGUERE,BARKEDJI,THIEL,"H1 DAROU SALAM THIOBE",4,4,36,20,56
LOUGA,LINGUERE,BARKEDJI,THIEL,"TOUBA DIACK SAO",13,30,104,75,179
LOUGA,LINGUERE,BARKEDJI,THIEL,"TOUBA SANGHE",3,11,35,31,66
LOUGA,LINGUERE,BARKEDJI,THIEL,"WAKERE THIEL",1,1,8,13,21
LOUGA,LINGUERE,BARKEDJI,THIEL,"WENDOU  GADA LADE",9,13,57,69,126
LOUGA,LINGUERE,BARKEDJI,THIEL,"WENDOU GUELOKY",4,5,38,47,85
LOUGA,LINGUERE,BARKEDJI,THIEL,"WOURO DJOLOF",3,13,21,20,41
LOUGA,LINGUERE,DODJI,DODJI,ABOBE,11,20,55,62,117
LOUGA,LINGUERE,DODJI,DODJI,"H1 TORDIOL",2,4,15,15,30
LOUGA,LINGUERE,DODJI,DODJI,"ASRE GAOUDY",12,29,87,86,173
LOUGA,LINGUERE,DODJI,DODJI,BALDIEL,15,37,102,119,221
LOUGA,LINGUERE,DODJI,DODJI,"H2 MEDINA ABDOUL",4,5,13,22,35
LOUGA,LINGUERE,DODJI,DODJI,BARRY,29,38,195,204,399
LOUGA,LINGUERE,DODJI,DODJI,"BATAMBA SAMBA",11,27,60,70,130
LOUGA,LINGUERE,DODJI,DODJI,"BELEL DADY II",2,6,28,24,52
LOUGA,LINGUERE,DODJI,DODJI,"PALOL BELEL MAYE",1,5,17,18,35
LOUGA,LINGUERE,DODJI,DODJI,"BELEL MBONO",1,5,14,18,32
LOUGA,LINGUERE,DODJI,DODJI,"BELLY WELLY PEULH (BELLY OLY)",37,61,192,220,412
LOUGA,LINGUERE,DODJI,DODJI,"BOULY BOUTEL",11,20,63,58,121
LOUGA,LINGUERE,DODJI,DODJI,BOUNDIANG,11,19,95,83,178
LOUGA,LINGUERE,DODJI,DODJI,"BOWE BOBORAL I",1,4,10,11,21
LOUGA,LINGUERE,DODJI,DODJI,"KABEL I",5,7,27,33,60
LOUGA,LINGUERE,DODJI,DODJI,"BOWE OUROURBE I",21,43,142,181,323
LOUGA,LINGUERE,DODJI,DODJI,"BOWE OUROURBE II",8,16,57,89,146
LOUGA,LINGUERE,DODJI,DODJI,"BOWE SAMBA MODY",9,20,69,71,140
LOUGA,LINGUERE,DODJI,DODJI,"DASS NGOUROU",33,62,259,302,561
LOUGA,LINGUERE,DODJI,DODJI,"DODJI NDIALAL",46,84,292,364,656
LOUGA,LINGUERE,DODJI,DODJI,"DODJI OUOLOF",87,118,582,547,1129
LOUGA,LINGUERE,DODJI,DODJI,"DODJI PEULH",12,17,94,64,158
LOUGA,LINGUERE,DODJI,DODJI,"DODJI PEULH II",5,42,154,168,322
LOUGA,LINGUERE,DODJI,DODJI,"H1 BOKINEBAM",7,12,63,80,143
LOUGA,LINGUERE,DODJI,DODJI,"DODJI PEULH MBAYNABE",33,83,221,267,488
LOUGA,LINGUERE,DODJI,DODJI,"DODJI SANTHIE",20,22,106,131,237
LOUGA,LINGUERE,DODJI,DODJI,"DOUNE DOUNE LATHIE 1",13,45,116,117,233
LOUGA,LINGUERE,DODJI,DODJI,"DOUNE DOUNE LATHIE 2",11,47,153,135,288
LOUGA,LINGUERE,DODJI,DODJI,"DOUNE DOUNE NAIDE",6,17,78,54,132
LOUGA,LINGUERE,DODJI,DODJI,"DOUNE DOUNE ORIENTAL",12,56,132,138,270
LOUGA,LINGUERE,DODJI,DODJI,"GNIWA MBOURLOGNE",3,4,12,7,19
LOUGA,LINGUERE,DODJI,DODJI,"GNIWA 2",5,10,53,58,111
LOUGA,LINGUERE,DODJI,DODJI,"GNIWA WALY MATH",5,28,111,123,234
LOUGA,LINGUERE,DODJI,DODJI,"GNIWA WENDOU BEYE",14,29,106,83,189
LOUGA,LINGUERE,DODJI,DODJI,GONAKY,11,20,67,73,140
LOUGA,LINGUERE,DODJI,DODJI,"H2 LOUMBY THIANGHE",5,6,31,26,57
LOUGA,LINGUERE,DODJI,DODJI,"GUENTE NDAWEDJI 1",8,16,55,61,116
LOUGA,LINGUERE,DODJI,DODJI,"GUENTE NDAWEDJI 2",3,30,94,99,193
LOUGA,LINGUERE,DODJI,DODJI,"KABELE 2",26,81,222,252,474
LOUGA,LINGUERE,DODJI,DODJI,"KADJI MADIA",108,162,648,739,1387
LOUGA,LINGUERE,DODJI,DODJI,"KADJI NDIAYENE",18,29,157,138,295
LOUGA,LINGUERE,DODJI,DODJI,"KADJI NIANGHENE",14,18,112,103,215
LOUGA,LINGUERE,DODJI,DODJI,"KADJI THIONG",6,16,92,78,170
LOUGA,LINGUERE,DODJI,DODJI,"KHOL KHOL NIANGUENE",32,41,173,206,379
LOUGA,LINGUERE,DODJI,DODJI,"KODIOLELE 1",2,7,27,24,51
LOUGA,LINGUERE,DODJI,DODJI,"KODIOLELE 2",5,11,34,26,60
LOUGA,LINGUERE,DODJI,DODJI,"H1 BOWE SAMODY",8,15,49,41,90
LOUGA,LINGUERE,DODJI,DODJI,"LOUMBAL KADJI",6,16,71,70,141
LOUGA,LINGUERE,DODJI,DODJI,"LOUMBAL MALI",9,20,49,63,112
LOUGA,LINGUERE,DODJI,DODJI,"LOUMBAL NDAMA",9,38,130,124,254
LOUGA,LINGUERE,DODJI,DODJI,"LOUMBOL PADALDY",43,59,215,193,408
LOUGA,LINGUERE,DODJI,DODJI,"LOUMBY SAMBA PENDA",10,23,81,96,177
LOUGA,LINGUERE,DODJI,DODJI,"H1 NAFFA",1,5,11,9,20
LOUGA,LINGUERE,DODJI,DODJI,"MERINA KHOL KHOL",79,142,632,612,1244
LOUGA,LINGUERE,DODJI,DODJI,"H1 KHOL KHOL PEULH",13,21,76,64,140
LOUGA,LINGUERE,DODJI,DODJI,"MERINA NDOKHOBE",10,11,60,50,110
LOUGA,LINGUERE,DODJI,DODJI,"H1 DAROU SALAM NDOKHOBE",6,10,27,23,50
LOUGA,LINGUERE,DODJI,DODJI,"H2 RANG RANG",2,4,13,13,26
LOUGA,LINGUERE,DODJI,DODJI,"WOURO SENO 1",10,14,45,35,80
LOUGA,LINGUERE,DODJI,DODJI,"H1 WENDOU BEYE DEMBA",5,10,36,19,55
LOUGA,LINGUERE,DODJI,DODJI,"WOURO SENO 2",8,13,35,42,77
LOUGA,LINGUERE,DODJI,DODJI,"KAMB WOURO SENO",1,1,1,6,7
LOUGA,LINGUERE,DODJI,DODJI,"PALOL DIARAL",23,61,180,170,350
LOUGA,LINGUERE,DODJI,DODJI,"PALOL WODABE",12,24,80,90,170
LOUGA,LINGUERE,DODJI,DODJI,"PORANE LATHIE 1",5,19,73,50,123
LOUGA,LINGUERE,DODJI,DODJI,"PORANE LATHIE 2",6,25,81,67,148
LOUGA,LINGUERE,DODJI,DODJI,"PORANE OUOLOF",20,50,181,177,358
LOUGA,LINGUERE,DODJI,DODJI,"H1 KEUR SAM MODY DIALLO",2,4,13,20,33
LOUGA,LINGUERE,DODJI,DODJI,"PORANE PEULH 2",7,18,65,41,106
LOUGA,LINGUERE,DODJI,DODJI,"H1 PORANE PEULH 1",8,14,40,50,90
LOUGA,LINGUERE,DODJI,DODJI,"H2 PORANE PEULH 2",3,11,31,33,64
LOUGA,LINGUERE,DODJI,DODJI,"PORANE PEULH 3",5,18,53,48,101
LOUGA,LINGUERE,DODJI,DODJI,"PORANE THIANOR",3,7,8,25,33
LOUGA,LINGUERE,DODJI,DODJI,THIASKY,12,56,137,163,300
LOUGA,LINGUERE,DODJI,DODJI,"THIAT NGOL PALOL",16,34,99,98,197
LOUGA,LINGUERE,DODJI,DODJI,"THIELE 1",6,18,58,51,109
LOUGA,LINGUERE,DODJI,DODJI,"THIELE 2",4,14,36,49,85
LOUGA,LINGUERE,DODJI,DODJI,"THIENEL DIASSANE",5,6,24,20,44
LOUGA,LINGUERE,DODJI,DODJI,"TIDIANE 1",2,6,14,16,30
LOUGA,LINGUERE,DODJI,DODJI,"WENDOU BEYE DEMBA",20,32,105,75,180
LOUGA,LINGUERE,DODJI,DODJI,"WENDOU BEYE GUELONGAL",6,8,28,25,53
LOUGA,LINGUERE,DODJI,DODJI,"WENDOU BEYE 1",6,13,35,31,66
LOUGA,LINGUERE,DODJI,DODJI,"WENDOU BEYE 2",6,6,23,14,37
LOUGA,LINGUERE,DODJI,DODJI,"WENDOU BEYE OUROU GAO",26,68,443,315,758
LOUGA,LINGUERE,DODJI,DODJI,"WENDOU BEYE WOURO MBANG",2,2,7,9,16
LOUGA,LINGUERE,DODJI,DODJI,"WENDOU DIABY (BELEL DIABY)",5,12,47,31,78
LOUGA,LINGUERE,DODJI,DODJI,"WENDOU SENO",11,20,56,66,122
LOUGA,LINGUERE,DODJI,DODJI,"BELEL DADY 3",12,20,56,71,127
LOUGA,LINGUERE,DODJI,DODJI,"BOWE BOBORAL 2",3,7,16,29,45
LOUGA,LINGUERE,DODJI,DODJI,"BOWE MBELOGNE",3,5,9,21,30
LOUGA,LINGUERE,DODJI,DODJI,"BOWE NIERY 1",4,7,18,21,39
LOUGA,LINGUERE,DODJI,DODJI,"BOWE NIERY 2",6,13,47,45,92
LOUGA,LINGUERE,DODJI,DODJI,"GUENTE NDAWEDJI 3",4,4,21,22,43
LOUGA,LINGUERE,DODJI,DODJI,"KABEL THIANOR",7,17,75,66,141
LOUGA,LINGUERE,DODJI,DODJI,"PORAME WENDOU BARKEDJI",2,5,13,18,31
LOUGA,LINGUERE,DODJI,DODJI,"THIASKY DIAMANT",5,8,17,24,41
LOUGA,LINGUERE,DODJI,DODJI,"TIDIANE 2",1,2,9,12,21
LOUGA,LINGUERE,DODJI,DODJI,"TOUBA NDINDY",4,4,16,12,28
LOUGA,LINGUERE,DODJI,DODJI,"WENDOU BEYE 3",6,22,86,79,165
LOUGA,LINGUERE,DODJI,DODJI,"WENDOU BEYE LAMORDE",4,9,25,24,49
LOUGA,LINGUERE,DODJI,DODJI,"WENDOU BEYE MEDINA",7,13,41,42,83
LOUGA,LINGUERE,DODJI,DODJI,"WENDOU BEYE WOURO GAWDY",15,27,114,68,182
LOUGA,LINGUERE,DODJI,LABGAR,"ASRE KODIOL",10,13,54,58,112
LOUGA,LINGUERE,DODJI,LABGAR,"H3 ASRE KODIOL",6,8,43,38,81
LOUGA,LINGUERE,DODJI,LABGAR,"H4 ASRE KODIOL",2,3,13,11,24
LOUGA,LINGUERE,DODJI,LABGAR,"BADDE I",7,13,74,45,119
LOUGA,LINGUERE,DODJI,LABGAR,"H1 BADDE 1",1,9,19,24,43
LOUGA,LINGUERE,DODJI,LABGAR,BALDIEL,4,12,26,46,72
LOUGA,LINGUERE,DODJI,LABGAR,"H1 BALDIEL",2,2,7,7,14
LOUGA,LINGUERE,DODJI,LABGAR,"BAWDE TOUDOUNDE MAURE",36,52,157,194,351
LOUGA,LINGUERE,DODJI,LABGAR,"BOULOGNE I",10,42,65,104,169
LOUGA,LINGUERE,DODJI,LABGAR,"BOULOGNE II",8,12,63,58,121
LOUGA,LINGUERE,DODJI,LABGAR,"GAIDOUME HAYRANCOBE 2",6,16,53,77,130
LOUGA,LINGUERE,DODJI,LABGAR,"GAIDOUME NDIALALE",7,9,28,29,57
LOUGA,LINGUERE,DODJI,LABGAR,"GNIWA DOWE 1",6,20,67,72,139
LOUGA,LINGUERE,DODJI,LABGAR,"KABEL 1",10,22,48,66,114
LOUGA,LINGUERE,DODJI,LABGAR,"KHADAR 1",7,15,33,47,80
LOUGA,LINGUERE,DODJI,LABGAR,"H1 NDIARKA",3,5,11,17,28
LOUGA,LINGUERE,DODJI,LABGAR,"H2 WOURO SEYDOU SOW",2,2,9,14,23
LOUGA,LINGUERE,DODJI,LABGAR,"LABGAR MAURE",98,110,353,452,805
LOUGA,LINGUERE,DODJI,LABGAR,"LABGAR OUOLOF 1",190,217,1073,942,2015
LOUGA,LINGUERE,DODJI,LABGAR,"LABGAR THIANOR",20,27,117,131,248
LOUGA,LINGUERE,DODJI,LABGAR,"LOUMBOL DJIBY 1",5,13,47,55,102
LOUGA,LINGUERE,DODJI,LABGAR,"LOUMBOL DJIBY 2",23,38,128,162,290
LOUGA,LINGUERE,DODJI,LABGAR,"LOUMBOL DJIBY 3",1,8,11,12,23
LOUGA,LINGUERE,DODJI,LABGAR,"H1 LOUMBY DJIBY 2",5,7,33,27,60
LOUGA,LINGUERE,DODJI,LABGAR,"LOUMBOL KOTY",16,27,100,98,198
LOUGA,LINGUERE,DODJI,LABGAR,"H1 NGOLDE",13,19,94,89,183
LOUGA,LINGUERE,DODJI,LABGAR,"LOUMBY AIRANCOBE",15,23,75,76,151
LOUGA,LINGUERE,DODJI,LABGAR,"H1 LOUMBY HAYRANKOBE 1",3,5,20,26,46
LOUGA,LINGUERE,DODJI,LABGAR,"LOUMBY BOULOUMBY 2",12,22,86,103,189
LOUGA,LINGUERE,DODJI,LABGAR,"H1 LOUMBY NGUIDO",4,11,50,57,107
LOUGA,LINGUERE,DODJI,LABGAR,"LOUMBY MBAREDJI (LOUMBOL ERY)",5,5,14,23,37
LOUGA,LINGUERE,DODJI,LABGAR,"H1 LOUMBY MBAREDJI",6,15,37,51,88
LOUGA,LINGUERE,DODJI,LABGAR,"H2 LOUMBY MBAREDJI",5,9,30,30,60
LOUGA,LINGUERE,DODJI,LABGAR,"H3 WOURO MBAYE BA",7,9,31,41,72
LOUGA,LINGUERE,DODJI,LABGAR,"LOUMBY NGUIDO",18,35,129,116,245
LOUGA,LINGUERE,DODJI,LABGAR,"LOUMBY YERO SAMBA",7,13,45,60,105
LOUGA,LINGUERE,DODJI,LABGAR,"H1 WOURO MBAMBALY",2,2,7,9,16
LOUGA,LINGUERE,DODJI,LABGAR,"H2 LOUMBY YERO SAMBA",3,13,28,44,72
LOUGA,LINGUERE,DODJI,LABGAR,"THIETIERLE NDAWEDJI",22,52,87,120,207
LOUGA,LINGUERE,DODJI,LABGAR,"H2 WOURO DIAM GUIDJILE",6,7,30,22,52
LOUGA,LINGUERE,DODJI,LABGAR,"H3 WOURO SAMBAREL (AOURE SAPO)",8,14,30,47,77
LOUGA,LINGUERE,DODJI,LABGAR,"H4 WOURO BOULA",4,4,2,18,20
LOUGA,LINGUERE,DODJI,LABGAR,"H5 WOURO TOLBE",1,1,3,3,6
LOUGA,LINGUERE,DODJI,LABGAR,"H6 THIELIERLE NDAWEDJI",3,8,14,13,27
LOUGA,LINGUERE,DODJI,LABGAR,THILELE,12,20,58,78,136
LOUGA,LINGUERE,DODJI,LABGAR,"ASRE GAOUDY",9,23,43,50,93
LOUGA,LINGUERE,DODJI,LABGAR,"BADDE 2",8,13,41,50,91
LOUGA,LINGUERE,DODJI,LABGAR,"BELEL HENDE",4,5,20,17,37
LOUGA,LINGUERE,DODJI,LABGAR,"BELY GAWDY",1,1,4,6,10
LOUGA,LINGUERE,DODJI,LABGAR,"BOULOGNE 3",6,22,61,66,127
LOUGA,LINGUERE,DODJI,LABGAR,"BOULOGNE 4",11,44,83,103,186
LOUGA,LINGUERE,DODJI,LABGAR,"BOULOGNE THIAT NGOLE",11,39,76,90,166
LOUGA,LINGUERE,DODJI,LABGAR,"FERGO WODABE",2,2,7,8,15
LOUGA,LINGUERE,DODJI,LABGAR,"GAIDOUME HAYRANCOBE 1",4,10,31,25,56
LOUGA,LINGUERE,DODJI,LABGAR,"H1 GAIDOUME HAYRANCOBE 1",6,7,23,26,49
LOUGA,LINGUERE,DODJI,LABGAR,"GAIDOUME HAYRANCOBE 3",2,9,20,38,58
LOUGA,LINGUERE,DODJI,LABGAR,"GAIDOUME HAYRANCOBE 4",5,15,34,44,78
LOUGA,LINGUERE,DODJI,LABGAR,"H1 GAIDOU HAYRANCOBE 4",2,4,11,17,28
LOUGA,LINGUERE,DODJI,LABGAR,"GAIDOUME OUROUBE",8,22,76,125,201
LOUGA,LINGUERE,DODJI,LABGAR,"GNIWA DOWE 2",1,5,16,21,37
LOUGA,LINGUERE,DODJI,LABGAR,"H1 GNIWA DOME 2",10,14,33,56,89
LOUGA,LINGUERE,DODJI,LABGAR,"KELELY 1",3,14,41,53,94
LOUGA,LINGUERE,DODJI,LABGAR,"KELELY 2",4,6,21,17,38
LOUGA,LINGUERE,DODJI,LABGAR,"H1 LOUMBOL KELELY",9,21,68,81,149
LOUGA,LINGUERE,DODJI,LABGAR,"KHADAR 2",4,5,15,14,29
LOUGA,LINGUERE,DODJI,LABGAR,"LABGAR OUOLOF 2",13,13,37,38,75
LOUGA,LINGUERE,DODJI,LABGAR,"LABGAR THIANOR 2",7,15,44,50,94
LOUGA,LINGUERE,DODJI,LABGAR,LEDEM,3,3,14,14,28
LOUGA,LINGUERE,DODJI,LABGAR,"LOUMBOL BARRILE",12,24,80,91,171
LOUGA,LINGUERE,DODJI,LABGAR,"LOUMBOL DJIBY 4",9,14,40,81,121
LOUGA,LINGUERE,DODJI,LABGAR,"LOUMBOL DJIBY HAYRANKOBE 2",8,16,59,84,143
LOUGA,LINGUERE,DODJI,LABGAR,"LOUMBOL DORO",8,13,44,51,95
LOUGA,LINGUERE,DODJI,LABGAR,"LOUMBOL HABIBOU",10,18,35,42,77
LOUGA,LINGUERE,DODJI,LABGAR,"LOUMBY BOULOUMBY 1",8,13,40,48,88
LOUGA,LINGUERE,DODJI,LABGAR,"H1 LOUMBY BOULOUMBY 1",12,20,82,84,166
LOUGA,LINGUERE,DODJI,LABGAR,"NGASAMA BALDIEL",4,8,21,42,63
LOUGA,LINGUERE,DODJI,LABGAR,"RABY NAF1",1,3,5,12,17
LOUGA,LINGUERE,DODJI,LABGAR,"ROGOTHIE 1",6,22,72,74,146
LOUGA,LINGUERE,DODJI,LABGAR,"ROGOTHIE 2",6,11,50,48,98
LOUGA,LINGUERE,DODJI,LABGAR,"WENDOU SOWNABE",7,9,28,45,73
LOUGA,LINGUERE,DODJI,LABGAR,THIEBY,5,8,26,26,52
LOUGA,LINGUERE,DODJI,LABGAR,"H1 THIEBY",5,7,20,28,48
LOUGA,LINGUERE,DODJI,LABGAR,"H2 THIEBY",2,2,5,7,12
LOUGA,LINGUERE,DODJI,LABGAR,"H3 THIEBY",3,4,13,22,35
LOUGA,LINGUERE,DODJI,OUARKHOKH,"BALEL CISSE",32,38,216,256,472
LOUGA,LINGUERE,DODJI,OUARKHOKH,"BELAL SALL",4,5,20,28,48
LOUGA,LINGUERE,DODJI,OUARKHOKH,"DAROU SALAM LOUMBI",17,23,118,106,224
LOUGA,LINGUERE,DODJI,OUARKHOKH,"DIAMBAL PEULH",14,20,81,89,170
LOUGA,LINGUERE,DODJI,OUARKHOKH,"LOUMBY DJIOLOFF (DICK DIAOBE)",1,7,26,24,50
LOUGA,LINGUERE,DODJI,OUARKHOKH,"DICK DOW GASSAMA (PITELE)",11,37,114,112,226
LOUGA,LINGUERE,DODJI,OUARKHOKH,"DICK DOW MBATHIOR",15,40,183,145,328
LOUGA,LINGUERE,DODJI,OUARKHOKH,"DICK LESS",18,33,159,126,285
LOUGA,LINGUERE,DODJI,OUARKHOKH,"DICK OUOLOF",10,13,51,60,111
LOUGA,LINGUERE,DODJI,OUARKHOKH,"KOROSSEMENT LOUMBY",15,23,71,83,154
LOUGA,LINGUERE,DODJI,OUARKHOKH,"H2 BANIARE",6,18,48,45,93
LOUGA,LINGUERE,DODJI,OUARKHOKH,"DICK SASSY",15,42,136,145,281
LOUGA,LINGUERE,DODJI,OUARKHOKH,"DICK SANTHIE",22,29,130,116,246
LOUGA,LINGUERE,DODJI,OUARKHOKH,DIORY,19,21,128,115,243
LOUGA,LINGUERE,DODJI,OUARKHOKH,"DOUNDODJI THIAKHO",46,57,308,253,561
LOUGA,LINGUERE,DODJI,OUARKHOKH,"DOUNDODJI NIANGUENE",11,17,84,78,162
LOUGA,LINGUERE,DODJI,OUARKHOKH,"DOUNDODJI PARBA",26,34,146,138,284
LOUGA,LINGUERE,DODJI,OUARKHOKH,"GOREE THIONGUE 1",22,50,164,152,316
LOUGA,LINGUERE,DODJI,OUARKHOKH,"GOREE WALY 1",14,26,99,92,191
LOUGA,LINGUERE,DODJI,OUARKHOKH,"GOREE WALY 2",23,50,154,159,313
LOUGA,LINGUERE,DODJI,OUARKHOKH,GUENENE,35,39,193,189,382
LOUGA,LINGUERE,DODJI,OUARKHOKH,GHETTO,17,23,91,81,172
LOUGA,LINGUERE,DODJI,OUARKHOKH,"H1 KEUR BOYE DIA",9,12,42,47,89
LOUGA,LINGUERE,DODJI,OUARKHOKH,"DAROU SIRE NDIAKHAYE",9,12,61,35,96
LOUGA,LINGUERE,DODJI,OUARKHOKH,"KILIM PEULH",9,13,79,70,149
LOUGA,LINGUERE,DODJI,OUARKHOKH,"LOUMBI AIRANKOBE (FORAGE 2)",13,45,126,122,248
LOUGA,LINGUERE,DODJI,OUARKHOKH,"LOUMBI RUBISSENE (FORAGE 1)",21,52,170,120,290
LOUGA,LINGUERE,DODJI,OUARKHOKH,"DICK THIANOR",13,21,63,76,139
LOUGA,LINGUERE,DODJI,OUARKHOKH,MBADIENE,31,36,217,191,408
LOUGA,LINGUERE,DODJI,OUARKHOKH,"MBAYE TALLY",6,7,19,18,37
LOUGA,LINGUERE,DODJI,OUARKHOKH,"MBOUL 1",11,15,68,61,129
LOUGA,LINGUERE,DODJI,OUARKHOKH,"MEDINA DIALI (SINENE)",51,60,319,353,672
LOUGA,LINGUERE,DODJI,OUARKHOKH,"NDADANE RIBISSENE",11,19,83,77,160
LOUGA,LINGUERE,DODJI,OUARKHOKH,"NDARNDECK GANDOL",5,8,68,38,106
LOUGA,LINGUERE,DODJI,OUARKHOKH,"NDARNDECK 1",18,26,117,113,230
LOUGA,LINGUERE,DODJI,OUARKHOKH,"NDARNDECK 2",12,26,81,47,128
LOUGA,LINGUERE,DODJI,OUARKHOKH,"NDIA MOURIDE",15,17,67,72,139
LOUGA,LINGUERE,DODJI,OUARKHOKH,"NDIA NGONDIAL",7,14,45,40,85
LOUGA,LINGUERE,DODJI,OUARKHOKH,"NDIAKHAYE OUOLOF",10,10,46,49,95
LOUGA,LINGUERE,DODJI,OUARKHOKH,"NDIAKHAYE PEULH",15,23,94,79,173
LOUGA,LINGUERE,DODJI,OUARKHOKH,"NDIAYENE KHALY",20,26,123,158,281
LOUGA,LINGUERE,DODJI,OUARKHOKH,NGARAFF,26,54,193,150,343
LOUGA,LINGUERE,DODJI,OUARKHOKH,NGAYENE,16,17,95,111,206
LOUGA,LINGUERE,DODJI,OUARKHOKH,NGOUROU,8,12,54,67,121
LOUGA,LINGUERE,DODJI,OUARKHOKH,NGUITH,83,90,413,406,819
LOUGA,LINGUERE,DODJI,OUARKHOKH,"NIOUKHOUL 1",11,26,77,73,150
LOUGA,LINGUERE,DODJI,OUARKHOKH,"NIOUKHOUL 2",4,13,29,31,60
LOUGA,LINGUERE,DODJI,OUARKHOKH,"NIOUKHOUL KAW",30,59,199,169,368
LOUGA,LINGUERE,DODJI,OUARKHOKH,"OUARKHOKH DETHIE (POURDY GUENTH)",9,27,102,72,174
LOUGA,LINGUERE,DODJI,OUARKHOKH,"OUARKHOKH NARE",90,113,447,511,958
LOUGA,LINGUERE,DODJI,OUARKHOKH,"OUARKHOKH PARBA",101,122,543,469,1012
LOUGA,LINGUERE,DODJI,OUARKHOKH,PAWEL,7,27,88,87,175
LOUGA,LINGUERE,DODJI,OUARKHOKH,"POURDY 1",5,13,19,29,48
LOUGA,LINGUERE,DODJI,OUARKHOKH,"SOMME DANDE 1",11,19,87,72,159
LOUGA,LINGUERE,DODJI,OUARKHOKH,"SOMME DANDE 2",18,36,114,110,224
LOUGA,LINGUERE,DODJI,OUARKHOKH,"SOME PEULH",9,20,64,48,112
LOUGA,LINGUERE,DODJI,OUARKHOKH,"TALLY DIABE",6,12,43,41,84
LOUGA,LINGUERE,DODJI,OUARKHOKH,"H2 MBAGANE",9,17,55,67,122
LOUGA,LINGUERE,DODJI,OUARKHOKH,"TALLY GUENTH",19,43,134,158,292
LOUGA,LINGUERE,DODJI,OUARKHOKH,KOBO,29,65,154,166,320
LOUGA,LINGUERE,DODJI,OUARKHOKH,"H1 DEBY GUETH",8,10,56,41,97
LOUGA,LINGUERE,DODJI,OUARKHOKH,"TAMBEDOU DIERY",6,13,63,40,103
LOUGA,LINGUERE,DODJI,OUARKHOKH,"THIEBE THIDOGNE",15,32,120,105,225
LOUGA,LINGUERE,DODJI,OUARKHOKH,"THIOMBE 1",11,18,43,86,129
LOUGA,LINGUERE,DODJI,OUARKHOKH,"THIOMBE SAMB",4,7,26,27,53
LOUGA,LINGUERE,DODJI,OUARKHOKH,"THYLLA 1",19,25,106,151,257
LOUGA,LINGUERE,DODJI,OUARKHOKH,"YITTY 1",6,10,39,23,62
LOUGA,LINGUERE,DODJI,OUARKHOKH,"YITTY 2",19,29,106,104,210
LOUGA,LINGUERE,DODJI,OUARKHOKH,"DICK DIAOBE",4,5,20,19,39
LOUGA,LINGUERE,DODJI,OUARKHOKH,"DOUNDODJI GUEYENE",15,21,125,123,248
LOUGA,LINGUERE,DODJI,OUARKHOKH,"DOUNDODJI MBISSATE",48,64,286,257,543
LOUGA,LINGUERE,DODJI,OUARKHOKH,"DOUNDODJI NGOMENE",18,27,116,127,243
LOUGA,LINGUERE,DODJI,OUARKHOKH,"GORE SENO 2",3,3,9,12,21
LOUGA,LINGUERE,DODJI,OUARKHOKH,"GOREE THIONGUE 2",11,24,77,78,155
LOUGA,LINGUERE,DODJI,OUARKHOKH,"GOREE THIONGUE 3",5,10,26,31,57
LOUGA,LINGUERE,DODJI,OUARKHOKH,"GOREE WALY 3",6,10,34,36,70
LOUGA,LINGUERE,DODJI,OUARKHOKH,"GOURODJI 2",2,7,14,14,28
LOUGA,LINGUERE,DODJI,OUARKHOKH,"GUENTH BOBORY POURDY",3,6,32,28,60
LOUGA,LINGUERE,DODJI,OUARKHOKH,"LINDE NDIALAI",6,20,77,66,143
LOUGA,LINGUERE,DODJI,OUARKHOKH,LOBODIE,5,13,35,41,76
LOUGA,LINGUERE,DODJI,OUARKHOKH,"MBOUL 2",71,84,322,399,721
LOUGA,LINGUERE,DODJI,OUARKHOKH,"MEDINA CHEIKHOU",8,10,65,40,105
LOUGA,LINGUERE,DODJI,OUARKHOKH,"NDADANE DIALAL",18,22,90,82,172
LOUGA,LINGUERE,DODJI,OUARKHOKH,"NDADANE OUROUBE",3,9,21,23,44
LOUGA,LINGUERE,DODJI,OUARKHOKH,NDENGA,9,16,67,75,142
LOUGA,LINGUERE,DODJI,OUARKHOKH,"NDIAYENE THIOTTO",27,54,182,244,426
LOUGA,LINGUERE,DODJI,OUARKHOKH,NGOBE,3,4,14,13,27
LOUGA,LINGUERE,DODJI,OUARKHOKH,NOKI,6,13,29,34,63
LOUGA,LINGUERE,DODJI,OUARKHOKH,"POURDY 2",8,19,67,69,136
LOUGA,LINGUERE,DODJI,OUARKHOKH,"POURDY 3",4,7,18,22,40
LOUGA,LINGUERE,DODJI,OUARKHOKH,"POURDY DOULO DEMBA",10,21,76,65,141
LOUGA,LINGUERE,DODJI,OUARKHOKH,"SOMME DANDE 3",6,11,31,25,56
LOUGA,LINGUERE,DODJI,OUARKHOKH,"TALLY 1",8,15,69,38,107
LOUGA,LINGUERE,DODJI,OUARKHOKH,"TALLY 2",3,6,19,18,37
LOUGA,LINGUERE,DODJI,OUARKHOKH,"THIEBE 2",3,11,47,45,92
LOUGA,LINGUERE,DODJI,OUARKHOKH,"THIEBE 3",6,18,57,53,110
LOUGA,LINGUERE,DODJI,OUARKHOKH,"THIEBE COLY",16,34,112,106,218
LOUGA,LINGUERE,DODJI,OUARKHOKH,"THIEBE DAROU SALAM",9,15,56,63,119
LOUGA,LINGUERE,DODJI,OUARKHOKH,"THIEBE PAWEL",7,7,22,30,52
LOUGA,LINGUERE,DODJI,OUARKHOKH,"THYLLA 2",22,35,129,181,310
LOUGA,LINGUERE,DODJI,OUARKHOKH,"TOUBA NGAYENE",6,12,47,61,108
LOUGA,LINGUERE,DODJI,OUARKHOKH,"YITTY 3",9,13,42,61,103
LOUGA,LINGUERE,"YANG YANG",KAMB,"ASRE GAOUDY",3,6,28,17,45
LOUGA,LINGUERE,"YANG YANG",KAMB,"BALI ROTO",9,18,47,64,111
LOUGA,LINGUERE,"YANG YANG",KAMB,"BATAL (LAMOUROU)",13,36,92,102,194
LOUGA,LINGUERE,"YANG YANG",KAMB,"H3 LOUYE MBETHIO",7,15,39,27,66
LOUGA,LINGUERE,"YANG YANG",KAMB,"BELEL GUELOKI",9,11,42,43,85
LOUGA,LINGUERE,"YANG YANG",KAMB,BELIHEL,3,6,11,19,30
LOUGA,LINGUERE,"YANG YANG",KAMB,"H1 BELIHEL DEMBOYNANE",4,5,15,25,40
LOUGA,LINGUERE,"YANG YANG",KAMB,"BELIHEL AYRE",6,12,44,37,81
LOUGA,LINGUERE,"YANG YANG",KAMB,"BOFI BISNABE",18,31,108,139,247
LOUGA,LINGUERE,"YANG YANG",KAMB,"DAGA DECK REYE 1",26,32,102,101,203
LOUGA,LINGUERE,"YANG YANG",KAMB,"H1 BELEL BOURLY",2,4,8,10,18
LOUGA,LINGUERE,"YANG YANG",KAMB,"DAGA ROTO (RAHMANE)",19,20,107,96,203
LOUGA,LINGUERE,"YANG YANG",KAMB,"DECK REYE BELIHEL",1,3,9,6,15
LOUGA,LINGUERE,"YANG YANG",KAMB,"H1 BELIHEL LAONIANDE",3,7,13,24,37
LOUGA,LINGUERE,"YANG YANG",KAMB,"DECK REYE 1",17,22,60,54,114
LOUGA,LINGUERE,"YANG YANG",KAMB,"DECK REYE 2",6,8,20,29,49
LOUGA,LINGUERE,"YANG YANG",KAMB,"DEMBA NDIARNO",5,17,19,19,38
LOUGA,LINGUERE,"YANG YANG",KAMB,"GARDY 2",9,14,42,48,90
LOUGA,LINGUERE,"YANG YANG",KAMB,GASSEL,7,15,47,33,80
LOUGA,LINGUERE,"YANG YANG",KAMB,"H1 BOULY KELLE",6,12,31,38,69
LOUGA,LINGUERE,"YANG YANG",KAMB,"GASSEL CAMARA",7,9,18,29,47
LOUGA,LINGUERE,"YANG YANG",KAMB,"GASSEL NOUROU",4,4,15,17,32
LOUGA,LINGUERE,"YANG YANG",KAMB,"GOUBY BISNABE",4,4,8,9,17
LOUGA,LINGUERE,"YANG YANG",KAMB,"GOULOUM NDIAYENE",32,33,134,139,273
LOUGA,LINGUERE,"YANG YANG",KAMB,"GOULOUM NGAYENE",6,7,37,43,80
LOUGA,LINGUERE,"YANG YANG",KAMB,"H1 THIECKENE (GOULOUM TEUG)",11,19,84,58,142
LOUGA,LINGUERE,"YANG YANG",KAMB,"GOULOUM THIARENE",31,36,150,163,313
LOUGA,LINGUERE,"YANG YANG",KAMB,"GUEDJI BOGUEL",7,13,46,30,76
LOUGA,LINGUERE,"YANG YANG",KAMB,"GUEDJI MBARA THIEWELLE (BELEL DIABE)",6,8,23,24,47
LOUGA,LINGUERE,"YANG YANG",KAMB,"H1 THIEWELLE",2,3,19,11,30
LOUGA,LINGUERE,"YANG YANG",KAMB,"GUEDJI NAMASS",13,17,71,52,123
LOUGA,LINGUERE,"YANG YANG",KAMB,"GUENT AHMETH GUELY (OURO SAMBA)",3,5,20,18,38
LOUGA,LINGUERE,"YANG YANG",KAMB,"KAMARA OUOLOF",7,8,38,33,71
LOUGA,LINGUERE,"YANG YANG",KAMB,"KAMARA PEULH",4,4,8,8,16
LOUGA,LINGUERE,"YANG YANG",KAMB,KAMB,41,61,161,171,332
LOUGA,LINGUERE,"YANG YANG",KAMB,"H1 DEPAL DECK REYE",5,10,26,36,62
LOUGA,LINGUERE,"YANG YANG",KAMB,"KEBE KHAKHAM",27,44,165,163,328
LOUGA,LINGUERE,"YANG YANG",KAMB,"KEBE THIANOR",3,12,26,40,66
LOUGA,LINGUERE,"YANG YANG",KAMB,"KERLANE MAURE",7,7,28,35,63
LOUGA,LINGUERE,"YANG YANG",KAMB,"KERLANE PEULH",3,6,6,10,16
LOUGA,LINGUERE,"YANG YANG",KAMB,"LOUYE OUOLOF",23,32,180,152,332
LOUGA,LINGUERE,"YANG YANG",KAMB,"LOUYE PEULH",6,17,63,67,130
LOUGA,LINGUERE,"YANG YANG",KAMB,"MALEME (LEGNE)",33,41,194,156,350
LOUGA,LINGUERE,"YANG YANG",KAMB,"H1 BOFI",11,18,83,84,167
LOUGA,LINGUERE,"YANG YANG",KAMB,"MBADIENE OUOLOF",3,4,21,22,43
LOUGA,LINGUERE,"YANG YANG",KAMB,"H1 KOYLEL DECK REYE",7,10,24,28,52
LOUGA,LINGUERE,"YANG YANG",KAMB,"H2 KOYLEL DECK REYE",13,14,42,43,85
LOUGA,LINGUERE,"YANG YANG",KAMB,"MBADIENE PEULH",4,4,11,10,21
LOUGA,LINGUERE,"YANG YANG",KAMB,"H1 MBADIENE DECK REYE I",9,12,43,43,86
LOUGA,LINGUERE,"YANG YANG",KAMB,"H2 BELEL BOURKY",4,5,20,19,39
LOUGA,LINGUERE,"YANG YANG",KAMB,"MBAYENE THIASDE",58,75,381,316,697
LOUGA,LINGUERE,"YANG YANG",KAMB,"MBETHIO DIAOBE",14,29,86,86,172
LOUGA,LINGUERE,"YANG YANG",KAMB,"MBETHIO 2",9,19,56,73,129
LOUGA,LINGUERE,"YANG YANG",KAMB,"MBETHIO OURO SENO",12,20,64,59,123
LOUGA,LINGUERE,"YANG YANG",KAMB,"MBETHIO PEULH",12,13,51,48,99
LOUGA,LINGUERE,"YANG YANG",KAMB,"MBEYENE BISNABE",35,69,122,197,319
LOUGA,LINGUERE,"YANG YANG",KAMB,MOUYE,35,40,159,183,342
LOUGA,LINGUERE,"YANG YANG",KAMB,"NAWEL OUROURBE",18,35,103,153,256
LOUGA,LINGUERE,"YANG YANG",KAMB,"NAWEL THIANOR",1,4,13,8,21
LOUGA,LINGUERE,"YANG YANG",KAMB,"NDIARNO OUOLOF",30,31,97,133,230
LOUGA,LINGUERE,"YANG YANG",KAMB,"H1 NDIAO",5,10,35,30,65
LOUGA,LINGUERE,"YANG YANG",KAMB,NDIPA,3,5,19,19,38
LOUGA,LINGUERE,"YANG YANG",KAMB,NDOTHIE,51,66,256,331,587
LOUGA,LINGUERE,"YANG YANG",KAMB,"NGOLO ALY",10,11,29,28,57
LOUGA,LINGUERE,"YANG YANG",KAMB,"NGOLO DIABA",4,8,24,32,56
LOUGA,LINGUERE,"YANG YANG",KAMB,"H1 WENDOU WANDE",3,7,15,29,44
LOUGA,LINGUERE,"YANG YANG",KAMB,"NGOLO IBRAHIMA",9,15,38,37,75
LOUGA,LINGUERE,"YANG YANG",KAMB,"NGOLO MBELOGNE I",10,11,21,34,55
LOUGA,LINGUERE,"YANG YANG",KAMB,"NGOLO MBELOGNE II",7,8,12,18,30
LOUGA,LINGUERE,"YANG YANG",KAMB,"NIAMINA PEULH",9,36,74,68,142
LOUGA,LINGUERE,"YANG YANG",KAMB,"NIAMINA TOURE (NIAMINA FORAGE)",7,18,31,31,62
LOUGA,LINGUERE,"YANG YANG",KAMB,"ROTO ERY",18,22,89,84,173
LOUGA,LINGUERE,"YANG YANG",KAMB,"ROTO 1",8,13,48,45,93
LOUGA,LINGUERE,"YANG YANG",KAMB,"SARE DOCKY",11,18,59,54,113
LOUGA,LINGUERE,"YANG YANG",KAMB,"H2 BELEL",5,19,35,36,71
LOUGA,LINGUERE,"YANG YANG",KAMB,"SINGATE DIAM WELI",4,5,27,31,58
LOUGA,LINGUERE,"YANG YANG",KAMB,"SINGATE DEMBA DIOUBO (MAKHAM)",15,23,75,87,162
LOUGA,LINGUERE,"YANG YANG",KAMB,THIANKHE,15,37,97,94,191
LOUGA,LINGUERE,"YANG YANG",KAMB,THICOGNE,51,71,321,343,664
LOUGA,LINGUERE,"YANG YANG",KAMB,"WENDOU KODIALAL",3,6,27,26,53
LOUGA,LINGUERE,"YANG YANG",KAMB,"DADAL DADO",25,28,88,101,189
LOUGA,LINGUERE,"YANG YANG",KAMB,"DAGA THIAMBENE",11,17,86,104,190
LOUGA,LINGUERE,"YANG YANG",KAMB,"DEMBA DIARNO 2",5,8,17,23,40
LOUGA,LINGUERE,"YANG YANG",KAMB,NDIAKHATE,6,6,38,36,74
LOUGA,LINGUERE,"YANG YANG",MBOULA,"BELEL DABAL",30,37,127,140,267
LOUGA,LINGUERE,"YANG YANG",MBOULA,"BELEL SAMBEYE",11,20,46,78,124
LOUGA,LINGUERE,"YANG YANG",MBOULA,"H1 BELELE SILEYE",5,18,51,47,98
LOUGA,LINGUERE,"YANG YANG",MBOULA,"KLIF DECK (BOBARAL)",8,14,30,51,81
LOUGA,LINGUERE,"YANG YANG",MBOULA,"BOCKY MBALOU",24,36,111,126,237
LOUGA,LINGUERE,"YANG YANG",MBOULA,"BOCKY NDAO",11,14,33,48,81
LOUGA,LINGUERE,"YANG YANG",MBOULA,"H1 GOUBY",20,33,88,98,186
LOUGA,LINGUERE,"YANG YANG",MBOULA,"BOCKY THIANDEL",19,29,103,134,237
LOUGA,LINGUERE,"YANG YANG",MBOULA,"BOGUEL NDIAYENE",3,6,10,19,29
LOUGA,LINGUERE,"YANG YANG",MBOULA,"H1 KODIOLELE",4,6,13,15,28
LOUGA,LINGUERE,"YANG YANG",MBOULA,DORO,11,17,30,47,77
LOUGA,LINGUERE,"YANG YANG",MBOULA,"H1 BARKEWY",12,20,63,64,127
LOUGA,LINGUERE,"YANG YANG",MBOULA,FEDIOBE,3,15,35,56,91
LOUGA,LINGUERE,"YANG YANG",MBOULA,"KLIF GALEYEL 2",12,14,34,54,88
LOUGA,LINGUERE,"YANG YANG",MBOULA,"KLIF GALEYEL 3 (WOURO BEYE)",12,13,31,39,70
LOUGA,LINGUERE,"YANG YANG",MBOULA,"H1 WENDOU KADOU",14,21,56,58,114
LOUGA,LINGUERE,"YANG YANG",MBOULA,"KLIF SENENE",24,37,103,149,252
LOUGA,LINGUERE,"YANG YANG",MBOULA,"KODIOLELE 1",7,9,26,35,61
LOUGA,LINGUERE,"YANG YANG",MBOULA,"KODIOLELE 2",6,12,28,55,83
LOUGA,LINGUERE,"YANG YANG",MBOULA,"KOTHIEDIE AYRE",7,16,47,54,101
LOUGA,LINGUERE,"YANG YANG",MBOULA,"KOTHIEDIE MAURE",3,6,27,28,55
LOUGA,LINGUERE,"YANG YANG",MBOULA,"KOYLI ALPHA",38,67,479,277,756
LOUGA,LINGUERE,"YANG YANG",MBOULA,"NDIAYENE DIATMY",2,5,16,14,30
LOUGA,LINGUERE,"YANG YANG",MBOULA,"LOUMBY DIATBE",5,7,16,16,32
LOUGA,LINGUERE,"YANG YANG",MBOULA,"LOUMBY SANARABE",9,12,40,40,80
LOUGA,LINGUERE,"YANG YANG",MBOULA,"KOTHIEDIE KEUR DARY",26,37,153,186,339
LOUGA,LINGUERE,"YANG YANG",MBOULA,"MBELOGNE BOULBY",11,26,108,130,238
LOUGA,LINGUERE,"YANG YANG",MBOULA,"MBEYENE BISSINABE",13,16,47,54,101
LOUGA,LINGUERE,"YANG YANG",MBOULA,"MBEYENE BISSIRNABE 2",6,13,25,28,53
LOUGA,LINGUERE,"YANG YANG",MBOULA,"MBEYENE WOLOF",21,26,191,144,335
LOUGA,LINGUERE,"YANG YANG",MBOULA,MBOULA,107,115,594,749,1343
LOUGA,LINGUERE,"YANG YANG",MBOULA,MBOYNANE,35,41,108,167,275
LOUGA,LINGUERE,"YANG YANG",MBOULA,"MEDINA ALPHA",11,27,118,150,268
LOUGA,LINGUERE,"YANG YANG",MBOULA,"NEGUE BISSIRNABE",10,13,42,57,99
LOUGA,LINGUERE,"YANG YANG",MBOULA,"H2 NAWEL OUROURBE",23,31,69,96,165
LOUGA,LINGUERE,"YANG YANG",MBOULA,"NEGUE OUOLOF",27,35,197,203,400
LOUGA,LINGUERE,"YANG YANG",MBOULA,"THILAL LAOBE",11,26,92,75,167
LOUGA,LINGUERE,"YANG YANG",MBOULA,"WOURO SENO",9,15,36,49,85
LOUGA,LINGUERE,"YANG YANG",MBOULA,"BELAL THIASKY",7,7,21,25,46
LOUGA,LINGUERE,"YANG YANG",MBOULA,"BOBARAL 1",3,6,14,20,34
LOUGA,LINGUERE,"YANG YANG",MBOULA,"BOBORAL 2",2,4,13,14,27
LOUGA,LINGUERE,"YANG YANG",MBOULA,DIATMAL,5,7,24,31,55
LOUGA,LINGUERE,"YANG YANG",MBOULA,DIEKKUKI,7,11,35,44,79
LOUGA,LINGUERE,"YANG YANG",MBOULA,"GOUREL MALEL",3,6,7,17,24
LOUGA,LINGUERE,"YANG YANG",MBOULA,KERFEDIE,3,11,33,35,68
LOUGA,LINGUERE,"YANG YANG",MBOULA,"KEUR KODE (WOURO KODE)",10,16,47,61,108
LOUGA,LINGUERE,"YANG YANG",MBOULA,"KILIF DECK 2",2,5,20,24,44
LOUGA,LINGUERE,"YANG YANG",MBOULA,"KILIF WOURO YERO DIME",10,15,35,61,96
LOUGA,LINGUERE,"YANG YANG",MBOULA,"KLIF GALAYEL 1",15,22,46,77,123
LOUGA,LINGUERE,"YANG YANG",MBOULA,"KLIF WOURO CHEIKHOU",5,9,23,41,64
LOUGA,LINGUERE,"YANG YANG",MBOULA,"KOYLI ARDA",1,2,6,7,13
LOUGA,LINGUERE,"YANG YANG",MBOULA,"LOUMBY ARABOBE",8,13,48,45,93
LOUGA,LINGUERE,"YANG YANG",MBOULA,MBANDE,19,26,83,104,187
LOUGA,LINGUERE,"YANG YANG",MBOULA,"MBAYE AWA",31,34,187,220,407
LOUGA,LINGUERE,"YANG YANG",MBOULA,"MBAYE AWA AYRE",17,23,103,90,193
LOUGA,LINGUERE,"YANG YANG",MBOULA,"MBELOGNE KADJI",22,26,72,79,151
LOUGA,LINGUERE,"YANG YANG",MBOULA,"MBELOGNE KELLE",9,12,63,50,113
LOUGA,LINGUERE,"YANG YANG",MBOULA,MBILO,7,9,22,27,49
LOUGA,LINGUERE,"YANG YANG",MBOULA,"MEDINA MBANDE",3,5,18,17,35
LOUGA,LINGUERE,"YANG YANG",MBOULA,PALIBA,3,6,16,23,39
LOUGA,LINGUERE,"YANG YANG",MBOULA,"THIAT NGAL",3,3,13,10,23
LOUGA,LINGUERE,"YANG YANG",MBOULA,"WENDOU KODIOLEL",7,9,29,25,54
LOUGA,LINGUERE,"YANG YANG",MBOULA,"WENDOU PETHIE",5,8,20,22,42
LOUGA,LINGUERE,"YANG YANG","TESSEKERE FORAGE","AMALY 1",3,10,44,45,89
LOUGA,LINGUERE,"YANG YANG","TESSEKERE FORAGE","AMALY 2",6,8,31,30,61
LOUGA,LINGUERE,"YANG YANG","TESSEKERE FORAGE","H1 DE AMALY 2",4,15,34,45,79
LOUGA,LINGUERE,"YANG YANG","TESSEKERE FORAGE","AMALY 3",5,5,24,20,44
LOUGA,LINGUERE,"YANG YANG","TESSEKERE FORAGE","AMALY 4",2,2,21,36,57
LOUGA,LINGUERE,"YANG YANG","TESSEKERE FORAGE","AMALY MAURE",11,11,39,25,64
LOUGA,LINGUERE,"YANG YANG","TESSEKERE FORAGE","BALDIENE SOWENABE",5,7,27,24,51
LOUGA,LINGUERE,"YANG YANG","TESSEKERE FORAGE","H1 KENIEDJI",16,20,90,100,190
LOUGA,LINGUERE,"YANG YANG","TESSEKERE FORAGE","H2 WOURO OUSSEL",3,3,5,9,14
LOUGA,LINGUERE,"YANG YANG","TESSEKERE FORAGE","H3 SAMBOY",4,6,20,24,44
LOUGA,LINGUERE,"YANG YANG","TESSEKERE FORAGE","BAYTIL MAKHDISS (BOGAL DANAYAL II)",6,10,20,37,57
LOUGA,LINGUERE,"YANG YANG","TESSEKERE FORAGE","BEDE PAMPINABE",12,42,113,122,235
LOUGA,LINGUERE,"YANG YANG","TESSEKERE FORAGE","H1 85 WOURO DEMBA GALEL BA",2,8,14,21,35
LOUGA,LINGUERE,"YANG YANG","TESSEKERE FORAGE","BELEL BAWAMY",15,32,124,115,239
LOUGA,LINGUERE,"YANG YANG","TESSEKERE FORAGE","BELEL DOUTEY 1",17,27,64,91,155
LOUGA,LINGUERE,"YANG YANG","TESSEKERE FORAGE","BELEL HOTONDE",13,28,71,78,149
LOUGA,LINGUERE,"YANG YANG","TESSEKERE FORAGE","BELEL MOUTHIETEKY",7,9,22,27,49
LOUGA,LINGUERE,"YANG YANG","TESSEKERE FORAGE","BELEL NAMARY",14,24,71,92,163
LOUGA,LINGUERE,"YANG YANG","TESSEKERE FORAGE","BELEL NDOULO",15,40,102,100,202
LOUGA,LINGUERE,"YANG YANG","TESSEKERE FORAGE","BELEL SAMBA",2,4,19,22,41
LOUGA,LINGUERE,"YANG YANG","TESSEKERE FORAGE","BOCKY SAKEYAL",14,28,83,79,162
LOUGA,LINGUERE,"YANG YANG","TESSEKERE FORAGE","BOCKY THIAWO",10,18,77,72,149
LOUGA,LINGUERE,"YANG YANG","TESSEKERE FORAGE","H1 MBELOGNE SIROBE",5,7,22,27,49
LOUGA,LINGUERE,"YANG YANG","TESSEKERE FORAGE","BOGAL DANAYAL 1",5,11,50,53,103
LOUGA,LINGUERE,"YANG YANG","TESSEKERE FORAGE","BOWDY DIOYE",10,17,42,61,103
LOUGA,LINGUERE,"YANG YANG","TESSEKERE FORAGE","DIABE SOWNABE",19,32,123,134,257
LOUGA,LINGUERE,"YANG YANG","TESSEKERE FORAGE","GANINA SAMBOUROU",9,14,43,60,103
LOUGA,LINGUERE,"YANG YANG","TESSEKERE FORAGE","GANINAYEL I (GANINAYEL BAKARNABE)",3,11,30,30,60
LOUGA,LINGUERE,"YANG YANG","TESSEKERE FORAGE","GANINAYEL WODABE",6,10,35,44,79
LOUGA,LINGUERE,"YANG YANG","TESSEKERE FORAGE","GUENT BOUBOU",9,15,39,46,85
LOUGA,LINGUERE,"YANG YANG","TESSEKERE FORAGE",LABARDY,10,30,100,86,186
LOUGA,LINGUERE,"YANG YANG","TESSEKERE FORAGE","LABARDY PAMPINABE",7,14,27,39,66
LOUGA,LINGUERE,"YANG YANG","TESSEKERE FORAGE","LOUMBOL GALELE",4,14,22,39,61
LOUGA,LINGUERE,"YANG YANG","TESSEKERE FORAGE","LOUMBOL GAWDY THIADNGOL",16,25,86,111,197
LOUGA,LINGUERE,"YANG YANG","TESSEKERE FORAGE","H1 LOUMBOL GAWDY BALDIOLI FORAGE 2",4,7,8,21,29
LOUGA,LINGUERE,"YANG YANG","TESSEKERE FORAGE","LOUMBOL GAWDY SENO 1",10,23,75,94,169
LOUGA,LINGUERE,"YANG YANG","TESSEKERE FORAGE","LOUMBOL GAWDY BALDIOL",32,59,171,232,403
LOUGA,LINGUERE,"YANG YANG","TESSEKERE FORAGE","LOUMBOL GAWDY SENO 2",6,10,47,42,89
LOUGA,LINGUERE,"YANG YANG","TESSEKERE FORAGE","LOUMBY YORO",23,34,113,121,234
LOUGA,LINGUERE,"YANG YANG","TESSEKERE FORAGE","H1 LOUMBY YORE",7,9,23,41,64
LOUGA,LINGUERE,"YANG YANG","TESSEKERE FORAGE","LOUMBI YORE",8,10,55,65,120
LOUGA,LINGUERE,"YANG YANG","TESSEKERE FORAGE","MEDINA RANDE",9,18,67,74,141
LOUGA,LINGUERE,"YANG YANG","TESSEKERE FORAGE","NGOLKA DIABY 1",30,82,193,202,395
LOUGA,LINGUERE,"YANG YANG","TESSEKERE FORAGE","NGOLKA DIABY 2",5,6,18,26,44
LOUGA,LINGUERE,"YANG YANG","TESSEKERE FORAGE","NGOLKA BISNABE",14,20,100,92,192
LOUGA,LINGUERE,"YANG YANG","TESSEKERE FORAGE",RANDE,7,9,26,38,64
LOUGA,LINGUERE,"YANG YANG","TESSEKERE FORAGE","SOUMP 1",5,5,15,24,39
LOUGA,LINGUERE,"YANG YANG","TESSEKERE FORAGE","SOUMP 2",30,34,157,150,307
LOUGA,LINGUERE,"YANG YANG","TESSEKERE FORAGE","TESSEKRE BISSINABE",25,42,120,140,260
LOUGA,LINGUERE,"YANG YANG","TESSEKERE FORAGE","H2 WOURO SIDY BOUCAR DEME",1,1,8,3,11
LOUGA,LINGUERE,"YANG YANG","TESSEKERE FORAGE","TESSEKRE FORAGE 1",5,5,15,17,32
LOUGA,LINGUERE,"YANG YANG","TESSEKERE FORAGE","H1 FORAGE 1",5,9,17,30,47
LOUGA,LINGUERE,"YANG YANG","TESSEKERE FORAGE","H2 ANTENNE I0",2,2,8,10,18
LOUGA,LINGUERE,"YANG YANG","TESSEKERE FORAGE","TESSEKRE FORAGE 2",10,19,68,54,122
LOUGA,LINGUERE,"YANG YANG","TESSEKERE FORAGE","TESSEKRE FORAGE 3",2,4,10,10,20
LOUGA,LINGUERE,"YANG YANG","TESSEKERE FORAGE","TESSEKRE OUOLOF",32,36,112,98,210
LOUGA,LINGUERE,"YANG YANG","TESSEKERE FORAGE","TESSEKRE WENDOU DIABY",8,9,30,39,69
LOUGA,LINGUERE,"YANG YANG","TESSEKERE FORAGE",THIAMBALEDIA,9,15,63,62,125
LOUGA,LINGUERE,"YANG YANG","TESSEKERE FORAGE","THIAMBALEDIA BAKARNABE",9,11,31,36,67
LOUGA,LINGUERE,"YANG YANG","TESSEKERE FORAGE","THILELE BAKARNABE",23,42,147,152,299
LOUGA,LINGUERE,"YANG YANG","TESSEKERE FORAGE","THIOVE PAMPINABE",4,7,22,19,41
LOUGA,LINGUERE,"YANG YANG","TESSEKERE FORAGE","THIOVE THIDAR 1",4,15,39,43,82
LOUGA,LINGUERE,"YANG YANG","TESSEKERE FORAGE","THIOVE THIDAR 2",9,33,56,73,129
LOUGA,LINGUERE,"YANG YANG","TESSEKERE FORAGE","THIOVE THIDAR 3",3,9,24,32,56
LOUGA,LINGUERE,"YANG YANG","TESSEKERE FORAGE",WALAKOSS,4,5,19,23,42
LOUGA,LINGUERE,"YANG YANG","TESSEKERE FORAGE",WALANDE,6,17,42,47,89
LOUGA,LINGUERE,"YANG YANG","TESSEKERE FORAGE","H2 MEWEUL PEULH",2,7,26,23,49
LOUGA,LINGUERE,"YANG YANG","TESSEKERE FORAGE","WEDOU THINGOLY BISNABE",10,35,86,90,176
LOUGA,LINGUERE,"YANG YANG","TESSEKERE FORAGE","WIDOU THINGOLY FORAGE",1,1,4,3,7
LOUGA,LINGUERE,"YANG YANG","TESSEKERE FORAGE","WEDOU THINGOLY 1",6,16,37,41,78
LOUGA,LINGUERE,"YANG YANG","TESSEKERE FORAGE","WEDOU THINGOLY 2",3,14,30,34,64
LOUGA,LINGUERE,"YANG YANG","TESSEKERE FORAGE","WEDOU THINGOLY 3",4,11,38,38,76
LOUGA,LINGUERE,"YANG YANG","TESSEKERE FORAGE","WEDOU THINGOLY MAURE",12,25,107,109,216
LOUGA,LINGUERE,"YANG YANG","TESSEKERE FORAGE","WENDOU BOCKY",7,11,47,66,113
LOUGA,LINGUERE,"YANG YANG","TESSEKERE FORAGE","WENDOU DIABY",12,29,202,181,383
LOUGA,LINGUERE,"YANG YANG","TESSEKERE FORAGE","H1 WENDOU BOCKY",5,6,51,43,94
LOUGA,LINGUERE,"YANG YANG","TESSEKERE FORAGE","WENDOU DOCKY",11,18,40,24,64
LOUGA,LINGUERE,"YANG YANG","TESSEKERE FORAGE","H1 FANDONY",13,13,34,46,80
LOUGA,LINGUERE,"YANG YANG","TESSEKERE FORAGE","WENDOU MBARODJI",7,11,40,42,82
LOUGA,LINGUERE,"YANG YANG","TESSEKERE FORAGE","WENDOU NAMARY",10,39,92,114,206
LOUGA,LINGUERE,"YANG YANG","TESSEKERE FORAGE","WENDOU PAMPINABE",27,45,180,176,356
LOUGA,LINGUERE,"YANG YANG","TESSEKERE FORAGE","WENDOU THIOMBY 1",10,16,77,85,162
LOUGA,LINGUERE,"YANG YANG","TESSEKERE FORAGE","WENDOU THIOMBY 2",5,12,50,48,98
LOUGA,LINGUERE,"YANG YANG","TESSEKERE FORAGE","H1 WENDOU SAMBA DOULO",1,2,5,8,13
LOUGA,LINGUERE,"YANG YANG","TESSEKERE FORAGE","BELLY DIABÈ DEMBA BATHIE",10,17,73,81,154
LOUGA,LINGUERE,"YANG YANG","TESSEKERE FORAGE","BOGUEL GUAYE",10,30,85,87,172
LOUGA,LINGUERE,"YANG YANG","TESSEKERE FORAGE","DAROU SALAM BELEL BAWAMY",18,30,88,96,184
LOUGA,LINGUERE,"YANG YANG","TESSEKERE FORAGE","GANINAYEL BISNABE 2",1,8,59,56,115
LOUGA,LINGUERE,"YANG YANG","TESSEKERE FORAGE",HAOURE,2,11,30,24,54
LOUGA,LINGUERE,"YANG YANG","TESSEKERE FORAGE","LABARDY 2",6,9,15,32,47
LOUGA,LINGUERE,"YANG YANG","TESSEKERE FORAGE","LOUMBY DIABY",6,9,30,17,47
LOUGA,LINGUERE,"YANG YANG","TESSEKERE FORAGE","MBOKY BILALY",3,8,40,34,74
LOUGA,LINGUERE,"YANG YANG","TESSEKERE FORAGE","MEDINA BA",11,15,34,77,111
LOUGA,LINGUERE,"YANG YANG","TESSEKERE FORAGE","NGOLKA 2",5,13,59,62,121
LOUGA,LINGUERE,"YANG YANG","TESSEKERE FORAGE","PAMPINABE 2",7,25,58,56,114
LOUGA,LINGUERE,"YANG YANG","TESSEKERE FORAGE","THIOWE SAMBA COURA",2,7,12,23,35
LOUGA,LINGUERE,"YANG YANG","TESSEKERE FORAGE","WENDOU BOUBOU",2,5,11,11,22
LOUGA,LINGUERE,"YANG YANG","TESSEKERE FORAGE","WENDOU DELBY (LINGUÈRE)",9,23,44,51,95
LOUGA,LINGUERE,"YANG YANG","TESSEKERE FORAGE","WENDOU KOYLY",7,15,31,39,70
LOUGA,LINGUERE,"YANG YANG","TESSEKERE FORAGE","WENDOU SENO",1,2,5,6,11
LOUGA,LINGUERE,"YANG YANG","TESSEKERE FORAGE","WENDOU WANDE",8,15,25,33,58
LOUGA,LINGUERE,"YANG YANG","TESSEKERE FORAGE","WIDOU THINGOLY 1",3,3,11,15,26
LOUGA,LINGUERE,"YANG YANG","TESSEKERE FORAGE","WIDOU THINGOLY 4",1,1,1,0,1
LOUGA,LINGUERE,"YANG YANG","TESSEKERE FORAGE","WIDOU THINGOLY CENTRE",13,15,59,59,118
LOUGA,LINGUERE,"YANG YANG","TESSEKERE FORAGE","WIDOU THINGOLY MAURE",9,9,34,24,58
LOUGA,LINGUERE,"YANG YANG","YANG YANG","BELLY KODIOLEL",13,27,109,96,205
LOUGA,LINGUERE,"YANG YANG","YANG YANG","DAKHAR MBOUNDOU",4,5,19,18,37
LOUGA,LINGUERE,"YANG YANG","YANG YANG","DAKHAR MBOUNDOU THIOSSANE",2,4,22,25,47
LOUGA,LINGUERE,"YANG YANG","YANG YANG","DAROU SALAM THISSE",5,11,38,49,87
LOUGA,LINGUERE,"YANG YANG","YANG YANG","DIABE SAPO AYRE",7,8,17,23,40
LOUGA,LINGUERE,"YANG YANG","YANG YANG","DIABE SAPO 1",7,12,30,46,76
LOUGA,LINGUERE,"YANG YANG","YANG YANG","DIABE SAPO 2 (DIABE SAPO NERE)",11,17,33,44,77
LOUGA,LINGUERE,"YANG YANG","YANG YANG","DIABE SAPO SENO",5,8,26,18,44
LOUGA,LINGUERE,"YANG YANG","YANG YANG","DIABE SAPO THIANOR",1,2,8,7,15
LOUGA,LINGUERE,"YANG YANG","YANG YANG","NDAGANTOU PEULH",11,22,86,70,156
LOUGA,LINGUERE,"YANG YANG","YANG YANG","GUENT KHOSS",3,9,37,43,80
LOUGA,LINGUERE,"YANG YANG","YANG YANG","KADD PEULH",19,45,164,167,331
LOUGA,LINGUERE,"YANG YANG","YANG YANG","H1 CROISEMENT NIOUKOULOU",5,6,6,28,34
LOUGA,LINGUERE,"YANG YANG","YANG YANG","H2 MBELOGNE",9,11,45,51,96
LOUGA,LINGUERE,"YANG YANG","YANG YANG","KALOSSY OUOLOF",34,42,154,182,336
LOUGA,LINGUERE,"YANG YANG","YANG YANG","H1 MBAMBA",6,10,50,56,106
LOUGA,LINGUERE,"YANG YANG","YANG YANG",KOURKOKE,3,7,28,29,57
LOUGA,LINGUERE,"YANG YANG","YANG YANG","MEVELLE DIALLOUBE",8,16,46,36,82
LOUGA,LINGUERE,"YANG YANG","YANG YANG","MEVELLE MBATHIOR",2,3,8,14,22
LOUGA,LINGUERE,"YANG YANG","YANG YANG","MEVELLE OUOLOF",16,19,133,120,253
LOUGA,LINGUERE,"YANG YANG","YANG YANG","MEVELLE PEULH",57,123,343,377,720
LOUGA,LINGUERE,"YANG YANG","YANG YANG","MEVELLE THIAWO",6,14,42,50,92
LOUGA,LINGUERE,"YANG YANG","YANG YANG","NDALLA AIRANCOBE",25,37,102,120,222
LOUGA,LINGUERE,"YANG YANG","YANG YANG","NDALLA HAMADY",11,17,59,70,129
LOUGA,LINGUERE,"YANG YANG","YANG YANG",NDIANE,17,22,70,76,146
LOUGA,LINGUERE,"YANG YANG","YANG YANG","H1 NDIANE PEULH",6,10,24,28,52
LOUGA,LINGUERE,"YANG YANG","YANG YANG","H2 NDIANE 2",6,6,12,22,34
LOUGA,LINGUERE,"YANG YANG","YANG YANG","NDIAYENE SABOUR 1",6,13,31,43,74
LOUGA,LINGUERE,"YANG YANG","YANG YANG","NDIAYENE SABOUR 2",9,12,61,71,132
LOUGA,LINGUERE,"YANG YANG","YANG YANG","H1 DIABE SAPO",2,3,8,8,16
LOUGA,LINGUERE,"YANG YANG","YANG YANG","NGOUYE DIERY",49,56,184,213,397
LOUGA,LINGUERE,"YANG YANG","YANG YANG","NGOUYE DIERY PEULH",11,15,42,40,82
LOUGA,LINGUERE,"YANG YANG","YANG YANG","NGUER FORAGE",2,2,11,7,18
LOUGA,LINGUERE,"YANG YANG","YANG YANG","NGUER THIASKY",4,9,34,33,67
LOUGA,LINGUERE,"YANG YANG","YANG YANG","NGUER WENDOU",15,25,99,75,174
LOUGA,LINGUERE,"YANG YANG","YANG YANG","THIELAL GOBEDIELY",8,18,86,72,158
LOUGA,LINGUERE,"YANG YANG","YANG YANG","THIEWELE DIAOBE",5,8,35,50,85
LOUGA,LINGUERE,"YANG YANG","YANG YANG","THIEWELE OUROUR",10,15,61,65,126
LOUGA,LINGUERE,"YANG YANG","YANG YANG",TONGO,18,21,96,91,187
LOUGA,LINGUERE,"YANG YANG","YANG YANG","YANG YANG",41,42,288,245,533
LOUGA,LINGUERE,"YANG YANG","YANG YANG","H1 THISSE",13,17,69,58,127
LOUGA,LINGUERE,"YANG YANG","YANG YANG","YENGUE THIENGUE",2,6,27,16,43
LOUGA,LINGUERE,"YANG YANG",MBEULEUKHE,"MEVEL POKHO",18,20,97,79,176
LOUGA,LINGUERE,"YANG YANG",MBEULEUKHE,NDIAME,67,70,358,404,762
LOUGA,LINGUERE,"YANG YANG",MBEULEUKHE,POKHO,58,64,280,336,616
LOUGA,LINGUERE,"YANG YANG",MBEULEUKHE,THIARENE,35,37,236,178,414
LOUGA,LINGUERE,"SAGATTA DJOLOF",BOULAL,BARKEDJI,13,20,83,58,141
LOUGA,LINGUERE,"SAGATTA DJOLOF",BOULAL,"H1 LOUMBI DADI",7,14,46,30,76
LOUGA,LINGUERE,"SAGATTA DJOLOF",BOULAL,"BEL THIASKY (BOCKY)",36,45,185,130,315
LOUGA,LINGUERE,"SAGATTA DJOLOF",BOULAL,"BEL THIASKY MAURE",12,15,50,67,117
LOUGA,LINGUERE,"SAGATTA DJOLOF",BOULAL,"BEL THIASKY MBARA",4,4,8,12,20
LOUGA,LINGUERE,"SAGATTA DJOLOF",BOULAL,"BELEL BOCKY",11,15,47,28,75
LOUGA,LINGUERE,"SAGATTA DJOLOF",BOULAL,"H1 WALALANE",10,14,30,37,67
LOUGA,LINGUERE,"SAGATTA DJOLOF",BOULAL,"BELEL SAMBOUGA",1,1,1,3,4
LOUGA,LINGUERE,"SAGATTA DJOLOF",BOULAL,"BELEL THIOMBE",18,21,63,126,189
LOUGA,LINGUERE,"SAGATTA DJOLOF",BOULAL,"BOCKY SAMBOUDOU 1",8,9,18,37,55
LOUGA,LINGUERE,"SAGATTA DJOLOF",BOULAL,"BOCKY SAMBOUDOU 2",11,14,39,44,83
LOUGA,LINGUERE,"SAGATTA DJOLOF",BOULAL,BOULAL,214,238,1054,1141,2195
LOUGA,LINGUERE,"SAGATTA DJOLOF",BOULAL,"H1 BOULAL MBAPNABE",8,8,47,45,92
LOUGA,LINGUERE,"SAGATTA DJOLOF",BOULAL,"BOULI REOBE",9,14,29,36,65
LOUGA,LINGUERE,"SAGATTA DJOLOF",BOULAL,"WENDOU BOCKY",13,16,42,60,102
LOUGA,LINGUERE,"SAGATTA DJOLOF",BOULAL,"DABANEL BOCKY 1",19,60,180,186,366
LOUGA,LINGUERE,"SAGATTA DJOLOF",BOULAL,"DAGA KOYLOGNE PAMPI",6,13,40,34,74
LOUGA,LINGUERE,"SAGATTA DJOLOF",BOULAL,DANTHIALY,6,19,63,67,130
LOUGA,LINGUERE,"SAGATTA DJOLOF",BOULAL,DEPAL,7,10,32,30,62
LOUGA,LINGUERE,"SAGATTA DJOLOF",BOULAL,"DEPE KELLE",7,13,59,51,110
LOUGA,LINGUERE,"SAGATTA DJOLOF",BOULAL,"DIGANTE MAURE",7,11,35,36,71
LOUGA,LINGUERE,"SAGATTA DJOLOF",BOULAL,DIOLDIOLETE,7,10,33,27,60
LOUGA,LINGUERE,"SAGATTA DJOLOF",BOULAL,"GARDI 1 (TOUBA)",8,19,50,54,104
LOUGA,LINGUERE,"SAGATTA DJOLOF",BOULAL,"TOUBA GARDI 1",2,3,14,14,28
LOUGA,LINGUERE,"SAGATTA DJOLOF",BOULAL,GOUEDIA,49,59,213,225,438
LOUGA,LINGUERE,"SAGATTA DJOLOF",BOULAL,GOURIKY,18,48,114,95,209
LOUGA,LINGUERE,"SAGATTA DJOLOF",BOULAL,"GUELY BEL THIASKY",7,9,31,16,47
LOUGA,LINGUERE,"SAGATTA DJOLOF",BOULAL,"GUELY LOUMBAL",12,12,58,60,118
LOUGA,LINGUERE,"SAGATTA DJOLOF",BOULAL,"GUELY YODI 1",5,7,15,15,30
LOUGA,LINGUERE,"SAGATTA DJOLOF",BOULAL,"HARAKE DEPE KELLE",11,11,56,39,95
LOUGA,LINGUERE,"SAGATTA DJOLOF",BOULAL,"KOILY MBARA MAURE",29,33,116,123,239
LOUGA,LINGUERE,"SAGATTA DJOLOF",BOULAL,"KOILY MBARA PEULH",8,10,43,27,70
LOUGA,LINGUERE,"SAGATTA DJOLOF",BOULAL,"KOYLI PEGNA PEULH (KEUR TIEDO SIRA)",5,7,32,22,54
LOUGA,LINGUERE,"SAGATTA DJOLOF",BOULAL,"KOYLOGNE MBAPP",5,12,34,34,68
LOUGA,LINGUERE,"SAGATTA DJOLOF",BOULAL,"KOYLOGNE PAMPI 1",10,23,77,63,140
LOUGA,LINGUERE,"SAGATTA DJOLOF",BOULAL,"KOYLOGNE PAMPI 2",11,21,98,78,176
LOUGA,LINGUERE,"SAGATTA DJOLOF",BOULAL,"LABA THIADAO 2",4,5,20,27,47
LOUGA,LINGUERE,"SAGATTA DJOLOF",BOULAL,"LOULENE PAMPI",5,11,29,25,54
LOUGA,LINGUERE,"SAGATTA DJOLOF",BOULAL,"LOUMBAL KORAL",11,18,64,51,115
LOUGA,LINGUERE,"SAGATTA DJOLOF",BOULAL,"LOUMBOL DOCKY",6,6,4,12,16
LOUGA,LINGUERE,"SAGATTA DJOLOF",BOULAL,"NDANDIAME BISSINABE 1",17,20,38,67,105
LOUGA,LINGUERE,"SAGATTA DJOLOF",BOULAL,"NDANDIAME BISSINABE 2 (WOUROU AYMEDOU)",18,32,107,136,243
LOUGA,LINGUERE,"SAGATTA DJOLOF",BOULAL,"NDANDIAME MAURE",11,17,69,65,134
LOUGA,LINGUERE,"SAGATTA DJOLOF",BOULAL,"NDIAO DIEWAL",31,51,174,171,345
LOUGA,LINGUERE,"SAGATTA DJOLOF",BOULAL,"NDIOUGOUP PEULH",20,26,134,132,266
LOUGA,LINGUERE,"SAGATTA DJOLOF",BOULAL,NELBY,5,6,27,33,60
LOUGA,LINGUERE,"SAGATTA DJOLOF",BOULAL,"H2 WENDOU KELLY",7,8,36,45,81
LOUGA,LINGUERE,"SAGATTA DJOLOF",BOULAL,PATOUDE,44,57,219,256,475
LOUGA,LINGUERE,"SAGATTA DJOLOF",BOULAL,"PETEL (GUELY BOULAL)",13,16,50,42,92
LOUGA,LINGUERE,"SAGATTA DJOLOF",BOULAL,"SOLMEO GUELY YODI",1,1,2,2,4
LOUGA,LINGUERE,"SAGATTA DJOLOF",BOULAL,"SEBETTE DJINGUIDIRA",32,36,157,146,303
LOUGA,LINGUERE,"SAGATTA DJOLOF",BOULAL,"THIEYENE 1",13,16,43,45,88
LOUGA,LINGUERE,"SAGATTA DJOLOF",BOULAL,"THIEYENE 2",2,2,11,8,19
LOUGA,LINGUERE,"SAGATTA DJOLOF",BOULAL,"THIEYENE MOURIDE (DAROU KHOUDOSS)",55,59,348,316,664
LOUGA,LINGUERE,"SAGATTA DJOLOF",BOULAL,"TOUBA PAKHA ( CAMBOUMAR)",31,39,171,158,329
LOUGA,LINGUERE,"SAGATTA DJOLOF",BOULAL,"WENDOU MAOUNDOU",4,4,9,11,20
LOUGA,LINGUERE,"SAGATTA DJOLOF",BOULAL,"WENDOU MOURTEKY 1",14,16,51,79,130
LOUGA,LINGUERE,"SAGATTA DJOLOF",BOULAL,"WENDOU MOURTEKY 2",15,17,61,43,104
LOUGA,LINGUERE,"SAGATTA DJOLOF",BOULAL,"H1 DIATMEL MBODERY",4,6,15,18,33
LOUGA,LINGUERE,"SAGATTA DJOLOF",BOULAL,"WENDOU NAMARY 1",20,25,65,72,137
LOUGA,LINGUERE,"SAGATTA DJOLOF",BOULAL,"WENDOU NAMARY 2",13,36,107,163,270
LOUGA,LINGUERE,"SAGATTA DJOLOF",BOULAL,"WENDOU WENDE MBAPP",7,11,26,31,57
LOUGA,LINGUERE,"SAGATTA DJOLOF",BOULAL,"YATTI 1",32,37,132,105,237
LOUGA,LINGUERE,"SAGATTA DJOLOF",BOULAL,"YATTI 2 (BAWAME)",21,27,131,128,259
LOUGA,LINGUERE,"SAGATTA DJOLOF",BOULAL,"BALAYEL KOLY",6,8,36,34,70
LOUGA,LINGUERE,"SAGATTA DJOLOF",BOULAL,"BOULY DIABY",5,5,26,14,40
LOUGA,LINGUERE,"SAGATTA DJOLOF",BOULAL,"DAROU SALAM HAROUNA",5,5,14,17,31
LOUGA,LINGUERE,"SAGATTA DJOLOF",BOULAL,"DIABEL NDOUR",8,14,67,67,134
LOUGA,LINGUERE,"SAGATTA DJOLOF",BOULAL,"DIATMEL MBODERY",7,7,32,18,50
LOUGA,LINGUERE,"SAGATTA DJOLOF",BOULAL,"GARDI 1",4,11,47,48,95
LOUGA,LINGUERE,"SAGATTA DJOLOF",BOULAL,"GARDI 2",2,2,9,14,23
LOUGA,LINGUERE,"SAGATTA DJOLOF",BOULAL,"GARDI KOYLI NGOTY",8,10,61,72,133
LOUGA,LINGUERE,"SAGATTA DJOLOF",BOULAL,"GUELY YODI II II",3,4,12,11,23
LOUGA,LINGUERE,"SAGATTA DJOLOF",BOULAL,LANEL,5,7,28,33,61
LOUGA,LINGUERE,"SAGATTA DJOLOF",BOULAL,"LOUMBA TENDOU BOULAL",4,4,25,21,46
LOUGA,LINGUERE,"SAGATTA DJOLOF",BOULAL,"LOUMBI GAWDI OUSMANE",3,4,5,11,16
LOUGA,LINGUERE,"SAGATTA DJOLOF",BOULAL,"NIMZATT DAROU RAHMANE DJOLOFF",3,4,48,23,71
LOUGA,LINGUERE,"SAGATTA DJOLOF",BOULAL,"SOLMEO BEL THIASKY",8,14,48,43,91
LOUGA,LINGUERE,"SAGATTA DJOLOF",BOULAL,THIETHIERLE,8,12,51,57,108
LOUGA,LINGUERE,"SAGATTA DJOLOF",BOULAL,THIEWELLE,12,17,48,57,105
LOUGA,LINGUERE,"SAGATTA DJOLOF",BOULAL,"WENDOU SEBBE 1",3,6,21,18,39
LOUGA,LINGUERE,"SAGATTA DJOLOF",BOULAL,"WENDOU SEBBE 2",14,18,65,61,126
LOUGA,LINGUERE,"SAGATTA DJOLOF",BOULAL,"YATTI 3",1,1,2,5,7
LOUGA,LINGUERE,"SAGATTA DJOLOF",BOULAL,"YATTI BELEL DARAL",3,3,4,9,13
LOUGA,LINGUERE,"SAGATTA DJOLOF",BOULAL,"YATTI BELEL GOLEDIE",5,9,35,47,82
LOUGA,LINGUERE,"SAGATTA DJOLOF",BOULAL,"YATTI MAOUNDOU",5,5,25,21,46
LOUGA,LINGUERE,"SAGATTA DJOLOF",BOULAL,"YODI THIOSSANE",4,7,30,18,48
LOUGA,LINGUERE,"SAGATTA DJOLOF",DEALY,ARMA,10,17,66,57,123
LOUGA,LINGUERE,"SAGATTA DJOLOF",DEALY,"BALLODJI OUOLOF",28,28,190,159,349
LOUGA,LINGUERE,"SAGATTA DJOLOF",DEALY,"BALLODJI SERERE",13,15,81,72,153
LOUGA,LINGUERE,"SAGATTA DJOLOF",DEALY,"H1 DAROU KHOUDOSS",9,10,55,53,108
LOUGA,LINGUERE,"SAGATTA DJOLOF",DEALY,"BARKAYEL MOLO",10,49,152,194,346
LOUGA,LINGUERE,"SAGATTA DJOLOF",DEALY,"BELEL DIAOBE",12,16,57,54,111
LOUGA,LINGUERE,"SAGATTA DJOLOF",DEALY,"BELLY DJICORY",13,26,117,190,307
LOUGA,LINGUERE,"SAGATTA DJOLOF",DEALY,"BELLY I",6,10,46,30,76
LOUGA,LINGUERE,"SAGATTA DJOLOF",DEALY,"BELLY II",8,14,76,58,134
LOUGA,LINGUERE,"SAGATTA DJOLOF",DEALY,"BOGO DEMBA DIAM",15,19,132,124,256
LOUGA,LINGUERE,"SAGATTA DJOLOF",DEALY,NDIAPPABA,16,16,104,88,192
LOUGA,LINGUERE,"SAGATTA DJOLOF",DEALY,BOYLI,14,25,170,141,311
LOUGA,LINGUERE,"SAGATTA DJOLOF",DEALY,"DAROU BOGO",24,27,241,129,370
LOUGA,LINGUERE,"SAGATTA DJOLOF",DEALY,"DAROU GUEYE",19,20,84,53,137
LOUGA,LINGUERE,"SAGATTA DJOLOF",DEALY,"DAROU KHOUDOSS",53,61,469,416,885
LOUGA,LINGUERE,"SAGATTA DJOLOF",DEALY,"H1 NASROU BOGO",11,11,73,25,98
LOUGA,LINGUERE,"SAGATTA DJOLOF",DEALY,"H2 DAROU GAYE",3,3,8,12,20
LOUGA,LINGUERE,"SAGATTA DJOLOF",DEALY,"DAROU SALAM MOURIDE",36,38,251,201,452
LOUGA,LINGUERE,"SAGATTA DJOLOF",DEALY,"H1 NAIDE NDIOBA",12,15,99,78,177
LOUGA,LINGUERE,"SAGATTA DJOLOF",DEALY,"H3 DAROU DIAW",13,13,79,66,145
LOUGA,LINGUERE,"SAGATTA DJOLOF",DEALY,"DAROU SAM FALL",9,11,67,48,115
LOUGA,LINGUERE,"SAGATTA DJOLOF",DEALY,"H1 DAROU FALL",11,11,59,36,95
LOUGA,LINGUERE,"SAGATTA DJOLOF",DEALY,"DAYLE I",12,20,75,59,134
LOUGA,LINGUERE,"SAGATTA DJOLOF",DEALY,"DAYLE II",13,22,94,95,189
LOUGA,LINGUERE,"SAGATTA DJOLOF",DEALY,DEALI,178,224,1037,916,1953
LOUGA,LINGUERE,"SAGATTA DJOLOF",DEALY,"H1 KAMB I",3,4,29,25,54
LOUGA,LINGUERE,"SAGATTA DJOLOF",DEALY,"H3 KAMB III",1,2,14,7,21
LOUGA,LINGUERE,"SAGATTA DJOLOF",DEALY,"EDEL MBAPP",21,26,121,129,250
LOUGA,LINGUERE,"SAGATTA DJOLOF",DEALY,"H1 NDIADA",11,19,83,78,161
LOUGA,LINGUERE,"SAGATTA DJOLOF",DEALY,"FOGNY BATHIARY",17,33,131,151,282
LOUGA,LINGUERE,"SAGATTA DJOLOF",DEALY,"FOGNY DIABE NDIALLE",17,23,74,77,151
LOUGA,LINGUERE,"SAGATTA DJOLOF",DEALY,"FOYLOLDE NDIENGUEL",12,19,121,81,202
LOUGA,LINGUERE,"SAGATTA DJOLOF",DEALY,GOLGUI,13,34,144,115,259
LOUGA,LINGUERE,"SAGATTA DJOLOF",DEALY,"GORKO MODIO",19,19,144,142,286
LOUGA,LINGUERE,"SAGATTA DJOLOF",DEALY,"KADD NDIAYENE (KADD BALLODJI)",39,42,206,209,415
LOUGA,LINGUERE,"SAGATTA DJOLOF",DEALY,"H3 POUROUDJI",9,17,54,63,117
LOUGA,LINGUERE,"SAGATTA DJOLOF",DEALY,"KADD PEULH",15,22,146,88,234
LOUGA,LINGUERE,"SAGATTA DJOLOF",DEALY,KARKOUTHIE,24,31,242,208,450
LOUGA,LINGUERE,"SAGATTA DJOLOF",DEALY,KOURBA,14,18,80,65,145
LOUGA,LINGUERE,"SAGATTA DJOLOF",DEALY,"LOUMBY WAWALDE ECOLE",14,18,107,119,226
LOUGA,LINGUERE,"SAGATTA DJOLOF",DEALY,"LOUMBY WAWALDE PEULH",9,10,34,24,58
LOUGA,LINGUERE,"SAGATTA DJOLOF",DEALY,"LOUMBY WAWALDE SERERE",23,31,138,122,260
LOUGA,LINGUERE,"SAGATTA DJOLOF",DEALY,"H1 ONGUELE",13,14,101,103,204
LOUGA,LINGUERE,"SAGATTA DJOLOF",DEALY,"H1 KEUR ADIOUMA NGOM",9,12,84,86,170
LOUGA,LINGUERE,"SAGATTA DJOLOF",DEALY,"MAMOLLE OUOLOF",1,1,11,3,14
LOUGA,LINGUERE,"SAGATTA DJOLOF",DEALY,"MAMOLLE PEULH",12,13,40,54,94
LOUGA,LINGUERE,"SAGATTA DJOLOF",DEALY,"MBAYLO BARKEDJI",11,21,79,87,166
LOUGA,LINGUERE,"SAGATTA DJOLOF",DEALY,"MBOUNDOU BOCKY",20,26,139,109,248
LOUGA,LINGUERE,"SAGATTA DJOLOF",DEALY,"NAIDE BORTY",14,19,190,74,264
LOUGA,LINGUERE,"SAGATTA DJOLOF",DEALY,NDIASSAM,12,12,60,59,119
LOUGA,LINGUERE,"SAGATTA DJOLOF",DEALY,"H3 KEUR PITI (DIABY BOGO)",1,1,2,2,4
LOUGA,LINGUERE,"SAGATTA DJOLOF",DEALY,"H2 KEUR MBAYE SENE",5,5,36,23,59
LOUGA,LINGUERE,"SAGATTA DJOLOF",DEALY,NDIABANY,19,22,118,76,194
LOUGA,LINGUERE,"SAGATTA DJOLOF",DEALY,"NDIAPABA MBAPP 1",13,17,118,100,218
LOUGA,LINGUERE,"SAGATTA DJOLOF",DEALY,"H1 LOUMBA TENDOU",12,12,63,77,140
LOUGA,LINGUERE,"SAGATTA DJOLOF",DEALY,"NDIAPABA MBAPP 2",12,17,99,87,186
LOUGA,LINGUERE,"SAGATTA DJOLOF",DEALY,"NDIATBY NDIALLA",15,31,130,125,255
LOUGA,LINGUERE,"SAGATTA DJOLOF",DEALY,NDIGUEUL,49,49,175,160,335
LOUGA,LINGUERE,"SAGATTA DJOLOF",DEALY,"H4 DAROU KHITMATY",5,5,23,25,48
LOUGA,LINGUERE,"SAGATTA DJOLOF",DEALY,"NDONY PEULH",3,3,18,17,35
LOUGA,LINGUERE,"SAGATTA DJOLOF",DEALY,NGATEL,25,46,272,213,485
LOUGA,LINGUERE,"SAGATTA DJOLOF",DEALY,"NGOUILLE SYPETTE",40,78,322,330,652
LOUGA,LINGUERE,"SAGATTA DJOLOF",DEALY,"NGOYE DJOLOF I (DEUWDIKOYE)",43,64,490,402,892
LOUGA,LINGUERE,"SAGATTA DJOLOF",DEALY,"NGOYE 2",9,16,132,81,213
LOUGA,LINGUERE,"SAGATTA DJOLOF",DEALY,"NGUILO PEULH",61,91,502,419,921
LOUGA,LINGUERE,"SAGATTA DJOLOF",DEALY,"H2 DOGADE",1,3,5,13,18
LOUGA,LINGUERE,"SAGATTA DJOLOF",DEALY,"NIAYE PEULH",24,44,201,147,348
LOUGA,LINGUERE,"SAGATTA DJOLOF",DEALY,"H1 MEDINA NDIAYE",10,10,46,32,78
LOUGA,LINGUERE,"SAGATTA DJOLOF",DEALY,"H3 BOGOLORO",9,19,105,81,186
LOUGA,LINGUERE,"SAGATTA DJOLOF",DEALY,NIBODJI,22,22,420,133,553
LOUGA,LINGUERE,"SAGATTA DJOLOF",DEALY,"SAM FALL",92,98,485,474,959
LOUGA,LINGUERE,"SAGATTA DJOLOF",DEALY,"H1 NDONY SAM",21,28,216,138,354
LOUGA,LINGUERE,"SAGATTA DJOLOF",DEALY,"H2 TOUBA FALL",28,29,123,81,204
LOUGA,LINGUERE,"SAGATTA DJOLOF",DEALY,"H5 BELEL",53,58,340,210,550
LOUGA,LINGUERE,"SAGATTA DJOLOF",DEALY,"H6 TAWFEKH",2,2,19,12,31
LOUGA,LINGUERE,"SAGATTA DJOLOF",DEALY,"H7 DAROU NDIAYE",12,13,106,68,174
LOUGA,LINGUERE,"SAGATTA DJOLOF",DEALY,"H8 NASSROU FALL",22,22,102,118,220
LOUGA,LINGUERE,"SAGATTA DJOLOF",DEALY,"H9 TOUBA SAM NDIGUEL",13,13,89,48,137
LOUGA,LINGUERE,"SAGATTA DJOLOF",DEALY,"SOURANG FERRE ALLAH",8,15,111,102,213
LOUGA,LINGUERE,"SAGATTA DJOLOF",DEALY,"SOURANG OUOLOF (NDAWENE)",12,14,90,62,152
LOUGA,LINGUERE,"SAGATTA DJOLOF",DEALY,"H1 KEUR ABDOUL GAUREL",3,6,26,22,48
LOUGA,LINGUERE,"SAGATTA DJOLOF",DEALY,THIGNOL,15,29,138,113,251
LOUGA,LINGUERE,"SAGATTA DJOLOF",DEALY,"TIRTIROKY (POLOGNE)",6,12,59,64,123
LOUGA,LINGUERE,"SAGATTA DJOLOF",DEALY,"TOUBA BOGO",108,122,607,482,1089
LOUGA,LINGUERE,"SAGATTA DJOLOF",DEALY,"H1 DAROU MINAME",21,24,155,181,336
LOUGA,LINGUERE,"SAGATTA DJOLOF",DEALY,"H2 NIAYE",4,4,24,21,45
LOUGA,LINGUERE,"SAGATTA DJOLOF",DEALY,"TOUBA BOUSTANE",24,27,218,193,411
LOUGA,LINGUERE,"SAGATTA DJOLOF",DEALY,"H1 DIOSSY",11,16,60,59,119
LOUGA,LINGUERE,"SAGATTA DJOLOF",DEALY,"H1 NDIAPABA WOLOF",6,6,21,6,27
LOUGA,LINGUERE,"SAGATTA DJOLOF",DEALY,"TOUBA SAM FALL",75,76,351,277,628
LOUGA,LINGUERE,"SAGATTA DJOLOF",DEALY,"TOUBA SOURANG",22,29,165,151,316
LOUGA,LINGUERE,"SAGATTA DJOLOF",DEALY,"TOUBA WADENE",22,25,89,99,188
LOUGA,LINGUERE,"SAGATTA DJOLOF",DEALY,"WANDE PEULH",5,9,62,38,100
LOUGA,LINGUERE,"SAGATTA DJOLOF",DEALY,"WANDE SERERE",43,66,415,355,770
LOUGA,LINGUERE,"SAGATTA DJOLOF",DEALY,"WELLOU MBEL(ATOU TOGNE)",11,11,48,62,110
LOUGA,LINGUERE,"SAGATTA DJOLOF",DEALY,"WELLOU MBELL",11,16,120,89,209
LOUGA,LINGUERE,"SAGATTA DJOLOF",DEALY,"BOGUEL LALO",20,25,163,121,284
LOUGA,LINGUERE,"SAGATTA DJOLOF",DEALY,"DAROU NDIAYE",6,6,34,24,58
LOUGA,LINGUERE,"SAGATTA DJOLOF",DEALY,"DAROU SALAM NGUEYENE",10,11,70,57,127
LOUGA,LINGUERE,"SAGATTA DJOLOF",DEALY,"THIEDO DEALY",38,41,316,181,497
LOUGA,LINGUERE,"SAGATTA DJOLOF",DEALY,"SAME SECK",11,11,48,61,109
LOUGA,LINGUERE,"SAGATTA DJOLOF","SAGATTA DJOLOF","BELEL DIOUMA",15,18,60,55,115
LOUGA,LINGUERE,"SAGATTA DJOLOF","SAGATTA DJOLOF","DAGA BARRY",70,81,281,239,520
LOUGA,LINGUERE,"SAGATTA DJOLOF","SAGATTA DJOLOF","DAGA NGASSAMA",8,12,48,64,112
LOUGA,LINGUERE,"SAGATTA DJOLOF","SAGATTA DJOLOF","DAGA NGOM",15,20,113,81,194
LOUGA,LINGUERE,"SAGATTA DJOLOF","SAGATTA DJOLOF","DIAM DIALE",29,36,232,232,464
LOUGA,LINGUERE,"SAGATTA DJOLOF","SAGATTA DJOLOF","DIOUBAL NAMASS",20,26,110,114,224
LOUGA,LINGUERE,"SAGATTA DJOLOF","SAGATTA DJOLOF","H1 KODIELE",3,6,11,21,32
LOUGA,LINGUERE,"SAGATTA DJOLOF","SAGATTA DJOLOF","H2 KODIELEL 2",4,6,27,28,55
LOUGA,LINGUERE,"SAGATTA DJOLOF","SAGATTA DJOLOF","DIOUBAL NDALLA",18,22,142,114,256
LOUGA,LINGUERE,"SAGATTA DJOLOF","SAGATTA DJOLOF","DIOUBAL EDY",1,3,12,13,25
LOUGA,LINGUERE,"SAGATTA DJOLOF","SAGATTA DJOLOF",DONGHO,31,35,151,192,343
LOUGA,LINGUERE,"SAGATTA DJOLOF","SAGATTA DJOLOF","H1 DIADJI",15,19,89,100,189
LOUGA,LINGUERE,"SAGATTA DJOLOF","SAGATTA DJOLOF","GANG OUOLOF",57,67,326,382,708
LOUGA,LINGUERE,"SAGATTA DJOLOF","SAGATTA DJOLOF","GANG PEULH",5,5,17,25,42
LOUGA,LINGUERE,"SAGATTA DJOLOF","SAGATTA DJOLOF","H1 WINDE DIOUMA",3,3,13,15,28
LOUGA,LINGUERE,"SAGATTA DJOLOF","SAGATTA DJOLOF","H2 BILE",8,8,31,38,69
LOUGA,LINGUERE,"SAGATTA DJOLOF","SAGATTA DJOLOF",GNINGUENE,6,8,39,24,63
LOUGA,LINGUERE,"SAGATTA DJOLOF","SAGATTA DJOLOF","GUIDO ALLAH 1",7,7,12,23,35
LOUGA,LINGUERE,"SAGATTA DJOLOF","SAGATTA DJOLOF","GUIDO ALLAH 2",12,13,54,54,108
LOUGA,LINGUERE,"SAGATTA DJOLOF","SAGATTA DJOLOF","GUIDO ALLAH 3",2,2,12,12,24
LOUGA,LINGUERE,"SAGATTA DJOLOF","SAGATTA DJOLOF",KHATALI,29,36,247,252,499
LOUGA,LINGUERE,"SAGATTA DJOLOF","SAGATTA DJOLOF",KHOUBE,11,12,66,67,133
LOUGA,LINGUERE,"SAGATTA DJOLOF","SAGATTA DJOLOF","H1 KHOUBE NAMASS",12,13,61,50,111
LOUGA,LINGUERE,"SAGATTA DJOLOF","SAGATTA DJOLOF","LONCANE OUOLOF",16,16,84,113,197
LOUGA,LINGUERE,"SAGATTA DJOLOF","SAGATTA DJOLOF","LONCANE PANAL",11,12,69,72,141
LOUGA,LINGUERE,"SAGATTA DJOLOF","SAGATTA DJOLOF","H1 KEUR EL HADJI ANABY SOW",8,10,61,43,104
LOUGA,LINGUERE,"SAGATTA DJOLOF","SAGATTA DJOLOF","LOUMBE BODE BISSINABE",5,6,34,38,72
LOUGA,LINGUERE,"SAGATTA DJOLOF","SAGATTA DJOLOF",MADENE,7,8,73,62,135
LOUGA,LINGUERE,"SAGATTA DJOLOF","SAGATTA DJOLOF","H1 DAROU SALAM",4,5,32,24,56
LOUGA,LINGUERE,"SAGATTA DJOLOF","SAGATTA DJOLOF","H2 DAROU THIEYENE",6,7,57,56,113
LOUGA,LINGUERE,"SAGATTA DJOLOF","SAGATTA DJOLOF","M’BACKE DJOLOFF",91,98,593,583,1176
LOUGA,LINGUERE,"SAGATTA DJOLOF","SAGATTA DJOLOF","NDEMENE KAW",17,29,159,133,292
LOUGA,LINGUERE,"SAGATTA DJOLOF","SAGATTA DJOLOF","NDEMENE SIWOL",4,5,24,34,58
LOUGA,LINGUERE,"SAGATTA DJOLOF","SAGATTA DJOLOF","H1 NDIABA",8,8,40,50,90
LOUGA,LINGUERE,"SAGATTA DJOLOF","SAGATTA DJOLOF","NDIAYENE SAPENDA",25,27,148,185,333
LOUGA,LINGUERE,"SAGATTA DJOLOF","SAGATTA DJOLOF","H1 DAROU NDIAYE",8,8,59,41,100
LOUGA,LINGUERE,"SAGATTA DJOLOF","SAGATTA DJOLOF",NDRAME,54,60,302,306,608
LOUGA,LINGUERE,"SAGATTA DJOLOF","SAGATTA DJOLOF","NGASSAMA PANAL",23,27,128,116,244
LOUGA,LINGUERE,"SAGATTA DJOLOF","SAGATTA DJOLOF","NGASSAMA THIANOR",8,17,60,74,134
LOUGA,LINGUERE,"SAGATTA DJOLOF","SAGATTA DJOLOF",PAKOUR,15,15,72,73,145
LOUGA,LINGUERE,"SAGATTA DJOLOF","SAGATTA DJOLOF","PANAL OUOLOF",8,12,68,55,123
LOUGA,LINGUERE,"SAGATTA DJOLOF","SAGATTA DJOLOF","PEYE BAKHAL",6,10,45,32,77
LOUGA,LINGUERE,"SAGATTA DJOLOF","SAGATTA DJOLOF","SAGATTA DJOLOF",135,163,788,994,1782
LOUGA,LINGUERE,"SAGATTA DJOLOF","SAGATTA DJOLOF","H1 KHOUROU BAKHAL",9,12,88,67,155
LOUGA,LINGUERE,"SAGATTA DJOLOF","SAGATTA DJOLOF","H2 KEUR BAYE",9,13,58,89,147
LOUGA,LINGUERE,"SAGATTA DJOLOF","SAGATTA DJOLOF","SINE ABDOU",126,142,774,696,1470
LOUGA,LINGUERE,"SAGATTA DJOLOF","SAGATTA DJOLOF","H1 KELEL",7,13,62,41,103
LOUGA,LINGUERE,"SAGATTA DJOLOF","SAGATTA DJOLOF",THIALLA,11,15,60,62,122
LOUGA,LINGUERE,"SAGATTA DJOLOF","SAGATTA DJOLOF","THIAMBOUGUEL NDIELE",18,27,90,106,196
LOUGA,LINGUERE,"SAGATTA DJOLOF","SAGATTA DJOLOF","THIAMENE BAXAL",14,14,91,108,199
LOUGA,LINGUERE,"SAGATTA DJOLOF","SAGATTA DJOLOF","THIANGALE KADIEL",4,6,38,35,73
LOUGA,LINGUERE,"SAGATTA DJOLOF","SAGATTA DJOLOF","H1 THIANGNATE SANGUE BOYE",3,7,37,41,78
LOUGA,LINGUERE,"SAGATTA DJOLOF","SAGATTA DJOLOF",THIARRE,29,37,221,228,449
LOUGA,LINGUERE,"SAGATTA DJOLOF","SAGATTA DJOLOF","H1 KODIOLY DIALALE",8,10,38,41,79
LOUGA,LINGUERE,"SAGATTA DJOLOF","SAGATTA DJOLOF",THIOYENE,22,25,120,124,244
LOUGA,LINGUERE,"SAGATTA DJOLOF","SAGATTA DJOLOF","ARAFAT MELEKH",10,15,64,80,144
LOUGA,LINGUERE,"SAGATTA DJOLOF","SAGATTA DJOLOF","FASSE KEBE",3,3,14,20,34
LOUGA,LINGUERE,"SAGATTA DJOLOF","SAGATTA DJOLOF","GOUREL DOW",8,11,65,57,122
LOUGA,LINGUERE,"SAGATTA DJOLOF","SAGATTA DJOLOF","NGASSAMA WOLOF",3,3,13,14,27
LOUGA,LINGUERE,"SAGATTA DJOLOF","THIAMENE PASSE","BALI BIRAMA NABO",5,14,45,38,83
LOUGA,LINGUERE,"SAGATTA DJOLOF","THIAMENE PASSE","BALI BIRAMA DEMBA NGATAM",14,15,63,65,128
LOUGA,LINGUERE,"SAGATTA DJOLOF","THIAMENE PASSE",NDIPPANE,12,16,62,59,121
LOUGA,LINGUERE,"SAGATTA DJOLOF","THIAMENE PASSE","DAROU SALAM MAURE (NDOGANDOU)",123,134,933,610,1543
LOUGA,LINGUERE,"SAGATTA DJOLOF","THIAMENE PASSE","DAROU SALAM MELAKH",39,63,342,359,701
LOUGA,LINGUERE,"SAGATTA DJOLOF","THIAMENE PASSE","DECK WOTE LEWONABÈ",27,42,155,147,302
LOUGA,LINGUERE,"SAGATTA DJOLOF","THIAMENE PASSE","H1 NDIPANE",8,11,44,38,82
LOUGA,LINGUERE,"SAGATTA DJOLOF","THIAMENE PASSE","DECK WOTE LOUMBI KORE",12,14,55,51,106
LOUGA,LINGUERE,"SAGATTA DJOLOF","THIAMENE PASSE","DECK WOTE SOUGOUNABE",4,9,35,31,66
LOUGA,LINGUERE,"SAGATTA DJOLOF","THIAMENE PASSE","H1 BIRAM GATTE",4,4,17,22,39
LOUGA,LINGUERE,"SAGATTA DJOLOF","THIAMENE PASSE","DECK WOTE THIANOR",4,4,19,17,36
LOUGA,LINGUERE,"SAGATTA DJOLOF","THIAMENE PASSE","DENDIELY GUELY",15,15,35,33,68
LOUGA,LINGUERE,"SAGATTA DJOLOF","THIAMENE PASSE","DENDIELY ISLAM",20,36,141,136,277
LOUGA,LINGUERE,"SAGATTA DJOLOF","THIAMENE PASSE","DENDIELY NAMASSE",22,42,171,176,347
LOUGA,LINGUERE,"SAGATTA DJOLOF","THIAMENE PASSE","H1 WOURO SOPHIE",11,15,42,28,70
LOUGA,LINGUERE,"SAGATTA DJOLOF","THIAMENE PASSE","DIERY BIRANE",33,38,154,151,305
LOUGA,LINGUERE,"SAGATTA DJOLOF","THIAMENE PASSE","DOULY LOUMBI KORE",11,13,65,56,121
LOUGA,LINGUERE,"SAGATTA DJOLOF","THIAMENE PASSE","H1 WOURO HABIBOU",10,17,71,68,139
LOUGA,LINGUERE,"SAGATTA DJOLOF","THIAMENE PASSE","H1 WOUROUGAMA",5,5,24,21,45
LOUGA,LINGUERE,"SAGATTA DJOLOF","THIAMENE PASSE","DOULY NAMASSE KHOUBE",4,5,16,17,33
LOUGA,LINGUERE,"SAGATTA DJOLOF","THIAMENE PASSE","H2 BOGOGNE",3,3,9,5,14
LOUGA,LINGUERE,"SAGATTA DJOLOF","THIAMENE PASSE","H2 KADIALE",1,5,13,14,27
LOUGA,LINGUERE,"SAGATTA DJOLOF","THIAMENE PASSE","H3 BELEL KOLY",3,6,24,22,46
LOUGA,LINGUERE,"SAGATTA DJOLOF","THIAMENE PASSE","DOULY NAMASSE PATHE",5,9,35,36,71
LOUGA,LINGUERE,"SAGATTA DJOLOF","THIAMENE PASSE","DOULY NDALLA",5,6,27,22,49
LOUGA,LINGUERE,"SAGATTA DJOLOF","THIAMENE PASSE","FASS EL HADJI ABDOUL AZIZ SY DABAKH",24,28,125,141,266
LOUGA,LINGUERE,"SAGATTA DJOLOF","THIAMENE PASSE",GABOUGAL,13,22,79,65,144
LOUGA,LINGUERE,"SAGATTA DJOLOF","THIAMENE PASSE","H1 KELLE",2,3,19,11,30
LOUGA,LINGUERE,"SAGATTA DJOLOF","THIAMENE PASSE","GAINTH AMETH",11,13,46,34,80
LOUGA,LINGUERE,"SAGATTA DJOLOF","THIAMENE PASSE",LODODJIE,4,4,9,14,23
LOUGA,LINGUERE,"SAGATTA DJOLOF","THIAMENE PASSE","LOUMBAL OUOLOF",105,115,628,692,1320
LOUGA,LINGUERE,"SAGATTA DJOLOF","THIAMENE PASSE","LOUMBY GAOUDY OUSMANE",11,11,46,39,85
LOUGA,LINGUERE,"SAGATTA DJOLOF","THIAMENE PASSE","M’BACKE BARRY",13,13,65,34,99
LOUGA,LINGUERE,"SAGATTA DJOLOF","THIAMENE PASSE","MBAYENE GOUYE TEUDE",44,55,255,253,508
LOUGA,LINGUERE,"SAGATTA DJOLOF","THIAMENE PASSE","MBOUSSOBE HALTE",5,10,34,34,68
LOUGA,LINGUERE,"SAGATTA DJOLOF","THIAMENE PASSE","MBOUSSOBE OUOLOF",67,76,282,300,582
LOUGA,LINGUERE,"SAGATTA DJOLOF","THIAMENE PASSE","MBOUSSOBE PEULH",12,12,48,44,92
LOUGA,LINGUERE,"SAGATTA DJOLOF","THIAMENE PASSE","MEDINA NDIAYE (LOUMBAL)",18,20,187,127,314
LOUGA,LINGUERE,"SAGATTA DJOLOF","THIAMENE PASSE","MEDINA NDIAYE NDIAMA",12,15,67,54,121
LOUGA,LINGUERE,"SAGATTA DJOLOF","THIAMENE PASSE","MEDINA SY",20,23,131,123,254
LOUGA,LINGUERE,"SAGATTA DJOLOF","THIAMENE PASSE",MELAKH,196,238,1475,1380,2855
LOUGA,LINGUERE,"SAGATTA DJOLOF","THIAMENE PASSE","NDAMA PEULH",5,6,28,34,62
LOUGA,LINGUERE,"SAGATTA DJOLOF","THIAMENE PASSE","NDIAMA CONCESSION",12,14,50,51,101
LOUGA,LINGUERE,"SAGATTA DJOLOF","THIAMENE PASSE",NDIAMBOR,23,27,117,110,227
LOUGA,LINGUERE,"SAGATTA DJOLOF","THIAMENE PASSE",NDIAWENE,7,11,42,32,74
LOUGA,LINGUERE,"SAGATTA DJOLOF","THIAMENE PASSE","NDIEYENE SANTHIE",29,41,196,240,436
LOUGA,LINGUERE,"SAGATTA DJOLOF","THIAMENE PASSE","NDIOSSY MAURE",5,5,29,21,50
LOUGA,LINGUERE,"SAGATTA DJOLOF","THIAMENE PASSE","NDIOSSY WOLOF",79,96,495,547,1042
LOUGA,LINGUERE,"SAGATTA DJOLOF","THIAMENE PASSE",NGAPP,35,44,210,292,502
LOUGA,LINGUERE,"SAGATTA DJOLOF","THIAMENE PASSE",NIANDOUL,29,40,205,224,429
LOUGA,LINGUERE,"SAGATTA DJOLOF","THIAMENE PASSE","OFFROU NDAMALA",5,8,28,33,61
LOUGA,LINGUERE,"SAGATTA DJOLOF","THIAMENE PASSE","PAMPI NDALLA",3,8,23,24,47
LOUGA,LINGUERE,"SAGATTA DJOLOF","THIAMENE PASSE","PAMPI OUOLOF",45,50,194,232,426
LOUGA,LINGUERE,"SAGATTA DJOLOF","THIAMENE PASSE","PAMPI PANAL",27,41,149,159,308
LOUGA,LINGUERE,"SAGATTA DJOLOF","THIAMENE PASSE","H1 PAMPI HABOBE",4,6,32,17,49
LOUGA,LINGUERE,"SAGATTA DJOLOF","THIAMENE PASSE",PASSE,48,61,337,319,656
LOUGA,LINGUERE,"SAGATTA DJOLOF","THIAMENE PASSE","SINE PAKOUR",23,28,81,84,165
LOUGA,LINGUERE,"SAGATTA DJOLOF","THIAMENE PASSE","H1 KADIALY",8,15,54,48,102
LOUGA,LINGUERE,"SAGATTA DJOLOF","THIAMENE PASSE","TAIBA NIANGHENE",29,39,196,214,410
LOUGA,LINGUERE,"SAGATTA DJOLOF","THIAMENE PASSE","THIAMENE DJOLOF (THIAMENE PASS)",77,87,427,458,885
LOUGA,LINGUERE,"SAGATTA DJOLOF","THIAMENE PASSE",THINGOLY,1,2,10,4,14
LOUGA,LINGUERE,"SAGATTA DJOLOF","THIAMENE PASSE","THYLLA DAHRA",16,19,101,100,201
LOUGA,LINGUERE,"SAGATTA DJOLOF","THIAMENE PASSE","H1 PEULGA DE THYLLA",1,1,5,5,10
LOUGA,LINGUERE,"SAGATTA DJOLOF","THIAMENE PASSE","WENDOU FARBA",4,4,11,16,27
LOUGA,LINGUERE,"SAGATTA DJOLOF","THIAMENE PASSE",WEREANE,98,111,400,432,832
LOUGA,LINGUERE,"SAGATTA DJOLOF","THIAMENE PASSE","H1 GUETY",23,31,153,143,296
LOUGA,LINGUERE,"SAGATTA DJOLOF","THIAMENE PASSE","NDAMA WOLOF",47,56,267,291,558
LOUGA,LINGUERE,"SAGATTA DJOLOF","THIAMENE PASSE","FASSE NDIAYE",5,6,48,25,73
LOUGA,LINGUERE,"SAGATTA DJOLOF","THIAMENE PASSE","PAKOUR NDIAYE",7,11,45,38,83
LOUGA,LINGUERE,"SAGATTA DJOLOF","THIAMENE PASSE","GUELY DJOLOF",20,31,125,80,205
LOUGA,LINGUERE,"SAGATTA DJOLOF","THIAMENE PASSE","DECK WOTE",1,1,1,3,4
LOUGA,LINGUERE,"SAGATTA DJOLOF","THIAMENE PASSE","GUELY BOUCAR",5,6,33,16,49
LOUGA,LINGUERE,"SAGATTA DJOLOF","THIAMENE PASSE",PAYWODE,4,11,50,42,92
LOUGA,LINGUERE,"SAGATTA DJOLOF","AFFE DJOLOF","AFFE DJOLOF",270,309,1637,2113,3750
LOUGA,LINGUERE,"SAGATTA DJOLOF","AFFE DJOLOF","H1 POLLY",7,9,39,34,73
LOUGA,LINGUERE,"SAGATTA DJOLOF","AFFE DJOLOF","H2 DIAFFY 1",14,22,109,93,202
LOUGA,LINGUERE,"SAGATTA DJOLOF","AFFE DJOLOF","H3 DIAFFY 2",4,6,25,25,50
LOUGA,LINGUERE,"SAGATTA DJOLOF","AFFE DJOLOF","AFFE PEULH (BRAH)",14,21,84,81,165
LOUGA,LINGUERE,"SAGATTA DJOLOF","AFFE DJOLOF",BAMDY,9,21,80,80,160
LOUGA,LINGUERE,"SAGATTA DJOLOF","AFFE DJOLOF","BARRY PEULH",11,14,83,82,165
LOUGA,LINGUERE,"SAGATTA DJOLOF","AFFE DJOLOF","DEPRE GALLO",17,25,127,108,235
LOUGA,LINGUERE,"SAGATTA DJOLOF","AFFE DJOLOF",GADDY,7,7,19,25,44
LOUGA,LINGUERE,"SAGATTA DJOLOF","AFFE DJOLOF",KADIEL,8,24,89,82,171
LOUGA,LINGUERE,"SAGATTA DJOLOF","AFFE DJOLOF","KELLE SAMBOURGUEL",6,13,39,35,74
LOUGA,LINGUERE,"SAGATTA DJOLOF","AFFE DJOLOF","H1 DIAFFY 3",2,7,28,39,67
LOUGA,LINGUERE,"SAGATTA DJOLOF","AFFE DJOLOF","WENDOU PANAL NDALLA",26,36,142,143,285
LOUGA,LINGUERE,"SAGATTA DJOLOF","AFFE DJOLOF","LOUMBOL NIAW",2,5,18,18,36
LOUGA,LINGUERE,"SAGATTA DJOLOF","AFFE DJOLOF","MEDINA BAMGOL",21,34,96,129,225
LOUGA,LINGUERE,"SAGATTA DJOLOF","AFFE DJOLOF",NIANTANKA,4,9,39,31,70
LOUGA,LINGUERE,"SAGATTA DJOLOF","AFFE DJOLOF",NIOKORLOU,10,14,55,56,111
LOUGA,LINGUERE,"SAGATTA DJOLOF","AFFE DJOLOF","THIR NGUEL SIWOL",2,8,27,30,57
LOUGA,LINGUERE,"SAGATTA DJOLOF","AFFE DJOLOF","THIR NGUEL SOPHY",8,9,36,48,84
LOUGA,LINGUERE,"SAGATTA DJOLOF","AFFE DJOLOF","THYNDY BERNDE",11,14,91,82,173
LOUGA,LINGUERE,"SAGATTA DJOLOF","AFFE DJOLOF","THYNDY SAMBEY",4,8,49,55,104
LOUGA,LINGUERE,"SAGATTA DJOLOF","AFFE DJOLOF","H1 DAROU GONENE",1,1,4,6,10
LOUGA,LINGUERE,"SAGATTA DJOLOF","AFFE DJOLOF","WENDOU PANAL",24,30,149,139,288
LOUGA,LINGUERE,"SAGATTA DJOLOF","AFFE DJOLOF",POLLY,9,18,70,65,135
LOUGA,LINGUERE,"SAGATTA DJOLOF","AFFE DJOLOF","DAROU SALAM NIOKORLOU",7,7,26,36,62
LOUGA,LOUGA,LOUGA,LOUGA,"ARTILLERIE NORD",863,922,4708,4631,9339
LOUGA,LOUGA,LOUGA,LOUGA,"ARTILLERIE SUD",472,570,2649,2830,5479
LOUGA,LOUGA,LOUGA,LOUGA,"KEUR SERIGNE LOUGA EST",1739,1960,9093,8411,17504
LOUGA,LOUGA,LOUGA,LOUGA,"KEUR SERIGNE LOUGA NORD",379,525,2227,2520,4747
LOUGA,LOUGA,LOUGA,LOUGA,"KEUR SERIGNE LOUGA SUD",1589,1743,8485,8814,17299
LOUGA,LOUGA,LOUGA,LOUGA,"MONTAGNE NORD",1411,1587,7204,6744,13948
LOUGA,LOUGA,LOUGA,LOUGA,"MONTAGNE SUD",604,792,3023,3033,6056
LOUGA,LOUGA,LOUGA,LOUGA,"SANTHIABA CENTRE",1305,1461,5091,5863,10954
LOUGA,LOUGA,LOUGA,LOUGA,"SANTHIABA NORD",1615,1688,7281,6936,14217
LOUGA,LOUGA,LOUGA,LOUGA,"SANTHIABA SUD",959,1153,4566,5431,9997
LOUGA,LOUGA,LOUGA,LOUGA,THIOKHNA,369,530,2155,1670,3825
LOUGA,LOUGA,COKI,COKI,"BAL NGUER",7,7,44,34,78
LOUGA,LOUGA,COKI,COKI,"BELEL OUOLOF",54,84,556,477,1033
LOUGA,LOUGA,COKI,COKI,"H1 HOUDANE",1,3,126,40,166
LOUGA,LOUGA,COKI,COKI,"BELEL PEULH",29,42,125,120,245
LOUGA,LOUGA,COKI,COKI,"BOFFEL ALASSANE",35,43,295,301,596
LOUGA,LOUGA,COKI,COKI,"H1 GADGA",6,8,48,47,95
LOUGA,LOUGA,COKI,COKI,"BOFFEL MANDIAYE",6,6,23,23,46
LOUGA,LOUGA,COKI,COKI,BRAYLENE,11,17,74,70,144
LOUGA,LOUGA,COKI,COKI,COKI,656,757,7043,4056,11099
LOUGA,LOUGA,COKI,COKI,"COKI HEDE",16,17,83,96,179
LOUGA,LOUGA,COKI,COKI,DADIALO,39,59,132,210,342
LOUGA,LOUGA,COKI,COKI,"H1 DEBOLATE PEUL",11,18,70,79,149
LOUGA,LOUGA,COKI,COKI,"DAROU RAHMANE",2,2,12,7,19
LOUGA,LOUGA,COKI,COKI,DEBOLATE,12,12,54,50,104
LOUGA,LOUGA,COKI,COKI,"DIADIORDE I",46,48,336,242,578
LOUGA,LOUGA,COKI,COKI,"DIADIORDE II",22,22,155,134,289
LOUGA,LOUGA,COKI,COKI,FADAM,18,47,231,214,445
LOUGA,LOUGA,COKI,COKI,"H1 DORYGA",19,22,65,69,134
LOUGA,LOUGA,COKI,COKI,"H2 POUTHIO MADJI PEULH (KEUR DINGUERE)",8,10,77,33,110
LOUGA,LOUGA,COKI,COKI,HEDE,26,30,120,133,253
LOUGA,LOUGA,COKI,COKI,"KANENE HALL",15,18,122,134,256
LOUGA,LOUGA,COKI,COKI,"KANENE KHAR (TOUBA KANENE)",20,25,163,135,298
LOUGA,LOUGA,COKI,COKI,"KEBE SYLLA",6,10,68,51,119
LOUGA,LOUGA,COKI,COKI,"H1 DABAL",6,10,44,35,79
LOUGA,LOUGA,COKI,COKI,"KEUR MASSAL 1 (NDIOBENE)",10,18,95,88,183
LOUGA,LOUGA,COKI,COKI,"KEUR MASSAL 2 (SANTHIE)",5,11,42,39,81
LOUGA,LOUGA,COKI,COKI,"H2 ADIENNE",3,6,29,21,50
LOUGA,LOUGA,COKI,COKI,"KEUR NGOURA",42,46,330,354,684
LOUGA,LOUGA,COKI,COKI,"KEUR SALA",30,36,198,175,373
LOUGA,LOUGA,COKI,COKI,LOUMENE,18,23,80,103,183
LOUGA,LOUGA,COKI,COKI,"M’BACKE NDIOCK",3,3,14,23,37
LOUGA,LOUGA,COKI,COKI,"NDALLA AWEME",19,31,165,131,296
LOUGA,LOUGA,COKI,COKI,"NDALLA MBOUBENE",43,55,340,298,638
LOUGA,LOUGA,COKI,COKI,NDIAKHAR,46,67,426,385,811
LOUGA,LOUGA,COKI,COKI,"NDIARE WAKHY",49,76,359,412,771
LOUGA,LOUGA,COKI,COKI,"H1 KEUR DIABEL",4,14,46,40,86
LOUGA,LOUGA,COKI,COKI,"NDIAYENE BALLA",5,5,29,35,64
LOUGA,LOUGA,COKI,COKI,NDIEURE,6,7,38,33,71
LOUGA,LOUGA,COKI,COKI,"NDIOBENE BELAL",35,51,271,335,606
LOUGA,LOUGA,COKI,COKI,"OUARACK 1",96,116,578,673,1251
LOUGA,LOUGA,COKI,COKI,"OUARACK 2",56,65,325,313,638
LOUGA,LOUGA,COKI,COKI,PALLENE,26,31,143,221,364
LOUGA,LOUGA,COKI,COKI,"POUTHIO MADJI",18,28,138,126,264
LOUGA,LOUGA,COKI,COKI,"H1 TONGUEL NDIALLA",13,22,105,95,200
LOUGA,LOUGA,COKI,COKI,"SAMBA SADIO OUOLOF",21,27,170,168,338
LOUGA,LOUGA,COKI,COKI,"SAMBA SADIO PEULH",49,95,443,385,828
LOUGA,LOUGA,COKI,COKI,"SEUF MBAM PEULH",19,21,74,92,166
LOUGA,LOUGA,COKI,COKI,TAWFEKH,6,8,48,48,96
LOUGA,LOUGA,COKI,COKI,THIECKENE,50,55,226,332,558
LOUGA,LOUGA,COKI,COKI,"THIECKENE SAMBA SINY",22,31,91,95,186
LOUGA,LOUGA,COKI,COKI,"THIEYENE 1",9,10,33,41,74
LOUGA,LOUGA,COKI,COKI,"THIEYENE 2",14,17,90,116,206
LOUGA,LOUGA,COKI,COKI,THILENE,8,10,77,61,138
LOUGA,LOUGA,COKI,COKI,"H1 THILENE PEULH",7,11,24,34,58
LOUGA,LOUGA,COKI,COKI,THIOUROUR,52,68,530,369,899
LOUGA,LOUGA,COKI,COKI,"H1 GATY KEUR MADEMBA SECK",27,42,173,163,336
LOUGA,LOUGA,COKI,COKI,TOBENE,5,6,34,26,60
LOUGA,LOUGA,COKI,COKI,"H1 GATI KEUR ABDOULAYE NGOM",3,6,39,46,85
LOUGA,LOUGA,COKI,COKI,"H2 NDIAO",1,5,45,28,73
LOUGA,LOUGA,COKI,COKI,"H3 GATI KEUR BIRANE DIOP (KEUR YABAL DIOP)",1,4,31,20,51
LOUGA,LOUGA,COKI,COKI,"TONGUEL NDIALAL PEULH",20,30,154,113,267
LOUGA,LOUGA,COKI,COKI,WAKIRLOU,25,26,131,137,268
LOUGA,LOUGA,COKI,COKI,"KEUR MODOU AWA SYLLA",4,5,14,24,38
LOUGA,LOUGA,COKI,COKI,NDIOBENE,6,8,40,45,85
LOUGA,LOUGA,COKI,"PETE OUARACK",BELIOUR,8,11,60,45,105
LOUGA,LOUGA,COKI,"PETE OUARACK",LAMDOU,39,48,224,304,528
LOUGA,LOUGA,COKI,"PETE OUARACK","LOUGHY PEULH 1",21,32,122,127,249
LOUGA,LOUGA,COKI,"PETE OUARACK","LOUGHY PEULH 2",21,29,158,171,329
LOUGA,LOUGA,COKI,"PETE OUARACK","NANGADE (KEUR NGOUNTA)",24,32,167,274,441
LOUGA,LOUGA,COKI,"PETE OUARACK","H1 KEUR MACOUMBA DIAW",1,3,16,17,33
LOUGA,LOUGA,COKI,"PETE OUARACK","H1 KEUR MBAYE",18,20,105,134,239
LOUGA,LOUGA,COKI,"PETE OUARACK",NDIAWENE,37,51,229,285,514
LOUGA,LOUGA,COKI,"PETE OUARACK",NGUEMBE,13,13,56,100,156
LOUGA,LOUGA,COKI,"PETE OUARACK","PETE NIANGUENE",21,26,104,105,209
LOUGA,LOUGA,COKI,"PETE OUARACK","PETE OUARACK",114,141,703,850,1553
LOUGA,LOUGA,COKI,"PETE OUARACK","H1 LAMPADO",12,12,106,48,154
LOUGA,LOUGA,COKI,"PETE OUARACK","H1 LANIANE",3,5,55,25,80
LOUGA,LOUGA,COKI,"PETE OUARACK","H1 PETE GUAINTH",4,6,34,37,71
LOUGA,LOUGA,COKI,"PETE OUARACK","H2 KEUR NGAYO (KEUR MASSAMBA DIENABA)",17,17,158,80,238
LOUGA,LOUGA,COKI,"PETE OUARACK","PETE PEULH",32,42,206,249,455
LOUGA,LOUGA,COKI,"PETE OUARACK","H2 TOUGOUTY",6,8,78,45,123
LOUGA,LOUGA,COKI,"PETE OUARACK","H3 DIATMEL",8,10,82,61,143
LOUGA,LOUGA,COKI,"PETE OUARACK","H4 NDIAO",11,27,84,112,196
LOUGA,LOUGA,COKI,"PETE OUARACK","THIALENE 1",8,9,61,62,123
LOUGA,LOUGA,COKI,"PETE OUARACK","H2 THIALENE PEULH",7,11,43,40,83
LOUGA,LOUGA,COKI,"PETE OUARACK","WARENE PEULH",9,12,44,48,92
LOUGA,LOUGA,COKI,"PETE OUARACK","LOUGUI BAOME",6,9,34,30,64
LOUGA,LOUGA,COKI,"PETE OUARACK","PATHE POULO 2",1,1,4,5,9
LOUGA,LOUGA,COKI,THIAMENE,BELGARKY,28,31,118,151,269
LOUGA,LOUGA,COKI,THIAMENE,"H1 PAYENE",16,19,66,56,122
LOUGA,LOUGA,COKI,THIAMENE,"H3 KEUR SAMBA DOUCOUR SOW",9,17,55,59,114
LOUGA,LOUGA,COKI,THIAMENE,"H3 MOUGNAREL",9,10,35,38,73
LOUGA,LOUGA,COKI,THIAMENE,"BIRAM BODEL",9,12,45,66,111
LOUGA,LOUGA,COKI,THIAMENE,"DABAL AFFE",3,6,18,22,40
LOUGA,LOUGA,COKI,THIAMENE,"DAGA TOLEL",3,7,35,15,50
LOUGA,LOUGA,COKI,THIAMENE,"H2 MBELLOGNE",2,3,17,7,24
LOUGA,LOUGA,COKI,THIAMENE,DANTHIALY,7,12,21,36,57
LOUGA,LOUGA,COKI,THIAMENE,"DAROU DIOP",18,18,60,89,149
LOUGA,LOUGA,COKI,THIAMENE,"DAROU MBAYE",27,41,181,195,376
LOUGA,LOUGA,COKI,THIAMENE,"H1 DAGA TOLEL",22,28,136,126,262
LOUGA,LOUGA,COKI,THIAMENE,"DAROU NDIAYE",8,8,31,40,71
LOUGA,LOUGA,COKI,THIAMENE,"DAROU SALAM (TATKY)",23,30,112,96,208
LOUGA,LOUGA,COKI,THIAMENE,"H1 BOGUEL",2,3,3,12,15
LOUGA,LOUGA,COKI,THIAMENE,DOGOTEDIA,14,14,51,66,117
LOUGA,LOUGA,COKI,THIAMENE,"H1 KOEL TORDIO",3,7,17,10,27
LOUGA,LOUGA,COKI,THIAMENE,FASS,20,21,95,91,186
LOUGA,LOUGA,COKI,THIAMENE,"GATY NDEME (NIAMDADE)",3,4,19,17,36
LOUGA,LOUGA,COKI,THIAMENE,GUELY,38,47,255,251,506
LOUGA,LOUGA,COKI,THIAMENE,"H1 GUANAR GOBEL GUELY",12,26,99,85,184
LOUGA,LOUGA,COKI,THIAMENE,"H2 KEUR BOYDO",10,15,66,64,130
LOUGA,LOUGA,COKI,THIAMENE,KARTALAO,24,26,132,98,230
LOUGA,LOUGA,COKI,THIAMENE,"KEUR BASSINE 1",9,12,64,73,137
LOUGA,LOUGA,COKI,THIAMENE,"KEUR BASSINE 2",7,8,66,58,124
LOUGA,LOUGA,COKI,THIAMENE,"KEUR BASSINE 3",34,41,244,299,543
LOUGA,LOUGA,COKI,THIAMENE,"KEUR MAFALL (PALENE)",7,8,34,65,99
LOUGA,LOUGA,COKI,THIAMENE,KHORONDOME,1,1,19,24,43
LOUGA,LOUGA,COKI,THIAMENE,"MAKA TOURE 2",5,6,49,29,78
LOUGA,LOUGA,COKI,THIAMENE,"M’BACKE BARRY",23,25,179,148,327
LOUGA,LOUGA,COKI,THIAMENE,"MBADJINKOBE (BELTAGNE)",7,13,45,43,88
LOUGA,LOUGA,COKI,THIAMENE,"H1 KOLY",16,19,72,80,152
LOUGA,LOUGA,COKI,THIAMENE,"H2 KOLY",5,5,37,38,75
LOUGA,LOUGA,COKI,THIAMENE,MBAFAR,29,46,250,218,468
LOUGA,LOUGA,COKI,THIAMENE,"H1 HODIEL",6,8,47,44,91
LOUGA,LOUGA,COKI,THIAMENE,"MODJI NGAREL",11,21,139,78,217
LOUGA,LOUGA,COKI,THIAMENE,"MOUGNAREL 1 (BOGUEL)",13,15,57,63,120
LOUGA,LOUGA,COKI,THIAMENE,BELTAGNE,3,3,27,19,46
LOUGA,LOUGA,COKI,THIAMENE,"MOUGNAREL 4",23,40,269,150,419
LOUGA,LOUGA,COKI,THIAMENE,"H1  MOUGNAREL 4",7,10,76,57,133
LOUGA,LOUGA,COKI,THIAMENE,"MOUKH MOUKH",152,185,960,918,1878
LOUGA,LOUGA,COKI,THIAMENE,NDIAMBOR,21,36,187,134,321
LOUGA,LOUGA,COKI,THIAMENE,"H2 DAROU SALAM BOKILODJI",17,26,89,120,209
LOUGA,LOUGA,COKI,THIAMENE,"NDIAO 1",17,24,129,127,256
LOUGA,LOUGA,COKI,THIAMENE,"NDIAO 2",16,36,94,103,197
LOUGA,LOUGA,COKI,THIAMENE,"NDIARE KHORONDOME",1,1,85,12,97
LOUGA,LOUGA,COKI,THIAMENE,"H1 NDIARE PEULH",2,6,22,25,47
LOUGA,LOUGA,COKI,THIAMENE,"NDIARE TOUBA NDIAYE",13,20,127,120,247
LOUGA,LOUGA,COKI,THIAMENE,"H1 NDIOUFENE",9,13,44,57,101
LOUGA,LOUGA,COKI,THIAMENE,"NDIAYENE 2",89,99,599,662,1261
LOUGA,LOUGA,COKI,THIAMENE,"H1 SAKAL",23,27,296,268,564
LOUGA,LOUGA,COKI,THIAMENE,"PALLE MBEDANOU",4,14,22,27,49
LOUGA,LOUGA,COKI,THIAMENE,"H1 MBEDANOU",11,16,62,56,118
LOUGA,LOUGA,COKI,THIAMENE,"PASS (NDAWENE)",21,24,82,120,202
LOUGA,LOUGA,COKI,THIAMENE,SANGHE,56,72,244,300,544
LOUGA,LOUGA,COKI,THIAMENE,THIAMENE,171,207,1052,1235,2287
LOUGA,LOUGA,COKI,THIAMENE,"H1 FINIYONGO",9,13,34,42,76
LOUGA,LOUGA,COKI,THIAMENE,"H2 MERINA MBODJ",3,4,31,46,77
LOUGA,LOUGA,COKI,THIAMENE,"H3 DIGNIWE",10,21,65,91,156
LOUGA,LOUGA,COKI,THIAMENE,"THIAMENE (SANTHIE)",88,124,462,553,1015
LOUGA,LOUGA,COKI,THIAMENE,"THIAMENE MAIMOUNA",159,189,910,972,1882
LOUGA,LOUGA,COKI,THIAMENE,"THIANOR 1",10,15,43,61,104
LOUGA,LOUGA,COKI,THIAMENE,"THIANOR 2",5,12,37,34,71
LOUGA,LOUGA,COKI,THIAMENE,"H1 LOUBATENDOU",23,33,132,132,264
LOUGA,LOUGA,COKI,THIAMENE,THIOUSMEL,4,5,24,32,56
LOUGA,LOUGA,COKI,THIAMENE,TORDIO,17,26,171,106,277
LOUGA,LOUGA,COKI,THIAMENE,"H1 BELEL BOUBARY",14,18,103,73,176
LOUGA,LOUGA,COKI,THIAMENE,PALLENE,51,55,294,305,599
LOUGA,LOUGA,COKI,THIAMENE,"KEUR ALY BELTAGNE",1,3,11,12,23
LOUGA,LOUGA,COKI,THIAMENE,"KEUR DEMBA",12,17,58,44,102
LOUGA,LOUGA,COKI,THIAMENE,"KEUR SABOUSSO",3,4,16,19,35
LOUGA,LOUGA,COKI,"GUET ARDO","DEKHOLE 1",60,84,436,410,846
LOUGA,LOUGA,COKI,"GUET ARDO","DIAMOYE GAYE",36,49,185,230,415
LOUGA,LOUGA,COKI,"GUET ARDO",DIEYLANE,12,12,82,74,156
LOUGA,LOUGA,COKI,"GUET ARDO","DIAWAR SARR",22,27,179,182,361
LOUGA,LOUGA,COKI,"GUET ARDO","H1 SANTHIOU DIAWAR",15,18,133,112,245
LOUGA,LOUGA,COKI,"GUET ARDO",DIONABE,42,44,211,223,434
LOUGA,LOUGA,COKI,"GUET ARDO","GARKY DIAW",85,85,311,439,750
LOUGA,LOUGA,COKI,"GUET ARDO","GUET ARDO 1 ET GUET ARDO 1",198,220,1358,1188,2546
LOUGA,LOUGA,COKI,"GUET ARDO","KEUR GORA GUEYE",5,7,30,30,60
LOUGA,LOUGA,COKI,"GUET ARDO",MBOURGAL,18,20,125,101,226
LOUGA,LOUGA,COKI,"GUET ARDO","NDIOBENE NDEME (NIANGHENE NDEME)",62,70,358,355,713
LOUGA,LOUGA,COKI,"GUET ARDO","KEUR MOUSSEU",30,32,178,201,379
LOUGA,LOUGA,COKI,"GUET ARDO","NGUENE SEYE",9,9,79,71,150
LOUGA,LOUGA,COKI,"GUET ARDO",NOUFLE,4,9,30,28,58
LOUGA,LOUGA,COKI,"GUET ARDO","PATAR NAR",24,31,126,104,230
LOUGA,LOUGA,COKI,"GUET ARDO",ROUMDE,29,44,347,232,579
LOUGA,LOUGA,COKI,"GUET ARDO","H3 NGAR",12,13,76,49,125
LOUGA,LOUGA,COKI,"GUET ARDO",SOKORY,18,28,128,113,241
LOUGA,LOUGA,COKI,"GUET ARDO","THIALAGA NIANE",36,44,197,210,407
LOUGA,LOUGA,COKI,"GUET ARDO","THIAMBENE PEULH",10,11,110,104,214
LOUGA,LOUGA,COKI,"GUET ARDO","THIAR DIAMOYE (TOUBA THIAR)",5,5,59,45,104
LOUGA,LOUGA,COKI,"GUET ARDO","THIAR PEULH",52,57,450,432,882
LOUGA,LOUGA,COKI,"GUET ARDO","TOURE ATOUMANE",5,6,34,36,70
LOUGA,LOUGA,COKI,"GUET ARDO","DAROU SALAM SOKORY",15,17,89,76,165
LOUGA,LOUGA,COKI,"GUET ARDO",DIABOUGEL,5,6,32,30,62
LOUGA,LOUGA,COKI,"GUET ARDO",KOULIFEW,9,10,54,42,96
LOUGA,LOUGA,COKI,"GUET ARDO",SAGALE,4,5,27,25,52
LOUGA,LOUGA,COKI,"GUET ARDO",THIAMBAR,25,29,180,124,304
LOUGA,LOUGA,COKI,"GUET ARDO","THIAMBENE WOLOF",4,5,78,53,131
LOUGA,LOUGA,COKI,"GUET ARDO","TOURE FALL",24,27,127,129,256
LOUGA,LOUGA,COKI,NDIAGNE,ARAFAT,21,24,102,122,224
LOUGA,LOUGA,COKI,NDIAGNE,"DAROU KARIM",46,48,372,311,683
LOUGA,LOUGA,COKI,NDIAGNE,"DAROU KHOUDOSS",105,119,533,578,1111
LOUGA,LOUGA,COKI,NDIAGNE,"DAROU RAHMANE",110,114,477,573,1050
LOUGA,LOUGA,COKI,NDIAGNE,"DAROU SALAM",80,83,517,537,1054
LOUGA,LOUGA,COKI,NDIAGNE,"MEDINATOUL SALAM",48,53,313,336,649
LOUGA,LOUGA,COKI,NDIAGNE,MEDINE,41,49,199,244,443
LOUGA,LOUGA,COKI,NDIAGNE,MOUSDALIFA,52,55,306,443,749
LOUGA,LOUGA,COKI,NDIAGNE,"NDIAGNE MOSQUEE",133,156,1186,1305,2491
LOUGA,LOUGA,COKI,NDIAGNE,NDIEUCK,139,153,762,830,1592
LOUGA,LOUGA,"KEUR MOMAR SARR",GANDE,"BADJI 2",12,23,77,77,154
LOUGA,LOUGA,"KEUR MOMAR SARR",GANDE,"BISSINABE GALEGAL",6,14,34,37,71
LOUGA,LOUGA,"KEUR MOMAR SARR",GANDE,"BISSINABE GANDE",43,60,260,302,562
LOUGA,LOUGA,"KEUR MOMAR SARR",GANDE,"BISSINABE MBAYBE",79,118,541,505,1046
LOUGA,LOUGA,"KEUR MOMAR SARR",GANDE,"BISSINABE RENDO",23,42,160,173,333
LOUGA,LOUGA,"KEUR MOMAR SARR",GANDE,"H1 RENDO",9,9,32,28,60
LOUGA,LOUGA,"KEUR MOMAR SARR",GANDE,"BODEDJI OUOLOF",5,6,28,39,67
LOUGA,LOUGA,"KEUR MOMAR SARR",GANDE,"BODEDJI PEULH",11,28,86,98,184
LOUGA,LOUGA,"KEUR MOMAR SARR",GANDE,"BOGAL NDIAYENE GALOYEL",32,50,249,222,471
LOUGA,LOUGA,"KEUR MOMAR SARR",GANDE,"BOGAL NDIAYENE PEULH",8,15,69,58,127
LOUGA,LOUGA,"KEUR MOMAR SARR",GANDE,"BOGOGNE NDAME",9,16,40,58,98
LOUGA,LOUGA,"KEUR MOMAR SARR",GANDE,"BONDEYARA II",5,10,37,45,82
LOUGA,LOUGA,"KEUR MOMAR SARR",GANDE,"BONDOYARA PEULH",44,56,247,244,491
LOUGA,LOUGA,"KEUR MOMAR SARR",GANDE,BOULIDOGO,28,43,167,142,309
LOUGA,LOUGA,"KEUR MOMAR SARR",GANDE,"DAROU SALAM GADE BAYE",7,14,64,62,126
LOUGA,LOUGA,"KEUR MOMAR SARR",GANDE,"DIALAMBANE 1",44,93,274,341,615
LOUGA,LOUGA,"KEUR MOMAR SARR",GANDE,"DIALAMBANE 2",10,11,35,58,93
LOUGA,LOUGA,"KEUR MOMAR SARR",GANDE,"DIATMEL FAYANDE",6,9,29,31,60
LOUGA,LOUGA,"KEUR MOMAR SARR",GANDE,"H1 DIATMEL FAYANDE",3,6,20,23,43
LOUGA,LOUGA,"KEUR MOMAR SARR",GANDE,"GADE BADJI",14,24,100,116,216
LOUGA,LOUGA,"KEUR MOMAR SARR",GANDE,"GADE MBELOGNE",35,43,164,199,363
LOUGA,LOUGA,"KEUR MOMAR SARR",GANDE,"GALAYEL FORAGE",20,31,118,112,230
LOUGA,LOUGA,"KEUR MOMAR SARR",GANDE,"GALDE DIATMEL",5,8,49,64,113
LOUGA,LOUGA,"KEUR MOMAR SARR",GANDE,"GALDE DIOUNABE",1,2,9,10,19
LOUGA,LOUGA,"KEUR MOMAR SARR",GANDE,"GALEGAL 2",20,32,121,159,280
LOUGA,LOUGA,"KEUR MOMAR SARR",GANDE,"GANDE 1",125,258,909,920,1829
LOUGA,LOUGA,"KEUR MOMAR SARR",GANDE,"GANDE KAO",15,22,94,96,190
LOUGA,LOUGA,"KEUR MOMAR SARR",GANDE,"GORBEL OUOLOF",3,6,5,12,17
LOUGA,LOUGA,"KEUR MOMAR SARR",GANDE,"GORBEL PEULH",3,3,16,18,34
LOUGA,LOUGA,"KEUR MOMAR SARR",GANDE,"KEUR ALE",17,20,83,93,176
LOUGA,LOUGA,"KEUR MOMAR SARR",GANDE,"H1 GORBEL",2,2,11,5,16
LOUGA,LOUGA,"KEUR MOMAR SARR",GANDE,"KEUR BASSINE 1",75,93,511,650,1161
LOUGA,LOUGA,"KEUR MOMAR SARR",GANDE,"KEUR IBRA",16,22,151,182,333
LOUGA,LOUGA,"KEUR MOMAR SARR",GANDE,"KEUR SENOU",22,22,134,125,259
LOUGA,LOUGA,"KEUR MOMAR SARR",GANDE,"LOUMBOL BIRAME SEYDI",13,18,50,65,115
LOUGA,LOUGA,"KEUR MOMAR SARR",GANDE,"LOUMBOL BISSINABE",14,21,83,112,195
LOUGA,LOUGA,"KEUR MOMAR SARR",GANDE,"LOUMBOL BOBARY",9,17,56,64,120
LOUGA,LOUGA,"KEUR MOMAR SARR",GANDE,"LOUMBOL SIROBE",10,21,45,65,110
LOUGA,LOUGA,"KEUR MOMAR SARR",GANDE,"H1 GALAYEL",15,33,137,122,259
LOUGA,LOUGA,"KEUR MOMAR SARR",GANDE,"LOUMBY MAHAWA",7,8,50,55,105
LOUGA,LOUGA,"KEUR MOMAR SARR",GANDE,"LOUMBY YARE",2,5,17,16,33
LOUGA,LOUGA,"KEUR MOMAR SARR",GANDE,"MBAFFAR 1",18,19,48,83,131
LOUGA,LOUGA,"KEUR MOMAR SARR",GANDE,"MBAFFAR 2",19,25,79,71,150
LOUGA,LOUGA,"KEUR MOMAR SARR",GANDE,"MBAYBE DEMBA BILALI",22,40,153,166,319
LOUGA,LOUGA,"KEUR MOMAR SARR",GANDE,"MBAYBE 2",25,45,193,192,385
LOUGA,LOUGA,"KEUR MOMAR SARR",GANDE,"MBAYBE NDIAHENE",25,36,162,188,350
LOUGA,LOUGA,"KEUR MOMAR SARR",GANDE,"MBAYBE WODABE",5,11,39,38,77
LOUGA,LOUGA,"KEUR MOMAR SARR",GANDE,"H1 TIRTIRODE",14,22,80,84,164
LOUGA,LOUGA,"KEUR MOMAR SARR",GANDE,MBENGUENE,16,53,113,135,248
LOUGA,LOUGA,"KEUR MOMAR SARR",GANDE,"NDIAO PEULH",22,32,111,89,200
LOUGA,LOUGA,"KEUR MOMAR SARR",GANDE,"NDIAYE NDIANGOU 1",13,24,78,96,174
LOUGA,LOUGA,"KEUR MOMAR SARR",GANDE,"NDIAYE NDIANGOU 2",44,97,244,250,494
LOUGA,LOUGA,"KEUR MOMAR SARR",GANDE,"H1 DAROU RAKHMANE",9,29,53,77,130
LOUGA,LOUGA,"KEUR MOMAR SARR",GANDE,"NDIAYENE PEULH",26,51,199,201,400
LOUGA,LOUGA,"KEUR MOMAR SARR",GANDE,"RENDO OUOLOF",19,36,159,185,344
LOUGA,LOUGA,"KEUR MOMAR SARR",GANDE,"SANTHIOU DAROU",1,2,8,9,17
LOUGA,LOUGA,"KEUR MOMAR SARR",GANDE,"SIRINGUE DAOUDA",26,31,137,121,258
LOUGA,LOUGA,"KEUR MOMAR SARR",GANDE,"SIRINGUE NDONGO",34,62,267,235,502
LOUGA,LOUGA,"KEUR MOMAR SARR",GANDE,TAWFEKH,6,8,43,37,80
LOUGA,LOUGA,"KEUR MOMAR SARR",GANDE,"THIONKE PEULH",12,18,88,97,185
LOUGA,LOUGA,"KEUR MOMAR SARR",GANDE,TIRTIRODE,5,13,59,54,113
LOUGA,LOUGA,"KEUR MOMAR SARR",GANDE,"WODABE GALOYEL",14,19,77,50,127
LOUGA,LOUGA,"KEUR MOMAR SARR",GANDE,"BADJI LAMDOU",26,46,202,192,394
LOUGA,LOUGA,"KEUR MOMAR SARR",GANDE,"BOGAL ADAMA",17,27,136,127,263
LOUGA,LOUGA,"KEUR MOMAR SARR",GANDE,GALAYEL,38,79,246,281,527
LOUGA,LOUGA,"KEUR MOMAR SARR","KEUR MOMAR SARR",AINOUMANE,10,14,76,82,158
LOUGA,LOUGA,"KEUR MOMAR SARR","KEUR MOMAR SARR",ALSEGOU,14,35,85,102,187
LOUGA,LOUGA,"KEUR MOMAR SARR","KEUR MOMAR SARR",BADIENG,19,27,124,119,243
LOUGA,LOUGA,"KEUR MOMAR SARR","KEUR MOMAR SARR",BAFOU,4,6,33,21,54
LOUGA,LOUGA,"KEUR MOMAR SARR","KEUR MOMAR SARR","BIDY PEULH (TOUBA BIDY)",22,33,163,146,309
LOUGA,LOUGA,"KEUR MOMAR SARR","KEUR MOMAR SARR","BOGAL NDIAWENE",22,26,140,125,265
LOUGA,LOUGA,"KEUR MOMAR SARR","KEUR MOMAR SARR","H1 KEUR IBRA MARAME",21,48,182,154,336
LOUGA,LOUGA,"KEUR MOMAR SARR","KEUR MOMAR SARR",BRAR,54,71,413,384,797
LOUGA,LOUGA,"KEUR MOMAR SARR","KEUR MOMAR SARR","DAKHAR KOBA",21,40,152,137,289
LOUGA,LOUGA,"KEUR MOMAR SARR","KEUR MOMAR SARR","DIALBE DIALLA",6,10,28,35,63
LOUGA,LOUGA,"KEUR MOMAR SARR","KEUR MOMAR SARR","DIALBENABE MAKA",4,8,28,39,67
LOUGA,LOUGA,"KEUR MOMAR SARR","KEUR MOMAR SARR","DIALBENABE MAKA NDIAGA",10,28,86,95,181
LOUGA,LOUGA,"KEUR MOMAR SARR","KEUR MOMAR SARR","DIAMINAR KEUR KANE",39,41,262,224,486
LOUGA,LOUGA,"KEUR MOMAR SARR","KEUR MOMAR SARR","DIAMINAR LOYENE",47,50,289,250,539
LOUGA,LOUGA,"KEUR MOMAR SARR","KEUR MOMAR SARR","DIASSARNABE ALY (KEUR COUMBAL)",74,111,520,495,1015
LOUGA,LOUGA,"KEUR MOMAR SARR","KEUR MOMAR SARR","H1 MBANAR NGUESSOGNE",1,1,4,5,9
LOUGA,LOUGA,"KEUR MOMAR SARR","KEUR MOMAR SARR",DIOKOUL,39,41,231,222,453
LOUGA,LOUGA,"KEUR MOMAR SARR","KEUR MOMAR SARR","H1 KAWRI MBAYE",6,10,36,29,65
LOUGA,LOUGA,"KEUR MOMAR SARR","KEUR MOMAR SARR","DIOYE DIAOBE",39,56,205,169,374
LOUGA,LOUGA,"KEUR MOMAR SARR","KEUR MOMAR SARR",FETO,15,19,118,135,253
LOUGA,LOUGA,"KEUR MOMAR SARR","KEUR MOMAR SARR","H2 DEUG DEUG",2,2,6,8,14
LOUGA,LOUGA,"KEUR MOMAR SARR","KEUR MOMAR SARR","GADE KOFIA",1,2,16,19,35
LOUGA,LOUGA,"KEUR MOMAR SARR","KEUR MOMAR SARR","GANGUETTE BALLA",88,109,750,638,1388
LOUGA,LOUGA,"KEUR MOMAR SARR","KEUR MOMAR SARR","GANGUETTE NGUINTH",41,48,264,239,503
LOUGA,LOUGA,"KEUR MOMAR SARR","KEUR MOMAR SARR","H1 GADEGA",10,10,53,55,108
LOUGA,LOUGA,"KEUR MOMAR SARR","KEUR MOMAR SARR","H2 KEUR YAKHE SAWO (KEUR SOGUI)",5,5,46,44,90
LOUGA,LOUGA,"KEUR MOMAR SARR","KEUR MOMAR SARR",GAWGA,11,11,72,61,133
LOUGA,LOUGA,"KEUR MOMAR SARR","KEUR MOMAR SARR",GOLANDE,44,65,232,240,472
LOUGA,LOUGA,"KEUR MOMAR SARR","KEUR MOMAR SARR",GOUDIOUMANE,23,33,90,84,174
LOUGA,LOUGA,"KEUR MOMAR SARR","KEUR MOMAR SARR","GOUYE POULO 1",12,14,76,77,153
LOUGA,LOUGA,"KEUR MOMAR SARR","KEUR MOMAR SARR","GOUYE POULO 2",10,10,38,51,89
LOUGA,LOUGA,"KEUR MOMAR SARR","KEUR MOMAR SARR","GUENE GOUDY 1",15,19,76,66,142
LOUGA,LOUGA,"KEUR MOMAR SARR","KEUR MOMAR SARR","GUENE GOUDY 2",73,85,350,328,678
LOUGA,LOUGA,"KEUR MOMAR SARR","KEUR MOMAR SARR",GUEO,39,44,260,236,496
LOUGA,LOUGA,"KEUR MOMAR SARR","KEUR MOMAR SARR",IBA,7,21,120,87,207
LOUGA,LOUGA,"KEUR MOMAR SARR","KEUR MOMAR SARR","H1 TATHIEREL",4,9,72,69,141
LOUGA,LOUGA,"KEUR MOMAR SARR","KEUR MOMAR SARR",KARAMATOU,21,45,175,162,337
LOUGA,LOUGA,"KEUR MOMAR SARR","KEUR MOMAR SARR","KEUR ALY DEMBEL SOW",23,33,138,97,235
LOUGA,LOUGA,"KEUR MOMAR SARR","KEUR MOMAR SARR","KEUR DEMBA ANTA (DIEYE DEMBA)",18,33,186,188,374
LOUGA,LOUGA,"KEUR MOMAR SARR","KEUR MOMAR SARR","KEUR IBRA BINTA (MBARI BANTE)",66,79,423,267,690
LOUGA,LOUGA,"KEUR MOMAR SARR","KEUR MOMAR SARR","KEUR LIMALE",22,26,133,112,245
LOUGA,LOUGA,"KEUR MOMAR SARR","KEUR MOMAR SARR","KEUR MELO",16,16,69,57,126
LOUGA,LOUGA,"KEUR MOMAR SARR","KEUR MOMAR SARR","KEUR MOMAR SARR",240,317,1138,1166,2304
LOUGA,LOUGA,"KEUR MOMAR SARR","KEUR MOMAR SARR","H3 KEUR YERIM",5,9,34,25,59
LOUGA,LOUGA,"KEUR MOMAR SARR","KEUR MOMAR SARR","KEUR SAMBA FALL (MAKA)",10,14,71,80,151
LOUGA,LOUGA,"KEUR MOMAR SARR","KEUR MOMAR SARR","H1 MAKA PEULH",21,28,86,98,184
LOUGA,LOUGA,"KEUR MOMAR SARR","KEUR MOMAR SARR","KEUR SAMBA THIAMA",61,92,583,640,1223
LOUGA,LOUGA,"KEUR MOMAR SARR","KEUR MOMAR SARR","KEUR YERO MODY",5,5,31,19,50
LOUGA,LOUGA,"KEUR MOMAR SARR","KEUR MOMAR SARR","KEUR YERO THIOLO",29,49,198,171,369
LOUGA,LOUGA,"KEUR MOMAR SARR","KEUR MOMAR SARR","KEUR YORO TACKO",54,85,215,235,450
LOUGA,LOUGA,"KEUR MOMAR SARR","KEUR MOMAR SARR","LATHIANTE 1",25,33,166,121,287
LOUGA,LOUGA,"KEUR MOMAR SARR","KEUR MOMAR SARR","LATHIANTE 2",11,20,54,60,114
LOUGA,LOUGA,"KEUR MOMAR SARR","KEUR MOMAR SARR","LOBOUDOU (KEUR CHEIKH AMADOU NDIAYE)",176,208,875,876,1751
LOUGA,LOUGA,"KEUR MOMAR SARR","KEUR MOMAR SARR","NDOUR LOBOUDOU",8,15,79,90,169
LOUGA,LOUGA,"KEUR MOMAR SARR","KEUR MOMAR SARR","H1 WENDOU BALLY (DANDE MAYO)",19,24,119,136,255
LOUGA,LOUGA,"KEUR MOMAR SARR","KEUR MOMAR SARR","LOTE PEULH",12,26,91,99,190
LOUGA,LOUGA,"KEUR MOMAR SARR","KEUR MOMAR SARR","LOUMBI GUEDO",26,77,130,121,251
LOUGA,LOUGA,"KEUR MOMAR SARR","KEUR MOMAR SARR","H1 THILEL",11,50,97,65,162
LOUGA,LOUGA,"KEUR MOMAR SARR","KEUR MOMAR SARR","LOUMBOUL DADY 1",34,39,220,185,405
LOUGA,LOUGA,"KEUR MOMAR SARR","KEUR MOMAR SARR","LOUMBOUL DADY 2",33,38,176,131,307
LOUGA,LOUGA,"KEUR MOMAR SARR","KEUR MOMAR SARR","MAKA PEULH",23,34,120,147,267
LOUGA,LOUGA,"KEUR MOMAR SARR","KEUR MOMAR SARR","MAKA TALL",17,22,71,91,162
LOUGA,LOUGA,"KEUR MOMAR SARR","KEUR MOMAR SARR","MAKA TOURE (KEUR MBEUGUEL)",12,12,61,54,115
LOUGA,LOUGA,"KEUR MOMAR SARR","KEUR MOMAR SARR","MAYELDE IBRA (MAYELDE PEULH)",72,95,380,342,722
LOUGA,LOUGA,"KEUR MOMAR SARR","KEUR MOMAR SARR","MAYELDE OUOLOF",8,18,79,58,137
LOUGA,LOUGA,"KEUR MOMAR SARR","KEUR MOMAR SARR","MBARE BANTE (KEUR MABOYA)",19,27,142,121,263
LOUGA,LOUGA,"KEUR MOMAR SARR","KEUR MOMAR SARR","MERINA GUEDO",44,53,219,259,478
LOUGA,LOUGA,"KEUR MOMAR SARR","KEUR MOMAR SARR",MIDIO,50,87,307,313,620
LOUGA,LOUGA,"KEUR MOMAR SARR","KEUR MOMAR SARR",NDAME,7,9,39,33,72
LOUGA,LOUGA,"KEUR MOMAR SARR","KEUR MOMAR SARR","NDIA DIEYE",5,7,27,34,61
LOUGA,LOUGA,"KEUR MOMAR SARR","KEUR MOMAR SARR","NDIAO BOUDY",40,73,338,344,682
LOUGA,LOUGA,"KEUR MOMAR SARR","KEUR MOMAR SARR",NDIBE,20,24,133,126,259
LOUGA,LOUGA,"KEUR MOMAR SARR","KEUR MOMAR SARR","NDIMB MBODIENE",167,198,1183,1121,2304
LOUGA,LOUGA,"KEUR MOMAR SARR","KEUR MOMAR SARR","NDIMB NGAYENE",55,61,346,344,690
LOUGA,LOUGA,"KEUR MOMAR SARR","KEUR MOMAR SARR","NDIMB PALENE",52,65,204,220,424
LOUGA,LOUGA,"KEUR MOMAR SARR","KEUR MOMAR SARR","NDIMB PEULH",43,94,339,316,655
LOUGA,LOUGA,"KEUR MOMAR SARR","KEUR MOMAR SARR","NDIMB THIOUBENE",74,82,501,463,964
LOUGA,LOUGA,"KEUR MOMAR SARR","KEUR MOMAR SARR","NDIOBENE KEUR AYA",147,163,780,811,1591
LOUGA,LOUGA,"KEUR MOMAR SARR","KEUR MOMAR SARR","NDODJI SEYE",6,6,39,30,69
LOUGA,LOUGA,"KEUR MOMAR SARR","KEUR MOMAR SARR",NDONTHIE,38,67,325,168,493
LOUGA,LOUGA,"KEUR MOMAR SARR","KEUR MOMAR SARR","NDOUR BAITANGO",18,36,95,101,196
LOUGA,LOUGA,"KEUR MOMAR SARR","KEUR MOMAR SARR","NDOUR 1",44,70,229,229,458
LOUGA,LOUGA,"KEUR MOMAR SARR","KEUR MOMAR SARR","NDOUR 2 (TELLERE)",68,99,394,415,809
LOUGA,LOUGA,"KEUR MOMAR SARR","KEUR MOMAR SARR","H1 MIDIO",8,11,39,39,78
LOUGA,LOUGA,"KEUR MOMAR SARR","KEUR MOMAR SARR","NDOUR KOFIA",11,14,62,66,128
LOUGA,LOUGA,"KEUR MOMAR SARR","KEUR MOMAR SARR","NDOUR ROBO",33,79,216,221,437
LOUGA,LOUGA,"KEUR MOMAR SARR","KEUR MOMAR SARR",NGONAKE,55,73,323,249,572
LOUGA,LOUGA,"KEUR MOMAR SARR","KEUR MOMAR SARR","H1 NGONAKE",11,18,68,50,118
LOUGA,LOUGA,"KEUR MOMAR SARR","KEUR MOMAR SARR","H2 NGONAKE",25,28,149,132,281
LOUGA,LOUGA,"KEUR MOMAR SARR","KEUR MOMAR SARR","RINGAYE MAURES",11,15,53,48,101
LOUGA,LOUGA,"KEUR MOMAR SARR","KEUR MOMAR SARR","H1 KEUR ALY DEMBEL SOW",6,6,17,22,39
LOUGA,LOUGA,"KEUR MOMAR SARR","KEUR MOMAR SARR","H1 RINGAYE MAURE",40,59,207,198,405
LOUGA,LOUGA,"KEUR MOMAR SARR","KEUR MOMAR SARR","SAM KEBE",28,60,211,193,404
LOUGA,LOUGA,"KEUR MOMAR SARR","KEUR MOMAR SARR","TEGUELE DIOP",1,1,3,3,6
LOUGA,LOUGA,"KEUR MOMAR SARR","KEUR MOMAR SARR","TEUDE BITTY (SINTHIOU KEUR LAMINE)",86,90,384,481,865
LOUGA,LOUGA,"KEUR MOMAR SARR","KEUR MOMAR SARR",THIAPEDJI,48,100,401,334,735
LOUGA,LOUGA,"KEUR MOMAR SARR","KEUR MOMAR SARR","THIAT NGOL KADIE",43,87,323,309,632
LOUGA,LOUGA,"KEUR MOMAR SARR","KEUR MOMAR SARR","WENDOU NAMAREL 1",9,28,80,72,152
LOUGA,LOUGA,"KEUR MOMAR SARR","KEUR MOMAR SARR","WENDOU NAMAREL 2",3,10,32,34,66
LOUGA,LOUGA,"KEUR MOMAR SARR","KEUR MOMAR SARR","YOUGOU FALLY",6,8,17,26,43
LOUGA,LOUGA,"KEUR MOMAR SARR","KEUR MOMAR SARR","BALANDE  PEULH",19,34,153,151,304
LOUGA,LOUGA,"KEUR MOMAR SARR","KEUR MOMAR SARR","BOGAL SENE",4,5,25,18,43
LOUGA,LOUGA,"KEUR MOMAR SARR","KEUR MOMAR SARR","KEUR SAMBA TICKO SY",20,28,213,202,415
LOUGA,LOUGA,"KEUR MOMAR SARR","KEUR MOMAR SARR","MOURO ALLE",1,1,13,10,23
LOUGA,LOUGA,"KEUR MOMAR SARR","KEUR MOMAR SARR","NDIAYENE THIAPEDIA",22,36,149,155,304
LOUGA,LOUGA,"KEUR MOMAR SARR","KEUR MOMAR SARR","NDOUR MAYELDE",15,18,71,84,155
LOUGA,LOUGA,"KEUR MOMAR SARR","NGUER MALAL","BELEL KELY 1",18,22,80,88,168
LOUGA,LOUGA,"KEUR MOMAR SARR","NGUER MALAL","BELEL KELY 2",6,6,14,15,29
LOUGA,LOUGA,"KEUR MOMAR SARR","NGUER MALAL","BOKI ILLO",15,17,70,72,142
LOUGA,LOUGA,"KEUR MOMAR SARR","NGUER MALAL","H1 BAODE BALLE DIO",14,18,36,64,100
LOUGA,LOUGA,"KEUR MOMAR SARR","NGUER MALAL","BOUDI SAKHO",124,170,852,1120,1972
LOUGA,LOUGA,"KEUR MOMAR SARR","NGUER MALAL","BOUDI THIECKENE",30,33,89,174,263
LOUGA,LOUGA,"KEUR MOMAR SARR","NGUER MALAL","H2 KEUR PLI",5,5,43,38,81
LOUGA,LOUGA,"KEUR MOMAR SARR","NGUER MALAL","BOYO 1",71,77,366,498,864
LOUGA,LOUGA,"KEUR MOMAR SARR","NGUER MALAL","BOYO 2",72,92,400,565,965
LOUGA,LOUGA,"KEUR MOMAR SARR","NGUER MALAL","H3 NDIOBENE",17,17,67,124,191
LOUGA,LOUGA,"KEUR MOMAR SARR","NGUER MALAL",DABAL,12,12,42,58,100
LOUGA,LOUGA,"KEUR MOMAR SARR","NGUER MALAL","DAROU NOUROU KODIELE",20,21,114,105,219
LOUGA,LOUGA,"KEUR MOMAR SARR","NGUER MALAL","DAROU SALAM NDIACK",35,45,257,278,535
LOUGA,LOUGA,"KEUR MOMAR SARR","NGUER MALAL","DEPAL GUEYE",8,20,75,89,164
LOUGA,LOUGA,"KEUR MOMAR SARR","NGUER MALAL","H1 DEPAL GUEYE",5,5,20,29,49
LOUGA,LOUGA,"KEUR MOMAR SARR","NGUER MALAL","H2 NGUEYEN PEULH",3,4,13,21,34
LOUGA,LOUGA,"KEUR MOMAR SARR","NGUER MALAL","DEPAL MBAYE",21,24,135,136,271
LOUGA,LOUGA,"KEUR MOMAR SARR","NGUER MALAL","DIATMEL (KEUR NGATA)",26,32,174,246,420
LOUGA,LOUGA,"KEUR MOMAR SARR","NGUER MALAL","DIATMEL MIDERE",18,32,91,92,183
LOUGA,LOUGA,"KEUR MOMAR SARR","NGUER MALAL",DIAWENE,10,11,50,48,98
LOUGA,LOUGA,"KEUR MOMAR SARR","NGUER MALAL","GADE DIATMEL",6,6,17,16,33
LOUGA,LOUGA,"KEUR MOMAR SARR","NGUER MALAL","GADE GARANGUEL",7,15,45,47,92
LOUGA,LOUGA,"KEUR MOMAR SARR","NGUER MALAL","GADE MAKA SECK",24,32,188,196,384
LOUGA,LOUGA,"KEUR MOMAR SARR","NGUER MALAL","GARANGUEL DEMBA",15,21,68,78,146
LOUGA,LOUGA,"KEUR MOMAR SARR","NGUER MALAL","GARANGUEL OUOLOF",30,32,118,149,267
LOUGA,LOUGA,"KEUR MOMAR SARR","NGUER MALAL","GARANGUEL PEULH",9,10,37,46,83
LOUGA,LOUGA,"KEUR MOMAR SARR","NGUER MALAL","GATY PAKHA",11,13,60,64,124
LOUGA,LOUGA,"KEUR MOMAR SARR","NGUER MALAL","GOUYE MBEUTH",238,253,890,1259,2149
LOUGA,LOUGA,"KEUR MOMAR SARR","NGUER MALAL","H1 KEUR GADIO",21,24,91,99,190
LOUGA,LOUGA,"KEUR MOMAR SARR","NGUER MALAL","H2 KEUR MBAYE FALL",12,12,60,41,101
LOUGA,LOUGA,"KEUR MOMAR SARR","NGUER MALAL","GUIYAL GOTY",28,39,160,115,275
LOUGA,LOUGA,"KEUR MOMAR SARR","NGUER MALAL","KANTEYENE MANDACK",23,27,97,165,262
LOUGA,LOUGA,"KEUR MOMAR SARR","NGUER MALAL","KEUR ALLE DIAW",38,42,185,277,462
LOUGA,LOUGA,"KEUR MOMAR SARR","NGUER MALAL","KEUR BALLA SEYE",81,106,372,636,1008
LOUGA,LOUGA,"KEUR MOMAR SARR","NGUER MALAL","H2 NDIAYENE",12,12,74,74,148
LOUGA,LOUGA,"KEUR MOMAR SARR","NGUER MALAL","H4 KEUR DAME",20,20,95,115,210
LOUGA,LOUGA,"KEUR MOMAR SARR","NGUER MALAL","H5 GADE PETHIADJI",7,7,36,43,79
LOUGA,LOUGA,"KEUR MOMAR SARR","NGUER MALAL","KEUR GORA FANIANG",9,9,73,82,155
LOUGA,LOUGA,"KEUR MOMAR SARR","NGUER MALAL","KEUR MADIALE 1",50,55,282,260,542
LOUGA,LOUGA,"KEUR MOMAR SARR","NGUER MALAL","KEUR MADIALE 2",5,8,30,40,70
LOUGA,LOUGA,"KEUR MOMAR SARR","NGUER MALAL","KEUR MBALLO NDIAYE",32,35,163,229,392
LOUGA,LOUGA,"KEUR MOMAR SARR","NGUER MALAL","KEUR MEDOUNE MBAYE",30,34,134,162,296
LOUGA,LOUGA,"KEUR MOMAR SARR","NGUER MALAL","KEUR MODY MBAYE",25,27,175,155,330
LOUGA,LOUGA,"KEUR MOMAR SARR","NGUER MALAL","KEUR MOR BEYE",2,2,28,35,63
LOUGA,LOUGA,"KEUR MOMAR SARR","NGUER MALAL","KEUR NDIOUGA SARR",15,15,85,64,149
LOUGA,LOUGA,"KEUR MOMAR SARR","NGUER MALAL","H1 NGADIALAME KEUR NDIOGOU",5,8,30,36,66
LOUGA,LOUGA,"KEUR MOMAR SARR","NGUER MALAL","KEUR SAMBA",25,27,98,175,273
LOUGA,LOUGA,"KEUR MOMAR SARR","NGUER MALAL","LOBOUDOU NDIAYE 2",11,13,40,48,88
LOUGA,LOUGA,"KEUR MOMAR SARR","NGUER MALAL","LOTTE WOLOF",5,5,31,36,67
LOUGA,LOUGA,"KEUR MOMAR SARR","NGUER MALAL","LOUGUERE WANDE",17,29,91,94,185
LOUGA,LOUGA,"KEUR MOMAR SARR","NGUER MALAL","H2 KEUR NIANGANE",9,9,53,51,104
LOUGA,LOUGA,"KEUR MOMAR SARR","NGUER MALAL","LOUGUI TALLY PEULH",5,11,41,41,82
LOUGA,LOUGA,"KEUR MOMAR SARR","NGUER MALAL","LOUMBI ARDO",10,15,40,56,96
LOUGA,LOUGA,"KEUR MOMAR SARR","NGUER MALAL","LOUMBOL MBATHIE",60,62,250,325,575
LOUGA,LOUGA,"KEUR MOMAR SARR","NGUER MALAL","H1 KEUR ABDOU DIENG",1,1,4,4,8
LOUGA,LOUGA,"KEUR MOMAR SARR","NGUER MALAL",MBELOGNE,102,131,642,777,1419
LOUGA,LOUGA,"KEUR MOMAR SARR","NGUER MALAL","MBELOGNE DIOP",64,76,352,442,794
LOUGA,LOUGA,"KEUR MOMAR SARR","NGUER MALAL","MEDINA BALANDE PEULH",9,9,46,42,88
LOUGA,LOUGA,"KEUR MOMAR SARR","NGUER MALAL","NAIDE 1",7,7,18,11,29
LOUGA,LOUGA,"KEUR MOMAR SARR","NGUER MALAL","NAIDE 2",3,5,9,17,26
LOUGA,LOUGA,"KEUR MOMAR SARR","NGUER MALAL",NAYOBE,291,308,1405,1685,3090
LOUGA,LOUGA,"KEUR MOMAR SARR","NGUER MALAL","H1 KEUR MA NDIOUR",13,15,90,113,203
LOUGA,LOUGA,"KEUR MOMAR SARR","NGUER MALAL","NDADARLO GAYE",43,48,237,378,615
LOUGA,LOUGA,"KEUR MOMAR SARR","NGUER MALAL","NGADIALAME 1",40,41,182,311,493
LOUGA,LOUGA,"KEUR MOMAR SARR","NGUER MALAL","H1 KORLEL",12,25,82,97,179
LOUGA,LOUGA,"KEUR MOMAR SARR","NGUER MALAL","NGADIALAME KEUR MAYORO",47,50,197,304,501
LOUGA,LOUGA,"KEUR MOMAR SARR","NGUER MALAL","NGUER MALAL 1",42,49,170,183,353
LOUGA,LOUGA,"KEUR MOMAR SARR","NGUER MALAL","H1 NDIA",10,13,32,50,82
LOUGA,LOUGA,"KEUR MOMAR SARR","NGUER MALAL",NGUEYENE,15,15,92,143,235
LOUGA,LOUGA,"KEUR MOMAR SARR","NGUER MALAL","H1 KEUR MANDIAKHASS",9,11,39,65,104
LOUGA,LOUGA,"KEUR MOMAR SARR","NGUER MALAL","ODABE BADIENCOBE",22,37,138,108,246
LOUGA,LOUGA,"KEUR MOMAR SARR","NGUER MALAL","PATHE POULO 1",25,35,179,184,363
LOUGA,LOUGA,"KEUR MOMAR SARR","NGUER MALAL","PETHIADJI 1",40,47,181,337,518
LOUGA,LOUGA,"KEUR MOMAR SARR","NGUER MALAL","PETHIADJI 2",33,36,143,252,395
LOUGA,LOUGA,"KEUR MOMAR SARR","NGUER MALAL","THIAT NGOL",17,25,114,143,257
LOUGA,LOUGA,"KEUR MOMAR SARR","NGUER MALAL","H2 MBELOGNE MOUTHITEDE",9,11,25,35,60
LOUGA,LOUGA,"KEUR MOMAR SARR","NGUER MALAL","THIOUMADE 1",51,57,314,357,671
LOUGA,LOUGA,"KEUR MOMAR SARR","NGUER MALAL","THIOUMADE 2",31,44,211,190,401
LOUGA,LOUGA,"KEUR MOMAR SARR","NGUER MALAL","WENDOU FANDOU",35,47,183,177,360
LOUGA,LOUGA,"KEUR MOMAR SARR","NGUER MALAL","H1 LOUGUY TALLY PEULH",4,4,8,8,16
LOUGA,LOUGA,"KEUR MOMAR SARR","NGUER MALAL","YARI DAKHAR",63,87,437,504,941
LOUGA,LOUGA,"KEUR MOMAR SARR","NGUER MALAL","YERAL FALL",77,82,360,421,781
LOUGA,LOUGA,"KEUR MOMAR SARR","NGUER MALAL","H1 NGADIALAME PEULH",3,6,23,27,50
LOUGA,LOUGA,"KEUR MOMAR SARR","NGUER MALAL","H2 GARANGUEL PEULH 1",1,2,3,8,11
LOUGA,LOUGA,"KEUR MOMAR SARR","NGUER MALAL","YERAL SOW",60,60,273,377,650
LOUGA,LOUGA,"KEUR MOMAR SARR","NGUER MALAL","H1 YERAL SEYE",12,16,68,85,153
LOUGA,LOUGA,"KEUR MOMAR SARR","NGUER MALAL","YERAL THIAM",120,128,649,759,1408
LOUGA,LOUGA,"KEUR MOMAR SARR","NGUER MALAL",YORTE,5,10,21,32,53
LOUGA,LOUGA,"KEUR MOMAR SARR","NGUER MALAL","BALANDE KEUR SECK",12,13,66,68,134
LOUGA,LOUGA,"KEUR MOMAR SARR","NGUER MALAL","BOSS LABAL",32,49,173,178,351
LOUGA,LOUGA,"KEUR MOMAR SARR","NGUER MALAL","GARANGUEL 2",7,7,31,38,69
LOUGA,LOUGA,"KEUR MOMAR SARR","NGUER MALAL","LOTHE DEMBA THIAPATO",13,19,51,41,92
LOUGA,LOUGA,"KEUR MOMAR SARR","NGUER MALAL","H1 LOTHE L'ISLAM",4,12,21,19,40
LOUGA,LOUGA,"KEUR MOMAR SARR","NGUER MALAL","LOUMBOUL DIASSARNABE",9,12,66,40,106
LOUGA,LOUGA,"KEUR MOMAR SARR","NGUER MALAL","MAKA SECK",2,2,8,9,17
LOUGA,LOUGA,"KEUR MOMAR SARR","NGUER MALAL","NGADIALAME 2",16,30,158,172,330
LOUGA,LOUGA,"KEUR MOMAR SARR","NGUER MALAL","NGADIALAME 3",9,11,39,70,109
LOUGA,LOUGA,"KEUR MOMAR SARR","NGUER MALAL","NGUER MALAL 2",61,67,387,389,776
LOUGA,LOUGA,"KEUR MOMAR SARR","NGUER MALAL","PATHE POULO 2",13,13,102,91,193
LOUGA,LOUGA,"KEUR MOMAR SARR","NGUER MALAL",SAMBAR,3,9,48,35,83
LOUGA,LOUGA,"KEUR MOMAR SARR",SYER,"ALSEGOU (KEUR MASSAMBA DIAGNE)",7,13,36,38,74
LOUGA,LOUGA,"KEUR MOMAR SARR",SYER,"BAODE DOUDAL BISSENABE",18,22,106,88,194
LOUGA,LOUGA,"KEUR MOMAR SARR",SYER,"BAODE DOUDAL DIOUWONABE",22,36,93,127,220
LOUGA,LOUGA,"KEUR MOMAR SARR",SYER,"BAODE GOBEL NOODY",21,49,172,179,351
LOUGA,LOUGA,"KEUR MOMAR SARR",SYER,"BELEL BOKI MENDIELY",14,31,104,106,210
LOUGA,LOUGA,"KEUR MOMAR SARR",SYER,"BELEL KELLY NDOURNABE",18,35,91,112,203
LOUGA,LOUGA,"KEUR MOMAR SARR",SYER,"BELLY GAOUDE",24,72,201,200,401
LOUGA,LOUGA,"KEUR MOMAR SARR",SYER,"BELLY GAWDY CHERIF",22,40,129,127,256
LOUGA,LOUGA,"KEUR MOMAR SARR",SYER,"BELLY GAWDY 2",49,71,231,217,448
LOUGA,LOUGA,"KEUR MOMAR SARR",SYER,"BIGUENE 1",4,4,20,35,55
LOUGA,LOUGA,"KEUR MOMAR SARR",SYER,"BIGUENE 2 (BELEL AYA)",30,50,149,147,296
LOUGA,LOUGA,"KEUR MOMAR SARR",SYER,"BOKINEDO (SYER 1)",28,40,208,169,377
LOUGA,LOUGA,"KEUR MOMAR SARR",SYER,"H1 KEUR NDIANE",13,23,62,69,131
LOUGA,LOUGA,"KEUR MOMAR SARR",SYER,"H1 NOODY YALALBE",5,9,28,22,50
LOUGA,LOUGA,"KEUR MOMAR SARR",SYER,"FOSS 1",82,98,621,583,1204
LOUGA,LOUGA,"KEUR MOMAR SARR",SYER,"GADE BOKINEDO",11,12,48,45,93
LOUGA,LOUGA,"KEUR MOMAR SARR",SYER,"H2 GADE THIEL",6,7,28,30,58
LOUGA,LOUGA,"KEUR MOMAR SARR",SYER,"GADE TAGANIDE",58,99,325,337,662
LOUGA,LOUGA,"KEUR MOMAR SARR",SYER,GUIDICK,45,50,265,189,454
LOUGA,LOUGA,"KEUR MOMAR SARR",SYER,"H1 KEUR MODY SOW",8,26,97,113,210
LOUGA,LOUGA,"KEUR MOMAR SARR",SYER,"KEUR NDARY",14,36,85,67,152
LOUGA,LOUGA,"KEUR MOMAR SARR",SYER,KOUNDOUNGUE,36,63,154,170,324
LOUGA,LOUGA,"KEUR MOMAR SARR",SYER,MALATACK,64,74,420,333,753
LOUGA,LOUGA,"KEUR MOMAR SARR",SYER,"MBANAR KEUR NDIOUGA",8,9,28,27,55
LOUGA,LOUGA,"KEUR MOMAR SARR",SYER,"MBANAR KEUR YORO DADO",6,8,17,26,43
LOUGA,LOUGA,"KEUR MOMAR SARR",SYER,"MBAR TOUBAB",11,47,81,73,154
LOUGA,LOUGA,"KEUR MOMAR SARR",SYER,"MBELOGNE BOULBE",31,115,249,237,486
LOUGA,LOUGA,"KEUR MOMAR SARR",SYER,"MBELOGNE LAW NIANDE",24,81,145,151,296
LOUGA,LOUGA,"KEUR MOMAR SARR",SYER,"H1 MBAR TOUBAB FORAGE",19,42,124,109,233
LOUGA,LOUGA,"KEUR MOMAR SARR",SYER,"MBELOGNE YERO",28,37,115,149,264
LOUGA,LOUGA,"KEUR MOMAR SARR",SYER,"MBOKY NDIYAME",13,17,58,61,119
LOUGA,LOUGA,"KEUR MOMAR SARR",SYER,"MOUTHIE TENGAL 1",21,72,182,190,372
LOUGA,LOUGA,"KEUR MOMAR SARR",SYER,"NDIAYENE DAKHAR ( KEUR ALI DINGUERE)",26,88,266,253,519
LOUGA,LOUGA,"KEUR MOMAR SARR",SYER,"H2 MOUTHIE TENGAL 2",9,30,81,67,148
LOUGA,LOUGA,"KEUR MOMAR SARR",SYER,NDIOYONE,28,70,216,222,438
LOUGA,LOUGA,"KEUR MOMAR SARR",SYER,NOODY,22,37,119,131,250
LOUGA,LOUGA,"KEUR MOMAR SARR",SYER,"SYER 3",61,70,408,294,702
LOUGA,LOUGA,"KEUR MOMAR SARR",SYER,"H2 KEUR SIDY GALLO SOW",22,33,97,113,210
LOUGA,LOUGA,"KEUR MOMAR SARR",SYER,"TAGAR (BELIMARO)",39,142,272,300,572
LOUGA,LOUGA,"KEUR MOMAR SARR",SYER,"THIOYE BELAL",33,47,119,145,264
LOUGA,LOUGA,"KEUR MOMAR SARR",SYER,"WENDOU DELBY",24,54,164,163,327
LOUGA,LOUGA,"KEUR MOMAR SARR",SYER,DIELALLY,52,85,218,226,444
LOUGA,LOUGA,"KEUR MOMAR SARR",SYER,"H1 DIELAY",2,4,14,10,24
LOUGA,LOUGA,"KEUR MOMAR SARR",SYER,"H2 BELEL GAOUDY",8,12,26,34,60
LOUGA,LOUGA,"KEUR MOMAR SARR",SYER,"GADE DIEDIOUBA",10,31,45,62,107
LOUGA,LOUGA,"KEUR MOMAR SARR",SYER,LAWASSE,30,79,191,193,384
LOUGA,LOUGA,"KEUR MOMAR SARR",SYER,"NDIELEFOUL (LALODIE)",24,60,97,99,196
LOUGA,LOUGA,MBEDIENE,"KELE GUEYE","BEUL GUEYE",65,71,446,418,864
LOUGA,LOUGA,MBEDIENE,"KELE GUEYE","BIDIAM GUEYE 1",15,20,94,100,194
LOUGA,LOUGA,MBEDIENE,"KELE GUEYE","BIDIAM GUEYE 2",9,9,46,55,101
LOUGA,LOUGA,MBEDIENE,"KELE GUEYE","BIDIAM MBOUP",8,9,46,50,96
LOUGA,LOUGA,MBEDIENE,"KELE GUEYE","BIDIAM PEULH",6,8,40,39,79
LOUGA,LOUGA,MBEDIENE,"KELE GUEYE","BOUSSOURA LO",38,44,292,284,576
LOUGA,LOUGA,MBEDIENE,"KELE GUEYE","H1 BOUSSOURA PEULH",4,6,25,24,49
LOUGA,LOUGA,MBEDIENE,"KELE GUEYE","H2 MOULAYE IDRISSE",2,2,6,1,7
LOUGA,LOUGA,MBEDIENE,"KELE GUEYE","DARA ARAMINE",5,5,34,25,59
LOUGA,LOUGA,MBEDIENE,"KELE GUEYE","DARA DIAKHOUR",91,94,569,573,1142
LOUGA,LOUGA,MBEDIENE,"KELE GUEYE","KALASSANE NDIAYE",22,29,245,192,437
LOUGA,LOUGA,MBEDIENE,"KELE GUEYE","H1 KALASSANE PEULH",8,9,57,50,107
LOUGA,LOUGA,MBEDIENE,"KELE GUEYE","KAOTARA PEULH",5,12,63,65,128
LOUGA,LOUGA,MBEDIENE,"KELE GUEYE","KELLE GUEYE 1",31,37,170,179,349
LOUGA,LOUGA,MBEDIENE,"KELE GUEYE","KELLE GUEYE 2",27,27,168,188,356
LOUGA,LOUGA,MBEDIENE,"KELE GUEYE","KELLE NDIAYE",37,40,205,233,438
LOUGA,LOUGA,MBEDIENE,"KELE GUEYE","H1 KEUR OUSMANE SOW",3,6,24,27,51
LOUGA,LOUGA,MBEDIENE,"KELE GUEYE","H1 NDOUCOUMANE",23,24,98,115,213
LOUGA,LOUGA,MBEDIENE,"KELE GUEYE","KEUR BOUMI NDIAYE",35,37,290,282,572
LOUGA,LOUGA,MBEDIENE,"KELE GUEYE","KEUR DEMBA FALL",15,21,118,113,231
LOUGA,LOUGA,MBEDIENE,"KELE GUEYE","KEUR GOUMBA FALL",10,11,98,86,184
LOUGA,LOUGA,MBEDIENE,"KELE GUEYE","KEUR MBALLO NDIAYE",38,55,297,322,619
LOUGA,LOUGA,MBEDIENE,"KELE GUEYE","KEUR MOR BRAMA (KEUR DIADJA)",10,13,111,113,224
LOUGA,LOUGA,MBEDIENE,"KELE GUEYE","MBOUT FALL (MBOUT MAHANTA)",5,6,24,28,52
LOUGA,LOUGA,MBEDIENE,"KELE GUEYE","MBOUT KA (THIONE)",27,29,157,150,307
LOUGA,LOUGA,MBEDIENE,"KELE GUEYE","MBOUT SOW (MBOUT MOUSSA)",34,43,270,259,529
LOUGA,LOUGA,MBEDIENE,"KELE GUEYE","NDAME GOTTE",51,56,350,340,690
LOUGA,LOUGA,MBEDIENE,"KELE GUEYE","H1 DAROU",15,15,76,84,160
LOUGA,LOUGA,MBEDIENE,"KELE GUEYE","H2 PEULGA",16,17,99,81,180
LOUGA,LOUGA,MBEDIENE,"KELE GUEYE","NDAME KEUR GUIRY",57,57,206,375,581
LOUGA,LOUGA,MBEDIENE,"KELE GUEYE","H1 KEUR DJIBY SOW",4,7,23,33,56
LOUGA,LOUGA,MBEDIENE,"KELE GUEYE","H2 KEUR MODOU NIASS (RADIO)",8,8,51,64,115
LOUGA,LOUGA,MBEDIENE,"KELE GUEYE","NDANGOUR NDIAYE",28,30,270,260,530
LOUGA,LOUGA,MBEDIENE,"KELE GUEYE","NDIARY BA",19,19,103,109,212
LOUGA,LOUGA,MBEDIENE,"KELE GUEYE","NDIARY DIOP",10,12,104,92,196
LOUGA,LOUGA,MBEDIENE,"KELE GUEYE","NDIARY GUEYE",11,14,107,98,205
LOUGA,LOUGA,MBEDIENE,"KELE GUEYE","NDIOBENE KHAT",3,3,13,16,29
LOUGA,LOUGA,MBEDIENE,"KELE GUEYE","H1 BAÏTY GUEYE",59,62,235,247,482
LOUGA,LOUGA,MBEDIENE,"KELE GUEYE","NGANA KELLE",32,35,204,238,442
LOUGA,LOUGA,MBEDIENE,"KELE GUEYE","NGANA SALL",82,89,516,512,1028
LOUGA,LOUGA,MBEDIENE,"KELE GUEYE","NGUEUNE GUEYE",6,6,39,31,70
LOUGA,LOUGA,MBEDIENE,"KELE GUEYE","NGUEUNE MBENGUE",3,4,35,34,69
LOUGA,LOUGA,MBEDIENE,"KELE GUEYE","NGUEYENE 1 (NGUEYENE OUOLOF)",18,20,111,136,247
LOUGA,LOUGA,MBEDIENE,"KELE GUEYE","NGUEYENE PEULH",4,4,30,28,58
LOUGA,LOUGA,MBEDIENE,"KELE GUEYE","SAME GUEYE",11,13,60,59,119
LOUGA,LOUGA,MBEDIENE,"KELE GUEYE","SANTHIOU DIARAF",13,17,88,79,167
LOUGA,LOUGA,MBEDIENE,"KELE GUEYE","TAIBA SEYE WOLOF",9,16,90,59,149
LOUGA,LOUGA,MBEDIENE,MBEDIENE,"BEURI DIAM CISSE",49,72,332,308,640
LOUGA,LOUGA,MBEDIENE,MBEDIENE,"BEURI DIAM PEULH",3,3,17,15,32
LOUGA,LOUGA,MBEDIENE,MBEDIENE,"DAROU NDIAYE NDIAMBOUR",13,20,73,117,190
LOUGA,LOUGA,MBEDIENE,MBEDIENE,"H1 NDIARE KEUR SALY",4,4,23,35,58
LOUGA,LOUGA,MBEDIENE,MBEDIENE,"DEYE SEUMB",27,36,172,151,323
LOUGA,LOUGA,MBEDIENE,MBEDIENE,"DIADJI NDIAYE",13,13,110,106,216
LOUGA,LOUGA,MBEDIENE,MBEDIENE,"DIAPATE FALL",1,1,7,10,17
LOUGA,LOUGA,MBEDIENE,MBEDIENE,"NDIAPATE MBAYE",8,11,42,56,98
LOUGA,LOUGA,MBEDIENE,MBEDIENE,"DIOKOUL DIENG",15,19,133,97,230
LOUGA,LOUGA,MBEDIENE,MBEDIENE,"H1 NGUEYE",4,4,16,19,35
LOUGA,LOUGA,MBEDIENE,MBEDIENE,"DIOKOUL PEULH",3,3,12,14,26
LOUGA,LOUGA,MBEDIENE,MBEDIENE,"FASS NDIAYE",3,6,30,23,53
LOUGA,LOUGA,MBEDIENE,MBEDIENE,"GATY NDIAYE",4,5,22,23,45
LOUGA,LOUGA,MBEDIENE,MBEDIENE,"KADIAR GAYE",7,7,33,37,70
LOUGA,LOUGA,MBEDIENE,MBEDIENE,"KALLA MBENGUE",6,7,26,24,50
LOUGA,LOUGA,MBEDIENE,MBEDIENE,"KANENE 2",7,9,44,47,91
LOUGA,LOUGA,MBEDIENE,MBEDIENE,"KANENE NDIEKINANE 1",3,4,16,19,35
LOUGA,LOUGA,MBEDIENE,MBEDIENE,"KEUR BOUMY PEULH (NGUENTE PEULH)",2,7,27,21,48
LOUGA,LOUGA,MBEDIENE,MBEDIENE,"KEUR MATAR NDIAYE CISSE",3,6,29,31,60
LOUGA,LOUGA,MBEDIENE,MBEDIENE,"KEUR MODOU NDAO",11,11,58,54,112
LOUGA,LOUGA,MBEDIENE,MBEDIENE,"KEUR MOR ABDOU SEYE",29,35,525,188,713
LOUGA,LOUGA,MBEDIENE,MBEDIENE,"KEUR NDIAYE BALLE",15,17,78,70,148
LOUGA,LOUGA,MBEDIENE,MBEDIENE,"KEUR SACOKI",22,49,232,206,438
LOUGA,LOUGA,MBEDIENE,MBEDIENE,"KEUR SOULEYE LO",34,35,116,199,315
LOUGA,LOUGA,MBEDIENE,MBEDIENE,"KHANDA NDIOBENE",8,15,65,65,130
LOUGA,LOUGA,MBEDIENE,MBEDIENE,"KHANDA PEULH THIERNO",12,18,55,64,119
LOUGA,LOUGA,MBEDIENE,MBEDIENE,"KHANDA TALLENE",4,4,17,12,29
LOUGA,LOUGA,MBEDIENE,MBEDIENE,"KHANDA THIECKENE",3,3,12,7,19
LOUGA,LOUGA,MBEDIENE,MBEDIENE,"KHANDA THIEYENE",1,1,15,17,32
LOUGA,LOUGA,MBEDIENE,MBEDIENE,"LEGUETE BAO",10,11,39,38,77
LOUGA,LOUGA,MBEDIENE,MBEDIENE,"H1 BAIDY",7,9,40,46,86
LOUGA,LOUGA,MBEDIENE,MBEDIENE,MBABOU,5,5,38,41,79
LOUGA,LOUGA,MBEDIENE,MBEDIENE,"MBABOUCK LO",12,35,109,130,239
LOUGA,LOUGA,MBEDIENE,MBEDIENE,MBEDIENE,24,48,220,215,435
LOUGA,LOUGA,MBEDIENE,MBEDIENE,"MBENGUENE 1",3,3,22,29,51
LOUGA,LOUGA,MBEDIENE,MBEDIENE,"MBOREFOU DIOP",10,10,55,47,102
LOUGA,LOUGA,MBEDIENE,MBEDIENE,"MERINA SARR",23,34,159,145,304
LOUGA,LOUGA,MBEDIENE,MBEDIENE,"NDAME SALL NDIARE",15,18,77,71,148
LOUGA,LOUGA,MBEDIENE,MBEDIENE,"NDAME SANTHIE",1,2,28,4,32
LOUGA,LOUGA,MBEDIENE,MBEDIENE,"NDAWENE ALLE",31,40,162,257,419
LOUGA,LOUGA,MBEDIENE,MBEDIENE,"NDAWENE DETHIALAO",63,78,278,373,651
LOUGA,LOUGA,MBEDIENE,MBEDIENE,"NDAWENE PEULH",24,41,199,263,462
LOUGA,LOUGA,MBEDIENE,MBEDIENE,NDIACK,2,2,11,7,18
LOUGA,LOUGA,MBEDIENE,MBEDIENE,"NDIAKHATE KHAKHAM 1",2,6,21,26,47
LOUGA,LOUGA,MBEDIENE,MBEDIENE,"H1 PEULGA de NDIAKHATE KHAKHAM 1",4,4,14,8,22
LOUGA,LOUGA,MBEDIENE,MBEDIENE,"NDIAKHATE KHAKHAM 2",3,13,49,31,80
LOUGA,LOUGA,MBEDIENE,MBEDIENE,"NDIAKHATE NDELENE",8,8,32,38,70
LOUGA,LOUGA,MBEDIENE,MBEDIENE,"NDIARMEO CISSE",4,4,39,35,74
LOUGA,LOUGA,MBEDIENE,MBEDIENE,"NDIARMEO PEULH 1",7,7,30,42,72
LOUGA,LOUGA,MBEDIENE,MBEDIENE,"NDIARNO NIANG",4,5,29,19,48
LOUGA,LOUGA,MBEDIENE,MBEDIENE,"NDIAYE NAR PEULH",10,14,113,68,181
LOUGA,LOUGA,MBEDIENE,MBEDIENE,"NDIEKINANE OUOLOF",13,16,65,62,127
LOUGA,LOUGA,MBEDIENE,MBEDIENE,"NDIEKINANE PEULH",18,33,128,144,272
LOUGA,LOUGA,MBEDIENE,MBEDIENE,"NDIENG CODE NIANE",14,22,74,67,141
LOUGA,LOUGA,MBEDIENE,MBEDIENE,"H1 PEULGA de NDIENG CODE NIANE",10,16,73,73,146
LOUGA,LOUGA,MBEDIENE,MBEDIENE,"H2 KEUR MALICK SOW",3,3,8,7,15
LOUGA,LOUGA,MBEDIENE,MBEDIENE,"NDIMB NDAWENE I",15,19,104,116,220
LOUGA,LOUGA,MBEDIENE,MBEDIENE,"NDIMB NDAWENE II",4,8,35,45,80
LOUGA,LOUGA,MBEDIENE,MBEDIENE,"NGOUNDIOURA DIOP",14,17,80,61,141
LOUGA,LOUGA,MBEDIENE,MBEDIENE,"NGOUNDIOURA NIANE",3,5,25,16,41
LOUGA,LOUGA,MBEDIENE,MBEDIENE,"NGUEYENE II",10,18,72,82,154
LOUGA,LOUGA,MBEDIENE,MBEDIENE,"OUARACK DIOP",2,2,7,8,15
LOUGA,LOUGA,MBEDIENE,MBEDIENE,"PAL KHELY",33,51,196,232,428
LOUGA,LOUGA,MBEDIENE,MBEDIENE,"PALENE BALLA FALL",6,8,34,46,80
LOUGA,LOUGA,MBEDIENE,MBEDIENE,"H1 PALENE PEULH",22,28,190,150,340
LOUGA,LOUGA,MBEDIENE,MBEDIENE,"PALLENE MAFALL (KEUR ALY)",3,3,18,13,31
LOUGA,LOUGA,MBEDIENE,MBEDIENE,"PARE CISSE",46,49,241,279,520
LOUGA,LOUGA,MBEDIENE,MBEDIENE,"SANTHIOU DEKOLE",9,12,36,54,90
LOUGA,LOUGA,MBEDIENE,MBEDIENE,"SANTHIOU DIADJI",14,14,81,83,164
LOUGA,LOUGA,MBEDIENE,MBEDIENE,"SANTHIOU NDIOB I (KEUR BRAM)",3,7,26,38,64
LOUGA,LOUGA,MBEDIENE,MBEDIENE,"SANTHIOU NDIOB II",13,14,73,81,154
LOUGA,LOUGA,MBEDIENE,MBEDIENE,"SINE DIENG",37,44,283,278,561
LOUGA,LOUGA,MBEDIENE,MBEDIENE,"TAIBA PEULH",19,21,144,121,265
LOUGA,LOUGA,MBEDIENE,MBEDIENE,"THIARENE NDIAYE",13,27,108,98,206
LOUGA,LOUGA,MBEDIENE,MBEDIENE,"THIECKENE PEULH",17,22,115,128,243
LOUGA,LOUGA,MBEDIENE,MBEDIENE,"THIECKENE SAM SAM",12,24,114,132,246
LOUGA,LOUGA,MBEDIENE,MBEDIENE,"THIENO PEULH",7,14,65,40,105
LOUGA,LOUGA,MBEDIENE,MBEDIENE,"THILENE 1",6,6,54,49,103
LOUGA,LOUGA,MBEDIENE,MBEDIENE,"THIOLOM SAMB",7,9,37,41,78
LOUGA,LOUGA,MBEDIENE,MBEDIENE,"WAR CISSE",7,10,45,60,105
LOUGA,LOUGA,MBEDIENE,MBEDIENE,"YABTYL DIOP",57,61,565,545,1110
LOUGA,LOUGA,MBEDIENE,MBEDIENE,"YADOU SEYE",4,5,22,18,40
LOUGA,LOUGA,MBEDIENE,MBEDIENE,"NDIARE KEUR MAPENDA",7,7,33,31,64
LOUGA,LOUGA,MBEDIENE,MBEDIENE,"NGAR GUEYE",3,3,12,8,20
LOUGA,LOUGA,MBEDIENE,NGUIDILE,"BADEME DIENG",11,15,68,71,139
LOUGA,LOUGA,MBEDIENE,NGUIDILE,"BADEME NIANE",29,36,235,291,526
LOUGA,LOUGA,MBEDIENE,NGUIDILE,"BAKHAYA DIA",22,27,131,143,274
LOUGA,LOUGA,MBEDIENE,NGUIDILE,"BAKHDAR DIOP",17,19,141,134,275
LOUGA,LOUGA,MBEDIENE,NGUIDILE,"DAGATHIE LO",51,60,427,321,748
LOUGA,LOUGA,MBEDIENE,NGUIDILE,"DAHRA DIAGNE",42,44,282,311,593
LOUGA,LOUGA,MBEDIENE,NGUIDILE,"DIELERLOU SYLLA",177,193,951,1374,2325
LOUGA,LOUGA,MBEDIENE,NGUIDILE,"HALTE GOUYAR",39,44,189,284,473
LOUGA,LOUGA,MBEDIENE,NGUIDILE,"KAMITE SAMB",28,31,148,192,340
LOUGA,LOUGA,MBEDIENE,NGUIDILE,"KAYIP DIA",19,24,154,149,303
LOUGA,LOUGA,MBEDIENE,NGUIDILE,"H1 KAYIP SOW",1,1,7,3,10
LOUGA,LOUGA,MBEDIENE,NGUIDILE,"KEBE NDEUKTA",86,93,490,573,1063
LOUGA,LOUGA,MBEDIENE,NGUIDILE,"KEUR ARAMINE LO",12,28,76,87,163
LOUGA,LOUGA,MBEDIENE,NGUIDILE,"KEUR MAYIP GUEYE",46,54,347,342,689
LOUGA,LOUGA,MBEDIENE,NGUIDILE,"KEUR MBARICK OUOLOF I",32,34,316,203,519
LOUGA,LOUGA,MBEDIENE,NGUIDILE,"KEUR MBARICK OUOLOF II",9,9,50,41,91
LOUGA,LOUGA,MBEDIENE,NGUIDILE,"KEUR MBARICK PEULH I",8,10,71,54,125
LOUGA,LOUGA,MBEDIENE,NGUIDILE,"H1 NDIENDE PEULH",4,4,26,25,51
LOUGA,LOUGA,MBEDIENE,NGUIDILE,"KEUR MBARICK PEULH II",24,27,120,84,204
LOUGA,LOUGA,MBEDIENE,NGUIDILE,"KEUR MODOU KHAIRY MBOUP",73,80,296,448,744
LOUGA,LOUGA,MBEDIENE,NGUIDILE,"KEUR MODOU KHAIRY PEULH 1",13,18,105,92,197
LOUGA,LOUGA,MBEDIENE,NGUIDILE,"KEUR MODOU KHAIRY PEULH 2",7,8,74,59,133
LOUGA,LOUGA,MBEDIENE,NGUIDILE,"KEUR NDEUKTA GUEYE",15,21,108,114,222
LOUGA,LOUGA,MBEDIENE,NGUIDILE,"H1 KEUR SIDY BA",6,8,32,41,73
LOUGA,LOUGA,MBEDIENE,NGUIDILE,"KEUR NDIOUGA FALL",11,11,44,97,141
LOUGA,LOUGA,MBEDIENE,NGUIDILE,"KEUR SAER GUEYE",37,38,200,231,431
LOUGA,LOUGA,MBEDIENE,NGUIDILE,"KHANDA KEUR MBAYE",7,9,49,50,99
LOUGA,LOUGA,MBEDIENE,NGUIDILE,"MAKA BRA GUEYE 1",67,80,366,503,869
LOUGA,LOUGA,MBEDIENE,NGUIDILE,"MAKA BRA GUEYE 2",53,63,210,312,522
LOUGA,LOUGA,MBEDIENE,NGUIDILE,"MAKA MBOUBENE",75,78,257,407,664
LOUGA,LOUGA,MBEDIENE,NGUIDILE,"MAKA PEULH",5,9,34,27,61
LOUGA,LOUGA,MBEDIENE,NGUIDILE,"MBAROME DIOP",62,68,525,442,967
LOUGA,LOUGA,MBEDIENE,NGUIDILE,"NDAME KEUR AMADOU KHARY",22,31,162,249,411
LOUGA,LOUGA,MBEDIENE,NGUIDILE,"NDAME KEUR MODOU FATMA",151,158,885,845,1730
LOUGA,LOUGA,MBEDIENE,NGUIDILE,"NDANKOU BEYE",7,7,16,15,31
LOUGA,LOUGA,MBEDIENE,NGUIDILE,"NDIAGNE FALL (MBOUTE)",14,15,56,86,142
LOUGA,LOUGA,MBEDIENE,NGUIDILE,"NDIAGNE MEDOUNE",19,21,93,136,229
LOUGA,LOUGA,MBEDIENE,NGUIDILE,"NDIAGNE PEULH",7,7,24,32,56
LOUGA,LOUGA,MBEDIENE,NGUIDILE,"NDIARMEO PEULH 2",2,2,8,5,13
LOUGA,LOUGA,MBEDIENE,NGUIDILE,"NDIARY GAMBOUL",19,26,155,191,346
LOUGA,LOUGA,MBEDIENE,NGUIDILE,"NDIARY NIAKHAL",12,15,90,95,185
LOUGA,LOUGA,MBEDIENE,NGUIDILE,"H1 KEUR AMADOU HEGUE",3,3,24,28,52
LOUGA,LOUGA,MBEDIENE,NGUIDILE,"NDIOMENE MBODJI",20,25,119,212,331
LOUGA,LOUGA,MBEDIENE,NGUIDILE,"H1 DAROU GAYE",10,10,45,141,186
LOUGA,LOUGA,MBEDIENE,NGUIDILE,"H1 GOUYAR PEULH",6,7,37,38,75
LOUGA,LOUGA,MBEDIENE,NGUIDILE,"NDIOMENE SAMB",5,5,35,41,76
LOUGA,LOUGA,MBEDIENE,NGUIDILE,"NDJIMBY SECK",88,92,363,514,877
LOUGA,LOUGA,MBEDIENE,NGUIDILE,NGUIDILE,452,483,2533,2366,4899
LOUGA,LOUGA,MBEDIENE,NGUIDILE,"NIAKHAL PEULH",40,44,253,254,507
LOUGA,LOUGA,MBEDIENE,NGUIDILE,"H1 SANTHIE",53,60,245,381,626
LOUGA,LOUGA,MBEDIENE,NGUIDILE,"NIEME CISSE",83,91,472,574,1046
LOUGA,LOUGA,MBEDIENE,NGUIDILE,"H1 KEUR AMADOU BA",7,9,34,41,75
LOUGA,LOUGA,MBEDIENE,NGUIDILE,"OULINGARA NDIAYE",24,26,249,151,400
LOUGA,LOUGA,MBEDIENE,NGUIDILE,"OULINGARA PEULH",10,11,49,46,95
LOUGA,LOUGA,MBEDIENE,NGUIDILE,"OULINGARA TALL",52,62,288,317,605
LOUGA,LOUGA,MBEDIENE,NGUIDILE,"RITE DIAW",66,76,456,527,983
LOUGA,LOUGA,MBEDIENE,NGUIDILE,"H1 KEUR ALIOU KIP",7,13,41,38,79
LOUGA,LOUGA,MBEDIENE,NGUIDILE,"TAWA BEYE",14,15,131,106,237
LOUGA,LOUGA,MBEDIENE,NGUIDILE,"TAWA PEULH",15,17,131,98,229
LOUGA,LOUGA,MBEDIENE,NGUIDILE,"THILENE II",44,48,246,289,535
LOUGA,LOUGA,MBEDIENE,NGUIDILE,"THYLLA GUEYE",7,8,38,45,83
LOUGA,LOUGA,MBEDIENE,NGUIDILE,"TOUBA NIAMBOUR",2,2,6,9,15
LOUGA,LOUGA,MBEDIENE,NGUIDILE,"DAGATHIE DIOP",18,19,79,93,172
LOUGA,LOUGA,MBEDIENE,NGUIDILE,"DAGATHIE SARR",107,113,482,546,1028
LOUGA,LOUGA,MBEDIENE,NGUIDILE,"FERME BAYE MBAYE KEBE",1,1,2,0,2
LOUGA,LOUGA,MBEDIENE,NGUIDILE,"KEUR MBALLO LO",1,1,8,2,10
LOUGA,LOUGA,MBEDIENE,NGUIDILE,"NDIANG FALL",185,197,981,941,1922
LOUGA,LOUGA,MBEDIENE,NGUIDILE,"SAM SAM KEUR NDIAGA SOW",1,1,4,1,5
LOUGA,LOUGA,MBEDIENE,NIOMRE,"AFFE DIENG",39,40,196,269,465
LOUGA,LOUGA,MBEDIENE,NIOMRE,"DIAKHASSELENE KEBE",11,11,77,88,165
LOUGA,LOUGA,MBEDIENE,NIOMRE,"DIAKHASSELENE PEULH",6,9,30,31,61
LOUGA,LOUGA,MBEDIENE,NIOMRE,"H1 GADE NAR",6,6,34,41,75
LOUGA,LOUGA,MBEDIENE,NIOMRE,"GOUYAR DIENG",17,19,45,78,123
LOUGA,LOUGA,MBEDIENE,NIOMRE,"KANTEYENE MALICK",11,11,51,99,150
LOUGA,LOUGA,MBEDIENE,NIOMRE,"H1 SANTHIE",6,6,40,39,79
LOUGA,LOUGA,MBEDIENE,NIOMRE,"KEUR ABLAYE BOUYA",12,13,72,95,167
LOUGA,LOUGA,MBEDIENE,NIOMRE,"KEUR ALLE MARAME",7,7,27,40,67
LOUGA,LOUGA,MBEDIENE,NIOMRE,"KEUR CODE ALASSANE",45,56,187,285,472
LOUGA,LOUGA,MBEDIENE,NIOMRE,"KEUR DAME",14,15,77,105,182
LOUGA,LOUGA,MBEDIENE,NIOMRE,"KEUR IBRA MARAME",33,35,157,203,360
LOUGA,LOUGA,MBEDIENE,NIOMRE,"KEUR MAMOUR GUEYE",9,11,77,58,135
LOUGA,LOUGA,MBEDIENE,NIOMRE,"KEUR MAWA GUEYE",15,15,91,105,196
LOUGA,LOUGA,MBEDIENE,NIOMRE,"KEUR MBARGANE",20,22,192,182,374
LOUGA,LOUGA,MBEDIENE,NIOMRE,"KEUR NDIOUGA (MOR ANTA AYIP)",59,65,317,345,662
LOUGA,LOUGA,MBEDIENE,NIOMRE,"H1 KEUR MOR KEBE",1,1,2,1,3
LOUGA,LOUGA,MBEDIENE,NIOMRE,"KEUR PATHE TALL",18,19,173,157,330
LOUGA,LOUGA,MBEDIENE,NIOMRE,"KEUR SAMBA TACKO",29,29,153,183,336
LOUGA,LOUGA,MBEDIENE,NIOMRE,"KEUR SINY DIENG",24,27,146,120,266
LOUGA,LOUGA,MBEDIENE,NIOMRE,"H1 KEUR ABDOU SAMB",12,13,60,44,104
LOUGA,LOUGA,MBEDIENE,NIOMRE,MBADIANENE,1,1,6,8,14
LOUGA,LOUGA,MBEDIENE,NIOMRE,MBAYENE,25,25,195,203,398
LOUGA,LOUGA,MBEDIENE,NIOMRE,"MBENGUENE 2",71,73,194,381,575
LOUGA,LOUGA,MBEDIENE,NIOMRE,"NDAME KHAB",27,29,123,157,280
LOUGA,LOUGA,MBEDIENE,NIOMRE,"NDAME KHALIL NAR",7,10,53,59,112
LOUGA,LOUGA,MBEDIENE,NIOMRE,"H1 KEUR NDIAME",3,5,51,60,111
LOUGA,LOUGA,MBEDIENE,NIOMRE,"NDAME MAME NDIAYE",17,21,118,91,209
LOUGA,LOUGA,MBEDIENE,NIOMRE,"NDAME PEULH",24,36,163,212,375
LOUGA,LOUGA,MBEDIENE,NIOMRE,"NDIA GOUREYE",66,84,297,457,754
LOUGA,LOUGA,MBEDIENE,NIOMRE,"H1 DIAMAGUENE",16,20,84,111,195
LOUGA,LOUGA,MBEDIENE,NIOMRE,"NDIA KHAKHAM",8,8,55,46,101
LOUGA,LOUGA,MBEDIENE,NIOMRE,"NDIOBENE NGOUNTA",16,22,217,198,415
LOUGA,LOUGA,MBEDIENE,NIOMRE,"NDOGAL DIENG",46,52,217,245,462
LOUGA,LOUGA,MBEDIENE,NIOMRE,"NDOUKOUK DIAGNE",44,46,123,169,292
LOUGA,LOUGA,MBEDIENE,NIOMRE,"H1 PAKHA PEULH",5,7,49,36,85
LOUGA,LOUGA,MBEDIENE,NIOMRE,"H2 TOBY PEULH",6,7,22,47,69
LOUGA,LOUGA,MBEDIENE,NIOMRE,"NGANIAKH DIENG",30,32,162,198,360
LOUGA,LOUGA,MBEDIENE,NIOMRE,"H1 NGANIAKH PEULH",12,12,90,92,182
LOUGA,LOUGA,MBEDIENE,NIOMRE,NGONDAM,5,5,22,28,50
LOUGA,LOUGA,MBEDIENE,NIOMRE,"NGUEDJI DIOP",27,31,134,237,371
LOUGA,LOUGA,MBEDIENE,NIOMRE,"NIOMRE LO",417,458,2015,2503,4518
LOUGA,LOUGA,MBEDIENE,NIOMRE,"PAKHA SOW",84,86,441,493,934
LOUGA,LOUGA,MBEDIENE,NIOMRE,"SAKAL ALOUA (NDIAKHATE NDIERY)",15,16,134,75,209
LOUGA,LOUGA,MBEDIENE,NIOMRE,"SAKAL NIOMRE",14,15,100,95,195
LOUGA,LOUGA,MBEDIENE,NIOMRE,"H1 THIAMBENE",2,2,8,7,15
LOUGA,LOUGA,MBEDIENE,NIOMRE,"SAKHAF BABOU",27,29,120,155,275
LOUGA,LOUGA,MBEDIENE,NIOMRE,"TACKO BISSAP",19,19,117,120,237
LOUGA,LOUGA,MBEDIENE,NIOMRE,"TANIME NGAGNACK",59,64,269,390,659
LOUGA,LOUGA,MBEDIENE,NIOMRE,"H1 KEUR MA FATIME FALL",4,4,29,43,72
LOUGA,LOUGA,MBEDIENE,NIOMRE,"TANIME NIOMRE",60,70,395,424,819
LOUGA,LOUGA,MBEDIENE,NIOMRE,"THIENG NIANG",21,23,100,151,251
LOUGA,LOUGA,MBEDIENE,NIOMRE,"THIENGUE 1",110,124,504,660,1164
LOUGA,LOUGA,MBEDIENE,NIOMRE,"THIENGUE 2",100,111,444,688,1132
LOUGA,LOUGA,MBEDIENE,NIOMRE,THIOUBENE,15,15,77,106,183
LOUGA,LOUGA,MBEDIENE,NIOMRE,"H1 MA NDIAW",4,4,39,31,70
LOUGA,LOUGA,MBEDIENE,NIOMRE,"TOBY NDOUKOUK (TOBY DIOP)",25,25,107,114,221
LOUGA,LOUGA,SAKAL,LEONA,"BAITY GUEYE",74,106,485,579,1064
LOUGA,LOUGA,SAKAL,LEONA,"BAYAKH GAYE",10,15,68,99,167
LOUGA,LOUGA,SAKAL,LEONA,"H1 BAYAKH GAYE",15,24,106,141,247
LOUGA,LOUGA,SAKAL,LEONA,"BAYAKH PEULH 1",4,9,35,26,61
LOUGA,LOUGA,SAKAL,LEONA,"BAYAKH PEULH 2",7,16,68,71,139
LOUGA,LOUGA,SAKAL,LEONA,"BEUTE LAMINE (BATTA)",40,106,298,296,594
LOUGA,LOUGA,SAKAL,LEONA,"BOUNDOU NOULA 1",15,33,147,163,310
LOUGA,LOUGA,SAKAL,LEONA,"BOUNDOU NOULA 2",5,5,21,21,42
LOUGA,LOUGA,SAKAL,LEONA,"CHERIF MBAYE",6,7,61,55,116
LOUGA,LOUGA,SAKAL,LEONA,"DABAYE NDIAYE",7,17,50,41,91
LOUGA,LOUGA,SAKAL,LEONA,DALDIAM,14,24,178,178,356
LOUGA,LOUGA,SAKAL,LEONA,"DAO 1",11,22,143,87,230
LOUGA,LOUGA,SAKAL,LEONA,"DAO 2",77,170,765,668,1433
LOUGA,LOUGA,SAKAL,LEONA,"H2 NAW DJADE (KEUR ARONA DIA)",29,43,152,188,340
LOUGA,LOUGA,SAKAL,LEONA,"DEUK BOUREYE",16,21,154,105,259
LOUGA,LOUGA,SAKAL,LEONA,"DIAMAGUENE OUOLOF",8,8,28,29,57
LOUGA,LOUGA,SAKAL,LEONA,"DIOKOUL WADE",28,33,167,164,331
LOUGA,LOUGA,SAKAL,LEONA,"GABANE OUOLOF",41,57,304,269,573
LOUGA,LOUGA,SAKAL,LEONA,"GABANE PEULH 2",26,39,186,118,304
LOUGA,LOUGA,SAKAL,LEONA,"GABAR 1",65,101,433,407,840
LOUGA,LOUGA,SAKAL,LEONA,"GABAR 2",36,68,309,319,628
LOUGA,LOUGA,SAKAL,LEONA,"GAL DAMEL 1",24,69,295,318,613
LOUGA,LOUGA,SAKAL,LEONA,"GATY TOYE 1 (GATY SARR)",16,18,68,70,138
LOUGA,LOUGA,SAKAL,LEONA,"GATY TOYE 2 (GATY DIOP)",13,13,74,79,153
LOUGA,LOUGA,SAKAL,LEONA,"H1 KEUR AMADOU SOW",5,9,37,28,65
LOUGA,LOUGA,SAKAL,LEONA,GNAYAME,69,136,648,653,1301
LOUGA,LOUGA,SAKAL,LEONA,"GNAYAME RAYETTE",42,64,353,236,589
LOUGA,LOUGA,SAKAL,LEONA,"KEUR AMADOU MOUNA",19,33,139,130,269
LOUGA,LOUGA,SAKAL,LEONA,"KEUR COURA DIERY",65,96,396,362,758
LOUGA,LOUGA,SAKAL,LEONA,"H1 NOREYNI",2,4,9,13,22
LOUGA,LOUGA,SAKAL,LEONA,"KEUR GOUMBA FAYE",10,38,179,176,355
LOUGA,LOUGA,SAKAL,LEONA,"KEUR MALICK FALL",26,43,200,155,355
LOUGA,LOUGA,SAKAL,LEONA,"H1 KEUR MALICK FALL",4,4,18,13,31
LOUGA,LOUGA,SAKAL,LEONA,"KEUR MANDIOLE",22,39,167,161,328
LOUGA,LOUGA,SAKAL,LEONA,"H1 KEUR ALASSANE SOW",4,6,31,19,50
LOUGA,LOUGA,SAKAL,LEONA,"KEUR MOR ARENE",16,17,150,102,252
LOUGA,LOUGA,SAKAL,LEONA,"KEUR NDARY",8,23,74,62,136
LOUGA,LOUGA,SAKAL,LEONA,"KEUR PATHE",3,4,14,9,23
LOUGA,LOUGA,SAKAL,LEONA,"KOGNE KOGNE I",10,18,123,103,226
LOUGA,LOUGA,SAKAL,LEONA,"KOGNE KOGNE II",4,6,22,20,42
LOUGA,LOUGA,SAKAL,LEONA,LEONA,143,176,782,733,1515
LOUGA,LOUGA,SAKAL,LEONA,"H1 LONGHOR PEULH",9,9,36,31,67
LOUGA,LOUGA,SAKAL,LEONA,LONGHOR,40,68,317,239,556
LOUGA,LOUGA,SAKAL,LEONA,"MADAYANA MADE",24,31,195,187,382
LOUGA,LOUGA,SAKAL,LEONA,"H1 KEUR IFRA BA",1,4,16,21,37
LOUGA,LOUGA,SAKAL,LEONA,"MAKA MOR MADICKE",28,33,162,139,301
LOUGA,LOUGA,SAKAL,LEONA,"MAKA NDIAYE",8,8,32,46,78
LOUGA,LOUGA,SAKAL,LEONA,"MAKA TARE",21,30,109,117,226
LOUGA,LOUGA,SAKAL,LEONA,"H1 MBOYENE",1,3,14,17,31
LOUGA,LOUGA,SAKAL,LEONA,"MAUREL PEULH",11,19,100,81,181
LOUGA,LOUGA,SAKAL,LEONA,"MAUREL TARE",50,62,348,398,746
LOUGA,LOUGA,SAKAL,LEONA,"MBAMBA (RAYETTE BAMBA)",10,18,76,78,154
LOUGA,LOUGA,SAKAL,LEONA,MBANDJI,31,39,147,123,270
LOUGA,LOUGA,SAKAL,LEONA,"MBAYE MBAYE MAPATHE",57,65,360,436,796
LOUGA,LOUGA,SAKAL,LEONA,"MBAYE MBAYE MAYORO",8,8,44,56,100
LOUGA,LOUGA,SAKAL,LEONA,MEDINE,11,29,161,123,284
LOUGA,LOUGA,SAKAL,LEONA,"MERINA NDIAYE PEULH",3,4,19,22,41
LOUGA,LOUGA,SAKAL,LEONA,"MERINA SANTHIE",4,4,29,25,54
LOUGA,LOUGA,SAKAL,LEONA,"MERINA SIMONG",16,22,125,131,256
LOUGA,LOUGA,SAKAL,LEONA,"NDADE 1",2,9,26,28,54
LOUGA,LOUGA,SAKAL,LEONA,NDALDAGOU,30,45,189,181,370
LOUGA,LOUGA,SAKAL,LEONA,"H1 GABAR 2",13,13,63,55,118
LOUGA,LOUGA,SAKAL,LEONA,"NDEMBA 1",11,22,108,135,243
LOUGA,LOUGA,SAKAL,LEONA,"NDEMBA 2",19,44,126,166,292
LOUGA,LOUGA,SAKAL,LEONA,"H1 KEUR OUMAR SOW",2,2,7,6,13
LOUGA,LOUGA,SAKAL,LEONA,"NDIAGNE FALL",6,8,53,48,101
LOUGA,LOUGA,SAKAL,LEONA,"NDIALAKHAR SAMB",18,24,105,99,204
LOUGA,LOUGA,SAKAL,LEONA,"NDIAMBE FALL",86,151,677,636,1313
LOUGA,LOUGA,SAKAL,LEONA,"NDIAYENE OUOLOF",11,16,121,117,238
LOUGA,LOUGA,SAKAL,LEONA,"NDIAYENE PEULH 1",8,11,47,45,92
LOUGA,LOUGA,SAKAL,LEONA,"NDIAYENE PEULH 2",15,16,62,57,119
LOUGA,LOUGA,SAKAL,LEONA,"H1 ABOU BA",5,6,25,17,42
LOUGA,LOUGA,SAKAL,LEONA,"NDIAYENE SANTHIE",11,11,53,46,99
LOUGA,LOUGA,SAKAL,LEONA,"H3 NDIALE",23,29,118,138,256
LOUGA,LOUGA,SAKAL,LEONA,NDIELEGNE,76,141,655,531,1186
LOUGA,LOUGA,SAKAL,LEONA,NDIOBENE,42,75,226,253,479
LOUGA,LOUGA,SAKAL,LEONA,NDJIGUEL,13,27,90,74,164
LOUGA,LOUGA,SAKAL,LEONA,NDOUNE,34,53,229,198,427
LOUGA,LOUGA,SAKAL,LEONA,"H2 FASS DIOL",5,5,27,15,42
LOUGA,LOUGA,SAKAL,LEONA,NGONDAME,13,27,95,92,187
LOUGA,LOUGA,SAKAL,LEONA,"NGOUFAT 1",20,67,248,260,508
LOUGA,LOUGA,SAKAL,LEONA,"NGOUFAT 2",33,64,249,286,535
LOUGA,LOUGA,SAKAL,LEONA,"NGUEUREUNG OUOLOF",2,4,15,14,29
LOUGA,LOUGA,SAKAL,LEONA,"NGUEUREUNG PEULH 1",8,14,68,79,147
LOUGA,LOUGA,SAKAL,LEONA,"NGUEUREUNG PEULH 2",7,14,40,23,63
LOUGA,LOUGA,SAKAL,LEONA,"NIANDOUL 1",7,17,71,65,136
LOUGA,LOUGA,SAKAL,LEONA,"NIANDOUL 2",21,36,131,136,267
LOUGA,LOUGA,SAKAL,LEONA,"OUASSA MASSAL",19,79,337,318,655
LOUGA,LOUGA,SAKAL,LEONA,"POTOU 1",141,222,785,638,1423
LOUGA,LOUGA,SAKAL,LEONA,"POTOU 2",11,20,80,66,146
LOUGA,LOUGA,SAKAL,LEONA,"SAGUE DJIBY YAGUE",43,61,324,257,581
LOUGA,LOUGA,SAKAL,LEONA,"H1 KEUR MAGATTE DIAGNE",5,7,20,13,33
LOUGA,LOUGA,SAKAL,LEONA,"SAGUE SATHIEL 1",33,39,203,176,379
LOUGA,LOUGA,SAKAL,LEONA,"SAGUE SAYORO",14,43,179,139,318
LOUGA,LOUGA,SAKAL,LEONA,"SAM SAM",27,33,119,105,224
LOUGA,LOUGA,SAKAL,LEONA,"SAME NDIAYE",40,54,332,347,679
LOUGA,LOUGA,SAKAL,LEONA,"SANTHIOU DABAYE",3,7,30,26,56
LOUGA,LOUGA,SAKAL,LEONA,"SANTHIOU DIADJI",81,87,472,437,909
LOUGA,LOUGA,SAKAL,LEONA,"SANTHIOU DIAOBE 1",4,8,24,15,39
LOUGA,LOUGA,SAKAL,LEONA,"H1 KEUR ASSANE NGOM",3,13,61,58,119
LOUGA,LOUGA,SAKAL,LEONA,"SYER OUOLOF",6,9,46,39,85
LOUGA,LOUGA,SAKAL,LEONA,"SYER PEULH",17,40,244,223,467
LOUGA,LOUGA,SAKAL,LEONA,"H1 KEUR OUMAR NDANKH",8,11,50,63,113
LOUGA,LOUGA,SAKAL,LEONA,TARE,86,103,553,548,1101
LOUGA,LOUGA,SAKAL,LEONA,"THIAR NDIAYE",49,58,307,324,631
LOUGA,LOUGA,SAKAL,LEONA,"THIAR PEULH",9,13,40,33,73
LOUGA,LOUGA,SAKAL,LEONA,"THIAR SENE",15,22,96,106,202
LOUGA,LOUGA,SAKAL,LEONA,"THIARENE SARR",3,7,21,28,49
LOUGA,LOUGA,SAKAL,LEONA,"H1 KEUR LABA SOW",3,3,19,11,30
LOUGA,LOUGA,SAKAL,LEONA,"THIELE MANE",2,2,13,14,27
LOUGA,LOUGA,SAKAL,LEONA,THIOWORE,186,301,1277,1228,2505
LOUGA,LOUGA,SAKAL,LEONA,THISNOR,10,35,122,95,217
LOUGA,LOUGA,SAKAL,LEONA,TOBY,7,7,22,28,50
LOUGA,LOUGA,SAKAL,LEONA,"H1 KEUR OMAR KA",6,6,26,27,53
LOUGA,LOUGA,SAKAL,LEONA,WAKHALDIAM,21,55,231,218,449
LOUGA,LOUGA,SAKAL,LEONA,WEKHE,49,95,527,439,966
LOUGA,LOUGA,SAKAL,LEONA,"YEGOUL MBOYO",53,88,328,264,592
LOUGA,LOUGA,SAKAL,LEONA,"H1 KEUR SIDI BA",4,5,20,18,38
LOUGA,LOUGA,SAKAL,LEONA,"DIAMAGUENE PEULH",3,9,59,38,97
LOUGA,LOUGA,SAKAL,LEONA,"GABANE PEULH 1",4,4,11,6,17
LOUGA,LOUGA,SAKAL,LEONA,"GAL DAMEL 2",1,6,21,15,36
LOUGA,LOUGA,SAKAL,LEONA,"KEUR ABDOUL SOW",16,19,107,101,208
LOUGA,LOUGA,SAKAL,LEONA,"KEUR ASSANE SOW",9,10,77,48,125
LOUGA,LOUGA,SAKAL,LEONA,"KEUR COURA GUEDJI",13,22,90,106,196
LOUGA,LOUGA,SAKAL,LEONA,"KEUR DOUDOU BA",6,14,82,82,164
LOUGA,LOUGA,SAKAL,LEONA,"KEUR MAMADOU DIAMALY",9,16,64,62,126
LOUGA,LOUGA,SAKAL,LEONA,"MAKA KA",2,4,16,13,29
LOUGA,LOUGA,SAKAL,LEONA,MARNANE,11,19,97,86,183
LOUGA,LOUGA,SAKAL,LEONA,"MBABA NDIAYE",19,41,155,139,294
LOUGA,LOUGA,SAKAL,LEONA,"MEDINA THIOLOME",28,41,222,251,473
LOUGA,LOUGA,SAKAL,LEONA,"MERINA SAME",14,17,84,116,200
LOUGA,LOUGA,SAKAL,LEONA,MONTAGNE,155,184,766,665,1431
LOUGA,LOUGA,SAKAL,LEONA,"NDADE 2",16,40,154,123,277
LOUGA,LOUGA,SAKAL,LEONA,NDOP,10,19,83,61,144
LOUGA,LOUGA,SAKAL,LEONA,NOREYNI,3,7,42,40,82
LOUGA,LOUGA,SAKAL,LEONA,SAGNE,8,17,48,49,97
LOUGA,LOUGA,SAKAL,LEONA,"SAGUE SATHIEL 2",15,55,240,196,436
LOUGA,LOUGA,SAKAL,LEONA,"SAME FALL",14,14,103,79,182
LOUGA,LOUGA,SAKAL,LEONA,"SAME PEULH",6,14,64,58,122
LOUGA,LOUGA,SAKAL,LEONA,"SANTHIE NDIOBENE",16,22,87,110,197
LOUGA,LOUGA,SAKAL,LEONA,"SANTHIOU DIAOBE 2",10,18,82,72,154
LOUGA,LOUGA,SAKAL,LEONA,"THIAR SECK",9,11,47,55,102
LOUGA,LOUGA,SAKAL,"NGUEUNE SARR","BAYNACK PEUL",3,4,18,8,26
LOUGA,LOUGA,SAKAL,"NGUEUNE SARR","BANGADJI SAMB",31,42,256,231,487
LOUGA,LOUGA,SAKAL,"NGUEUNE SARR","BAYTI RIP (SANTHIOU BAITY) ET MBAYE MBAYE SALIOU",46,57,431,434,865
LOUGA,LOUGA,SAKAL,"NGUEUNE SARR","H1 SANTHIOU THIARENE",19,24,174,162,336
LOUGA,LOUGA,SAKAL,"NGUEUNE SARR",BAINACK,6,18,49,62,111
LOUGA,LOUGA,SAKAL,"NGUEUNE SARR","DABAYE PEULH 1",13,20,99,77,176
LOUGA,LOUGA,SAKAL,"NGUEUNE SARR","DABAYE PEULH 2",9,13,71,82,153
LOUGA,LOUGA,SAKAL,"NGUEUNE SARR","DABAYE SARR",52,60,333,317,650
LOUGA,LOUGA,SAKAL,"NGUEUNE SARR","DAROU NIANG",30,32,230,230,460
LOUGA,LOUGA,SAKAL,"NGUEUNE SARR","DIADJI GOUMACK",41,62,345,354,699
LOUGA,LOUGA,SAKAL,"NGUEUNE SARR","DIADJI GUEYE (NGAITA)",6,6,23,23,46
LOUGA,LOUGA,SAKAL,"NGUEUNE SARR","DIAPAL PEULH",11,11,53,38,91
LOUGA,LOUGA,SAKAL,"NGUEUNE SARR","DIAPAL SARR",4,7,17,22,39
LOUGA,LOUGA,SAKAL,"NGUEUNE SARR","DIEYE PEULH BA",2,4,14,27,41
LOUGA,LOUGA,SAKAL,"NGUEUNE SARR","FASS GAYE",3,5,21,28,49
LOUGA,LOUGA,SAKAL,"NGUEUNE SARR","GOUYAR SARR",49,68,289,276,565
LOUGA,LOUGA,SAKAL,"NGUEUNE SARR","KEBE SAM PEULH",10,16,78,80,158
LOUGA,LOUGA,SAKAL,"NGUEUNE SARR","KEUR BARA",8,9,57,63,120
LOUGA,LOUGA,SAKAL,"NGUEUNE SARR","KEUR MAFALL FALL",29,32,245,274,519
LOUGA,LOUGA,SAKAL,"NGUEUNE SARR","KEUR MAYORO AGA",1,1,1,0,1
LOUGA,LOUGA,SAKAL,"NGUEUNE SARR","KEUR SAMBOU (NDIOUROUKHLENE)",61,75,445,350,795
LOUGA,LOUGA,SAKAL,"NGUEUNE SARR","KHAMBALLA FALL",39,41,181,248,429
LOUGA,LOUGA,SAKAL,"NGUEUNE SARR","KHAMBALLA TOP",46,49,199,328,527
LOUGA,LOUGA,SAKAL,"NGUEUNE SARR",KHANADJI,30,30,191,182,373
LOUGA,LOUGA,SAKAL,"NGUEUNE SARR","H2 KEUR MOR (SANTHIE KHANADJI)",10,14,81,88,169
LOUGA,LOUGA,SAKAL,"NGUEUNE SARR","KHELCOM HALL",22,25,135,140,275
LOUGA,LOUGA,SAKAL,"NGUEUNE SARR","H1 TAIBA DIOP",6,11,34,48,82
LOUGA,LOUGA,SAKAL,"NGUEUNE SARR","KHELCOM PEULH",13,20,126,127,253
LOUGA,LOUGA,SAKAL,"NGUEUNE SARR","KHELCOM SARR",4,5,28,30,58
LOUGA,LOUGA,SAKAL,"NGUEUNE SARR","LAMBADJI NDIAYE",18,20,128,119,247
LOUGA,LOUGA,SAKAL,"NGUEUNE SARR","LAMBADJI PEULH",8,12,54,62,116
LOUGA,LOUGA,SAKAL,"NGUEUNE SARR","MARAYE SECK",16,22,163,127,290
LOUGA,LOUGA,SAKAL,"NGUEUNE SARR","MBANDE DIOP",26,45,139,126,265
LOUGA,LOUGA,SAKAL,"NGUEUNE SARR","MBOUBENE MBATAR",15,18,150,125,275
LOUGA,LOUGA,SAKAL,"NGUEUNE SARR","MBAYE MBAYE FARY",12,13,120,111,231
LOUGA,LOUGA,SAKAL,"NGUEUNE SARR","MBAYENE DIOP",7,8,61,35,96
LOUGA,LOUGA,SAKAL,"NGUEUNE SARR","H1 KEUR ALY TABARA",8,9,120,112,232
LOUGA,LOUGA,SAKAL,"NGUEUNE SARR",MBOUT,2,2,31,26,57
LOUGA,LOUGA,SAKAL,"NGUEUNE SARR","MERINA DIOP (MERINA OUOLOF)",3,3,13,9,22
LOUGA,LOUGA,SAKAL,"NGUEUNE SARR","MERINA PALLENE",25,27,117,136,253
LOUGA,LOUGA,SAKAL,"NGUEUNE SARR","MERINA PEULH 1",33,34,185,207,392
LOUGA,LOUGA,SAKAL,"NGUEUNE SARR","MERINA PEUL 2 (KHEWEUL)",14,16,127,128,255
LOUGA,LOUGA,SAKAL,"NGUEUNE SARR","NDAME LO",7,16,61,40,101
LOUGA,LOUGA,SAKAL,"NGUEUNE SARR","NDAME PEULH 1",12,17,65,59,124
LOUGA,LOUGA,SAKAL,"NGUEUNE SARR","NDAME PEULH 2",3,6,18,18,36
LOUGA,LOUGA,SAKAL,"NGUEUNE SARR","NDER MBALLO",28,34,162,128,290
LOUGA,LOUGA,SAKAL,"NGUEUNE SARR","NDER SANTHIE",2,2,15,18,33
LOUGA,LOUGA,SAKAL,"NGUEUNE SARR","NDIAMA OUOLOF",1,1,10,11,21
LOUGA,LOUGA,SAKAL,"NGUEUNE SARR","NDIAMA PEULH",2,4,29,23,52
LOUGA,LOUGA,SAKAL,"NGUEUNE SARR","NDIEYE NIANG",47,58,339,371,710
LOUGA,LOUGA,SAKAL,"NGUEUNE SARR","H1 KEUR DJIBEL BA",1,2,9,12,21
LOUGA,LOUGA,SAKAL,"NGUEUNE SARR",NDIOCK,35,47,299,256,555
LOUGA,LOUGA,SAKAL,"NGUEUNE SARR","NGUEUNE SARR",121,146,661,715,1376
LOUGA,LOUGA,SAKAL,"NGUEUNE SARR","PALLENE FALL",71,86,670,643,1313
LOUGA,LOUGA,SAKAL,"NGUEUNE SARR","RIMBAKH PEULH",44,59,218,230,448
LOUGA,LOUGA,SAKAL,"NGUEUNE SARR","H1 KEUR SAMBOU",67,82,456,479,935
LOUGA,LOUGA,SAKAL,"NGUEUNE SARR","SALIM PEULH",12,12,65,54,119
LOUGA,LOUGA,SAKAL,"NGUEUNE SARR","SALIM SARR",18,18,103,107,210
LOUGA,LOUGA,SAKAL,"NGUEUNE SARR","SAME SECK",13,16,69,81,150
LOUGA,LOUGA,SAKAL,"NGUEUNE SARR","SINE WADE OUOLOF",40,47,290,284,574
LOUGA,LOUGA,SAKAL,"NGUEUNE SARR","SINE WADE PEULH",7,7,58,49,107
LOUGA,LOUGA,SAKAL,"NGUEUNE SARR","H1 SINE WADE PEULH",8,10,61,62,123
LOUGA,LOUGA,SAKAL,"NGUEUNE SARR","TAIBA NDIAYE",3,5,25,17,42
LOUGA,LOUGA,SAKAL,"NGUEUNE SARR","TAIBA PEULH 1",21,31,170,153,323
LOUGA,LOUGA,SAKAL,"NGUEUNE SARR","TAIBA PEULH 2",8,14,74,73,147
LOUGA,LOUGA,SAKAL,"NGUEUNE SARR","THIARENE SARR 2",14,18,90,96,186
LOUGA,LOUGA,SAKAL,"NGUEUNE SARR","H2 THIARENE SARR 2",15,16,98,68,166
LOUGA,LOUGA,SAKAL,"NGUEUNE SARR","THIECKENE MBATAR",18,18,102,110,212
LOUGA,LOUGA,SAKAL,"NGUEUNE SARR","YERWAYE DIOP",32,38,303,290,593
LOUGA,LOUGA,SAKAL,"NGUEUNE SARR","YEURMANDE DIENG",66,78,517,506,1023
LOUGA,LOUGA,SAKAL,"NGUEUNE SARR","AFFE NIANG",3,4,17,14,31
LOUGA,LOUGA,SAKAL,"NGUEUNE SARR","H1 AFFE NIANG",20,20,85,87,172
LOUGA,LOUGA,SAKAL,"NGUEUNE SARR","DAROU RAHMANE",2,3,3,4,7
LOUGA,LOUGA,SAKAL,"NGUEUNE SARR","NGANAR DIAGNE",3,4,73,103,176
LOUGA,LOUGA,SAKAL,SAKAL,"AFFE SOW",21,21,85,93,178
LOUGA,LOUGA,SAKAL,SAKAL,"H1 NGONAKE",13,14,79,71,150
LOUGA,LOUGA,SAKAL,SAKAL,"ALLOULAYE (KEUR DAWE GAYE)",14,16,88,85,173
LOUGA,LOUGA,SAKAL,SAKAL,"BADEME OUOLOF",1,2,7,17,24
LOUGA,LOUGA,SAKAL,SAKAL,"H1 BADEME PEULH",5,6,54,51,105
LOUGA,LOUGA,SAKAL,SAKAL,"BAKHDAR MBENGUE",8,11,48,34,82
LOUGA,LOUGA,SAKAL,SAKAL,"BARALE NDIAYE",71,82,538,511,1049
LOUGA,LOUGA,SAKAL,SAKAL,"BARRY NIANG",26,32,126,146,272
LOUGA,LOUGA,SAKAL,SAKAL,"BARRY PEULH",8,9,53,49,102
LOUGA,LOUGA,SAKAL,SAKAL,"BAYRAT PEULH",15,16,92,86,178
LOUGA,LOUGA,SAKAL,SAKAL,"BEGAYE ARDO",20,34,150,135,285
LOUGA,LOUGA,SAKAL,SAKAL,"BEGAYE SAMB",13,15,107,122,229
LOUGA,LOUGA,SAKAL,SAKAL,"H2 KEUR ABDOU BERRY ANNE",4,14,79,76,155
LOUGA,LOUGA,SAKAL,SAKAL,"BOGAL DIOP",15,17,81,93,174
LOUGA,LOUGA,SAKAL,SAKAL,"DAROU SALAM",26,29,151,147,298
LOUGA,LOUGA,SAKAL,SAKAL,"DEBY GUEDJI",15,20,87,104,191
LOUGA,LOUGA,SAKAL,SAKAL,"DENDE 1",16,31,170,132,302
LOUGA,LOUGA,SAKAL,SAKAL,"DENDE 2",5,11,33,28,61
LOUGA,LOUGA,SAKAL,SAKAL,"DIAKHA LOUM",13,22,72,99,171
LOUGA,LOUGA,SAKAL,SAKAL,"DJIBY DIEKY",6,9,43,48,91
LOUGA,LOUGA,SAKAL,SAKAL,"FASS BAGDAD",2,2,15,6,21
LOUGA,LOUGA,SAKAL,SAKAL,"GADE NAR",11,13,75,58,133
LOUGA,LOUGA,SAKAL,SAKAL,"GADE NDEMBA OUOLOF",21,33,141,163,304
LOUGA,LOUGA,SAKAL,SAKAL,"H1 BOYA SECK",6,7,30,53,83
LOUGA,LOUGA,SAKAL,SAKAL,"GADE NDEMBA PEULH",11,16,64,75,139
LOUGA,LOUGA,SAKAL,SAKAL,"H1 GADE ll KEUR MAÏSSA GUEYE",11,13,46,47,93
LOUGA,LOUGA,SAKAL,SAKAL,"H2 LISLAM",10,10,61,61,122
LOUGA,LOUGA,SAKAL,SAKAL,"H3 LISLAM",9,10,55,57,112
LOUGA,LOUGA,SAKAL,SAKAL,"KADIAR DIOP",7,7,47,58,105
LOUGA,LOUGA,SAKAL,SAKAL,"KADIAR PEULH",20,28,155,106,261
LOUGA,LOUGA,SAKAL,SAKAL,"KALAMINE DIENG",30,32,182,174,356
LOUGA,LOUGA,SAKAL,SAKAL,"KALAMINE SARR",21,24,148,159,307
LOUGA,LOUGA,SAKAL,SAKAL,"KALLAMINE PEULH",5,5,21,12,33
LOUGA,LOUGA,SAKAL,SAKAL,"KEUR BALLA NIASSE",15,19,84,81,165
LOUGA,LOUGA,SAKAL,SAKAL,"KEUR BAME",9,11,14,25,39
LOUGA,LOUGA,SAKAL,SAKAL,"KEUR CODE DIOP",8,10,54,53,107
LOUGA,LOUGA,SAKAL,SAKAL,"KEUR GALLO PENDAL SOW",2,2,39,21,60
LOUGA,LOUGA,SAKAL,SAKAL,"H1 MODY BA SOW",6,13,39,56,95
LOUGA,LOUGA,SAKAL,SAKAL,"H2 MAMADOU BA",5,5,36,33,69
LOUGA,LOUGA,SAKAL,SAKAL,"KEUR IBRA NIANG",15,24,124,138,262
LOUGA,LOUGA,SAKAL,SAKAL,"KEUR MAHANTA DIOP",6,6,122,43,165
LOUGA,LOUGA,SAKAL,SAKAL,"H1 KEUR MAMADOU LAMINE BA",6,9,36,66,102
LOUGA,LOUGA,SAKAL,SAKAL,"KEUR MAHANTA PEULH",12,13,58,55,113
LOUGA,LOUGA,SAKAL,SAKAL,"KEUR MAMA (KEUR BOUYA)",7,7,43,56,99
LOUGA,LOUGA,SAKAL,SAKAL,"KEUR MANDIAYE BAKARY",51,56,297,268,565
LOUGA,LOUGA,SAKAL,SAKAL,"KEUR MASSAMBA MALICK",13,13,62,78,140
LOUGA,LOUGA,SAKAL,SAKAL,"KEUR MBAYE KANE OUOLOF",20,23,149,141,290
LOUGA,LOUGA,SAKAL,SAKAL,"KEUR MBAYE KANE PEULH",6,6,27,37,64
LOUGA,LOUGA,SAKAL,SAKAL,"KEUR MEISSA MBOUP",20,27,199,179,378
LOUGA,LOUGA,SAKAL,SAKAL,"KEUR MODOU FALL",31,41,65,210,275
LOUGA,LOUGA,SAKAL,SAKAL,"KEUR PATHE PEULH",37,36,217,168,385
LOUGA,LOUGA,SAKAL,SAKAL,"KEUR PATHE SANTHIE",19,27,170,194,364
LOUGA,LOUGA,SAKAL,SAKAL,"H2 KEUR PATHE SANTHIE",5,7,37,55,92
LOUGA,LOUGA,SAKAL,SAKAL,"KEUR PATHE SYLLA",5,5,53,65,118
LOUGA,LOUGA,SAKAL,SAKAL,"KEUR SAM PENDEL",15,25,127,130,257
LOUGA,LOUGA,SAKAL,SAKAL,"H1 NAMAREL",23,45,203,173,376
LOUGA,LOUGA,SAKAL,SAKAL,"KEUR SAMBA NGARA",11,16,68,61,129
LOUGA,LOUGA,SAKAL,SAKAL,"H1 KEUR DAOUDA BA",3,4,23,13,36
LOUGA,LOUGA,SAKAL,SAKAL,"MAKA GUEYE",5,7,24,24,48
LOUGA,LOUGA,SAKAL,SAKAL,"H1 MAKA GUEYE",7,7,63,76,139
LOUGA,LOUGA,SAKAL,SAKAL,"MAKA KALLE FALL",39,45,225,288,513
LOUGA,LOUGA,SAKAL,SAKAL,"MAKA LEYE",16,24,90,118,208
LOUGA,LOUGA,SAKAL,SAKAL,"MAKA YAMBE YADE",7,7,43,61,104
LOUGA,LOUGA,SAKAL,SAKAL,"MARA DIAGNE",12,14,62,64,126
LOUGA,LOUGA,SAKAL,SAKAL,"MASSAR 1",23,35,166,146,312
LOUGA,LOUGA,SAKAL,SAKAL,"MASSAR 2",17,17,80,82,162
LOUGA,LOUGA,SAKAL,SAKAL,"MASSAR TEUGUE",9,11,50,44,94
LOUGA,LOUGA,SAKAL,SAKAL,"H1 SINTHIOU YAMANE SECK",36,47,194,224,418
LOUGA,LOUGA,SAKAL,SAKAL,"H2 SINTHIOU KADIAR",12,13,67,71,138
LOUGA,LOUGA,SAKAL,SAKAL,"MBANDE PEULH",9,11,70,54,124
LOUGA,LOUGA,SAKAL,SAKAL,"H1 KEUR TALLA SOW",2,6,14,22,36
LOUGA,LOUGA,SAKAL,SAKAL,"MBAYE MBAYE PEULH",8,8,37,60,97
LOUGA,LOUGA,SAKAL,SAKAL,MBEKHEUL,20,28,119,118,237
LOUGA,LOUGA,SAKAL,SAKAL,"MBIRAMA SENGUE RATE",16,21,76,89,165
LOUGA,LOUGA,SAKAL,SAKAL,MBOUBENE,3,4,19,22,41
LOUGA,LOUGA,SAKAL,SAKAL,"MBOYO SECK",8,8,60,69,129
LOUGA,LOUGA,SAKAL,SAKAL,"H2 KEUR NDIAGA MAMADOU",7,9,31,28,59
LOUGA,LOUGA,SAKAL,SAKAL,"NDABE TALL",35,42,171,172,343
LOUGA,LOUGA,SAKAL,SAKAL,"H1 MBAYE MBAYE DIAGNE",6,8,39,44,83
LOUGA,LOUGA,SAKAL,SAKAL,"NDAKHAR NDIAYE",25,29,104,136,240
LOUGA,LOUGA,SAKAL,SAKAL,"NDANGOUR FALL",18,20,182,183,365
LOUGA,LOUGA,SAKAL,SAKAL,"H1 NAYEDIA BA",8,19,71,66,137
LOUGA,LOUGA,SAKAL,SAKAL,"H2 KEUR BARA",6,11,36,37,73
LOUGA,LOUGA,SAKAL,SAKAL,"NDAWASS DIAGNE",30,32,187,192,379
LOUGA,LOUGA,SAKAL,SAKAL,"NDIADIERE PEULH",6,8,51,53,104
LOUGA,LOUGA,SAKAL,SAKAL,"NDIAGUENE OUOLOF",23,23,108,163,271
LOUGA,LOUGA,SAKAL,SAKAL,"NDIAGUENE PEULH",34,49,212,194,406
LOUGA,LOUGA,SAKAL,SAKAL,"NDIAMADJI FALL",7,7,32,27,59
LOUGA,LOUGA,SAKAL,SAKAL,"NDIAYENE POTOU",8,11,35,36,71
LOUGA,LOUGA,SAKAL,SAKAL,"NDIEYE PEULH",9,11,44,41,85
LOUGA,LOUGA,SAKAL,SAKAL,"NDIEYE SATOURE",20,32,187,159,346
LOUGA,LOUGA,SAKAL,SAKAL,"H1 NIANGUENE",3,3,16,8,24
LOUGA,LOUGA,SAKAL,SAKAL,"H2 NDIEYE PEULH",5,5,26,30,56
LOUGA,LOUGA,SAKAL,SAKAL,"NDIOBENE MBATAR",44,54,377,147,524
LOUGA,LOUGA,SAKAL,SAKAL,"NDIOBENE NDIAMADJI",19,22,132,124,256
LOUGA,LOUGA,SAKAL,SAKAL,"NDIOBENE SAMBA LOPE",13,16,100,90,190
LOUGA,LOUGA,SAKAL,SAKAL,NDIOMBASSA,7,8,54,70,124
LOUGA,LOUGA,SAKAL,SAKAL,NDIOURENE,4,4,16,18,34
LOUGA,LOUGA,SAKAL,SAKAL,"NGADJI SARR",60,80,284,514,798
LOUGA,LOUGA,SAKAL,SAKAL,NGAIDE,5,5,21,26,47
LOUGA,LOUGA,SAKAL,SAKAL,"H1 KEUR AMADOU SOW",2,2,13,17,30
LOUGA,LOUGA,SAKAL,SAKAL,"NGAYE BALLA",16,18,144,154,298
LOUGA,LOUGA,SAKAL,SAKAL,"NGAYENE SARR",13,19,92,118,210
LOUGA,LOUGA,SAKAL,SAKAL,"NGOMENE DIAGNE",14,14,81,111,192
LOUGA,LOUGA,SAKAL,SAKAL,NGONAKE,15,21,105,93,198
LOUGA,LOUGA,SAKAL,SAKAL,"NGUICK FALL",77,103,628,631,1259
LOUGA,LOUGA,SAKAL,SAKAL,"H1 KEUR BIRANE NIASSE",2,2,13,9,22
LOUGA,LOUGA,SAKAL,SAKAL,"NIANGUENE PEULH",13,14,72,100,172
LOUGA,LOUGA,SAKAL,SAKAL,PENEDJI,38,65,356,377,733
LOUGA,LOUGA,SAKAL,SAKAL,"H1 PENEDJI FAYE",5,11,53,64,117
LOUGA,LOUGA,SAKAL,SAKAL,"RIMBAKH SYLLA",38,52,248,272,520
LOUGA,LOUGA,SAKAL,SAKAL,"ROYE DIEYE",41,47,219,259,478
LOUGA,LOUGA,SAKAL,SAKAL,"ROYE PEULH",5,6,23,20,43
LOUGA,LOUGA,SAKAL,SAKAL,SAKAL,184,210,908,1023,1931
LOUGA,LOUGA,SAKAL,SAKAL,"SANTHIOU MERINA",37,48,240,273,513
LOUGA,LOUGA,SAKAL,SAKAL,SINOUBAR,7,8,24,25,49
LOUGA,LOUGA,SAKAL,SAKAL,"TABANE PEULH",3,10,33,24,57
LOUGA,LOUGA,SAKAL,SAKAL,"TEUD BITTY",38,45,126,183,309
LOUGA,LOUGA,SAKAL,SAKAL,"THIALLA KEBE",27,29,142,136,278
LOUGA,LOUGA,SAKAL,SAKAL,"THIAMBENE SAMB",27,29,159,167,326
LOUGA,LOUGA,SAKAL,SAKAL,"THIAMBENE TILLE",25,34,195,209,404
LOUGA,LOUGA,SAKAL,SAKAL,"THIAR DIOP",17,18,87,120,207
LOUGA,LOUGA,SAKAL,SAKAL,"THIAR NDIAYE 2",15,24,97,124,221
LOUGA,LOUGA,SAKAL,SAKAL,"THIARE ALE",16,21,139,139,278
LOUGA,LOUGA,SAKAL,SAKAL,"THIARE PEULH",18,27,134,96,230
LOUGA,LOUGA,SAKAL,SAKAL,"H1 KEUR ABLAYE SOW",6,12,53,46,99
LOUGA,LOUGA,SAKAL,SAKAL,"THIARENE SYLLA",11,15,74,70,144
LOUGA,LOUGA,SAKAL,SAKAL,"THIECKENE BAYRAT",12,14,61,60,121
LOUGA,LOUGA,SAKAL,SAKAL,"THIELLE OUOLOF",39,42,197,194,391
LOUGA,LOUGA,SAKAL,SAKAL,"THIELLE PEULH",5,5,30,36,66
LOUGA,LOUGA,SAKAL,SAKAL,"TOGUEUL NDIAYE",21,21,82,106,188
LOUGA,LOUGA,SAKAL,SAKAL,"TOGUEUL PEULH",4,8,24,37,61
LOUGA,LOUGA,SAKAL,SAKAL,"WADANE OUOLOF",9,15,51,45,96
LOUGA,LOUGA,SAKAL,SAKAL,"WADANE PEULH",16,20,58,46,104
LOUGA,LOUGA,SAKAL,SAKAL,"WARENE OUOLOF",32,39,225,239,464
LOUGA,LOUGA,SAKAL,SAKAL,"WARENE PEULH",8,8,48,53,101
LOUGA,LOUGA,SAKAL,SAKAL,YADOULAYE,32,39,178,169,347
LOUGA,LOUGA,SAKAL,SAKAL,"YAKHI NIAYE (AMBIDIERE)",7,11,62,49,111
LOUGA,LOUGA,SAKAL,SAKAL,"YAKHI NIAYE (BAFFOU NDIAYE)",13,19,49,82,131
LOUGA,LOUGA,SAKAL,SAKAL,"YAKHI NIAYE (SINE SALL)",7,22,84,103,187
LOUGA,LOUGA,SAKAL,SAKAL,"YAKHI NIAYE (WINDOU)",3,8,12,24,36
LOUGA,LOUGA,SAKAL,SAKAL,"YAMANE SECK",11,11,56,56,112
LOUGA,LOUGA,SAKAL,SAKAL,"YARI DAKHAR",33,47,80,183,263
LOUGA,LOUGA,SAKAL,SAKAL,"DAROU NDIOUFENE",11,24,116,119,235
LOUGA,LOUGA,SAKAL,SAKAL,KIPPU,1,2,5,4,9
LOUGA,LOUGA,SAKAL,SAKAL,"PALYARIGOUYE 1",1,1,2,0,2
LOUGA,LOUGA,SAKAL,SAKAL,"PENEDJI SARR",6,7,28,31,59
LOUGA,LOUGA,SAKAL,SAKAL,"TAIBA SAKAL",62,89,291,527,818
FATICK,FATICK,FATICK,FATICK,"CROISEMENT TP",292,352,1422,1263,2685
FATICK,FATICK,FATICK,FATICK,DARAL,537,684,2354,2594,4948
FATICK,FATICK,FATICK,FATICK,"DAROU SALAM",532,671,2235,2186,4421
FATICK,FATICK,FATICK,FATICK,ESCALE,214,313,1140,994,2134
FATICK,FATICK,FATICK,FATICK,LOGANDEME,157,257,914,940,1854
FATICK,FATICK,FATICK,FATICK,MBOUBANE,186,241,1047,967,2014
FATICK,FATICK,FATICK,FATICK,"NDIANDIAYE I",432,589,2276,2668,4944
FATICK,FATICK,FATICK,FATICK,"NDIANDIAYE II",178,240,936,1091,2027
FATICK,FATICK,FATICK,FATICK,NDOUCK,393,523,1956,2105,4061
FATICK,FATICK,FATICK,FATICK,PEULGA,457,646,2334,2586,4920
FATICK,FATICK,FATICK,FATICK,POUKHAM,467,609,3345,2008,5353
FATICK,FATICK,DIOFFIOR,DIOFFIOR,DIONGFA,525,659,2749,2783,5532
FATICK,FATICK,DIOFFIOR,DIOFFIOR,SINDIANEKA,687,832,3577,3686,7263
FATICK,FATICK,NDIOP,DIAOULE,"BOFA COP",7,15,68,81,149
FATICK,FATICK,NDIOP,DIAOULE,"H1 FELANE COP",25,39,208,234,442
FATICK,FATICK,NDIOP,DIAOULE,"DIAMBEYE TIGA",28,29,168,155,323
FATICK,FATICK,NDIOP,DIAOULE,"DIAOULE 1 ET 4",195,220,963,956,1919
FATICK,FATICK,NDIOP,DIAOULE,"H1 PETHIAKA",9,16,74,70,144
FATICK,FATICK,NDIOP,DIAOULE,"DIAOULE 3",14,15,79,76,155
FATICK,FATICK,NDIOP,DIAOULE,"DIAT MOURY",12,24,154,143,297
FATICK,FATICK,NDIOP,DIAOULE,"H1 KEUR DIATTA",20,29,146,117,263
FATICK,FATICK,NDIOP,DIAOULE,"H3 BIRAME MACK",6,9,58,47,105
FATICK,FATICK,NDIOP,DIAOULE,"H4 KEUR MALICK SARR",4,4,32,39,71
FATICK,FATICK,NDIOP,DIAOULE,"H5 KEUR MANDIAYE",6,8,45,32,77
FATICK,FATICK,NDIOP,DIAOULE,"H6 KEUR LAMINE SENE",11,19,92,89,181
FATICK,FATICK,NDIOP,DIAOULE,"H7 KEUR MANDIOC",9,14,75,67,142
FATICK,FATICK,NDIOP,DIAOULE,"H8 KEUR NDENE BOP",4,5,40,36,76
FATICK,FATICK,NDIOP,DIAOULE,"FELANE (FELANE GOUMA)",39,57,281,342,623
FATICK,FATICK,NDIOP,DIAOULE,"H1 KEUR BIRAME PATHE",6,9,76,90,166
FATICK,FATICK,NDIOP,DIAOULE,"H2 NDIORAKOUM",9,16,100,112,212
FATICK,FATICK,NDIOP,DIAOULE,"GALANGUE PEULH",3,8,35,38,73
FATICK,FATICK,NDIOP,DIAOULE,"GALANGUE SERERE",22,31,205,174,379
FATICK,FATICK,NDIOP,DIAOULE,"H1 THIENABA",2,5,40,48,88
FATICK,FATICK,NDIOP,DIAOULE,"H2 TOUCAR",7,7,33,37,70
FATICK,FATICK,NDIOP,DIAOULE,"H3 NGALAGNE",9,13,88,90,178
FATICK,FATICK,NDIOP,DIAOULE,"H4 NGALAGNE COKE",3,3,15,16,31
FATICK,FATICK,NDIOP,DIAOULE,"H5 KEUR MOR GUEYE",12,13,58,55,113
FATICK,FATICK,NDIOP,DIAOULE,"H6 KEUR DIEL DIOUF",10,13,87,82,169
FATICK,FATICK,NDIOP,DIAOULE,"H7 KEUR BOCAR GUEYE",4,7,55,45,100
FATICK,FATICK,NDIOP,DIAOULE,"KEUR BISSICK",15,22,91,114,205
FATICK,FATICK,NDIOP,DIAOULE,"H1 MBESS SOUMBEL",9,11,87,101,188
FATICK,FATICK,NDIOP,DIAOULE,"KEUR DIARNO",17,28,105,124,229
FATICK,FATICK,NDIOP,DIAOULE,KHODJIL,17,23,130,126,256
FATICK,FATICK,NDIOP,DIAOULE,"H1 KHODJIL BOUMACK",3,4,29,34,63
FATICK,FATICK,NDIOP,DIAOULE,"H2 KEUR THIERNO DIALLO",3,4,58,34,92
FATICK,FATICK,NDIOP,DIAOULE,"H3 WOURO MBAYE",4,5,22,27,49
FATICK,FATICK,NDIOP,DIAOULE,"KORA 1",21,26,145,123,268
FATICK,FATICK,NDIOP,DIAOULE,"H1 FOUGHEME",5,5,29,28,57
FATICK,FATICK,NDIOP,DIAOULE,"KORA 2",5,7,46,31,77
FATICK,FATICK,NDIOP,DIAOULE,"KORA 3",4,5,29,22,51
FATICK,FATICK,NDIOP,DIAOULE,"H1 KEUR MASSAMBA KANDJI",13,16,117,119,236
FATICK,FATICK,NDIOP,DIAOULE,"H2 KEUR SILMANG",15,18,152,139,291
FATICK,FATICK,NDIOP,DIAOULE,"H3 THIOURGUEL",2,2,13,13,26
FATICK,FATICK,NDIOP,DIAOULE,MAROUTH,54,81,302,338,640
FATICK,FATICK,NDIOP,DIAOULE,"H1 BACK NDIOL (BACKO DIOL)",22,29,142,136,278
FATICK,FATICK,NDIOP,DIAOULE,"H3 MBEFOU",5,9,79,56,135
FATICK,FATICK,NDIOP,DIAOULE,"H4 KEUR GUEDJ NIANG",16,20,70,84,154
FATICK,FATICK,NDIOP,DIAOULE,"H5 MBALEME ET KEUR DIENE",21,28,112,117,229
FATICK,FATICK,NDIOP,DIAOULE,"H6 KEUR BESS",3,5,37,33,70
FATICK,FATICK,NDIOP,DIAOULE,"H7 KEUR MASSAR",6,11,63,68,131
FATICK,FATICK,NDIOP,DIAOULE,"H8 DANKHEM ET KEUR DABO",22,26,176,145,321
FATICK,FATICK,NDIOP,DIAOULE,NDAGANE,38,52,242,292,534
FATICK,FATICK,NDIOP,DIAOULE,"H3 GOUBAL",6,8,48,33,81
FATICK,FATICK,NDIOP,DIAOULE,"H4 KEUR MASSAR",5,9,41,47,88
FATICK,FATICK,NDIOP,DIAOULE,"H5 MBINE KHOLE",4,4,30,23,53
FATICK,FATICK,NDIOP,DIAOULE,"H6 KEUR DIOKEL",1,1,4,10,14
FATICK,FATICK,NDIOP,DIAOULE,"NDIALAL SAFOKINE",16,20,109,95,204
FATICK,FATICK,NDIOP,DIAOULE,"H1 WOURO LAMINE",9,11,47,45,92
FATICK,FATICK,NDIOP,DIAOULE,"H2 WOURO DIBOR",2,3,22,17,39
FATICK,FATICK,NDIOP,DIAOULE,"PARGUINE OUOLOF",16,20,73,92,165
FATICK,FATICK,NDIOP,DIAOULE,"PARGUINE PEULH",14,17,74,59,133
FATICK,FATICK,NDIOP,DIAOULE,"SABAR 1",38,64,404,410,814
FATICK,FATICK,NDIOP,DIAOULE,"SABAR 2",52,77,442,485,927
FATICK,FATICK,NDIOP,DIAOULE,"SAMBE NOMADE",24,57,222,257,479
FATICK,FATICK,NDIOP,DIAOULE,"H1 KEUR SEMOU",6,6,25,37,62
FATICK,FATICK,NDIOP,DIAOULE,SOB,21,32,128,132,260
FATICK,FATICK,NDIOP,DIAOULE,"TENE TOUBAB PEULH",12,15,68,62,130
FATICK,FATICK,NDIOP,DIAOULE,"TENE TOUBAB SERERE",23,29,112,146,258
FATICK,FATICK,NDIOP,DIAOULE,"TONGO KORA",12,17,95,86,181
FATICK,FATICK,NDIOP,DIAOULE,"DIAOULE 2",15,16,106,101,207
FATICK,FATICK,NDIOP,MBELLACADIAO,DIAGLE,35,47,245,271,516
FATICK,FATICK,NDIOP,MBELLACADIAO,"H1 NDIOBENE",9,14,58,64,122
FATICK,FATICK,NDIOP,MBELLACADIAO,MBELLACADIAO,151,191,642,777,1419
FATICK,FATICK,NDIOP,MBELLACADIAO,"H1 MASSARNA",11,21,60,77,137
FATICK,FATICK,NDIOP,MBELLACADIAO,"H2 RIPO",2,3,24,24,48
FATICK,FATICK,NDIOP,MBELLACADIAO,"H3 KHASSEME",16,30,141,183,324
FATICK,FATICK,NDIOP,MBELLACADIAO,"H4 KEUR DJIBANE",17,20,70,86,156
FATICK,FATICK,NDIOP,MBELLACADIAO,"H5 KEUR FARBA",5,5,22,19,41
FATICK,FATICK,NDIOP,MBELLACADIAO,"H6 PAKHAREME",21,31,182,176,358
FATICK,FATICK,NDIOP,MBELLACADIAO,"H8 KEUR TIDIAKH",1,4,18,24,42
FATICK,FATICK,NDIOP,MBELLACADIAO,"H9 MBELKHAPAME",15,20,77,74,151
FATICK,FATICK,NDIOP,MBELLACADIAO,"H10 KEUR SONAR",3,3,19,22,41
FATICK,FATICK,NDIOP,MBELLACADIAO,"H11 KEUR MANGUE",16,24,116,143,259
FATICK,FATICK,NDIOP,MBELLACADIAO,"H12 SIBDAR",17,26,144,115,259
FATICK,FATICK,NDIOP,MBELLACADIAO,"H13 MODELE",9,10,62,61,123
FATICK,FATICK,NDIOP,MBELLACADIAO,"H14 NGORAL",5,7,58,40,98
FATICK,FATICK,NDIOP,MBELLACADIAO,"MBOTIL COP",25,35,191,225,416
FATICK,FATICK,NDIOP,MBELLACADIAO,"H1 MAISSA WALY",33,44,254,307,561
FATICK,FATICK,NDIOP,MBELLACADIAO,"MBOUMA GOUMACK",30,38,133,192,325
FATICK,FATICK,NDIOP,MBELLACADIAO,"H1 MARONEME",4,19,114,86,200
FATICK,FATICK,NDIOP,MBELLACADIAO,"H2 KEUR DIAGA",13,19,105,94,199
FATICK,FATICK,NDIOP,MBELLACADIAO,"H3 KEUR AMATH",5,10,55,48,103
FATICK,FATICK,NDIOP,MBELLACADIAO,"H4 MBOUMA GOUNDAW",29,43,225,200,425
FATICK,FATICK,NDIOP,MBELLACADIAO,NDIARY,40,51,202,241,443
FATICK,FATICK,NDIOP,MBELLACADIAO,"H1 THIADABI 1",18,20,78,83,161
FATICK,FATICK,NDIOP,MBELLACADIAO,"H2 THIADABI 2",8,12,71,70,141
FATICK,FATICK,NDIOP,MBELLACADIAO,"H3 MOLANE",14,22,132,127,259
FATICK,FATICK,NDIOP,MBELLACADIAO,"H4 TOCAMBEL",9,13,70,89,159
FATICK,FATICK,NDIOP,MBELLACADIAO,"H5 NGOTHIEME",6,8,47,45,92
FATICK,FATICK,NDIOP,MBELLACADIAO,"H6 KEUR NGOR NGOM",5,6,26,23,49
FATICK,FATICK,NDIOP,MBELLACADIAO,"H7 PINTOCK",7,8,49,54,103
FATICK,FATICK,NDIOP,MBELLACADIAO,"NDOFFANE LATYR",23,35,180,185,365
FATICK,FATICK,NDIOP,MBELLACADIAO,"H1 KEUR LATYR",23,46,219,229,448
FATICK,FATICK,NDIOP,MBELLACADIAO,"H2 KEUR SEMOU",12,22,99,97,196
FATICK,FATICK,NDIOP,MBELLACADIAO,"NGOULOUL PEULH",44,54,238,249,487
FATICK,FATICK,NDIOP,MBELLACADIAO,"H1 NIOWDANE",24,28,239,217,456
FATICK,FATICK,NDIOP,MBELLACADIAO,"H2 NGUELOR",2,3,29,14,43
FATICK,FATICK,NDIOP,MBELLACADIAO,"H3 SETABE",2,3,27,32,59
FATICK,FATICK,NDIOP,MBELLACADIAO,"NGOULOUL SERERE",43,64,400,451,851
FATICK,FATICK,NDIOP,MBELLACADIAO,"NGUIDINE PEULH",14,18,102,84,186
FATICK,FATICK,NDIOP,MBELLACADIAO,"H1 WOURO BAIDY",18,22,124,106,230
FATICK,FATICK,NDIOP,MBELLACADIAO,"NGUIDINE SERERE",46,64,339,316,655
FATICK,FATICK,NDIOP,MBELLACADIAO,"OUYAL SANDE PEULH",3,4,28,23,51
FATICK,FATICK,NDIOP,MBELLACADIAO,"OUYAL SANDE SERERE",65,90,513,510,1023
FATICK,FATICK,NDIOP,MBELLACADIAO,"H1 MBIRICK",23,23,106,119,225
FATICK,FATICK,NDIOP,MBELLACADIAO,"H2 TABE",38,44,254,227,481
FATICK,FATICK,NDIOP,MBELLACADIAO,"POUKHAM TOCK",43,69,318,310,628
FATICK,FATICK,NDIOP,MBELLACADIAO,"H1 MBORANE SERERE",18,26,106,99,205
FATICK,FATICK,NDIOP,MBELLACADIAO,"H2 NIANGLA",6,9,67,61,128
FATICK,FATICK,NDIOP,MBELLACADIAO,"H3 SINDIANE KA",10,11,78,66,144
FATICK,FATICK,NDIOP,MBELLACADIAO,"H4 NIANGLA NGONIANE (MBINE DIABYA)",22,27,141,133,274
FATICK,FATICK,NDIOP,MBELLACADIAO,"H5 THIARE",6,6,25,18,43
FATICK,FATICK,NDIOP,MBELLACADIAO,"H6 BACK BARA",2,3,23,20,43
FATICK,FATICK,NDIOP,MBELLACADIAO,"SAKHAW PEULH",29,38,138,163,301
FATICK,FATICK,NDIOP,MBELLACADIAO,"H1 SAKHAW BAME",6,7,36,45,81
FATICK,FATICK,NDIOP,MBELLACADIAO,"H2 DYABOUGOU",3,3,13,23,36
FATICK,FATICK,NDIOP,MBELLACADIAO,"H3 KEUR NDEME",9,11,58,83,141
FATICK,FATICK,NDIOP,MBELLACADIAO,"SAKHAW SERERE",42,56,267,302,569
FATICK,FATICK,NDIOP,MBELLACADIAO,"H1 BACK",15,19,83,102,185
FATICK,FATICK,NDIOP,MBELLACADIAO,"H2 BELELE",11,14,97,93,190
FATICK,FATICK,NDIOP,MBELLACADIAO,TAGDIAME,31,34,146,129,275
FATICK,FATICK,NDIOP,MBELLACADIAO,"H1 DIECKNA",7,10,37,58,95
FATICK,FATICK,NDIOP,MBELLACADIAO,"H2 YARI 1",10,11,46,45,91
FATICK,FATICK,NDIOP,MBELLACADIAO,"H3 YARI 2",9,9,46,45,91
FATICK,FATICK,NDIOP,MBELLACADIAO,"THIABA NDIOF DIAME",22,29,163,163,326
FATICK,FATICK,NDIOP,MBELLACADIAO,"H1 THIABA NDOMBODOGNE",6,7,82,69,151
FATICK,FATICK,NDIOP,MBELLACADIAO,"H2 THIABA MBINE MBOUNDOR",10,12,86,72,158
FATICK,FATICK,NDIOP,MBELLACADIAO,"H3 THIABA BAOL",20,33,229,249,478
FATICK,FATICK,NDIOP,NDIOP,"BACCO DIOR",11,17,81,85,166
FATICK,FATICK,NDIOP,NDIOP,"H1 MBELANE",16,25,151,150,301
FATICK,FATICK,NDIOP,NDIOP,"H2 THIOGNE ET LIGNE",14,19,104,114,218
FATICK,FATICK,NDIOP,NDIOP,"H3 MBELGOR",4,6,66,69,135
FATICK,FATICK,NDIOP,NDIOP,"H4 SERALE",33,56,350,339,689
FATICK,FATICK,NDIOP,NDIOP,"BACCO SERERE",18,29,158,126,284
FATICK,FATICK,NDIOP,NDIOP,"H1 BOUBANE",9,14,86,64,150
FATICK,FATICK,NDIOP,NDIOP,"H2 PEULGA",5,8,37,39,76
FATICK,FATICK,NDIOP,NDIOP,"H3 YABAL",6,13,73,66,139
FATICK,FATICK,NDIOP,NDIOP,"H4 YADOU",3,3,19,17,36
FATICK,FATICK,NDIOP,NDIOP,BANGADJI,22,28,138,105,243
FATICK,FATICK,NDIOP,NDIOP,"H4 KEUR DEMBA GONIO",22,29,162,153,315
FATICK,FATICK,NDIOP,NDIOP,"H5 NDIAKHATE",11,13,69,78,147
FATICK,FATICK,NDIOP,NDIOP,"H6 NGOMENE",6,14,113,105,218
FATICK,FATICK,NDIOP,NDIOP,"H7 THISSE",4,5,25,20,45
FATICK,FATICK,NDIOP,NDIOP,"BACCO MBOYTOLE",49,134,891,819,1710
FATICK,FATICK,NDIOP,NDIOP,"H4 FENTELE",14,22,169,137,306
FATICK,FATICK,NDIOP,NDIOP,"BOOF NDEMENE",25,43,286,258,544
FATICK,FATICK,NDIOP,NDIOP,"H1 DIAM SENE",14,25,132,118,250
FATICK,FATICK,NDIOP,NDIOP,"BOOF NDOYEME",14,32,166,172,338
FATICK,FATICK,NDIOP,NDIOP,"H1 MBINE DIBOCOR",16,18,123,140,263
FATICK,FATICK,NDIOP,NDIOP,"DAROU SALAM",150,204,935,929,1864
FATICK,FATICK,NDIOP,NDIOP,"H1 DAROU TOURE",8,11,55,32,87
FATICK,FATICK,NDIOP,NDIOP,"H2 DAARA JAMMI LAHI",1,2,39,25,64
FATICK,FATICK,NDIOP,NDIOP,"H3 TOUBA THIEYENE",9,16,87,90,177
FATICK,FATICK,NDIOP,NDIOP,FARARE,69,112,483,471,954
FATICK,FATICK,NDIOP,NDIOP,"H1 BACK GUEDJ",1,2,10,15,25
FATICK,FATICK,NDIOP,NDIOP,MBATAR,15,33,190,175,365
FATICK,FATICK,NDIOP,NDIOP,"H1 KEUR SONGO",12,17,87,92,179
FATICK,FATICK,NDIOP,NDIOP,"H2 GOURGOU",9,16,93,96,189
FATICK,FATICK,NDIOP,NDIOP,NDIOB,179,361,1256,1351,2607
FATICK,FATICK,NDIOP,NDIOP,"H1 NGUE GUEYE",2,5,58,72,130
FATICK,FATICK,NDIOP,NDIOP,"H2 NDOUKHOU",9,18,107,96,203
FATICK,FATICK,NDIOP,NDIOP,"H3 NGODJILENE",14,32,176,194,370
FATICK,FATICK,NDIOP,NDIOP,"H4 NDOUNGAR",13,28,118,125,243
FATICK,FATICK,NDIOP,NDIOP,"H5 BACCOGOUR",40,71,518,439,957
FATICK,FATICK,NDIOP,NDIOP,"H6 BACK GAOUL",3,10,41,45,86
FATICK,FATICK,NDIOP,NDIOP,"H7 NGANKAL",5,6,44,33,77
FATICK,FATICK,NDIOP,NDIOP,"H8 MISSIRAH",8,13,59,71,130
FATICK,FATICK,NDIOP,NDIOP,"H9 TOUBA FALL",3,3,22,23,45
FATICK,FATICK,NDIOP,NDIOP,"H10 SOUPA",9,30,234,188,422
FATICK,FATICK,NDIOP,NDIOP,NDIOUDIOUF,20,46,208,262,470
FATICK,FATICK,NDIOP,NDIOP,"NDIOURBEL SINE",44,55,243,245,488
FATICK,FATICK,NDIOP,NDIOP,"H2 NGUITHIE",10,14,94,102,196
FATICK,FATICK,NDIOP,NDIOP,"H3 MBELLO MBAME",7,13,69,64,133
FATICK,FATICK,NDIOP,NDIOP,"H4 DEMBA NDIATHE",12,21,129,109,238
FATICK,FATICK,NDIOP,NDIOP,"H5 SANGO",25,30,173,155,328
FATICK,FATICK,NDIOP,NDIOP,"H6 MBAYE NDIOUGOUR",5,6,53,47,100
FATICK,FATICK,NDIOP,NDIOP,"H7 KEUR NDIOUMA",16,22,143,129,272
FATICK,FATICK,NDIOP,NDIOP,NDOTHIE,27,41,234,222,456
FATICK,FATICK,NDIOP,NDIOP,"H1 MBAMBARA",2,4,21,19,40
FATICK,FATICK,NDIOP,NDIOP,"H2 SINDIANE",18,32,211,198,409
FATICK,FATICK,NDIOP,NDIOP,"H3 BOULIDIAMA",15,22,140,141,281
FATICK,FATICK,NDIOP,NDIOP,NGALAGNE,80,102,483,505,988
FATICK,FATICK,NDIOP,NDIOP,"H1 NDIALO",9,10,66,55,121
FATICK,FATICK,NDIOP,NDIOP,"H2 NDOFANE",5,10,44,45,89
FATICK,FATICK,NDIOP,NDIOP,SOUMNANE,27,56,308,300,608
FATICK,FATICK,NDIOP,NDIOP,"H1 NDONE",3,3,14,16,30
FATICK,FATICK,NDIOP,NDIOP,"H2 MBOULALA",10,19,83,61,144
FATICK,FATICK,NDIOP,NDIOP,"H3 THIAKLENE",20,36,155,165,320
FATICK,FATICK,NDIOP,NDIOP,"SOUPA KEUR ALARBA (KEUR MARAMATA)",3,6,44,23,67
FATICK,FATICK,NDIOP,NDIOP,"H1 SOUPA SERERE",7,14,77,62,139
FATICK,FATICK,NDIOP,NDIOP,THIALLE,25,41,262,268,530
FATICK,FATICK,NDIOP,NDIOP,"H1 LOUKOU",16,21,141,140,281
FATICK,FATICK,NDIOP,NDIOP,"H2 PIDJI",16,20,138,130,268
FATICK,FATICK,NDIOP,NDIOP,THIEW,31,47,215,228,443
FATICK,FATICK,NDIOP,NDIOP,"H1 BABACAR DIOUF",3,11,83,84,167
FATICK,FATICK,NDIOP,NDIOP,"NDIOURBEL SINE 2 (PALLA)",2,6,24,30,54
FATICK,FATICK,NDIOP,"THIARE NDIALGUI","BOOF LOULOUM",26,53,270,260,530
FATICK,FATICK,NDIOP,"THIARE NDIALGUI","BOOF MBALEME 1",50,87,381,359,740
FATICK,FATICK,NDIOP,"THIARE NDIALGUI","H1 TOUCAR MBINE BOUCAR",10,14,76,86,162
FATICK,FATICK,NDIOP,"THIARE NDIALGUI","H2 BACK LALO",11,17,95,113,208
FATICK,FATICK,NDIOP,"THIARE NDIALGUI","H3 DOMB",8,22,161,173,334
FATICK,FATICK,NDIOP,"THIARE NDIALGUI","BOOF MBALEME 2",15,28,163,152,315
FATICK,FATICK,NDIOP,"THIARE NDIALGUI","BOOF POUPOUYE",34,94,533,434,967
FATICK,FATICK,NDIOP,"THIARE NDIALGUI","H1 SIMON NDEMENE",21,32,179,158,337
FATICK,FATICK,NDIOP,"THIARE NDIALGUI","H2 KEUR MBASSA",17,29,141,134,275
FATICK,FATICK,NDIOP,"THIARE NDIALGUI",DIADIEL,33,55,306,277,583
FATICK,FATICK,NDIOP,"THIARE NDIALGUI","H1 COUSSOUREME",3,6,56,47,103
FATICK,FATICK,NDIOP,"THIARE NDIALGUI",DIOCK,41,54,223,271,494
FATICK,FATICK,NDIOP,"THIARE NDIALGUI","H1 MBETOUNE",3,5,14,8,22
FATICK,FATICK,NDIOP,"THIARE NDIALGUI","H2 KEUR SING SARR",2,4,23,29,52
FATICK,FATICK,NDIOP,"THIARE NDIALGUI","H4 OLALA",1,2,35,27,62
FATICK,FATICK,NDIOP,"THIARE NDIALGUI",FAMB,11,20,92,114,206
FATICK,FATICK,NDIOP,"THIARE NDIALGUI",FANDANE,31,37,207,198,405
FATICK,FATICK,NDIOP,"THIARE NDIALGUI","H2 NDOUR NDOUR",3,6,35,24,59
FATICK,FATICK,NDIOP,"THIARE NDIALGUI",GOUNDIAYE,14,26,113,121,234
FATICK,FATICK,NDIOP,"THIARE NDIALGUI","H2 NGODJIL",4,5,35,26,61
FATICK,FATICK,NDIOP,"THIARE NDIALGUI",LAKHAR,11,18,59,54,113
FATICK,FATICK,NDIOP,"THIARE NDIALGUI","H1 NDIOM NIEKH",7,7,44,34,78
FATICK,FATICK,NDIOP,"THIARE NDIALGUI","H2 MBELGOR",7,12,95,81,176
FATICK,FATICK,NDIOP,"THIARE NDIALGUI","H3 THIOGNE",6,11,39,56,95
FATICK,FATICK,NDIOP,"THIARE NDIALGUI","MARANE (MARANE MACK)",26,31,180,157,337
FATICK,FATICK,NDIOP,"THIARE NDIALGUI","H2 YARGOUYE",20,25,146,133,279
FATICK,FATICK,NDIOP,"THIARE NDIALGUI","H3 MBOURSINE",23,36,260,248,508
FATICK,FATICK,NDIOP,"THIARE NDIALGUI","H4 MARANE DJIRE",9,13,53,55,108
FATICK,FATICK,NDIOP,"THIARE NDIALGUI","H5 MBIDIE",3,6,41,46,87
FATICK,FATICK,NDIOP,"THIARE NDIALGUI","H7 MBINE DIAGA FAYE",6,7,56,54,110
FATICK,FATICK,NDIOP,"THIARE NDIALGUI",MARONENE,26,68,297,288,585
FATICK,FATICK,NDIOP,"THIARE NDIALGUI","H1 SARAR",23,40,170,171,341
FATICK,FATICK,NDIOP,"THIARE NDIALGUI","H2 KAO",13,21,117,113,230
FATICK,FATICK,NDIOP,"THIARE NDIALGUI","H3 NDOFFANE BIRAME TENING",6,13,67,75,142
FATICK,FATICK,NDIOP,"THIARE NDIALGUI","MBAMANE (MBAMANE DIARAF)",17,32,221,194,415
FATICK,FATICK,NDIOP,"THIARE NDIALGUI","H1 MBAMANE DIAME",13,24,142,106,248
FATICK,FATICK,NDIOP,"THIARE NDIALGUI","H2 KEUR DIOGOYE",2,9,32,29,61
FATICK,FATICK,NDIOP,"THIARE NDIALGUI","H3 KEUR DIEGANE",6,11,67,73,140
FATICK,FATICK,NDIOP,"THIARE NDIALGUI","H4 PETHIE BIRAME",3,7,56,61,117
FATICK,FATICK,NDIOP,"THIARE NDIALGUI","H5 MBAMANE SEMOU",9,28,139,113,252
FATICK,FATICK,NDIOP,"THIARE NDIALGUI","H6 THIEURIGNE",6,16,106,88,194
FATICK,FATICK,NDIOP,"THIARE NDIALGUI","H7 NDIOUGALE",4,4,28,17,45
FATICK,FATICK,NDIOP,"THIARE NDIALGUI","H8 KEUR DETHIE SARR",8,8,60,58,118
FATICK,FATICK,NDIOP,"THIARE NDIALGUI","MBOTIL NDONE",19,35,210,198,408
FATICK,FATICK,NDIOP,"THIARE NDIALGUI","H1 NDONE",10,16,88,96,184
FATICK,FATICK,NDIOP,"THIARE NDIALGUI","MONE (MONE KHALLE)",12,15,88,64,152
FATICK,FATICK,NDIOP,"THIARE NDIALGUI","H1 MONE MACK",30,32,162,150,312
FATICK,FATICK,NDIOP,"THIARE NDIALGUI","H3 MBINE BABOU",11,15,72,84,156
FATICK,FATICK,NDIOP,"THIARE NDIALGUI",NDIAMSIL,13,21,150,143,293
FATICK,FATICK,NDIOP,"THIARE NDIALGUI","NDIELEME FARBA",42,60,332,271,603
FATICK,FATICK,NDIOP,"THIARE NDIALGUI","H1 KEUR MBODIA",2,3,20,13,33
FATICK,FATICK,NDIOP,"THIARE NDIALGUI","H2 NDIORAKOUM",10,20,112,90,202
FATICK,FATICK,NDIOP,"THIARE NDIALGUI","H3 BAYAKH",6,7,40,21,61
FATICK,FATICK,NDIOP,"THIARE NDIALGUI","H4 MBINE FATA",6,16,104,48,152
FATICK,FATICK,NDIOP,"THIARE NDIALGUI","NDIELEME SOUPE",12,23,86,84,170
FATICK,FATICK,NDIOP,"THIARE NDIALGUI","H1 SAGNE",11,14,94,89,183
FATICK,FATICK,NDIOP,"THIARE NDIALGUI","NDJILASSEME KEUR BISSIK",5,8,54,48,102
FATICK,FATICK,NDIOP,"THIARE NDIALGUI","H1 MBELBOUCK",37,62,393,392,785
FATICK,FATICK,NDIOP,"THIARE NDIALGUI","H2 KEUR SARA",10,16,114,101,215
FATICK,FATICK,NDIOP,"THIARE NDIALGUI","NDJILASSEME SERERE",14,19,92,85,177
FATICK,FATICK,NDIOP,"THIARE NDIALGUI","H1 SESSENE",4,6,53,50,103
FATICK,FATICK,NDIOP,"THIARE NDIALGUI","H3 KAMA KAMA",7,12,95,93,188
FATICK,FATICK,NDIOP,"THIARE NDIALGUI","NDJILASSEME THIEURIGNE",35,63,355,316,671
FATICK,FATICK,NDIOP,"THIARE NDIALGUI","H1 TOUCAR MABO",22,35,222,231,453
FATICK,FATICK,NDIOP,"THIARE NDIALGUI","H2 MBAYENE GOUMACK",11,18,89,63,152
FATICK,FATICK,NDIOP,"THIARE NDIALGUI","H3 MBAYENE GOUNDAO",12,22,103,100,203
FATICK,FATICK,NDIOP,"THIARE NDIALGUI","H4 KEUR BOUCAR",16,21,106,117,223
FATICK,FATICK,NDIOP,"THIARE NDIALGUI","H5 KEUR NGOR DIOP",1,2,25,14,39
FATICK,FATICK,NDIOP,"THIARE NDIALGUI","H6 NGUILGATINE",14,23,137,123,260
FATICK,FATICK,NDIOP,"THIARE NDIALGUI","NDOFFANE MADE",14,18,73,93,166
FATICK,FATICK,NDIOP,"THIARE NDIALGUI",NDOFFENE,109,138,747,712,1459
FATICK,FATICK,NDIOP,"THIARE NDIALGUI",NGUEKOKH,19,25,137,118,255
FATICK,FATICK,NDIOP,"THIARE NDIALGUI","SANDOCK (KEUR ABDOU)",21,25,135,165,300
FATICK,FATICK,NDIOP,"THIARE NDIALGUI","H1 KEUR ABDOU",6,9,62,67,129
FATICK,FATICK,NDIOP,"THIARE NDIALGUI","SASS LINGUERE",22,33,170,166,336
FATICK,FATICK,NDIOP,"THIARE NDIALGUI","H1 MABO",12,13,70,88,158
FATICK,FATICK,NDIOP,"THIARE NDIALGUI","H2 OLALA",8,16,129,113,242
FATICK,FATICK,NDIOP,"THIARE NDIALGUI","H3 MBINE KODIOLI",8,15,103,106,209
FATICK,FATICK,NDIOP,"THIARE NDIALGUI","H4 KEUR BIRAME",6,7,34,31,65
FATICK,FATICK,NDIOP,"THIARE NDIALGUI","H5 MBINE SOUDIECK",6,10,75,73,148
FATICK,FATICK,NDIOP,"THIARE NDIALGUI","THIARE NDIALGUI",70,78,343,392,735
FATICK,FATICK,NDIOP,"THIARE NDIALGUI","H1 THIARE MACK",12,25,177,125,302
FATICK,FATICK,NDIOP,"THIARE NDIALGUI","H2 THIARE BANE",8,11,84,82,166
FATICK,FATICK,NDIOP,"THIARE NDIALGUI","THIARE NGOLGUI",29,35,181,164,345
FATICK,FATICK,NDIOP,"THIARE NDIALGUI","H1 PETHIE BISSAT",20,35,206,197,403
FATICK,FATICK,NDIOP,"THIARE NDIALGUI","H2 NIAMFADE",5,10,79,78,157
FATICK,FATICK,NDIOP,"THIARE NDIALGUI",THIOUTHIOUNE,50,74,474,458,932
FATICK,FATICK,NDIOP,"THIARE NDIALGUI","H1 MBALEME",13,18,101,100,201
FATICK,FATICK,NDIOP,"THIARE NDIALGUI",TOFAYE,24,43,185,178,363
FATICK,FATICK,NDIOP,"THIARE NDIALGUI","H1 NDIEMANE",8,20,124,140,264
FATICK,FATICK,NDIOP,"THIARE NDIALGUI","GOUNDIAYE 1",13,14,116,94,210
FATICK,FATICK,NDIOP,"THIARE NDIALGUI","KEUR BOUCAR DIOME (A NDIOCKEL)",10,12,78,83,161
FATICK,FATICK,NDIOP,"THIARE NDIALGUI","MARANE BOUGAR",10,12,74,63,137
FATICK,FATICK,NDIOP,"THIARE NDIALGUI","H1 MBINE FAB",7,10,76,67,143
FATICK,FATICK,NDIOP,"THIARE NDIALGUI","NDOFFANE MOURIDE",25,38,183,222,405
FATICK,FATICK,NDIOP,"THIARE NDIALGUI","H1 MBIMOR",12,15,74,83,157
FATICK,FATICK,NDIOP,"THIARE NDIALGUI","H2 MBINE DIAGA (DOGA)",12,15,87,66,153
FATICK,FATICK,NDIOP,"THIARE NDIALGUI","H3 WALO",2,2,9,9,18
FATICK,FATICK,NDIOP,DIAKHAO,DIAKHAO,406,612,2152,2376,4528
FATICK,FATICK,NDIOP,DIAKHAO,DINGUILYAME,17,21,129,137,266
FATICK,FATICK,NDIOP,DIAKHAO,DJILOR,4,8,48,49,97
FATICK,FATICK,NDIOP,DIAKHAO,"NDOFFANE DEME",13,30,195,193,388
FATICK,FATICK,NDIOP,DIAKHAO,"DIAKHAO MACK",24,27,147,164,311
FATICK,FATICK,FIMELA,FIMELA,"BABOUCAR TOUMBOU",76,89,497,442,939
FATICK,FATICK,FIMELA,FIMELA,"H1 KEUR THIENDOU SOW",2,2,28,23,51
FATICK,FATICK,FIMELA,FIMELA,DJILOR,109,151,552,540,1092
FATICK,FATICK,FIMELA,FIMELA,FIMELA,558,727,2764,2571,5335
FATICK,FATICK,FIMELA,FIMELA,"KOBONGOYE 1",62,76,481,460,941
FATICK,FATICK,FIMELA,FIMELA,"H1 NDIEDIENG SEMOU",5,5,36,32,68
FATICK,FATICK,FIMELA,FIMELA,"H2 KEUR NGOR",7,8,86,72,158
FATICK,FATICK,FIMELA,FIMELA,"H3 KEUR KOUSSOUM",3,3,18,4,22
FATICK,FATICK,FIMELA,FIMELA,"H4 KEUR GORANE",2,2,7,7,14
FATICK,FATICK,FIMELA,FIMELA,"H5 KEUR MBAYE DIODIO",5,6,45,34,79
FATICK,FATICK,FIMELA,FIMELA,"H6 KEUR DIENE",5,6,32,25,57
FATICK,FATICK,FIMELA,FIMELA,"KOBONGOYE 2",37,40,226,172,398
FATICK,FATICK,FIMELA,FIMELA,"MAR FAFACO",200,270,1258,1277,2535
FATICK,FATICK,FIMELA,FIMELA,"MAR LOTHIE",263,314,937,960,1897
FATICK,FATICK,FIMELA,FIMELA,"MAR SOULOU",56,64,220,240,460
FATICK,FATICK,FIMELA,FIMELA,MBISSEL,73,80,242,243,485
FATICK,FATICK,FIMELA,FIMELA,"NDANGANE CAMPEMENT",401,497,1437,1347,2784
FATICK,FATICK,FIMELA,FIMELA,"H1 KEUR SOBEL",4,4,15,12,27
FATICK,FATICK,FIMELA,FIMELA,"NDANGANE SAMBOU",178,211,1083,1051,2134
FATICK,FATICK,FIMELA,FIMELA,NDIEDIENG,34,41,282,247,529
FATICK,FATICK,FIMELA,FIMELA,"H1 KEUR DIAME",1,2,13,11,24
FATICK,FATICK,FIMELA,FIMELA,"SAMBA DIA",447,557,2701,2516,5217
FATICK,FATICK,FIMELA,FIMELA,"H1 NIANGA",10,13,81,63,144
FATICK,FATICK,FIMELA,FIMELA,"SAMBA DIALLO",27,41,231,224,455
FATICK,FATICK,FIMELA,FIMELA,"H1 KEUR ADIOUMA DIALLO",3,7,25,25,50
FATICK,FATICK,FIMELA,FIMELA,SIMAL,256,324,1522,1433,2955
FATICK,FATICK,FIMELA,FIMELA,YAYEME,217,243,944,1030,1974
FATICK,FATICK,FIMELA,FIMELA,"H1 KEUR SOCE",6,6,33,29,62
FATICK,FATICK,FIMELA,"LOUL SESSENE","BOYARD NDIODIOME",138,186,642,633,1275
FATICK,FATICK,FIMELA,"LOUL SESSENE","BOYARD TOCK",64,87,376,331,707
FATICK,FATICK,FIMELA,"LOUL SESSENE",DACK,18,40,148,171,319
FATICK,FATICK,FIMELA,"LOUL SESSENE","FOUAH MBEGNARD",31,44,293,284,577
FATICK,FATICK,FIMELA,"LOUL SESSENE","H1 PETHIE MAKHA",20,27,185,157,342
FATICK,FATICK,FIMELA,"LOUL SESSENE","H2 NGOYA COP",21,42,277,258,535
FATICK,FATICK,FIMELA,"LOUL SESSENE","LOUL NDIODIONE",26,32,142,154,296
FATICK,FATICK,FIMELA,"LOUL SESSENE","LOUL NDOUR NDIOUR",62,69,440,419,859
FATICK,FATICK,FIMELA,"LOUL SESSENE","LOUL SESSENE",221,297,999,1107,2106
FATICK,FATICK,FIMELA,"LOUL SESSENE","H3 TOCKOMACK ET ESCALE",23,29,166,140,306
FATICK,FATICK,FIMELA,"LOUL SESSENE","H4 KHABANE",10,13,62,67,129
FATICK,FATICK,FIMELA,"LOUL SESSENE",NDIAGAMBA,68,90,356,371,727
FATICK,FATICK,FIMELA,"LOUL SESSENE","H1 MBINE MODY",28,36,168,162,330
FATICK,FATICK,FIMELA,"LOUL SESSENE","H2 MBEKHOURANE",38,56,258,264,522
FATICK,FATICK,FIMELA,"LOUL SESSENE","H3 DIOMKHEL",17,24,119,129,248
FATICK,FATICK,FIMELA,"LOUL SESSENE","H4 MBOUDAYE",42,58,281,294,575
FATICK,FATICK,FIMELA,"LOUL SESSENE","NDIOL KHOKHANE",17,26,166,152,318
FATICK,FATICK,FIMELA,"LOUL SESSENE","H1 MOURIDE",21,24,153,153,306
FATICK,FATICK,FIMELA,"LOUL SESSENE","H2 PINKA SIDAKHA",6,12,87,74,161
FATICK,FATICK,FIMELA,"LOUL SESSENE","H3 PINO RIMAK",16,29,205,182,387
FATICK,FATICK,FIMELA,"LOUL SESSENE","H4 PINO DIARREKH",5,5,30,32,62
FATICK,FATICK,FIMELA,"LOUL SESSENE","H5 NDIOUROUP",6,8,60,43,103
FATICK,FATICK,FIMELA,"LOUL SESSENE","NDIOL MANGANE",111,154,901,857,1758
FATICK,FATICK,FIMELA,"LOUL SESSENE","H1 KEUR MADICKE",23,43,269,235,504
FATICK,FATICK,FIMELA,"LOUL SESSENE","H2 FASSANA",2,3,14,10,24
FATICK,FATICK,FIMELA,"LOUL SESSENE","H3 KEUR MA ABDOU",8,10,213,112,325
FATICK,FATICK,FIMELA,"LOUL SESSENE","H4 KEUR DIATTA",17,19,134,112,246
FATICK,FATICK,FIMELA,"LOUL SESSENE","H5 NDIOL DIBOCOR",30,54,422,391,813
FATICK,FATICK,FIMELA,"LOUL SESSENE",NDOFF,31,45,167,179,346
FATICK,FATICK,FIMELA,"LOUL SESSENE",NGUESSINE,93,112,472,497,969
FATICK,FATICK,FIMELA,"LOUL SESSENE","H1 NIANGUINE BOUNDAW",2,2,13,10,23
FATICK,FATICK,FIMELA,"LOUL SESSENE","H3 SAM SAM",2,2,16,17,33
FATICK,FATICK,FIMELA,"LOUL SESSENE",NOBANDANE,17,24,148,132,280
FATICK,FATICK,FIMELA,"LOUL SESSENE","H1 NDIOYINEME",26,38,190,169,359
FATICK,FATICK,FIMELA,"LOUL SESSENE","H2 MBADATEME",9,18,89,81,170
FATICK,FATICK,FIMELA,"LOUL SESSENE","H3 PINO RIMACK",18,25,134,154,288
FATICK,FATICK,FIMELA,"LOUL SESSENE","H4 NGAKHEME",17,22,145,139,284
FATICK,FATICK,FIMELA,"LOUL SESSENE","H5 NGALCOKI",30,58,308,304,612
FATICK,FATICK,FIMELA,"LOUL SESSENE",POMBANE,46,62,431,405,836
FATICK,FATICK,FIMELA,"LOUL SESSENE","H1 NDIAFE",18,28,157,153,310
FATICK,FATICK,FIMELA,"LOUL SESSENE","H2 POMBANE BOUMACK",11,17,89,103,192
FATICK,FATICK,FIMELA,"LOUL SESSENE","H3 MBOUKHOUM",11,14,87,71,158
FATICK,FATICK,FIMELA,"LOUL SESSENE","H4 MBINE MODY",16,24,145,134,279
FATICK,FATICK,FIMELA,"LOUL SESSENE","H5 BOUBANE",8,12,58,47,105
FATICK,FATICK,FIMELA,"LOUL SESSENE","SAKHOR (TOCANE)",59,98,216,222,438
FATICK,FATICK,FIMELA,"LOUL SESSENE","H1 PIMB",5,5,19,17,36
FATICK,FATICK,FIMELA,"LOUL SESSENE","SING (SING NGESSINE)",39,47,212,211,423
FATICK,FATICK,FIMELA,"LOUL SESSENE","SING BOYARD",60,79,336,321,657
FATICK,FATICK,FIMELA,"LOUL SESSENE",THIENDIE,23,35,211,185,396
FATICK,FATICK,FIMELA,"LOUL SESSENE","H1 FASSANE",10,13,65,53,118
FATICK,FATICK,FIMELA,"LOUL SESSENE","H2 THIEMANE",3,6,41,32,73
FATICK,FATICK,FIMELA,"LOUL SESSENE","H3 KEUR COLY",23,31,147,136,283
FATICK,FATICK,FIMELA,"PALMARIN FACAO",DJIFFER,459,763,3027,1622,4649
FATICK,FATICK,FIMELA,"PALMARIN FACAO","PALMARIN DIAKHANOR",85,93,336,316,652
FATICK,FATICK,FIMELA,"PALMARIN FACAO","PALMARIN FACAO",132,297,738,728,1466
FATICK,FATICK,FIMELA,"PALMARIN FACAO","PALMARIN NGALLOU",110,167,529,516,1045
FATICK,FATICK,FIMELA,"PALMARIN FACAO","PALMARIN NGUETHIE",91,135,352,324,676
FATICK,FATICK,FIMELA,"PALMARIN FACAO","PALMARIN SESSENE",299,378,1242,1197,2439
FATICK,FATICK,FIMELA,DJILASSE,DJILASSE,373,502,2338,2279,4617
FATICK,FATICK,FIMELA,DJILASSE,FAOYE,130,149,632,552,1184
FATICK,FATICK,FIMELA,DJILASSE,NDIMBINDING,9,11,49,48,97
FATICK,FATICK,FIMELA,DJILASSE,"H1 KEUR NGOR SARR",1,1,10,16,26
FATICK,FATICK,FIMELA,DJILASSE,NGARIGNE,18,26,200,153,353
FATICK,FATICK,FIMELA,DJILASSE,ROH,23,35,161,166,327
FATICK,FATICK,FIMELA,DJILASSE,SOROBOUGOU,24,28,123,123,246
FATICK,FATICK,FIMELA,DJILASSE,"H1 NGARIGNE PEULH",3,3,21,24,45
FATICK,FATICK,FIMELA,DJILASSE,"H2 NGARIGNE NANDOKH",6,9,32,25,57
FATICK,FATICK,FIMELA,DJILASSE,"SOUDIANE BALLA",26,28,163,138,301
FATICK,FATICK,FIMELA,DJILASSE,"SOUDIANE THIELEME",33,40,254,210,464
FATICK,FATICK,FIMELA,DJILASSE,"H1 VELINGARA",36,45,262,259,521
FATICK,FATICK,FIMELA,DJILASSE,"H2 SOUDIANE LOUL",17,28,163,109,272
FATICK,FATICK,FIMELA,DJILASSE,"H3 SOUDIANE SANTHIE",14,17,89,80,169
FATICK,FATICK,FIMELA,DJILASSE,"H4 SOUDIANE SANGKAYE",10,17,114,114,228
FATICK,FATICK,FIMELA,DJILASSE,"H6 SOUDIANE DIMELE",39,49,301,313,614
FATICK,FATICK,FIMELA,DJILASSE,"H7 NDIAFADJI",4,5,38,33,71
FATICK,FATICK,FIMELA,DJILASSE,"H8 SOUDIANE NDIANABANE",17,23,194,94,288
FATICK,FATICK,FIMELA,DJILASSE,"H9 SOUDIANE DALY",28,32,296,254,550
FATICK,FATICK,FIMELA,DJILASSE,"H10 SOUDIANE WAGNE",16,17,99,88,187
FATICK,FATICK,FIMELA,DJILASSE,SOUMBEL,15,20,120,92,212
FATICK,FATICK,FIMELA,DJILASSE,"SOUDIANE NDIOL",15,24,155,122,277
FATICK,FATICK,NIAKHAR,NGAYOKHEME,"BARI SINE",35,91,717,663,1380
FATICK,FATICK,NIAKHAR,NGAYOKHEME,DAROU,9,12,64,57,121
FATICK,FATICK,NIAKHAR,NGAYOKHEME,DATEL,16,21,181,140,321
FATICK,FATICK,NIAKHAR,NGAYOKHEME,"H1 PETHIE GOR",14,19,94,122,216
FATICK,FATICK,NIAKHAR,NGAYOKHEME,"H2 DIAM DIOP",5,10,73,69,142
FATICK,FATICK,NIAKHAR,NGAYOKHEME,"H3 TOKOMBEDE",20,27,214,196,410
FATICK,FATICK,NIAKHAR,NGAYOKHEME,"H4 NDOUNDOUR",3,6,53,42,95
FATICK,FATICK,NIAKHAR,NGAYOKHEME,"H5 GANKARE",3,8,32,42,74
FATICK,FATICK,NIAKHAR,NGAYOKHEME,"H6 SIBONE",2,9,62,45,107
FATICK,FATICK,NIAKHAR,NGAYOKHEME,DIOKOUL,19,35,222,217,439
FATICK,FATICK,NIAKHAR,NGAYOKHEME,"KALOME NDOFFANE",40,72,258,313,571
FATICK,FATICK,NIAKHAR,NGAYOKHEME,"H1 NDOFFANE",9,23,111,114,225
FATICK,FATICK,NIAKHAR,NGAYOKHEME,"H2 MBAFAYE",3,5,24,24,48
FATICK,FATICK,NIAKHAR,NGAYOKHEME,"H3 FELANE KALOME",12,25,109,104,213
FATICK,FATICK,NIAKHAR,NGAYOKHEME,"H5 MBINO NDIANA",16,21,130,128,258
FATICK,FATICK,NIAKHAR,NGAYOKHEME,LAMBANEME,33,64,291,314,605
FATICK,FATICK,NIAKHAR,NGAYOKHEME,"H1 MBINE SIRA",8,13,53,73,126
FATICK,FATICK,NIAKHAR,NGAYOKHEME,"H2 DAME",5,8,50,61,111
FATICK,FATICK,NIAKHAR,NGAYOKHEME,"H3 MBINE BOURE WAYNANE",1,3,17,18,35
FATICK,FATICK,NIAKHAR,NGAYOKHEME,"MBINONDAR (KAM SATE)",26,32,146,143,289
FATICK,FATICK,NIAKHAR,NGAYOKHEME,"H1 NGODJILEME",4,5,25,25,50
FATICK,FATICK,NIAKHAR,NGAYOKHEME,"H2 NDIALO NDIALO",7,7,36,50,86
FATICK,FATICK,NIAKHAR,NGAYOKHEME,"H3 MBINONDAR",8,9,34,40,74
FATICK,FATICK,NIAKHAR,NGAYOKHEME,"H4 THIATHIAW MBINONDAR",6,14,80,86,166
FATICK,FATICK,NIAKHAR,NGAYOKHEME,MBOYENE,22,37,207,228,435
FATICK,FATICK,NIAKHAR,NGAYOKHEME,"H1 MBOUR DIACK",8,13,96,123,219
FATICK,FATICK,NIAKHAR,NGAYOKHEME,"H2 MBOYENE TOCK",14,17,116,120,236
FATICK,FATICK,NIAKHAR,NGAYOKHEME,NDOKH,58,102,504,505,1009
FATICK,FATICK,NIAKHAR,NGAYOKHEME,"H1 SOUNDANE",2,2,19,18,37
FATICK,FATICK,NIAKHAR,NGAYOKHEME,"NGALAGNE KOP",27,44,282,290,572
FATICK,FATICK,NIAKHAR,NGAYOKHEME,"H1 KEUR BIRAME FALL",5,6,54,36,90
FATICK,FATICK,NIAKHAR,NGAYOKHEME,"H2 PINTOCK",8,8,65,62,127
FATICK,FATICK,NIAKHAR,NGAYOKHEME,"H3 SOBEME",9,9,51,49,100
FATICK,FATICK,NIAKHAR,NGAYOKHEME,"H4 KAMO NGALAGNE",29,48,285,324,609
FATICK,FATICK,NIAKHAR,NGAYOKHEME,"NGANE FISSEL",37,65,347,411,758
FATICK,FATICK,NIAKHAR,NGAYOKHEME,"H1 NGANE PADEME",12,17,106,99,205
FATICK,FATICK,NIAKHAR,NGAYOKHEME,"H2 KHAPINO NGANE",10,10,48,54,102
FATICK,FATICK,NIAKHAR,NGAYOKHEME,NGANGARLAME,14,42,223,193,416
FATICK,FATICK,NIAKHAR,NGAYOKHEME,"H1 DOULEME",19,27,176,185,361
FATICK,FATICK,NIAKHAR,NGAYOKHEME,"H2 PODOME",14,24,122,147,269
FATICK,FATICK,NIAKHAR,NGAYOKHEME,"H3 KHAKHAL",13,25,98,92,190
FATICK,FATICK,NIAKHAR,NGAYOKHEME,"H4 NGANGARLAME SOUF",9,18,89,84,173
FATICK,FATICK,NIAKHAR,NGAYOKHEME,"H5 PETHIE SAMBOUNE",13,20,106,99,205
FATICK,FATICK,NIAKHAR,NGAYOKHEME,"H6 NDOFFANE",23,38,219,279,498
FATICK,FATICK,NIAKHAR,NGAYOKHEME,NGAYOKHEME,161,209,1003,1034,2037
FATICK,FATICK,NIAKHAR,NGAYOKHEME,"H1 MBINE PAMA",16,16,96,111,207
FATICK,FATICK,NIAKHAR,NGAYOKHEME,"H2 NDIOUDIOUF",13,16,91,109,200
FATICK,FATICK,NIAKHAR,NGAYOKHEME,"H3 NDIALO",24,39,202,232,434
FATICK,FATICK,NIAKHAR,NGAYOKHEME,"H4 MONEME",17,31,158,146,304
FATICK,FATICK,NIAKHAR,NGAYOKHEME,"H5 NGUILGADANE",11,13,84,67,151
FATICK,FATICK,NIAKHAR,NGAYOKHEME,"NGONINE MBESS",62,104,579,604,1183
FATICK,FATICK,NIAKHAR,NGAYOKHEME,"H1 SOBEME",25,48,450,435,885
FATICK,FATICK,NIAKHAR,NGAYOKHEME,"H2 NGONINE",44,76,524,527,1051
FATICK,FATICK,NIAKHAR,NGAYOKHEME,"H3 GADIACK",24,38,210,231,441
FATICK,FATICK,NIAKHAR,NGAYOKHEME,POUDAYE,66,111,794,732,1526
FATICK,FATICK,NIAKHAR,NGAYOKHEME,"H1 NGAFOYE",5,8,80,79,159
FATICK,FATICK,NIAKHAR,NGAYOKHEME,"H2 TOUNE",10,15,99,113,212
FATICK,FATICK,NIAKHAR,NGAYOKHEME,"SASS NDIAFADJI",59,102,652,605,1257
FATICK,FATICK,NIAKHAR,NGAYOKHEME,"H1 NDOFFENE",14,18,112,115,227
FATICK,FATICK,NIAKHAR,NGAYOKHEME,"H2 BACK MACK",1,2,17,13,30
FATICK,FATICK,NIAKHAR,NGAYOKHEME,SOB,74,123,714,714,1428
FATICK,FATICK,NIAKHAR,NGAYOKHEME,TOUCAR,341,466,2697,2606,5303
FATICK,FATICK,NIAKHAR,NIAKHAR,BIBANE,22,37,181,195,376
FATICK,FATICK,NIAKHAR,NIAKHAR,"H1 NDIOUDIOUF",11,15,70,88,158
FATICK,FATICK,NIAKHAR,NIAKHAR,"H2 NDOUNDOUR",5,7,30,43,73
FATICK,FATICK,NIAKHAR,NIAKHAR,GODAGUENE,30,42,230,233,463
FATICK,FATICK,NIAKHAR,NIAKHAR,"H2 KEUR FAGNANE",10,16,60,84,144
FATICK,FATICK,NIAKHAR,NIAKHAR,"H3 KEUR DEMBA",21,29,109,130,239
FATICK,FATICK,NIAKHAR,NIAKHAR,"H4 KEUR MANG MBAYE",7,8,32,34,66
FATICK,FATICK,NIAKHAR,NIAKHAR,"H5 MBINE DIBA",3,6,36,35,71
FATICK,FATICK,NIAKHAR,NIAKHAR,KANDIOU,30,38,225,212,437
FATICK,FATICK,NIAKHAR,NIAKHAR,KONEME,33,58,289,289,578
FATICK,FATICK,NIAKHAR,NIAKHAR,LANGHEME,38,49,218,255,473
FATICK,FATICK,NIAKHAR,NIAKHAR,"H1 YONE",11,14,77,68,145
FATICK,FATICK,NIAKHAR,NIAKHAR,"H2 MBINE GUEDJ ET DIBOCOR",16,21,94,93,187
FATICK,FATICK,NIAKHAR,NIAKHAR,"H3 MBINE SOUCKA ET GONAR",18,18,95,101,196
FATICK,FATICK,NIAKHAR,NIAKHAR,"H4 MBINE DIOGOYE",12,12,69,91,160
FATICK,FATICK,NIAKHAR,NIAKHAR,"MBADIOCK (NDOSS MBAD)",30,40,207,209,416
FATICK,FATICK,NIAKHAR,NIAKHAR,"H1 NDIAMBASS",7,7,37,27,64
FATICK,FATICK,NIAKHAR,NIAKHAR,"H2 MBIND LADIE",3,3,14,14,28
FATICK,FATICK,NIAKHAR,NIAKHAR,"H3 NGUITHIEME",22,38,194,193,387
FATICK,FATICK,NIAKHAR,NIAKHAR,"H4 NDOSS NDOFFENE",20,28,90,142,232
FATICK,FATICK,NIAKHAR,NIAKHAR,MBAFAYE,47,75,306,322,628
FATICK,FATICK,NIAKHAR,NIAKHAR,"H1 MBINE LATYR",5,6,29,50,79
FATICK,FATICK,NIAKHAR,NIAKHAR,"H2 MBINE NDIACK",6,9,59,56,115
FATICK,FATICK,NIAKHAR,NIAKHAR,MBANE,42,59,232,223,455
FATICK,FATICK,NIAKHAR,NIAKHAR,"H1 DIOKOUL BAMBARA",5,7,42,31,73
FATICK,FATICK,NIAKHAR,NIAKHAR,"H2 PINDA DIOHINE",3,5,41,31,72
FATICK,FATICK,NIAKHAR,NIAKHAR,"H3 DIOKOUL",15,17,100,75,175
FATICK,FATICK,NIAKHAR,NIAKHAR,"H4 MBINE DIENE",13,27,108,138,246
FATICK,FATICK,NIAKHAR,NIAKHAR,"H5 MBINE SEDAR",19,30,196,148,344
FATICK,FATICK,NIAKHAR,NIAKHAR,MBOLTOGNE,18,30,191,184,375
FATICK,FATICK,NIAKHAR,NIAKHAR,"H1 SASSAR MBOLTOGNE",4,11,40,63,103
FATICK,FATICK,NIAKHAR,NIAKHAR,"H2 TOKHAKHAL",9,12,47,51,98
FATICK,FATICK,NIAKHAR,NIAKHAR,MBOUDAYE,32,69,274,278,552
FATICK,FATICK,NIAKHAR,NIAKHAR,"H1 MBINE NIOKHOR ET LEONA",8,22,105,121,226
FATICK,FATICK,NIAKHAR,NIAKHAR,"H2 NGUIGUIRENE",3,7,27,34,61
FATICK,FATICK,NIAKHAR,NIAKHAR,"H3 NDIANGA",7,9,38,35,73
FATICK,FATICK,NIAKHAR,NIAKHAR,MBOUKHOUTOUR,13,17,111,107,218
FATICK,FATICK,NIAKHAR,NIAKHAR,"H2 MBINE DIANE",14,18,79,78,157
FATICK,FATICK,NIAKHAR,NIAKHAR,"H4 MBINE WALY SIKAT",1,2,13,11,24
FATICK,FATICK,NIAKHAR,NIAKHAR,MEME,43,65,312,340,652
FATICK,FATICK,NIAKHAR,NIAKHAR,"H2 NGORODOME",3,6,42,31,73
FATICK,FATICK,NIAKHAR,NIAKHAR,"H4 KEUR DIARAF (NDIAYENNE DARAF)",6,7,42,41,83
FATICK,FATICK,NIAKHAR,NIAKHAR,NDIANEME,56,67,404,418,822
FATICK,FATICK,NIAKHAR,NIAKHAR,NDIEMOU,22,39,215,226,441
FATICK,FATICK,NIAKHAR,NIAKHAR,"H1 NDIEMOUTAN",24,30,190,164,354
FATICK,FATICK,NIAKHAR,NIAKHAR,"H2 KEUR AMA SARR",3,4,27,28,55
FATICK,FATICK,NIAKHAR,NIAKHAR,"NDOFFANE BOURE",33,43,167,178,345
FATICK,FATICK,NIAKHAR,NIAKHAR,"NDOSS DIARAF",21,43,197,204,401
FATICK,FATICK,NIAKHAR,NIAKHAR,"H2 NDIACK NDIAYE",1,4,25,18,43
FATICK,FATICK,NIAKHAR,NIAKHAR,NGOYERE,15,21,129,191,320
FATICK,FATICK,NIAKHAR,NIAKHAR,NGUESS,17,35,186,155,341
FATICK,FATICK,NIAKHAR,NIAKHAR,"H1 MBALEME ET KEUR DIOULY",12,14,113,86,199
FATICK,FATICK,NIAKHAR,NIAKHAR,"H3 MBINE NDIOUGA",7,8,31,27,58
FATICK,FATICK,NIAKHAR,NIAKHAR,"H4 NGUESS MBALEME",6,7,64,56,120
FATICK,FATICK,NIAKHAR,NIAKHAR,NIAKHAR,852,1073,3771,4441,8212
FATICK,FATICK,NIAKHAR,NIAKHAR,"H1 PINDACOP SOP MACK",32,37,220,200,420
FATICK,FATICK,NIAKHAR,NIAKHAR,"H2 TOKA SONE",23,33,162,171,333
FATICK,FATICK,NIAKHAR,NIAKHAR,"H3 NGARAF",23,24,101,118,219
FATICK,FATICK,NIAKHAR,NIAKHAR,"H4 MBINE NIOKHOR",21,34,175,195,370
FATICK,FATICK,NIAKHAR,NIAKHAR,"H5 GOLGANE",15,20,104,112,216
FATICK,FATICK,NIAKHAR,NIAKHAR,NIANIANE,23,43,224,250,474
FATICK,FATICK,NIAKHAR,NIAKHAR,"H1 MBINE ABDOU",2,2,12,6,18
FATICK,FATICK,NIAKHAR,NIAKHAR,"H2 MBINE DIOUMA DIONE",6,6,26,35,61
FATICK,FATICK,NIAKHAR,NIAKHAR,NIONDOUNE,13,17,104,113,217
FATICK,FATICK,NIAKHAR,NIAKHAR,"H1 NGATY",3,7,43,45,88
FATICK,FATICK,NIAKHAR,NIAKHAR,"H2 LEONA (PARINE)",11,18,44,45,89
FATICK,FATICK,NIAKHAR,NIAKHAR,PODOME,7,10,50,50,100
FATICK,FATICK,NIAKHAR,NIAKHAR,"H2 MBINE DIOULY",2,4,11,12,23
FATICK,FATICK,NIAKHAR,NIAKHAR,"H3 DAROU",7,11,47,67,114
FATICK,FATICK,NIAKHAR,NIAKHAR,"H4 MBOULOUP",11,22,114,127,241
FATICK,FATICK,NIAKHAR,NIAKHAR,"H5 NDIADIE YARANE",12,19,121,133,254
FATICK,FATICK,NIAKHAR,NIAKHAR,"H6 ROUDIOUDJI",3,3,25,19,44
FATICK,FATICK,NIAKHAR,NIAKHAR,"H7 SAMBANG",2,2,16,13,29
FATICK,FATICK,NIAKHAR,NIAKHAR,POLECK,21,35,176,177,353
FATICK,FATICK,NIAKHAR,NIAKHAR,SAGNE,67,104,366,347,713
FATICK,FATICK,NIAKHAR,NIAKHAR,"H2 NDIAYENE SEMOU",16,22,150,143,293
FATICK,FATICK,NIAKHAR,NIAKHAR,"H3 NDIAYENE DJARAF",8,10,45,36,81
FATICK,FATICK,NIAKHAR,NIAKHAR,"H4 DIAGUE",17,31,103,126,229
FATICK,FATICK,NIAKHAR,NIAKHAR,"SAGNE FOLO (NDIATE)",28,47,268,296,564
FATICK,FATICK,NIAKHAR,NIAKHAR,"H1 PETHIE MBALEME",6,13,94,89,183
FATICK,FATICK,NIAKHAR,NIAKHAR,SANGHAYE,73,95,433,467,900
FATICK,FATICK,NIAKHAR,NIAKHAR,"H1 TAMBA",3,7,49,64,113
FATICK,FATICK,NIAKHAR,NIAKHAR,"H2 PETHIAKA",9,18,104,99,203
FATICK,FATICK,NIAKHAR,NIAKHAR,"H3 NDIANKOL",3,7,37,46,83
FATICK,FATICK,NIAKHAR,NIAKHAR,"H4 YAYEKA",3,5,19,25,44
FATICK,FATICK,NIAKHAR,NIAKHAR,"H5 DIAM SIDIBE",12,17,77,86,163
FATICK,FATICK,NIAKHAR,NIAKHAR,"H6 TELLA SANGHAYE",7,10,43,31,74
FATICK,FATICK,NIAKHAR,NIAKHAR,"H7 MBINE NDOUP",1,3,32,22,54
FATICK,FATICK,NIAKHAR,NIAKHAR,"H8 MBINE HAMATH",6,6,21,26,47
FATICK,FATICK,NIAKHAR,NIAKHAR,"H9 MBINE NDONGO (MBODAKHANE)",2,4,19,10,29
FATICK,FATICK,NIAKHAR,NIAKHAR,"SAS MACK",30,33,259,240,499
FATICK,FATICK,NIAKHAR,NIAKHAR,SASSAR,27,32,169,173,342
FATICK,FATICK,NIAKHAR,NIAKHAR,SATEME,7,9,51,66,117
FATICK,FATICK,NIAKHAR,NIAKHAR,"H1 NGAKH",7,11,108,92,200
FATICK,FATICK,NIAKHAR,NIAKHAR,SOROKH,79,90,486,490,976
FATICK,FATICK,NIAKHAR,NIAKHAR,"H6 NGODAGUENE",14,25,198,154,352
FATICK,FATICK,NIAKHAR,NIAKHAR,"H7 PAKOM",6,10,61,47,108
FATICK,FATICK,NIAKHAR,NIAKHAR,YENGUELE,62,74,341,408,749
FATICK,FATICK,NIAKHAR,NIAKHAR,"H2 KOPA KARIGNE",9,12,79,91,170
FATICK,FATICK,NIAKHAR,NIAKHAR,"H3 MBINE KORY",10,11,59,62,121
FATICK,FATICK,NIAKHAR,NIAKHAR,"H4 MBINE MBAGNICK SENE",39,67,496,420,916
FATICK,FATICK,NIAKHAR,NIAKHAR,"KEUR AMANDIOGOU",11,20,108,116,224
FATICK,FATICK,NIAKHAR,PATAR,BACK,33,44,326,304,630
FATICK,FATICK,NIAKHAR,PATAR,"H1 MBILE",6,9,40,34,74
FATICK,FATICK,NIAKHAR,PATAR,"H2 MODELEME",10,20,143,125,268
FATICK,FATICK,NIAKHAR,PATAR,DIADIACK,71,90,427,437,864
FATICK,FATICK,NIAKHAR,PATAR,DIANDOUM,18,27,188,185,373
FATICK,FATICK,NIAKHAR,PATAR,"H1 MBELLOUGUITHE",33,46,290,286,576
FATICK,FATICK,NIAKHAR,PATAR,"H2 YATTONGAL",11,14,95,93,188
FATICK,FATICK,NIAKHAR,PATAR,"DIANE (BEREDJI)",75,102,645,614,1259
FATICK,FATICK,NIAKHAR,PATAR,"H1 DIAME FALL & DIOCK SAKH",19,23,134,124,258
FATICK,FATICK,NIAKHAR,PATAR,"H2 NGAYOKHEME",13,25,138,130,268
FATICK,FATICK,NIAKHAR,PATAR,"H3 BERRY",7,7,27,33,60
FATICK,FATICK,NIAKHAR,PATAR,"H4 BELKY",45,82,495,389,884
FATICK,FATICK,NIAKHAR,PATAR,"H5 SOMA DIAMBOUGOU",40,74,525,493,1018
FATICK,FATICK,NIAKHAR,PATAR,LAKHAR,46,63,413,413,826
FATICK,FATICK,NIAKHAR,PATAR,"H1 BARKELY",2,4,25,31,56
FATICK,FATICK,NIAKHAR,PATAR,"H2 DAROU RASSAKH",3,3,62,41,103
FATICK,FATICK,NIAKHAR,PATAR,MAKHADJI,21,39,169,215,384
FATICK,FATICK,NIAKHAR,PATAR,"H1 BACKGANE",4,10,58,54,112
FATICK,FATICK,NIAKHAR,PATAR,"H2 KHAPIND",6,10,67,63,130
FATICK,FATICK,NIAKHAR,PATAR,MBADATTE,68,88,409,439,848
FATICK,FATICK,NIAKHAR,PATAR,"H1 DIABRONG",8,18,114,101,215
FATICK,FATICK,NIAKHAR,PATAR,"H2 DAROU",4,6,28,17,45
FATICK,FATICK,NIAKHAR,PATAR,"H3 NDANEGANE",9,17,109,93,202
FATICK,FATICK,NIAKHAR,PATAR,"H4 NDIANIAW",18,26,140,160,300
FATICK,FATICK,NIAKHAR,PATAR,"H5 DOUMEL",12,22,147,118,265
FATICK,FATICK,NIAKHAR,PATAR,"H6 KEUR NGOTHIE",19,30,148,158,306
FATICK,FATICK,NIAKHAR,PATAR,"MBAKHANE (NENEME)",46,87,439,461,900
FATICK,FATICK,NIAKHAR,PATAR,MBOUL,55,83,444,395,839
FATICK,FATICK,NIAKHAR,PATAR,NDIAMBOUR,137,148,961,925,1886
FATICK,FATICK,NIAKHAR,PATAR,"H1 KADAME",11,23,142,115,257
FATICK,FATICK,NIAKHAR,PATAR,"H2 NDIEMBERE",11,20,116,87,203
FATICK,FATICK,NIAKHAR,PATAR,"H3 NGAYOKHEME",3,9,41,44,85
FATICK,FATICK,NIAKHAR,PATAR,"H4 MODO MBESS ET MODO SASS",20,23,165,161,326
FATICK,FATICK,NIAKHAR,PATAR,"H5 MBASSE",33,60,315,369,684
FATICK,FATICK,NIAKHAR,PATAR,"H6 TINDITTE ET KODOU",37,60,345,403,748
FATICK,FATICK,NIAKHAR,PATAR,"H7 KHODJIL ET MALAGNE",15,25,142,153,295
FATICK,FATICK,NIAKHAR,PATAR,NDIDOR,23,32,135,138,273
FATICK,FATICK,NIAKHAR,PATAR,"H1 NDIONGOLOR",16,20,105,102,207
FATICK,FATICK,NIAKHAR,PATAR,"H2 GUEDIADIABA",5,8,38,46,84
FATICK,FATICK,NIAKHAR,PATAR,"H3 NDIAWDINE",12,16,65,68,133
FATICK,FATICK,NIAKHAR,PATAR,"H4 NGUELMALO (NDIAYENE BIRAME)",20,34,165,167,332
FATICK,FATICK,NIAKHAR,PATAR,"H5 MBALMAD",8,9,60,41,101
FATICK,FATICK,NIAKHAR,PATAR,"H6 MBOUDOU",7,9,54,37,91
FATICK,FATICK,NIAKHAR,PATAR,"H7 NDIAYENE TOCK",11,11,58,48,106
FATICK,FATICK,NIAKHAR,PATAR,"H8 TOUBA NDIAYENE",4,6,24,30,54
FATICK,FATICK,NIAKHAR,PATAR,"H9 KEUR SEMOU",4,6,34,31,65
FATICK,FATICK,NIAKHAR,PATAR,"NDIONE THIOGOME",58,85,486,467,953
FATICK,FATICK,NIAKHAR,PATAR,"H1 KEUR GANE",4,4,34,38,72
FATICK,FATICK,NIAKHAR,PATAR,NDIOULBETH,56,68,341,424,765
FATICK,FATICK,NIAKHAR,PATAR,"H2 LANDANE",7,10,65,64,129
FATICK,FATICK,NIAKHAR,PATAR,"NGALAGNE DIARAF",53,79,336,408,744
FATICK,FATICK,NIAKHAR,PATAR,"H1 NGALAGNE KITH",1,1,3,6,9
FATICK,FATICK,NIAKHAR,PATAR,PATAR,270,352,1525,1796,3321
FATICK,FATICK,NIAKHAR,PATAR,"H1 BAKACOYE",29,39,269,252,521
FATICK,FATICK,NIAKHAR,PATAR,"H2 DANGALA",21,26,149,173,322
FATICK,FATICK,NIAKHAR,PATAR,"H3 KEUR MOR NGOM",5,7,55,43,98
FATICK,FATICK,NIAKHAR,PATAR,"H4 NDIOUP SERERE",11,14,81,84,165
FATICK,FATICK,NIAKHAR,PATAR,"H5 NDIOUP TOUCOULEUR",7,8,35,38,73
FATICK,FATICK,NIAKHAR,PATAR,"SAMBA TOUDE",80,113,633,594,1227
FATICK,FATICK,NIAKHAR,PATAR,"TELLA YARGOUYE",74,90,387,422,809
FATICK,FATICK,NIAKHAR,PATAR,"H2 MBELGOR",9,11,70,57,127
FATICK,FATICK,NIAKHAR,PATAR,"H3 KEUR DJIDIACK",4,4,34,30,64
FATICK,FATICK,NIAKHAR,PATAR,"H4 MBOULANELA",6,6,31,23,54
FATICK,FATICK,NIAKHAR,PATAR,"H5 YARGOUYE",34,41,208,211,419
FATICK,FATICK,NIAKHAR,PATAR,"WAKHALDIAM (SINDIANE)",190,217,902,976,1878
FATICK,FATICK,NIAKHAR,PATAR,"DIADIACK TOCK",33,50,338,314,652
FATICK,FATICK,TATTAGUINE,DIARRERE,BICOLE,45,91,421,415,836
FATICK,FATICK,TATTAGUINE,DIARRERE,"H1 NDOFFANE",27,32,159,164,323
FATICK,FATICK,TATTAGUINE,DIARRERE,"H2 BAKHOUM",19,24,86,92,178
FATICK,FATICK,TATTAGUINE,DIARRERE,"H3 LAKHAR",4,8,33,38,71
FATICK,FATICK,TATTAGUINE,DIARRERE,"H4 SONGHORMA",15,27,111,110,221
FATICK,FATICK,TATTAGUINE,DIARRERE,"H5 MODANE",22,33,154,135,289
FATICK,FATICK,TATTAGUINE,DIARRERE,DAME,18,27,108,135,243
FATICK,FATICK,TATTAGUINE,DIARRERE,DIARRERE,315,397,2007,1948,3955
FATICK,FATICK,TATTAGUINE,DIARRERE,"H1 NAREME",2,8,48,40,88
FATICK,FATICK,TATTAGUINE,DIARRERE,"H3 NERANE",11,70,103,117,220
FATICK,FATICK,TATTAGUINE,DIARRERE,"H5 PETHIE DJIRE",14,22,150,190,340
FATICK,FATICK,TATTAGUINE,DIARRERE,"H6 THIAGNE THEME",9,9,53,40,93
FATICK,FATICK,TATTAGUINE,DIARRERE,"H7 MBOCANE DIARRERE",33,51,219,237,456
FATICK,FATICK,TATTAGUINE,DIARRERE,"H8 BOUCAR",4,5,30,38,68
FATICK,FATICK,TATTAGUINE,DIARRERE,"H9 MBISSEL",6,9,54,50,104
FATICK,FATICK,TATTAGUINE,DIARRERE,DIOHINE,291,377,1801,1748,3549
FATICK,FATICK,TATTAGUINE,DIARRERE,"H1 THYTAR NDIATE",13,21,121,134,255
FATICK,FATICK,TATTAGUINE,DIARRERE,"GADIACK 1",70,90,535,544,1079
FATICK,FATICK,TATTAGUINE,DIARRERE,"H1 MBELONGUITHIE",27,43,359,352,711
FATICK,FATICK,TATTAGUINE,DIARRERE,"H2 BALACK",11,15,75,75,150
FATICK,FATICK,TATTAGUINE,DIARRERE,"H3 SOUNDANE",9,13,65,65,130
FATICK,FATICK,TATTAGUINE,DIARRERE,"H4 DAFEME",15,20,93,104,197
FATICK,FATICK,TATTAGUINE,DIARRERE,"H5 MBEDIEDJ",15,20,91,92,183
FATICK,FATICK,TATTAGUINE,DIARRERE,"H6 NGASSIAK",36,46,237,257,494
FATICK,FATICK,TATTAGUINE,DIARRERE,"H7 MBELONGHOUTH",31,50,300,329,629
FATICK,FATICK,TATTAGUINE,DIARRERE,"H8 BACO NDANE",9,12,77,82,159
FATICK,FATICK,TATTAGUINE,DIARRERE,"H9 DAROU SALAM GADIACK I",12,13,59,33,92
FATICK,FATICK,TATTAGUINE,DIARRERE,"GADIACK 2",10,10,51,69,120
FATICK,FATICK,TATTAGUINE,DIARRERE,GODEL,27,43,248,236,484
FATICK,FATICK,TATTAGUINE,DIARRERE,"H1 NGUERANE",20,31,311,253,564
FATICK,FATICK,TATTAGUINE,DIARRERE,"H2 BACK NDJIEKE",21,27,167,159,326
FATICK,FATICK,TATTAGUINE,DIARRERE,"H6 MBELFATAR",13,13,82,85,167
FATICK,FATICK,TATTAGUINE,DIARRERE,KHASSOUS,37,41,296,279,575
FATICK,FATICK,TATTAGUINE,DIARRERE,"H1 NGELOKH",20,35,253,257,510
FATICK,FATICK,TATTAGUINE,DIARRERE,"H2 MOURTALE",7,10,67,45,112
FATICK,FATICK,TATTAGUINE,DIARRERE,"H3 BACK WAGANE",8,14,88,100,188
FATICK,FATICK,TATTAGUINE,DIARRERE,"H4 MBETITE KHASSOUS",16,22,87,100,187
FATICK,FATICK,TATTAGUINE,DIARRERE,KOTHIOKH,27,35,253,206,459
FATICK,FATICK,TATTAGUINE,DIARRERE,"H1 BACO MBANE",10,14,85,82,167
FATICK,FATICK,TATTAGUINE,DIARRERE,"H3 NDOFOMBODJI",16,20,143,129,272
FATICK,FATICK,TATTAGUINE,DIARRERE,"H4 ONGUITHE",24,37,302,255,557
FATICK,FATICK,TATTAGUINE,DIARRERE,"H5 ABADA",9,14,81,100,181
FATICK,FATICK,TATTAGUINE,DIARRERE,"H6 MBELPILE",12,13,84,88,172
FATICK,FATICK,TATTAGUINE,DIARRERE,"H7 NENECOR",9,18,130,148,278
FATICK,FATICK,TATTAGUINE,DIARRERE,"H8 NGUERANE",15,18,117,78,195
FATICK,FATICK,TATTAGUINE,DIARRERE,LEME,22,33,108,130,238
FATICK,FATICK,TATTAGUINE,DIARRERE,LOGDIR,25,38,250,250,500
FATICK,FATICK,TATTAGUINE,DIARRERE,"H1 PETHIAMAGAYE",9,15,94,110,204
FATICK,FATICK,TATTAGUINE,DIARRERE,"H2 MBOUMI",14,20,110,118,228
FATICK,FATICK,TATTAGUINE,DIARRERE,"H3 MONE",7,8,53,67,120
FATICK,FATICK,TATTAGUINE,DIARRERE,"H4 SESSENE",13,27,149,151,300
FATICK,FATICK,TATTAGUINE,DIARRERE,"H5 NDONDOL",1,11,71,97,168
FATICK,FATICK,TATTAGUINE,DIARRERE,"H6 SOUBEME",5,10,71,88,159
FATICK,FATICK,TATTAGUINE,DIARRERE,MBASSIS,20,72,178,160,338
FATICK,FATICK,TATTAGUINE,DIARRERE,"H1 MBINO NDOUP",2,12,51,56,107
FATICK,FATICK,TATTAGUINE,DIARRERE,"H2 KEUR NGOR NDIAYE",4,14,22,12,34
FATICK,FATICK,TATTAGUINE,DIARRERE,"MBETITE NGOUYE",74,96,631,633,1264
FATICK,FATICK,TATTAGUINE,DIARRERE,"H1 MBETITE DIARAF",22,39,256,242,498
FATICK,FATICK,TATTAGUINE,DIARRERE,MEME,20,26,108,134,242
FATICK,FATICK,TATTAGUINE,DIARRERE,"MOCANE NGOUYE",10,10,56,56,112
FATICK,FATICK,TATTAGUINE,DIARRERE,"H1 TITISS",18,23,167,177,344
FATICK,FATICK,TATTAGUINE,DIARRERE,"H2 NGOUYE",19,25,122,170,292
FATICK,FATICK,TATTAGUINE,DIARRERE,"H3 NGUESSIAM",11,13,59,75,134
FATICK,FATICK,TATTAGUINE,DIARRERE,"H4 NDOUTEKI",15,20,111,111,222
FATICK,FATICK,TATTAGUINE,DIARRERE,NDOUFF,37,66,430,422,852
FATICK,FATICK,TATTAGUINE,DIARRERE,"H1 NDANKH NDOUFF",15,25,191,154,345
FATICK,FATICK,TATTAGUINE,DIARRERE,"H2 MBETITE NDOUFF",15,22,141,141,282
FATICK,FATICK,TATTAGUINE,DIARRERE,"H3 KHODJIL",11,13,73,86,159
FATICK,FATICK,TATTAGUINE,DIARRERE,"H4 KHASSIDE",25,161,227,221,448
FATICK,FATICK,TATTAGUINE,DIARRERE,NDOUNDOKH,33,48,267,275,542
FATICK,FATICK,TATTAGUINE,DIARRERE,"H1 MBINE KORY",1,9,29,32,61
FATICK,FATICK,TATTAGUINE,DIARRERE,"H2 NIELESSE",11,15,56,85,141
FATICK,FATICK,TATTAGUINE,DIARRERE,"H3 KEUR NIOKHOR BIRANE",8,10,40,53,93
FATICK,FATICK,TATTAGUINE,DIARRERE,NGODJILEME,29,42,253,220,473
FATICK,FATICK,TATTAGUINE,DIARRERE,"H1 NDANKH NGODJILEME",23,39,247,202,449
FATICK,FATICK,TATTAGUINE,DIARRERE,NGARDIAME,28,51,370,359,729
FATICK,FATICK,TATTAGUINE,DIARRERE,"POULTOCK DIOHINE",55,110,649,656,1305
FATICK,FATICK,TATTAGUINE,DIARRERE,"H1 NDIODIONE ET MBALEME",10,20,83,95,178
FATICK,FATICK,TATTAGUINE,DIARRERE,"H2 NGODJILEME",9,17,118,118,236
FATICK,FATICK,TATTAGUINE,DIARRERE,"H3 TOCK NGOL",18,30,211,194,405
FATICK,FATICK,TATTAGUINE,DIARRERE,SANGHARE,45,69,288,321,609
FATICK,FATICK,TATTAGUINE,DIARRERE,"H1 KEUR SEMOU",8,12,70,58,128
FATICK,FATICK,TATTAGUINE,DIARRERE,"H2 NDIOBA",11,16,71,86,157
FATICK,FATICK,TATTAGUINE,DIARRERE,"H3 NDOUNGUE",6,10,44,44,88
FATICK,FATICK,TATTAGUINE,DIARRERE,"H4 KEUR SING DIOUF",2,3,13,16,29
FATICK,FATICK,TATTAGUINE,DIARRERE,"SOBEME MACK",18,23,109,83,192
FATICK,FATICK,TATTAGUINE,DIARRERE,"H1 PINTOCK",12,18,108,108,216
FATICK,FATICK,TATTAGUINE,DIARRERE,"H2 KHAPIND BAYAKH",28,41,174,191,365
FATICK,FATICK,TATTAGUINE,DIARRERE,WANDIARA,32,39,307,269,576
FATICK,FATICK,TATTAGUINE,DIARRERE,KHASSIDE,26,29,214,183,397
FATICK,FATICK,TATTAGUINE,DIARRERE,"MBETITE DIARRERE",10,15,92,97,189
FATICK,FATICK,TATTAGUINE,DIOUROUP,"DIOP NDOFFENE",70,120,307,310,617
FATICK,FATICK,TATTAGUINE,DIOUROUP,"H1 APATHIAR",26,42,232,220,452
FATICK,FATICK,TATTAGUINE,DIOUROUP,"H2 NDOFFENE",29,35,199,205,404
FATICK,FATICK,TATTAGUINE,DIOUROUP,"H3 BOUBANE",24,33,152,146,298
FATICK,FATICK,TATTAGUINE,DIOUROUP,"H4 NDIOUDAKH",6,16,90,90,180
FATICK,FATICK,TATTAGUINE,DIOUROUP,"H5 FANGATH",14,27,118,163,281
FATICK,FATICK,TATTAGUINE,DIOUROUP,"H6 PETHIE KOR SENE",6,9,55,53,108
FATICK,FATICK,TATTAGUINE,DIOUROUP,"H7 DIOP SIMON",19,24,115,120,235
FATICK,FATICK,TATTAGUINE,DIOUROUP,DIORAL,71,92,366,420,786
FATICK,FATICK,TATTAGUINE,DIOUROUP,"H1 BISMILLAH",5,5,27,22,49
FATICK,FATICK,TATTAGUINE,DIOUROUP,"H2 BITEW",1,6,41,32,73
FATICK,FATICK,TATTAGUINE,DIOUROUP,"H4 KEUR AMADOU FALL",1,2,24,15,39
FATICK,FATICK,TATTAGUINE,DIOUROUP,"DIOUROUP (NDIODIONE)",368,462,1673,1872,3545
FATICK,FATICK,TATTAGUINE,DIOUROUP,"H1 DIOUROUP LERAYE",8,18,85,102,187
FATICK,FATICK,TATTAGUINE,DIOUROUP,"H2 DIOUROUP FAMACK",101,139,741,747,1488
FATICK,FATICK,TATTAGUINE,DIOUROUP,"H3 NDIADJIMAR",15,19,148,134,282
FATICK,FATICK,TATTAGUINE,DIOUROUP,"H4 DIOUROUP NDOUR NDOUR",43,90,428,369,797
FATICK,FATICK,TATTAGUINE,DIOUROUP,"H5 DIOUROUP MBARDIEME",80,111,479,510,989
FATICK,FATICK,TATTAGUINE,DIOUROUP,"H6 DIOBAYE",9,16,68,80,148
FATICK,FATICK,TATTAGUINE,DIOUROUP,DOUDAME,77,101,473,509,982
FATICK,FATICK,TATTAGUINE,DIOUROUP,FAYIL,352,434,1404,1532,2936
FATICK,FATICK,TATTAGUINE,DIOUROUP,"H1 NERANE",41,77,384,328,712
FATICK,FATICK,TATTAGUINE,DIOUROUP,"H3 LOUCOUCOUCK",3,7,23,20,43
FATICK,FATICK,TATTAGUINE,DIOUROUP,"H4 SILIF",9,12,23,14,37
FATICK,FATICK,TATTAGUINE,DIOUROUP,"H5 MASSA",5,8,38,26,64
FATICK,FATICK,TATTAGUINE,DIOUROUP,"H6 TENGHANE",3,5,19,23,42
FATICK,FATICK,TATTAGUINE,DIOUROUP,NDIONGOLOR,257,298,1357,1360,2717
FATICK,FATICK,TATTAGUINE,DIOUROUP,"H1 BACCO BOF",14,26,73,82,155
FATICK,FATICK,TATTAGUINE,DIOUROUP,"H2 TOURNAL",15,20,140,125,265
FATICK,FATICK,TATTAGUINE,DIOUROUP,NDIOUDIOUF,77,92,363,417,780
FATICK,FATICK,TATTAGUINE,DIOUROUP,"H1 NDIOUWAR",208,237,702,809,1511
FATICK,FATICK,TATTAGUINE,DIOUROUP,NGOUYE,50,77,378,424,802
FATICK,FATICK,TATTAGUINE,DIOUROUP,"H1 MBINE NDIONGOL",2,2,9,10,19
FATICK,FATICK,TATTAGUINE,DIOUROUP,"H2 MBINE YADE",23,28,132,161,293
FATICK,FATICK,TATTAGUINE,DIOUROUP,"H3 NDOFFANE NGOUYE",27,43,228,279,507
FATICK,FATICK,TATTAGUINE,DIOUROUP,"H4 DIAMBOUGOUM",6,11,66,74,140
FATICK,FATICK,TATTAGUINE,DIOUROUP,PARARE,57,79,368,358,726
FATICK,FATICK,TATTAGUINE,DIOUROUP,"H1 NIELESSE",7,7,45,33,78
FATICK,FATICK,TATTAGUINE,DIOUROUP,SENGHOR,176,225,1177,1007,2184
FATICK,FATICK,TATTAGUINE,DIOUROUP,SOWANE,48,50,190,207,397
FATICK,FATICK,TATTAGUINE,TATTAGUINE,BACOBOF,47,78,553,528,1081
FATICK,FATICK,TATTAGUINE,TATTAGUINE,"H1 KHAOUL",18,31,208,182,390
FATICK,FATICK,TATTAGUINE,TATTAGUINE,"H2 ROF BACOBOF",12,23,146,142,288
FATICK,FATICK,TATTAGUINE,TATTAGUINE,"H3 MBAFAYE",14,22,162,120,282
FATICK,FATICK,TATTAGUINE,TATTAGUINE,"H4 MBASSIS WANACK",84,122,721,658,1379
FATICK,FATICK,TATTAGUINE,TATTAGUINE,"H5 MBASSIS NGANE",12,14,91,89,180
FATICK,FATICK,TATTAGUINE,TATTAGUINE,"H6 PETHIE MAKHA",40,60,388,366,754
FATICK,FATICK,TATTAGUINE,TATTAGUINE,"H7 SASSE POMBANE",5,6,51,35,86
FATICK,FATICK,TATTAGUINE,TATTAGUINE,"H8 NAKHAMAYE",36,67,363,378,741
FATICK,FATICK,TATTAGUINE,TATTAGUINE,KAMYACK,36,48,311,262,573
FATICK,FATICK,TATTAGUINE,TATTAGUINE,"H1 NGUEKOKH",1,1,7,7,14
FATICK,FATICK,TATTAGUINE,TATTAGUINE,"H2 NDIOTHIO MBAME",12,15,141,113,254
FATICK,FATICK,TATTAGUINE,TATTAGUINE,"H3 PETHIE BOURE",15,17,114,102,216
FATICK,FATICK,TATTAGUINE,TATTAGUINE,"KEUR MANGARY (MOURIDE)",10,17,114,93,207
FATICK,FATICK,TATTAGUINE,TATTAGUINE,"H1 MBETOUL",16,22,103,102,205
FATICK,FATICK,TATTAGUINE,TATTAGUINE,"H2 KEUR MOUTFA",2,2,23,15,38
FATICK,FATICK,TATTAGUINE,TATTAGUINE,"H3 KEUR MANGARY",26,41,340,342,682
FATICK,FATICK,TATTAGUINE,TATTAGUINE,KHONDIONGNE,71,107,482,545,1027
FATICK,FATICK,TATTAGUINE,TATTAGUINE,"H1 SASSEME (KHONDIONGNE)",10,10,75,61,136
FATICK,FATICK,TATTAGUINE,TATTAGUINE,"H2 SASSEME (SACKINE)",40,48,246,245,491
FATICK,FATICK,TATTAGUINE,TATTAGUINE,"H3 DOKH",67,83,368,416,784
FATICK,FATICK,TATTAGUINE,TATTAGUINE,MBEDAB,34,53,247,262,509
FATICK,FATICK,TATTAGUINE,TATTAGUINE,"H3 BANGADJ",18,21,125,133,258
FATICK,FATICK,TATTAGUINE,TATTAGUINE,"H4 NDIOFANE",17,36,251,258,509
FATICK,FATICK,TATTAGUINE,TATTAGUINE,"H6 MBELMEO",12,18,101,112,213
FATICK,FATICK,TATTAGUINE,TATTAGUINE,"H7 YELE",20,24,128,134,262
FATICK,FATICK,TATTAGUINE,TATTAGUINE,MBELONGHOUTH,78,115,569,559,1128
FATICK,FATICK,TATTAGUINE,TATTAGUINE,"H1 NDIOTHIO NGODANE",7,9,38,43,81
FATICK,FATICK,TATTAGUINE,TATTAGUINE,"MBOUGUEL (NGOHE MBOUGUEL)",19,29,188,163,351
FATICK,FATICK,TATTAGUINE,TATTAGUINE,"H1 MBAYELAR",12,31,116,150,266
FATICK,FATICK,TATTAGUINE,TATTAGUINE,"H2 MBOUGUEL FANDEB",11,12,104,85,189
FATICK,FATICK,TATTAGUINE,TATTAGUINE,"H3 BAKAMACK",41,53,360,323,683
FATICK,FATICK,TATTAGUINE,TATTAGUINE,NDIOSMONE,28,46,276,219,495
FATICK,FATICK,TATTAGUINE,TATTAGUINE,"H2 DAROU",6,9,71,67,138
FATICK,FATICK,TATTAGUINE,TATTAGUINE,"H3 TOCAMBEL",55,79,449,409,858
FATICK,FATICK,TATTAGUINE,TATTAGUINE,"H4 POKATTE",38,64,170,179,349
FATICK,FATICK,TATTAGUINE,TATTAGUINE,"H5 CROISEMENT NDIOSMONE",68,78,446,448,894
FATICK,FATICK,TATTAGUINE,TATTAGUINE,"NGOHE MBADATTE",101,147,933,881,1814
FATICK,FATICK,TATTAGUINE,TATTAGUINE,"NGOHE NDOFONGOR",202,239,720,779,1499
FATICK,FATICK,TATTAGUINE,TATTAGUINE,"NGOHE POFINE",163,192,1060,971,2031
FATICK,FATICK,TATTAGUINE,TATTAGUINE,"POULTOCK NDIOSMONE",153,165,790,755,1545
FATICK,FATICK,TATTAGUINE,TATTAGUINE,"H1 GANDIAYE",11,23,173,173,346
FATICK,FATICK,TATTAGUINE,TATTAGUINE,"H2 MBINE LADEMBA FAYE",14,19,114,94,208
FATICK,FATICK,TATTAGUINE,TATTAGUINE,"H3 DIAMAGUENE",9,24,167,168,335
FATICK,FATICK,TATTAGUINE,TATTAGUINE,"H4 POULTOCK DIARGA",25,42,300,236,536
FATICK,FATICK,TATTAGUINE,TATTAGUINE,"TATTAGUINE ESCALE",231,411,1167,1381,2548
FATICK,FATICK,TATTAGUINE,TATTAGUINE,"H3 BAKEME",5,14,77,83,160
FATICK,FATICK,TATTAGUINE,TATTAGUINE,"H4 LOUCOUCK",11,13,105,80,185
FATICK,FATICK,TATTAGUINE,TATTAGUINE,"H5 NGODJILEME",7,11,69,61,130
FATICK,FATICK,TATTAGUINE,TATTAGUINE,"TATTAGUINE SERERE",88,105,562,608,1170
FATICK,FATICK,TATTAGUINE,TATTAGUINE,"H4 DIOUROUPACOP",25,36,270,265,535
FATICK,FATICK,TATTAGUINE,TATTAGUINE,"H6 BAKHAMAYE",15,19,178,161,339
FATICK,FATICK,TATTAGUINE,TATTAGUINE,"H10 PODOME",28,43,295,257,552
FATICK,FATICK,TATTAGUINE,TATTAGUINE,"H11 KEUR MEO",8,12,96,65,161
FATICK,FATICK,TATTAGUINE,TATTAGUINE,THIAMENE,60,78,343,379,722
FATICK,FATICK,TATTAGUINE,TATTAGUINE,"H1 PODOME THIAMENE",24,38,174,193,367
FATICK,FATICK,TATTAGUINE,TATTAGUINE,"H2 GARAGE",124,145,649,684,1333
FATICK,FATICK,TATTAGUINE,TATTAGUINE,"KEUR MARTIN",46,54,321,279,600
FATICK,FATICK,TATTAGUINE,TATTAGUINE,"H1 KAMA DIOUM",7,11,97,83,180
FATICK,FATICK,TATTAGUINE,TATTAGUINE,"H2 NDIANGODJ",13,15,115,107,222
FATICK,FATICK,TATTAGUINE,TATTAGUINE,"LOUL SOB",40,62,402,364,766
FATICK,FATICK,TATTAGUINE,TATTAGUINE,"H1 BOUBANE",6,9,44,51,95
FATICK,FATICK,TATTAGUINE,TATTAGUINE,"H2 NDIOROKH",11,17,140,118,258
FATICK,FATICK,TATTAGUINE,TATTAGUINE,"H3 NDOFFANE",11,18,75,84,159
FATICK,FATICK,TATTAGUINE,TATTAGUINE,"H4 NGARDIAM",31,34,227,183,410
FATICK,FOUNDIOUGNE,FOUNDIOUGNE,FOUNDIOUGNE,ALMADIES,99,109,271,283,554
FATICK,FOUNDIOUGNE,FOUNDIOUGNE,FOUNDIOUGNE,"CITE BENOIT",217,256,890,737,1627
FATICK,FOUNDIOUGNE,FOUNDIOUGNE,FOUNDIOUGNE,ESCALE,62,109,452,340,792
FATICK,FOUNDIOUGNE,FOUNDIOUGNE,FOUNDIOUGNE,HLM,84,122,296,337,633
FATICK,FOUNDIOUGNE,FOUNDIOUGNE,FOUNDIOUGNE,MBELGORE,83,113,586,470,1056
FATICK,FOUNDIOUGNE,FOUNDIOUGNE,FOUNDIOUGNE,THIAMENE,133,183,745,770,1515
FATICK,FOUNDIOUGNE,FOUNDIOUGNE,FOUNDIOUGNE,"THIARAKHOLE I",121,192,622,637,1259
FATICK,FOUNDIOUGNE,FOUNDIOUGNE,FOUNDIOUGNE,"THIARAKHOLE II",171,199,773,715,1488
FATICK,FOUNDIOUGNE,SOKONE,SOKONE,"DIAMAGUENE NORD",260,343,1276,1423,2699
FATICK,FOUNDIOUGNE,SOKONE,SOKONE,"DIAMAGUENE SUD",319,371,1511,1461,2972
FATICK,FOUNDIOUGNE,SOKONE,SOKONE,LEONA,179,335,804,920,1724
FATICK,FOUNDIOUGNE,SOKONE,SOKONE,NDIONGHONE,58,65,345,333,678
FATICK,FOUNDIOUGNE,SOKONE,SOKONE,MEDINA,347,520,1573,1748,3321
FATICK,FOUNDIOUGNE,SOKONE,SOKONE,NDANGANE,193,238,964,1092,2056
FATICK,FOUNDIOUGNE,SOKONE,SOKONE,"DIAMAGUENE CENTRE",409,514,1921,2177,4098
FATICK,FOUNDIOUGNE,SOKONE,SOKONE,MBOULDIAME,67,81,331,407,738
FATICK,FOUNDIOUGNE,SOKONE,SOKONE,NIMZAT,39,42,194,183,377
FATICK,FOUNDIOUGNE,SOKONE,SOKONE,SANTHIABA,178,213,847,914,1761
FATICK,FOUNDIOUGNE,DJILOR,DJILOR,BADANDAR,86,110,660,731,1391
FATICK,FOUNDIOUGNE,DJILOR,DJILOR,BAYE,24,31,226,204,430
FATICK,FOUNDIOUGNE,DJILOR,DJILOR,"BOLY SERRERE",28,34,165,191,356
FATICK,FOUNDIOUGNE,DJILOR,DJILOR,"H1 PETHIALA",3,5,27,24,51
FATICK,FOUNDIOUGNE,DJILOR,DJILOR,"DAGA SOUKOUM",22,27,101,120,221
FATICK,FOUNDIOUGNE,DJILOR,DJILOR,DIAMAGUENE,8,9,62,76,138
FATICK,FOUNDIOUGNE,DJILOR,DJILOR,DJILOR,357,445,1848,2049,3897
FATICK,FOUNDIOUGNE,DJILOR,DJILOR,"H1 DIOKOUL",5,5,40,37,77
FATICK,FOUNDIOUGNE,DJILOR,DJILOR,FELANE,99,105,504,496,1000
FATICK,FOUNDIOUGNE,DJILOR,DJILOR,"GAGUE CHERIF",101,120,543,587,1130
FATICK,FOUNDIOUGNE,DJILOR,DJILOR,"GOUDEME SIDY",57,90,724,563,1287
FATICK,FOUNDIOUGNE,DJILOR,DJILOR,GUEDE,8,9,45,45,90
FATICK,FOUNDIOUGNE,DJILOR,DJILOR,"KAMATANE MBAMBARA",31,40,173,175,348
FATICK,FOUNDIOUGNE,DJILOR,DJILOR,"KAMATANE MBAR",34,38,154,155,309
FATICK,FOUNDIOUGNE,DJILOR,DJILOR,"KEUR BAKARY DIAMBANG",13,14,89,104,193
FATICK,FOUNDIOUGNE,DJILOR,DJILOR,"KEUR BONDJI",16,20,108,119,227
FATICK,FOUNDIOUGNE,DJILOR,DJILOR,"KEUR BOUBA",12,15,94,88,182
FATICK,FOUNDIOUGNE,DJILOR,DJILOR,"KEUR CHEIKHOU",13,15,115,103,218
FATICK,FOUNDIOUGNE,DJILOR,DJILOR,"H1 KEUR THIALLA",17,20,106,86,192
FATICK,FOUNDIOUGNE,DJILOR,DJILOR,"H2 KEUR SAMBODJI",8,9,61,61,122
FATICK,FOUNDIOUGNE,DJILOR,DJILOR,"KEUR DABO",56,59,369,315,684
FATICK,FOUNDIOUGNE,DJILOR,DJILOR,"H1 KEUR DIARRA",15,17,108,81,189
FATICK,FOUNDIOUGNE,DJILOR,DJILOR,"KEUR DJINDAKE",12,15,92,111,203
FATICK,FOUNDIOUGNE,DJILOR,DJILOR,"KEUR FARBA",83,97,494,567,1061
FATICK,FOUNDIOUGNE,DJILOR,DJILOR,"KEUR IBRAHIMA GORY",22,23,125,121,246
FATICK,FOUNDIOUGNE,DJILOR,DJILOR,"H1 KEUR YOUGA",10,11,63,62,125
FATICK,FOUNDIOUGNE,DJILOR,DJILOR,"KEUR MANDAO (BODY MBALEME)",34,45,214,272,486
FATICK,FOUNDIOUGNE,DJILOR,DJILOR,"KEUR MATHIORO",9,17,105,93,198
FATICK,FOUNDIOUGNE,DJILOR,DJILOR,"H1 PEULGA",2,2,21,24,45
FATICK,FOUNDIOUGNE,DJILOR,DJILOR,"KEUR MBAR",4,7,58,38,96
FATICK,FOUNDIOUGNE,DJILOR,DJILOR,"KEUR MOR DIOP",40,47,278,307,585
FATICK,FOUNDIOUGNE,DJILOR,DJILOR,"KEUR NGARY",12,12,91,84,175
FATICK,FOUNDIOUGNE,DJILOR,DJILOR,"KEUR NIAOUTH",17,19,111,105,216
FATICK,FOUNDIOUGNE,DJILOR,DJILOR,"KEUR OMAR",55,62,298,292,590
FATICK,FOUNDIOUGNE,DJILOR,DJILOR,"KEUR PATHE",7,10,47,53,100
FATICK,FOUNDIOUGNE,DJILOR,DJILOR,"KEUR THIENEKE NDIAS",23,26,112,102,214
FATICK,FOUNDIOUGNE,DJILOR,DJILOR,"KEUR WALY NDIAYE",8,11,43,57,100
FATICK,FOUNDIOUGNE,DJILOR,DJILOR,"KEUR WALY PENDA",13,17,107,93,200
FATICK,FOUNDIOUGNE,DJILOR,DJILOR,"KEUR YORO",38,42,185,226,411
FATICK,FOUNDIOUGNE,DJILOR,DJILOR,LAMBAYE,26,27,137,123,260
FATICK,FOUNDIOUGNE,DJILOR,DJILOR,MBELANE,30,31,163,175,338
FATICK,FOUNDIOUGNE,DJILOR,DJILOR,"H1 KEUR NGOLO",12,12,63,63,126
FATICK,FOUNDIOUGNE,DJILOR,DJILOR,"NDIASSANE SALOUM",39,41,173,194,367
FATICK,FOUNDIOUGNE,DJILOR,DJILOR,NDIOMDY,50,58,315,354,669
FATICK,FOUNDIOUGNE,DJILOR,DJILOR,"H1 KEUR MOMAR BIGUE",6,8,44,47,91
FATICK,FOUNDIOUGNE,DJILOR,DJILOR,"NDOUR NDOUR",25,31,94,95,189
FATICK,FOUNDIOUGNE,DJILOR,DJILOR,"H1 NDOUR NDOUR PEULH",3,4,17,22,39
FATICK,FOUNDIOUGNE,DJILOR,DJILOR,NGAMSA,11,11,91,61,152
FATICK,FOUNDIOUGNE,DJILOR,DJILOR,NGUEKOKH,64,85,391,425,816
FATICK,FOUNDIOUGNE,DJILOR,DJILOR,PETHIE,43,51,251,260,511
FATICK,FOUNDIOUGNE,DJILOR,DJILOR,SADIOGA,86,99,531,517,1048
FATICK,FOUNDIOUGNE,DJILOR,DJILOR,"H1 KEUR SOUKOUM",3,4,24,29,53
FATICK,FOUNDIOUGNE,DJILOR,DJILOR,"SANTHIE DEMBA",6,9,45,57,102
FATICK,FOUNDIOUGNE,DJILOR,DJILOR,YERWAGO,27,34,183,149,332
FATICK,FOUNDIOUGNE,DJILOR,DIOSSONG,"BAMBOUGAR EL HADJI",30,34,136,212,348
FATICK,FOUNDIOUGNE,DJILOR,DIOSSONG,"BAMBOUGAR MALICK (KEUR MALICK NDIAYE)",41,54,334,295,629
FATICK,FOUNDIOUGNE,DJILOR,DIOSSONG,"BAMBOUGAR MASSAMBA",29,39,223,183,406
FATICK,FOUNDIOUGNE,DJILOR,DIOSSONG,"BAMBOUGAR MOMATH (KEUR DIOULDE)",14,19,125,106,231
FATICK,FOUNDIOUGNE,DJILOR,DIOSSONG,"H1 SAGNANE",7,8,37,30,67
FATICK,FOUNDIOUGNE,DJILOR,DIOSSONG,BANGALERE,47,53,276,314,590
FATICK,FOUNDIOUGNE,DJILOR,DIOSSONG,BOULY,20,24,100,101,201
FATICK,FOUNDIOUGNE,DJILOR,DIOSSONG,"H1 BOULY BOUMACK",6,7,34,33,67
FATICK,FOUNDIOUGNE,DJILOR,DIOSSONG,"H2 KEUR SALOUM",2,4,21,11,32
FATICK,FOUNDIOUGNE,DJILOR,DIOSSONG,"DAROU SADER KHOUMA",33,54,315,434,749
FATICK,FOUNDIOUGNE,DJILOR,DIOSSONG,DIOSSONG,216,280,1408,1599,3007
FATICK,FOUNDIOUGNE,DJILOR,DIOSSONG,"KEBE ANSOU",66,75,383,514,897
FATICK,FOUNDIOUGNE,DJILOR,DIOSSONG,"KEBE KONDE (KEBE AMATH)",34,47,301,376,677
FATICK,FOUNDIOUGNE,DJILOR,DIOSSONG,"KEUR ABDOU YACINE",33,36,235,260,495
FATICK,FOUNDIOUGNE,DJILOR,DIOSSONG,"KEUR ALIOU DIOP",25,33,197,178,375
FATICK,FOUNDIOUGNE,DJILOR,DIOSSONG,"KEUR DIAKHAM BOULY",7,7,29,24,53
FATICK,FOUNDIOUGNE,DJILOR,DIOSSONG,"KEUR ELIMANE",35,41,267,297,564
FATICK,FOUNDIOUGNE,DJILOR,DIOSSONG,"H1 SANTHIE NDIAYENE",7,10,72,72,144
FATICK,FOUNDIOUGNE,DJILOR,DIOSSONG,"KEUR ELIMANE AICHA",28,32,182,250,432
FATICK,FOUNDIOUGNE,DJILOR,DIOSSONG,"KEUR FAFA WELLY",42,51,325,413,738
FATICK,FOUNDIOUGNE,DJILOR,DIOSSONG,"KEUR KHOUREICHY",4,4,14,23,37
FATICK,FOUNDIOUGNE,DJILOR,DIOSSONG,"KEUR LAHINE FATIM",52,64,342,437,779
FATICK,FOUNDIOUGNE,DJILOR,DIOSSONG,"KEUR MBAYE MATY",26,29,123,144,267
FATICK,FOUNDIOUGNE,DJILOR,DIOSSONG,"KEUR SETTE NIAKHOUBA",10,25,118,121,239
FATICK,FOUNDIOUGNE,DJILOR,DIOSSONG,"LERANE COLY",44,57,309,258,567
FATICK,FOUNDIOUGNE,DJILOR,DIOSSONG,"LERANE SAMBOU",77,87,643,610,1253
FATICK,FOUNDIOUGNE,DJILOR,DIOSSONG,MBOULOUM,73,90,567,516,1083
FATICK,FOUNDIOUGNE,DJILOR,DIOSSONG,"MBOWENE IBRA",12,23,119,114,233
FATICK,FOUNDIOUGNE,DJILOR,DIOSSONG,"H1 MBOWENE SOKHNA",6,12,103,89,192
FATICK,FOUNDIOUGNE,DJILOR,DIOSSONG,"MBOWENE SOULEYEMANE",26,35,226,205,431
FATICK,FOUNDIOUGNE,DJILOR,DIOSSONG,"NDIAFFE NDIAFFE",50,81,424,452,876
FATICK,FOUNDIOUGNE,DJILOR,DIOSSONG,"H1 NDIAYENE",10,14,67,85,152
FATICK,FOUNDIOUGNE,DJILOR,DIOSSONG,"H4 KEUR ALIOU BA",3,5,20,15,35
FATICK,FOUNDIOUGNE,DJILOR,DIOSSONG,"NDIAYE NDIAYE OUOLOF",124,140,790,947,1737
FATICK,FOUNDIOUGNE,DJILOR,DIOSSONG,"NDIENGHENE MADY",30,37,245,267,512
FATICK,FOUNDIOUGNE,DJILOR,DIOSSONG,"NDIOBENE NDIAFFE",24,30,150,185,335
FATICK,FOUNDIOUGNE,DJILOR,DIOSSONG,"NDIONGHONE BOURE",56,70,329,301,630
FATICK,FOUNDIOUGNE,DJILOR,DIOSSONG,"NDIONGHONE NDIACK",20,34,193,179,372
FATICK,FOUNDIOUGNE,DJILOR,DIOSSONG,"NDORONG SERERE",68,83,417,415,832
FATICK,FOUNDIOUGNE,DJILOR,DIOSSONG,"NDORONG WOLOF",68,74,502,529,1031
FATICK,FOUNDIOUGNE,DJILOR,DIOSSONG,"NDRAME MACOUMBA (DRAME NGUEDIANE)",50,58,386,435,821
FATICK,FOUNDIOUGNE,DJILOR,DIOSSONG,"NGAYENE DAOUR",43,49,338,338,676
FATICK,FOUNDIOUGNE,DJILOR,DIOSSONG,"PASSY ALY DIE",17,27,235,249,484
FATICK,FOUNDIOUGNE,DJILOR,DIOSSONG,"PASSY MBITEYENE",27,36,265,300,565
FATICK,FOUNDIOUGNE,DJILOR,DIOSSONG,TALLENE,44,76,348,395,743
FATICK,FOUNDIOUGNE,DJILOR,DIOSSONG,"THIAKHO MALAMINE",45,62,341,439,780
FATICK,FOUNDIOUGNE,DJILOR,DIOSSONG,"THIAMENE BIRANE",21,27,175,190,365
FATICK,FOUNDIOUGNE,DJILOR,DIOSSONG,"THIAMENE SATHIEBO (THIAMENE BAMBARA)",21,23,128,127,255
FATICK,FOUNDIOUGNE,DJILOR,"DIAGANE BARKA","DIAGANE BARKA",34,35,234,235,469
FATICK,FOUNDIOUGNE,DJILOR,"DIAGANE BARKA","DIAGANE SENGHANE",19,24,153,169,322
FATICK,FOUNDIOUGNE,DJILOR,"DIAGANE BARKA","H1 THIAMENE",8,9,33,38,71
FATICK,FOUNDIOUGNE,DJILOR,"DIAGANE BARKA","DIAGLE DJILOR",35,35,225,217,442
FATICK,FOUNDIOUGNE,DJILOR,"DIAGANE BARKA","DIALABA BOUMACK",12,19,90,123,213
FATICK,FOUNDIOUGNE,DJILOR,"DIAGANE BARKA","DIALABA SANTHIE",35,40,205,219,424
FATICK,FOUNDIOUGNE,DJILOR,"DIAGANE BARKA","KEUR ALY GUEYE",34,38,258,248,506
FATICK,FOUNDIOUGNE,DJILOR,"DIAGANE BARKA","KEUR BAKA MANSATA",17,31,180,231,411
FATICK,FOUNDIOUGNE,DJILOR,"DIAGANE BARKA","KEUR BAKARY",30,36,278,314,592
FATICK,FOUNDIOUGNE,DJILOR,"DIAGANE BARKA","KEUR LAHINE NDITY",15,16,115,119,234
FATICK,FOUNDIOUGNE,DJILOR,"DIAGANE BARKA","KEUR MAMADOU FATOUMA",35,49,347,317,664
FATICK,FOUNDIOUGNE,DJILOR,"DIAGANE BARKA","KEUR MBAYE GUEYE",17,38,289,317,606
FATICK,FOUNDIOUGNE,DJILOR,"DIAGANE BARKA","KEUR NDIOL FALL",18,34,299,293,592
FATICK,FOUNDIOUGNE,DJILOR,"DIAGANE BARKA","KEUR OUMAR DIOULY (PEULGA)",10,14,134,132,266
FATICK,FOUNDIOUGNE,DJILOR,"DIAGANE BARKA","KEUR SAMBA KHODIA",28,40,260,280,540
FATICK,FOUNDIOUGNE,DJILOR,"DIAGANE BARKA","KEUR TAMSIR KHODIA",30,40,300,315,615
FATICK,FOUNDIOUGNE,DJILOR,"DIAGANE BARKA",LOUMENE,66,77,457,454,911
FATICK,FOUNDIOUGNE,DJILOR,"DIAGANE BARKA","NDIAYE NDIAYE SERERE",43,51,402,228,630
FATICK,FOUNDIOUGNE,DJILOR,"DIAGANE BARKA","NDIENGHENE MALICK",22,36,298,376,674
FATICK,FOUNDIOUGNE,DJILOR,"DIAGANE BARKA",NDIOMBOREL,19,22,162,140,302
FATICK,FOUNDIOUGNE,DJILOR,"DIAGANE BARKA","NDOFFANE NDARY",49,63,485,467,952
FATICK,FOUNDIOUGNE,DJILOR,"DIAGANE BARKA","NGAYENE MOMAR",25,30,222,262,484
FATICK,FOUNDIOUGNE,DJILOR,"DIAGANE BARKA",SOROM,69,79,783,745,1528
FATICK,FOUNDIOUGNE,DJILOR,"DIAGANE BARKA",THIOGUENE,17,19,181,190,371
FATICK,FOUNDIOUGNE,DJILOR,"DIAGANE BARKA","H1 KEUR MBANA",2,2,30,45,75
FATICK,FOUNDIOUGNE,DJILOR,"DIAGANE BARKA","H2 THIOGUENE TOURKA",5,5,42,51,93
FATICK,FOUNDIOUGNE,DJILOR,MBAM,"GAGUE BOCAR",77,82,358,332,690
FATICK,FOUNDIOUGNE,DJILOR,MBAM,"H1 NDOLETE",10,16,71,67,138
FATICK,FOUNDIOUGNE,DJILOR,MBAM,"GAGUE MODY",127,143,726,706,1432
FATICK,FOUNDIOUGNE,DJILOR,MBAM,MBAM,384,443,1918,1986,3904
FATICK,FOUNDIOUGNE,DJILOR,MBAM,MBAGLOR,5,5,63,0,63
FATICK,FOUNDIOUGNE,DJILOR,MBAM,MBASSIS,203,264,1026,945,1971
FATICK,FOUNDIOUGNE,DJILOR,MBAM,"H1 BAMBOU",10,11,54,45,99
FATICK,FOUNDIOUGNE,DJILOR,MBAM,"NDORONG LOG",101,123,586,635,1221
FATICK,FOUNDIOUGNE,DJILOR,MBAM,SAP,34,36,151,161,312
FATICK,FOUNDIOUGNE,DJILOR,MBAM,"H1 KEUR SAMBA WANE",29,30,146,137,283
FATICK,FOUNDIOUGNE,DJILOR,MBAM,"THIARE LOG",178,195,748,838,1586
FATICK,FOUNDIOUGNE,DJILOR,MBAM,"KEUR WALY NDIAYE",1,1,10,4,14
FATICK,FOUNDIOUGNE,DJILOR,NIASSENE,"AINOUMANE (KEBE AINOUMANE)",12,24,136,136,272
FATICK,FOUNDIOUGNE,DJILOR,NIASSENE,"DAGA BIRANE 1",9,12,55,58,113
FATICK,FOUNDIOUGNE,DJILOR,NIASSENE,"H1 KEUR SEYNI",5,14,68,71,139
FATICK,FOUNDIOUGNE,DJILOR,NIASSENE,"DAGA BIRANE 2",20,26,144,102,246
FATICK,FOUNDIOUGNE,DJILOR,NIASSENE,"DAGA DIERY PEULH",29,44,262,271,533
FATICK,FOUNDIOUGNE,DJILOR,NIASSENE,"DAGA DIERY SERERE",18,23,153,181,334
FATICK,FOUNDIOUGNE,DJILOR,NIASSENE,"DAGA NDOUP",39,42,289,268,557
FATICK,FOUNDIOUGNE,DJILOR,NIASSENE,"DAROU KEUR MAMOUR KHOREDIA",66,79,523,488,1011
FATICK,FOUNDIOUGNE,DJILOR,NIASSENE,"H1 THIOCE",1,4,18,12,30
FATICK,FOUNDIOUGNE,DJILOR,NIASSENE,"DIAGANE SADER",23,32,236,289,525
FATICK,FOUNDIOUGNE,DJILOR,NIASSENE,"H1 KEUR SOULEYE",7,16,150,124,274
FATICK,FOUNDIOUGNE,DJILOR,NIASSENE,"DIANKHA ALY",31,39,214,218,432
FATICK,FOUNDIOUGNE,DJILOR,NIASSENE,"DIOGO SERERE 1",11,21,103,91,194
FATICK,FOUNDIOUGNE,DJILOR,NIASSENE,"DIOGO SERERE 2 (DIOP TOUCOULEUR)",6,9,46,27,73
FATICK,FOUNDIOUGNE,DJILOR,NIASSENE,"FASS MATAR",33,56,398,372,770
FATICK,FOUNDIOUGNE,DJILOR,NIASSENE,"KEUR ABDOU FANA",13,19,90,94,184
FATICK,FOUNDIOUGNE,DJILOR,NIASSENE,"H1 KEUR LAHINE BOMBE",17,20,110,92,202
FATICK,FOUNDIOUGNE,DJILOR,NIASSENE,"KEUR BABOU COUMBA",7,14,72,98,170
FATICK,FOUNDIOUGNE,DJILOR,NIASSENE,"KEUR BABOU KANY",18,38,228,248,476
FATICK,FOUNDIOUGNE,DJILOR,NIASSENE,"KEUR BAKARY LY",31,42,239,320,559
FATICK,FOUNDIOUGNE,DJILOR,NIASSENE,"KEUR BIRANE KHOREDIA",101,144,1189,1267,2456
FATICK,FOUNDIOUGNE,DJILOR,NIASSENE,"KEUR DIEBEL SENE",38,46,273,293,566
FATICK,FOUNDIOUGNE,DJILOR,NIASSENE,"KEUR KHALIFA (THILLA KEUR KHALIFA)",37,54,255,356,611
FATICK,FOUNDIOUGNE,DJILOR,NIASSENE,"KEUR MALAO",16,23,133,131,264
FATICK,FOUNDIOUGNE,DJILOR,NIASSENE,"KEUR MATH THIAM",24,33,314,272,586
FATICK,FOUNDIOUGNE,DJILOR,NIASSENE,"KEUR MBANGOU",83,100,578,685,1263
FATICK,FOUNDIOUGNE,DJILOR,NIASSENE,"KEUR MBOSSE",5,6,76,80,156
FATICK,FOUNDIOUGNE,DJILOR,NIASSENE,"KEUR MOMATH FANA",9,18,114,111,225
FATICK,FOUNDIOUGNE,DJILOR,NIASSENE,"MEDINA KEBE (KEBE SANTHIE)",12,24,142,140,282
FATICK,FOUNDIOUGNE,DJILOR,NIASSENE,"MEDINA THIAMENE",4,10,33,42,75
FATICK,FOUNDIOUGNE,DJILOR,NIASSENE,"NDIAGNENE OMAR",17,31,238,243,481
FATICK,FOUNDIOUGNE,DJILOR,NIASSENE,"NDIAGNENE ISSOUP",47,79,513,656,1169
FATICK,FOUNDIOUGNE,DJILOR,NIASSENE,"NDIANKHA YOUSSOUPHA",27,40,231,248,479
FATICK,FOUNDIOUGNE,DJILOR,NIASSENE,"NDIOBENE THIANDA",7,11,65,78,143
FATICK,FOUNDIOUGNE,DJILOR,NIASSENE,NDIOURBEL,35,49,310,287,597
FATICK,FOUNDIOUGNE,DJILOR,NIASSENE,NIANENE,23,31,219,170,389
FATICK,FOUNDIOUGNE,DJILOR,NIASSENE,"NIASSENE SAMB",64,79,336,412,748
FATICK,FOUNDIOUGNE,DJILOR,NIASSENE,"H1 NIASSENE SANTHIE",6,8,36,32,68
FATICK,FOUNDIOUGNE,DJILOR,NIASSENE,"THIAMENE DIOGO",28,45,282,248,530
FATICK,FOUNDIOUGNE,DJILOR,NIASSENE,"THIAMENE SOULEYE",24,34,208,232,440
FATICK,FOUNDIOUGNE,DJILOR,NIASSENE,"THIANDA THIAMENE",19,33,181,206,387
FATICK,FOUNDIOUGNE,DJILOR,NIASSENE,"THIANDE THISSE",23,42,471,508,979
FATICK,FOUNDIOUGNE,DJILOR,NIASSENE,THIECKENE,21,26,166,169,335
FATICK,FOUNDIOUGNE,DJILOR,NIASSENE,THIOUROUM,34,45,305,277,582
FATICK,FOUNDIOUGNE,DJILOR,PASSY,ESCALE,450,495,2121,2481,4602
FATICK,FOUNDIOUGNE,DJILOR,PASSY,LEONA,270,305,1436,1475,2911
FATICK,FOUNDIOUGNE,DJILOR,PASSY,"NDRAME MAPATHE",39,66,340,364,704
FATICK,FOUNDIOUGNE,DJILOR,PASSY,SANTHIABA,263,305,1445,1525,2970
FATICK,FOUNDIOUGNE,DJILOR,PASSY,"DAROU NDIAYENE",13,13,121,130,251
FATICK,FOUNDIOUGNE,DJILOR,PASSY,"DAROU SALAM",365,449,1744,2161,3905
FATICK,FOUNDIOUGNE,DJILOR,PASSY,DIAMAGUENE,240,289,1466,1420,2886
FATICK,FOUNDIOUGNE,DJILOR,PASSY,"KEUR NGAGNE",4,9,52,41,93
FATICK,FOUNDIOUGNE,DJILOR,SOUM,"BAAK 1",31,64,313,300,613
FATICK,FOUNDIOUGNE,DJILOR,SOUM,"BAAK 2 (DAROU SALAM)",62,80,346,394,740
FATICK,FOUNDIOUGNE,DJILOR,SOUM,"BAAK 3 (MEDINA)",67,73,277,307,584
FATICK,FOUNDIOUGNE,DJILOR,SOUM,"MBOUDAYE 1",25,37,161,167,328
FATICK,FOUNDIOUGNE,DJILOR,SOUM,"MBOUDAYE 2",58,63,208,243,451
FATICK,FOUNDIOUGNE,DJILOR,SOUM,"MBOUDAYE 3",74,92,366,441,807
FATICK,FOUNDIOUGNE,DJILOR,SOUM,NDANEGUEMEGANE,64,82,349,360,709
FATICK,FOUNDIOUGNE,DJILOR,SOUM,NDIBORIBO,56,81,315,384,699
FATICK,FOUNDIOUGNE,DJILOR,SOUM,"SINDIANE 1",66,77,260,333,593
FATICK,FOUNDIOUGNE,DJILOR,SOUM,"SINDIANE 2",64,70,309,326,635
FATICK,FOUNDIOUGNE,NIODIOR,BASSOUL,BASSAR,115,176,955,1005,1960
FATICK,FOUNDIOUGNE,NIODIOR,BASSOUL,BASSOUL,266,515,2918,3175,6093
FATICK,FOUNDIOUGNE,NIODIOR,BASSOUL,DIOGANE,78,109,743,733,1476
FATICK,FOUNDIOUGNE,NIODIOR,BASSOUL,SIWO,51,82,580,550,1130
FATICK,FOUNDIOUGNE,NIODIOR,BASSOUL,THIALANE,71,109,618,624,1242
FATICK,FOUNDIOUGNE,NIODIOR,BASSOUL,"H1 DIOURE",2,3,32,13,45
FATICK,FOUNDIOUGNE,NIODIOR,DIONEWAR,DIONEWAR,241,481,2512,2545,5057
FATICK,FOUNDIOUGNE,NIODIOR,DIONEWAR,FALIA,77,90,515,536,1051
FATICK,FOUNDIOUGNE,NIODIOR,DIONEWAR,NIODIOR,290,605,3007,3474,6481
FATICK,FOUNDIOUGNE,NIODIOR,DJIRNDA,BAOUTH,83,94,516,492,1008
FATICK,FOUNDIOUGNE,NIODIOR,DJIRNDA,DIAMNIADIO,109,141,709,678,1387
FATICK,FOUNDIOUGNE,NIODIOR,DJIRNDA,DJIRNDA,194,256,1299,1382,2681
FATICK,FOUNDIOUGNE,NIODIOR,DJIRNDA,"H1 NDINDE",2,3,11,7,18
FATICK,FOUNDIOUGNE,NIODIOR,DJIRNDA,FAMBINE,39,46,263,280,543
FATICK,FOUNDIOUGNE,NIODIOR,DJIRNDA,"H1 MAYA",21,26,114,147,261
FATICK,FOUNDIOUGNE,NIODIOR,DJIRNDA,FAYAKO,41,45,275,267,542
FATICK,FOUNDIOUGNE,NIODIOR,DJIRNDA,"H1 NIAMDIAROKH",1,1,4,1,5
FATICK,FOUNDIOUGNE,NIODIOR,DJIRNDA,FELIR,42,49,286,278,564
FATICK,FOUNDIOUGNE,NIODIOR,DJIRNDA,"H1 NDAKHONGA",1,2,14,15,29
FATICK,FOUNDIOUGNE,NIODIOR,DJIRNDA,MOUNDE,117,144,724,744,1468
FATICK,FOUNDIOUGNE,NIODIOR,DJIRNDA,"H1 MOUNDE DAGA",1,1,9,6,15
FATICK,FOUNDIOUGNE,NIODIOR,DJIRNDA,"H2 WANDIE",13,15,81,76,157
FATICK,FOUNDIOUGNE,NIODIOR,DJIRNDA,NGADIOR,71,96,624,601,1225
FATICK,FOUNDIOUGNE,NIODIOR,DJIRNDA,ROFANGUE,36,42,251,220,471
FATICK,FOUNDIOUGNE,NIODIOR,DJIRNDA,VELINGARA,5,6,17,27,44
FATICK,FOUNDIOUGNE,TOUBACOUTA,"KEUR SALOUM DIANE","BAMBADALLA KONTEYENE",16,19,153,148,301
FATICK,FOUNDIOUGNE,TOUBACOUTA,"KEUR SALOUM DIANE","BAMBADALLA THIAKHO",83,107,617,808,1425
FATICK,FOUNDIOUGNE,TOUBACOUTA,"KEUR SALOUM DIANE","H1 SANTHIE BAMBA",8,9,49,53,102
FATICK,FOUNDIOUGNE,TOUBACOUTA,"KEUR SALOUM DIANE",BARIA,99,172,1029,1083,2112
FATICK,FOUNDIOUGNE,TOUBACOUTA,"KEUR SALOUM DIANE","H1 SANTHIE BARIA",13,13,99,107,206
FATICK,FOUNDIOUGNE,TOUBACOUTA,"KEUR SALOUM DIANE","H2 SANTHIE MAMOUR SAGNANE",32,42,244,194,438
FATICK,FOUNDIOUGNE,TOUBACOUTA,"KEUR SALOUM DIANE","H3 MANSASSOU",37,41,305,266,571
FATICK,FOUNDIOUGNE,TOUBACOUTA,"KEUR SALOUM DIANE",BAWOU,23,25,180,213,393
FATICK,FOUNDIOUGNE,TOUBACOUTA,"KEUR SALOUM DIANE","COULAR SARAKHOLE",35,44,181,201,382
FATICK,FOUNDIOUGNE,TOUBACOUTA,"KEUR SALOUM DIANE","H1 SINTHIOU BODIAN",16,18,129,111,240
FATICK,FOUNDIOUGNE,TOUBACOUTA,"KEUR SALOUM DIANE","COULAR SOCE",77,161,952,880,1832
FATICK,FOUNDIOUGNE,TOUBACOUTA,"KEUR SALOUM DIANE","KERE NIOMBATO",51,64,379,466,845
FATICK,FOUNDIOUGNE,TOUBACOUTA,"KEUR SALOUM DIANE","KEUR ANDALLAH WILLANE",50,63,428,400,828
FATICK,FOUNDIOUGNE,TOUBACOUTA,"KEUR SALOUM DIANE","KEUR BABOU COUMBA",67,84,587,820,1407
FATICK,FOUNDIOUGNE,TOUBACOUTA,"KEUR SALOUM DIANE","KEUR BABOU NDITY",41,57,435,531,966
FATICK,FOUNDIOUGNE,TOUBACOUTA,"KEUR SALOUM DIANE","KEUR BAKAR SANTHIE",31,45,353,342,695
FATICK,FOUNDIOUGNE,TOUBACOUTA,"KEUR SALOUM DIANE","KEUR BALLA MARY",23,25,164,202,366
FATICK,FOUNDIOUGNE,TOUBACOUTA,"KEUR SALOUM DIANE","KEUR BARKA DIAW",71,78,537,684,1221
FATICK,FOUNDIOUGNE,TOUBACOUTA,"KEUR SALOUM DIANE","KEUR BOYE",31,39,244,215,459
FATICK,FOUNDIOUGNE,TOUBACOUTA,"KEUR SALOUM DIANE","KEUR EL HADJI MACOUMBA",56,73,530,700,1230
FATICK,FOUNDIOUGNE,TOUBACOUTA,"KEUR SALOUM DIANE","KEUR KATIM GUEYE",25,33,203,182,385
FATICK,FOUNDIOUGNE,TOUBACOUTA,"KEUR SALOUM DIANE","KEUR LAHINE KHOREDIA",75,99,694,741,1435
FATICK,FOUNDIOUGNE,TOUBACOUTA,"KEUR SALOUM DIANE","KEUR LAHINE SOKHNA",62,77,533,590,1123
FATICK,FOUNDIOUGNE,TOUBACOUTA,"KEUR SALOUM DIANE","H1 BANGANIA",27,28,142,127,269
FATICK,FOUNDIOUGNE,TOUBACOUTA,"KEUR SALOUM DIANE","H2 PATAKO",3,3,32,18,50
FATICK,FOUNDIOUGNE,TOUBACOUTA,"KEUR SALOUM DIANE","KEUR MAGNANE",43,56,417,380,797
FATICK,FOUNDIOUGNE,TOUBACOUTA,"KEUR SALOUM DIANE","KEUR MANDIAYE FATIM",46,54,352,464,816
FATICK,FOUNDIOUGNE,TOUBACOUTA,"KEUR SALOUM DIANE","KEUR MOMATH DIAW",58,79,647,774,1421
FATICK,FOUNDIOUGNE,TOUBACOUTA,"KEUR SALOUM DIANE","KEUR SALOUM DIANE",157,211,1149,1183,2332
FATICK,FOUNDIOUGNE,TOUBACOUTA,"KEUR SALOUM DIANE","KEUR SENY GUEYE 2",52,80,586,608,1194
FATICK,FOUNDIOUGNE,TOUBACOUTA,"KEUR SALOUM DIANE","KEUR SERIGNE BAMBA",56,71,508,506,1014
FATICK,FOUNDIOUGNE,TOUBACOUTA,"KEUR SALOUM DIANE","KEUR SERIGNE KORKA",48,62,331,323,654
FATICK,FOUNDIOUGNE,TOUBACOUTA,"KEUR SALOUM DIANE","KEUR THIERNO NGALANE",18,21,120,130,250
FATICK,FOUNDIOUGNE,TOUBACOUTA,"KEUR SALOUM DIANE","KEUR YEWTY",9,10,55,62,117
FATICK,FOUNDIOUGNE,TOUBACOUTA,"KEUR SALOUM DIANE","MISSIRAH ALIOU",22,26,237,249,486
FATICK,FOUNDIOUGNE,TOUBACOUTA,"KEUR SALOUM DIANE","NDIAYE COUNDA",41,62,356,367,723
FATICK,FOUNDIOUGNE,TOUBACOUTA,"KEUR SALOUM DIANE","NDIAYE NDIAYE",81,109,859,807,1666
FATICK,FOUNDIOUGNE,TOUBACOUTA,"KEUR SALOUM DIANE","NDIAYENE FODE",63,78,394,590,984
FATICK,FOUNDIOUGNE,TOUBACOUTA,"KEUR SALOUM DIANE","NDIAYENE KEUR MOMATH THIANE",26,40,302,260,562
FATICK,FOUNDIOUGNE,TOUBACOUTA,"KEUR SALOUM DIANE","NDIAYENE SANTANG",72,86,543,733,1276
FATICK,FOUNDIOUGNE,TOUBACOUTA,"KEUR SALOUM DIANE","NDIENGHENE NDONGO",22,33,231,266,497
FATICK,FOUNDIOUGNE,TOUBACOUTA,"KEUR SALOUM DIANE","NDRAME MATAR",43,56,374,414,788
FATICK,FOUNDIOUGNE,TOUBACOUTA,"KEUR SALOUM DIANE","H1 KEUR ALPHA",10,11,79,77,156
FATICK,FOUNDIOUGNE,TOUBACOUTA,"KEUR SALOUM DIANE","H2 KEUR MODY SALLA",23,35,285,272,557
FATICK,FOUNDIOUGNE,TOUBACOUTA,"KEUR SALOUM DIANE","H3 KEUR SERIGNE MARAME",8,14,69,104,173
FATICK,FOUNDIOUGNE,TOUBACOUTA,"KEUR SALOUM DIANE","H4 DAROU SALAM",2,2,15,19,34
FATICK,FOUNDIOUGNE,TOUBACOUTA,"KEUR SALOUM DIANE","H5 KEUR SOULEYMANE DIALLO",14,17,115,138,253
FATICK,FOUNDIOUGNE,TOUBACOUTA,"KEUR SALOUM DIANE","SANTHIE MOMATH DRAME",8,14,106,125,231
FATICK,FOUNDIOUGNE,TOUBACOUTA,"KEUR SALOUM DIANE","THIARENE BABOU",39,55,337,401,738
FATICK,FOUNDIOUGNE,TOUBACOUTA,"KEUR SALOUM DIANE","H1 THIARENE SANTHIE",20,27,254,269,523
FATICK,FOUNDIOUGNE,TOUBACOUTA,"KEUR SALOUM DIANE","THILLA MATAR",19,23,144,126,270
FATICK,FOUNDIOUGNE,TOUBACOUTA,"KEUR SAMBA GUEYE",BANTANDING,5,5,31,25,56
FATICK,FOUNDIOUGNE,TOUBACOUTA,"KEUR SAMBA GUEYE","DAGA NDOUP (DIMBGA)",79,89,666,653,1319
FATICK,FOUNDIOUGNE,TOUBACOUTA,"KEUR SAMBA GUEYE","DJIDAH (SANTHIE MODOU)",46,58,419,353,772
FATICK,FOUNDIOUGNE,TOUBACOUTA,"KEUR SAMBA GUEYE","H1 KEUR SETTE COUMBA",41,46,391,340,731
FATICK,FOUNDIOUGNE,TOUBACOUTA,"KEUR SAMBA GUEYE","FASS THIECKENE",48,50,304,296,600
FATICK,FOUNDIOUGNE,TOUBACOUTA,"KEUR SAMBA GUEYE","KEUR ALIOU DIOP (NDIOBENE)",39,58,537,656,1193
FATICK,FOUNDIOUGNE,TOUBACOUTA,"KEUR SAMBA GUEYE","KEUR ALY GUEYE",40,50,323,358,681
FATICK,FOUNDIOUGNE,TOUBACOUTA,"KEUR SAMBA GUEYE","KEUR ALY YACINE",24,31,234,282,516
FATICK,FOUNDIOUGNE,TOUBACOUTA,"KEUR SAMBA GUEYE","KEUR AYIP KA",124,165,1017,1055,2072
FATICK,FOUNDIOUGNE,TOUBACOUTA,"KEUR SAMBA GUEYE","KEUR BAKARY CAMARA",29,29,186,177,363
FATICK,FOUNDIOUGNE,TOUBACOUTA,"KEUR SAMBA GUEYE","KEUR BOURAMA BOBO (KEUR ALASSANE DIALLO)",67,85,530,483,1013
FATICK,FOUNDIOUGNE,TOUBACOUTA,"KEUR SAMBA GUEYE","H1 KEUR LAMINE DIAME",18,18,78,55,133
FATICK,FOUNDIOUGNE,TOUBACOUTA,"KEUR SAMBA GUEYE","H2 KEUR MOMATH FATOU",15,26,125,129,254
FATICK,FOUNDIOUGNE,TOUBACOUTA,"KEUR SAMBA GUEYE","H3 POMBA",1,1,3,4,7
FATICK,FOUNDIOUGNE,TOUBACOUTA,"KEUR SAMBA GUEYE","KEUR HAMBOU",78,88,491,588,1079
FATICK,FOUNDIOUGNE,TOUBACOUTA,"KEUR SAMBA GUEYE","KEUR MAHANTHIA",7,11,73,61,134
FATICK,FOUNDIOUGNE,TOUBACOUTA,"KEUR SAMBA GUEYE","KEUR MAMADOU GUEYE",16,21,117,104,221
FATICK,FOUNDIOUGNE,TOUBACOUTA,"KEUR SAMBA GUEYE","KEUR MOMATH SOUNE",39,51,242,287,529
FATICK,FOUNDIOUGNE,TOUBACOUTA,"KEUR SAMBA GUEYE","H1 SANTHIOU EL HADJ DIENE",2,2,12,11,23
FATICK,FOUNDIOUGNE,TOUBACOUTA,"KEUR SAMBA GUEYE","KEUR MOUSSA SENY",26,38,198,226,424
FATICK,FOUNDIOUGNE,TOUBACOUTA,"KEUR SAMBA GUEYE","KEUR NDIANKOU",66,82,546,562,1108
FATICK,FOUNDIOUGNE,TOUBACOUTA,"KEUR SAMBA GUEYE","KEUR OUSSEYNOU DIENG",121,153,1004,992,1996
FATICK,FOUNDIOUGNE,TOUBACOUTA,"KEUR SAMBA GUEYE","KEUR SALOLY BOUYA",77,90,409,472,881
FATICK,FOUNDIOUGNE,TOUBACOUTA,"KEUR SAMBA GUEYE","KEUR SAMBA GUEYE",145,186,1024,1110,2134
FATICK,FOUNDIOUGNE,TOUBACOUTA,"KEUR SAMBA GUEYE","KEUR SAMBA KALLA",34,51,300,318,618
FATICK,FOUNDIOUGNE,TOUBACOUTA,"KEUR SAMBA GUEYE","KEUR SAMBA NOSSO",84,108,849,735,1584
FATICK,FOUNDIOUGNE,TOUBACOUTA,"KEUR SAMBA GUEYE","H1 KEUR KHALY SARR",12,12,62,58,120
FATICK,FOUNDIOUGNE,TOUBACOUTA,"KEUR SAMBA GUEYE","KEUR SERIGNE DIE",15,27,186,251,437
FATICK,FOUNDIOUGNE,TOUBACOUTA,"KEUR SAMBA GUEYE","KEUR SEYNI GUEYE",146,184,1583,1337,2920
FATICK,FOUNDIOUGNE,TOUBACOUTA,"KEUR SAMBA GUEYE","KEUR THIENDOU",72,101,683,686,1369
FATICK,FOUNDIOUGNE,TOUBACOUTA,"KEUR SAMBA GUEYE",MAHMOUDA,17,24,269,208,477
FATICK,FOUNDIOUGNE,TOUBACOUTA,"KEUR SAMBA GUEYE","MEDINA DJIKOYE",68,71,359,308,667
FATICK,FOUNDIOUGNE,TOUBACOUTA,"KEUR SAMBA GUEYE","MEDINA NGAYENE",40,43,341,243,584
FATICK,FOUNDIOUGNE,TOUBACOUTA,"KEUR SAMBA GUEYE","NDIEGANE KEUR GADJI",88,100,511,532,1043
FATICK,FOUNDIOUGNE,TOUBACOUTA,"KEUR SAMBA GUEYE",NDIEGANENE,8,22,169,163,332
FATICK,FOUNDIOUGNE,TOUBACOUTA,"KEUR SAMBA GUEYE","NDIOP KEUR OUMAR SARR",49,58,334,413,747
FATICK,FOUNDIOUGNE,TOUBACOUTA,"KEUR SAMBA GUEYE","NGADIOR NDAYAME",25,26,127,131,258
FATICK,FOUNDIOUGNE,TOUBACOUTA,"KEUR SAMBA GUEYE","PASSY NDINDERLING",56,76,489,497,986
FATICK,FOUNDIOUGNE,TOUBACOUTA,"KEUR SAMBA GUEYE","SANTHIE RAME",49,56,441,349,790
FATICK,FOUNDIOUGNE,TOUBACOUTA,"KEUR SAMBA GUEYE","SIMONG HAMDALLAYE (SIMONG SANTY)",22,25,107,123,230
FATICK,FOUNDIOUGNE,TOUBACOUTA,"KEUR SAMBA GUEYE",SIRMANG,91,106,869,813,1682
FATICK,FOUNDIOUGNE,TOUBACOUTA,"KEUR SAMBA GUEYE","THILLA KEUR SERIGNE BABO",45,74,494,494,988
FATICK,FOUNDIOUGNE,TOUBACOUTA,"KEUR SAMBA GUEYE","THIOYENE NIOMBATO",73,97,844,802,1646
FATICK,FOUNDIOUGNE,TOUBACOUTA,"KEUR SAMBA GUEYE","TOUBA BARIA",33,36,208,181,389
FATICK,FOUNDIOUGNE,TOUBACOUTA,"KEUR SAMBA GUEYE","KEUR BAKARY MANE",27,30,152,160,312
FATICK,FOUNDIOUGNE,TOUBACOUTA,"NIORO ALASSANE TALL",DANTAKHOUNE,35,41,292,296,588
FATICK,FOUNDIOUGNE,TOUBACOUTA,"NIORO ALASSANE TALL","DAROU KEUR IBRAHIMA",35,46,319,319,638
FATICK,FOUNDIOUGNE,TOUBACOUTA,"NIORO ALASSANE TALL",DIAMAGUENE,16,25,131,132,263
FATICK,FOUNDIOUGNE,TOUBACOUTA,"NIORO ALASSANE TALL","H1 KEUR IBRAHIMA BA (DIAMAGUENE THIALENE)",16,26,170,132,302
FATICK,FOUNDIOUGNE,TOUBACOUTA,"NIORO ALASSANE TALL","H3 KEUR BOURAMA DIARRA",5,5,27,26,53
FATICK,FOUNDIOUGNE,TOUBACOUTA,"NIORO ALASSANE TALL","KEUR AMADY DIALLO",10,14,133,141,274
FATICK,FOUNDIOUGNE,TOUBACOUTA,"NIORO ALASSANE TALL","H1 KEUR ALY KANY",12,18,177,175,352
FATICK,FOUNDIOUGNE,TOUBACOUTA,"NIORO ALASSANE TALL","KEUR AMATH SEUNE",70,78,594,613,1207
FATICK,FOUNDIOUGNE,TOUBACOUTA,"NIORO ALASSANE TALL","KEUR BABOU NDIAYE",3,3,30,36,66
FATICK,FOUNDIOUGNE,TOUBACOUTA,"NIORO ALASSANE TALL","KEUR BABOU PENDA",15,32,239,239,478
FATICK,FOUNDIOUGNE,TOUBACOUTA,"NIORO ALASSANE TALL","KEUR BABOU YACINE",14,24,165,141,306
FATICK,FOUNDIOUGNE,TOUBACOUTA,"NIORO ALASSANE TALL","KEUR BAKAR DIAITE",24,34,187,183,370
FATICK,FOUNDIOUGNE,TOUBACOUTA,"NIORO ALASSANE TALL","H1 KEUR ASSANE",9,9,50,35,85
FATICK,FOUNDIOUGNE,TOUBACOUTA,"NIORO ALASSANE TALL","KEUR DJIBEL SOUNE",14,26,210,180,390
FATICK,FOUNDIOUGNE,TOUBACOUTA,"NIORO ALASSANE TALL","KEUR GAYE YACINE",83,115,877,806,1683
FATICK,FOUNDIOUGNE,TOUBACOUTA,"NIORO ALASSANE TALL","KEUR LAHINE FATIM",155,186,1417,1316,2733
FATICK,FOUNDIOUGNE,TOUBACOUTA,"NIORO ALASSANE TALL","KEUR MALICK FADY",36,44,275,263,538
FATICK,FOUNDIOUGNE,TOUBACOUTA,"NIORO ALASSANE TALL","KEUR MAMA LAMINE SERERE",75,83,433,457,890
FATICK,FOUNDIOUGNE,TOUBACOUTA,"NIORO ALASSANE TALL","KEUR MAMA LAMINE TOUCOULEUR",57,64,386,363,749
FATICK,FOUNDIOUGNE,TOUBACOUTA,"NIORO ALASSANE TALL","KEUR MAMOUR FALL",28,38,259,243,502
FATICK,FOUNDIOUGNE,TOUBACOUTA,"NIORO ALASSANE TALL","KEUR MAMOUR SECK",39,45,323,286,609
FATICK,FOUNDIOUGNE,TOUBACOUTA,"NIORO ALASSANE TALL","KEUR MBAYE NIANG",4,5,47,43,90
FATICK,FOUNDIOUGNE,TOUBACOUTA,"NIORO ALASSANE TALL","KEUR NAMA",17,19,114,103,217
FATICK,FOUNDIOUGNE,TOUBACOUTA,"NIORO ALASSANE TALL","KEUR NGATANOR",41,49,487,449,936
FATICK,FOUNDIOUGNE,TOUBACOUTA,"NIORO ALASSANE TALL","KEUR OUMAR MBOMBE",23,39,252,285,537
FATICK,FOUNDIOUGNE,TOUBACOUTA,"NIORO ALASSANE TALL","KEUR SABASSY THIAM",56,64,452,429,881
FATICK,FOUNDIOUGNE,TOUBACOUTA,"NIORO ALASSANE TALL","KEUR SADIO NENE",12,28,223,170,393
FATICK,FOUNDIOUGNE,TOUBACOUTA,"NIORO ALASSANE TALL","KEUR SAER GUEYE (KEUR SETTE GUEYE)",62,72,527,615,1142
FATICK,FOUNDIOUGNE,TOUBACOUTA,"NIORO ALASSANE TALL","KEUR SAMBARE",19,25,133,118,251
FATICK,FOUNDIOUGNE,TOUBACOUTA,"NIORO ALASSANE TALL","KEUR SELLE CAMARA",11,18,155,151,306
FATICK,FOUNDIOUGNE,TOUBACOUTA,"NIORO ALASSANE TALL","KEUR SERIGNE KHODIA",103,137,982,1034,2016
FATICK,FOUNDIOUGNE,TOUBACOUTA,"NIORO ALASSANE TALL","H1 KEUR MAMOUR SEGNANE",5,6,59,55,114
FATICK,FOUNDIOUGNE,TOUBACOUTA,"NIORO ALASSANE TALL","KEUR YORO DIOP",16,18,124,139,263
FATICK,FOUNDIOUGNE,TOUBACOUTA,"NIORO ALASSANE TALL","H1 KEUR YORO DIOP WOLOF",9,11,71,78,149
FATICK,FOUNDIOUGNE,TOUBACOUTA,"NIORO ALASSANE TALL",KOUATINE,11,17,123,120,243
FATICK,FOUNDIOUGNE,TOUBACOUTA,"NIORO ALASSANE TALL","MEDINA MAFADY",19,26,233,239,472
FATICK,FOUNDIOUGNE,TOUBACOUTA,"NIORO ALASSANE TALL","NDEMENE NIOMBATO",6,10,62,65,127
FATICK,FOUNDIOUGNE,TOUBACOUTA,"NIORO ALASSANE TALL","NDIAW DIAMAGUENE",20,27,262,242,504
FATICK,FOUNDIOUGNE,TOUBACOUTA,"NIORO ALASSANE TALL","H1 NDIAW DIATTA",8,12,73,63,136
FATICK,FOUNDIOUGNE,TOUBACOUTA,"NIORO ALASSANE TALL","NDIAW MALICK",80,108,894,1018,1912
FATICK,FOUNDIOUGNE,TOUBACOUTA,"NIORO ALASSANE TALL","NDIAYENE KAD",76,82,675,607,1282
FATICK,FOUNDIOUGNE,TOUBACOUTA,"NIORO ALASSANE TALL","H1 KEUR MAKATIM",24,31,289,261,550
FATICK,FOUNDIOUGNE,TOUBACOUTA,"NIORO ALASSANE TALL","NDIAYENE MOUSSA",50,62,435,578,1013
FATICK,FOUNDIOUGNE,TOUBACOUTA,"NIORO ALASSANE TALL","NDIOB KEUR IBRA MBERY",31,44,399,320,719
FATICK,FOUNDIOUGNE,TOUBACOUTA,"NIORO ALASSANE TALL","NDIOB NDIENGHENE",12,17,104,123,227
FATICK,FOUNDIOUGNE,TOUBACOUTA,"NIORO ALASSANE TALL","NDIOB THIARENE",41,53,352,335,687
FATICK,FOUNDIOUGNE,TOUBACOUTA,"NIORO ALASSANE TALL",NDIOBENE,6,6,34,41,75
FATICK,FOUNDIOUGNE,TOUBACOUTA,"NIORO ALASSANE TALL","H1 KEUR SICKY",2,2,11,17,28
FATICK,FOUNDIOUGNE,TOUBACOUTA,"NIORO ALASSANE TALL",NDIOKHOLOKHO,21,32,172,152,324
FATICK,FOUNDIOUGNE,TOUBACOUTA,"NIORO ALASSANE TALL","NDIOUFFENE BAMBARA",11,13,88,79,167
FATICK,FOUNDIOUGNE,TOUBACOUTA,"NIORO ALASSANE TALL",NDOURENE,31,36,313,213,526
FATICK,FOUNDIOUGNE,TOUBACOUTA,"NIORO ALASSANE TALL","NDRAME SADIABOU",47,55,381,367,748
FATICK,FOUNDIOUGNE,TOUBACOUTA,"NIORO ALASSANE TALL","NGAYENE NGOUNDAO",23,31,236,200,436
FATICK,FOUNDIOUGNE,TOUBACOUTA,"NIORO ALASSANE TALL","NGAYENE THIEBO",126,176,1217,1275,2492
FATICK,FOUNDIOUGNE,TOUBACOUTA,"NIORO ALASSANE TALL",NGOUNGOUL,36,46,322,340,662
FATICK,FOUNDIOUGNE,TOUBACOUTA,"NIORO ALASSANE TALL","H1 KEUR KIMINTANG",12,13,66,65,131
FATICK,FOUNDIOUGNE,TOUBACOUTA,"NIORO ALASSANE TALL","NGOUYE MARY",14,21,204,144,348
FATICK,FOUNDIOUGNE,TOUBACOUTA,"NIORO ALASSANE TALL","H1 TOUBA MBOUL",2,4,26,26,52
FATICK,FOUNDIOUGNE,TOUBACOUTA,"NIORO ALASSANE TALL","NIORO ALASSANE TALL",65,90,483,645,1128
FATICK,FOUNDIOUGNE,TOUBACOUTA,"NIORO ALASSANE TALL","PADANENE KEUR MOMAR",6,7,53,40,93
FATICK,FOUNDIOUGNE,TOUBACOUTA,"NIORO ALASSANE TALL",PAKALA,127,151,1068,1066,2134
FATICK,FOUNDIOUGNE,TOUBACOUTA,"NIORO ALASSANE TALL","PAKALA SANTHIE (TOUBA M’BACKE)",27,34,185,170,355
FATICK,FOUNDIOUGNE,TOUBACOUTA,"NIORO ALASSANE TALL","PASSY DIEMOUL",71,79,503,555,1058
FATICK,FOUNDIOUGNE,TOUBACOUTA,"NIORO ALASSANE TALL","H1 DIEMOUL",1,1,11,14,25
FATICK,FOUNDIOUGNE,TOUBACOUTA,"NIORO ALASSANE TALL",PAYOMA,39,47,352,359,711
FATICK,FOUNDIOUGNE,TOUBACOUTA,"NIORO ALASSANE TALL",SENGHOR,32,47,270,268,538
FATICK,FOUNDIOUGNE,TOUBACOUTA,"NIORO ALASSANE TALL","SIMON BAMBARA",34,36,274,235,509
FATICK,FOUNDIOUGNE,TOUBACOUTA,"NIORO ALASSANE TALL","H1 KEUR LAMINE",10,10,98,86,184
FATICK,FOUNDIOUGNE,TOUBACOUTA,"NIORO ALASSANE TALL","SIMON DIENE",39,54,332,323,655
FATICK,FOUNDIOUGNE,TOUBACOUTA,"NIORO ALASSANE TALL","THILLA KEUR MOMAR MBAYANG",17,24,147,139,286
FATICK,FOUNDIOUGNE,TOUBACOUTA,"NIORO ALASSANE TALL","THIOYENE SOKONE",25,28,232,234,466
FATICK,FOUNDIOUGNE,TOUBACOUTA,"NIORO ALASSANE TALL","H1 THIOYENE",20,27,222,198,420
FATICK,FOUNDIOUGNE,TOUBACOUTA,"NIORO ALASSANE TALL","H2 KEUR AMADY PEULH",10,16,141,94,235
FATICK,FOUNDIOUGNE,TOUBACOUTA,"NIORO ALASSANE TALL","TOUBA MOURIDE",152,185,1265,1313,2578
FATICK,FOUNDIOUGNE,TOUBACOUTA,"NIORO ALASSANE TALL","H1 KEUR BONDIAL",14,18,139,132,271
FATICK,FOUNDIOUGNE,TOUBACOUTA,"NIORO ALASSANE TALL","SANTHIE MBAYE SY",18,34,264,224,488
FATICK,FOUNDIOUGNE,TOUBACOUTA,TOUBACOUTA,AIDARA,34,44,274,294,568
FATICK,FOUNDIOUGNE,TOUBACOUTA,TOUBACOUTA,BADOUDOU,55,62,358,300,658
FATICK,FOUNDIOUGNE,TOUBACOUTA,TOUBACOUTA,"H1 NDANGANE",1,1,1,0,1
FATICK,FOUNDIOUGNE,TOUBACOUTA,TOUBACOUTA,"H2 SADIOCOUNDA",12,12,65,37,102
FATICK,FOUNDIOUGNE,TOUBACOUTA,TOUBACOUTA,BAKADADJI,9,15,68,84,152
FATICK,FOUNDIOUGNE,TOUBACOUTA,TOUBACOUTA,BANDIAGARA,2,2,37,31,68
FATICK,FOUNDIOUGNE,TOUBACOUTA,TOUBACOUTA,BANY,40,69,350,303,653
FATICK,FOUNDIOUGNE,TOUBACOUTA,TOUBACOUTA,"H1 BAMAKO",32,33,179,177,356
FATICK,FOUNDIOUGNE,TOUBACOUTA,TOUBACOUTA,"H2 MBISKIT",9,9,58,57,115
FATICK,FOUNDIOUGNE,TOUBACOUTA,TOUBACOUTA,BATAMAR,21,29,263,225,488
FATICK,FOUNDIOUGNE,TOUBACOUTA,TOUBACOUTA,BETTENTY,319,537,3246,3816,7062
FATICK,FOUNDIOUGNE,TOUBACOUTA,TOUBACOUTA,"H1 HAMDALAYE",1,1,2,3,5
FATICK,FOUNDIOUGNE,TOUBACOUTA,TOUBACOUTA,"H2 BANDIOU",1,1,1,0,1
FATICK,FOUNDIOUGNE,TOUBACOUTA,TOUBACOUTA,"H3 KOSSAR",2,2,4,1,5
FATICK,FOUNDIOUGNE,TOUBACOUTA,TOUBACOUTA,"H4 DIOGAYE",1,5,15,8,23
FATICK,FOUNDIOUGNE,TOUBACOUTA,TOUBACOUTA,"H5 WOUDIARING",1,1,5,2,7
FATICK,FOUNDIOUGNE,TOUBACOUTA,TOUBACOUTA,"H6 SANSAN",2,3,5,5,10
FATICK,FOUNDIOUGNE,TOUBACOUTA,TOUBACOUTA,BOSSINKANG,113,204,928,1331,2259
FATICK,FOUNDIOUGNE,TOUBACOUTA,TOUBACOUTA,"H3 BAKOUSS",1,1,6,0,6
FATICK,FOUNDIOUGNE,TOUBACOUTA,TOUBACOUTA,"BOUSSOURAF (MASSARINKO)",42,46,289,297,586
FATICK,FOUNDIOUGNE,TOUBACOUTA,TOUBACOUTA,BOUTOULIMIT,13,17,150,138,288
FATICK,FOUNDIOUGNE,TOUBACOUTA,TOUBACOUTA,"DAGA BABOU",40,48,240,265,505
FATICK,FOUNDIOUGNE,TOUBACOUTA,TOUBACOUTA,"DAGA BERRA",25,28,148,130,278
FATICK,FOUNDIOUGNE,TOUBACOUTA,TOUBACOUTA,"DAGA DIAODINE",21,49,314,263,577
FATICK,FOUNDIOUGNE,TOUBACOUTA,TOUBACOUTA,"DASSILAME SERERE",62,73,278,310,588
FATICK,FOUNDIOUGNE,TOUBACOUTA,TOUBACOUTA,"DASSILAME SOCE",117,125,781,773,1554
FATICK,FOUNDIOUGNE,TOUBACOUTA,TOUBACOUTA,DIAGLE,157,167,1031,777,1808
FATICK,FOUNDIOUGNE,TOUBACOUTA,TOUBACOUTA,DIELMON,28,36,129,119,248
FATICK,FOUNDIOUGNE,TOUBACOUTA,TOUBACOUTA,"H1 SANTHIE MOUSSA",20,20,72,64,136
FATICK,FOUNDIOUGNE,TOUBACOUTA,TOUBACOUTA,"H2 SANTHIE MOURIDE",16,16,66,54,120
FATICK,FOUNDIOUGNE,TOUBACOUTA,TOUBACOUTA,"H2 SANTHIE MOUSSA",5,6,26,19,45
FATICK,FOUNDIOUGNE,TOUBACOUTA,TOUBACOUTA,"DJINACK BARA",19,51,203,244,447
FATICK,FOUNDIOUGNE,TOUBACOUTA,TOUBACOUTA,"DJINACK DIATACKO",10,15,49,57,106
FATICK,FOUNDIOUGNE,TOUBACOUTA,TOUBACOUTA,FIRDAOUSSI,37,39,229,224,453
FATICK,FOUNDIOUGNE,TOUBACOUTA,TOUBACOUTA,KARANTABA,16,16,133,95,228
FATICK,FOUNDIOUGNE,TOUBACOUTA,TOUBACOUTA,"KEUR ALIOU GUEYE",66,83,504,372,876
FATICK,FOUNDIOUGNE,TOUBACOUTA,TOUBACOUTA,"H1 BLOUF",2,2,14,9,23
FATICK,FOUNDIOUGNE,TOUBACOUTA,TOUBACOUTA,"H2 KEUR DIAMBA",12,13,85,68,153
FATICK,FOUNDIOUGNE,TOUBACOUTA,TOUBACOUTA,"KEUR BABOU DIOUF",15,16,128,82,210
FATICK,FOUNDIOUGNE,TOUBACOUTA,TOUBACOUTA,"KEUR LAHINE SOCE",24,26,101,110,211
FATICK,FOUNDIOUGNE,TOUBACOUTA,TOUBACOUTA,"KEUR SAMBEL",20,20,91,93,184
FATICK,FOUNDIOUGNE,TOUBACOUTA,TOUBACOUTA,"MEDINA SANGAKO",153,195,1149,869,2018
FATICK,FOUNDIOUGNE,TOUBACOUTA,TOUBACOUTA,"MEDINA SANTHIE (MEDINA SAMBA MADY)",36,53,217,213,430
FATICK,FOUNDIOUGNE,TOUBACOUTA,TOUBACOUTA,MISSIRAH,183,283,1789,1855,3644
FATICK,FOUNDIOUGNE,TOUBACOUTA,TOUBACOUTA,"MISSIRAH NGADIOR",28,32,216,204,420
FATICK,FOUNDIOUGNE,TOUBACOUTA,TOUBACOUTA,"H1 ILE KATHIOR",2,2,4,10,14
FATICK,FOUNDIOUGNE,TOUBACOUTA,TOUBACOUTA,NDIAMBANG,40,46,246,223,469
FATICK,FOUNDIOUGNE,TOUBACOUTA,TOUBACOUTA,"NDIOUFFENE LIMANE",14,15,69,69,138
FATICK,FOUNDIOUGNE,TOUBACOUTA,TOUBACOUTA,"H1 LIMANE",29,34,141,124,265
FATICK,FOUNDIOUGNE,TOUBACOUTA,TOUBACOUTA,NDOFFANE,19,21,149,133,282
FATICK,FOUNDIOUGNE,TOUBACOUTA,TOUBACOUTA,"H1 CAMPEMENT FADIDI",2,2,1,2,3
FATICK,FOUNDIOUGNE,TOUBACOUTA,TOUBACOUTA,NDOUMBOUDJI,120,121,628,657,1285
FATICK,FOUNDIOUGNE,TOUBACOUTA,TOUBACOUTA,"NEMA BAH",93,136,725,728,1453
FATICK,FOUNDIOUGNE,TOUBACOUTA,TOUBACOUTA,"NEMA NDING",99,132,766,669,1435
FATICK,FOUNDIOUGNE,TOUBACOUTA,TOUBACOUTA,SABOUYA,19,19,67,71,138
FATICK,FOUNDIOUGNE,TOUBACOUTA,TOUBACOUTA,"SADIO SALLA",37,45,259,214,473
FATICK,FOUNDIOUGNE,TOUBACOUTA,TOUBACOUTA,SAME,44,59,604,426,1030
FATICK,FOUNDIOUGNE,TOUBACOUTA,TOUBACOUTA,SANDICOLY,74,84,450,459,909
FATICK,FOUNDIOUGNE,TOUBACOUTA,TOUBACOUTA,"H1 FERME JC COUNDA",1,1,3,1,4
FATICK,FOUNDIOUGNE,TOUBACOUTA,TOUBACOUTA,SANGAKO,36,46,257,234,491
FATICK,FOUNDIOUGNE,TOUBACOUTA,TOUBACOUTA,SANTAMBA,52,62,237,251,488
FATICK,FOUNDIOUGNE,TOUBACOUTA,TOUBACOUTA,"SANTHIE ELIMANE",5,5,32,47,79
FATICK,FOUNDIOUGNE,TOUBACOUTA,TOUBACOUTA,SAROUDIA,27,34,212,230,442
FATICK,FOUNDIOUGNE,TOUBACOUTA,TOUBACOUTA,SIPPO,16,17,53,58,111
FATICK,FOUNDIOUGNE,TOUBACOUTA,TOUBACOUTA,SOUKOUTA,55,65,364,288,652
FATICK,FOUNDIOUGNE,TOUBACOUTA,TOUBACOUTA,SOUROU,28,34,158,169,327
FATICK,FOUNDIOUGNE,TOUBACOUTA,TOUBACOUTA,TABANDING,9,10,46,54,100
FATICK,FOUNDIOUGNE,TOUBACOUTA,TOUBACOUTA,"H1 MEDINA NDORONG",4,4,29,21,50
FATICK,FOUNDIOUGNE,TOUBACOUTA,TOUBACOUTA,TAIBA,51,60,279,283,562
FATICK,FOUNDIOUGNE,TOUBACOUTA,TOUBACOUTA,"TOUBA NDING",29,32,144,101,245
FATICK,FOUNDIOUGNE,TOUBACOUTA,TOUBACOUTA,TOUBACOUTA,366,504,1750,1711,3461
FATICK,FOUNDIOUGNE,TOUBACOUTA,TOUBACOUTA,"SANTHIE EL HADJI",1,1,6,5,11
FATICK,FOUNDIOUGNE,TOUBACOUTA,"KARANG POSTE",DIAMAGUENE,373,456,2167,1950,4117
FATICK,FOUNDIOUGNE,TOUBACOUTA,"KARANG POSTE","ESCALE 1",310,459,1742,1653,3395
FATICK,FOUNDIOUGNE,TOUBACOUTA,"KARANG POSTE","ESCALE 2",205,273,1361,1383,2744
FATICK,FOUNDIOUGNE,TOUBACOUTA,"KARANG POSTE","KARANG SOCE",64,76,442,442,884
FATICK,FOUNDIOUGNE,TOUBACOUTA,"KARANG POSTE",KASSOUMAYE,185,224,900,924,1824
FATICK,FOUNDIOUGNE,TOUBACOUTA,"KARANG POSTE",MEDINE,405,530,2774,2493,5267
FATICK,FOUNDIOUGNE,TOUBACOUTA,"KARANG POSTE","SANTHIE SADY",687,1084,4780,3961,8741
FATICK,GOSSAS,GOSSAS,GOSSAS,"CENT SIX (106)",201,236,1155,1222,2377
FATICK,GOSSAS,GOSSAS,GOSSAS,"DANGOU LEBOU",176,219,871,1022,1893
FATICK,GOSSAS,GOSSAS,GOSSAS,"DANGOU WALO",121,141,623,626,1249
FATICK,GOSSAS,GOSSAS,GOSSAS,DIAKHAO,229,275,1037,1149,2186
FATICK,GOSSAS,GOSSAS,GOSSAS,"KEUR EL HADJI",147,161,777,919,1696
FATICK,GOSSAS,GOSSAS,GOSSAS,NDIAMBOUL,164,189,840,890,1730
FATICK,GOSSAS,GOSSAS,GOSSAS,NDIAYENE,251,308,1303,1302,2605
FATICK,GOSSAS,GOSSAS,GOSSAS,PAKHA,154,176,913,981,1894
FATICK,GOSSAS,COLOBANE,COLOBANE,"ARALDE DIABEL",27,48,260,298,558
FATICK,GOSSAS,COLOBANE,COLOBANE,"H1 KEUR ALDIOUMA NDIAYE",2,2,8,15,23
FATICK,GOSSAS,COLOBANE,COLOBANE,"BALOL ELIMANE",32,31,139,104,243
FATICK,GOSSAS,COLOBANE,COLOBANE,"BALOL NGOR SALL",5,5,22,25,47
FATICK,GOSSAS,COLOBANE,COLOBANE,BANE,6,6,26,46,72
FATICK,GOSSAS,COLOBANE,COLOBANE,"H1 PEULGA",4,4,19,7,26
FATICK,GOSSAS,COLOBANE,COLOBANE,BANGADJI,1,4,32,29,61
FATICK,GOSSAS,COLOBANE,COLOBANE,"BENE KEUR MANDOUMBE",17,19,88,84,172
FATICK,GOSSAS,COLOBANE,COLOBANE,"BENE OUOLOF",10,11,66,45,111
FATICK,GOSSAS,COLOBANE,COLOBANE,"H1 SAMBOSSE",11,16,73,64,137
FATICK,GOSSAS,COLOBANE,COLOBANE,"H3 BOKI LODJI PEULH",12,18,107,95,202
FATICK,GOSSAS,COLOBANE,COLOBANE,"BOKY BARGA",13,28,140,133,273
FATICK,GOSSAS,COLOBANE,COLOBANE,"BOULOGNE NAOUDE",8,9,36,45,81
FATICK,GOSSAS,COLOBANE,COLOBANE,"BOUSTANE DIAW",34,40,307,257,564
FATICK,GOSSAS,COLOBANE,COLOBANE,"H1 NESSAWNA",22,36,211,206,417
FATICK,GOSSAS,COLOBANE,COLOBANE,"H2 DAROU BEUL",17,22,127,110,237
FATICK,GOSSAS,COLOBANE,COLOBANE,"COLOBANE I, II ET III",409,448,2323,2487,4810
FATICK,GOSSAS,COLOBANE,COLOBANE,"DAROU KHOUDOSS",4,4,23,15,38
FATICK,GOSSAS,COLOBANE,COLOBANE,"DAROU NDIAYE",42,47,361,320,681
FATICK,GOSSAS,COLOBANE,COLOBANE,"H1 KEUR SERIGNE MODOU M. DIOP",17,18,123,94,217
FATICK,GOSSAS,COLOBANE,COLOBANE,"DAROU SALAM LEWE",14,21,118,109,227
FATICK,GOSSAS,COLOBANE,COLOBANE,"H1 BELEL DOGUE",9,14,74,56,130
FATICK,GOSSAS,COLOBANE,COLOBANE,DIABEL,36,46,287,281,568
FATICK,GOSSAS,COLOBANE,COLOBANE,"H1 KABENE",7,11,67,49,116
FATICK,GOSSAS,COLOBANE,COLOBANE,"H2 PALENE",6,7,53,27,80
FATICK,GOSSAS,COLOBANE,COLOBANE,"H3 DAROU BEYE",13,14,81,87,168
FATICK,GOSSAS,COLOBANE,COLOBANE,"H4 NGOMENE",5,9,53,34,87
FATICK,GOSSAS,COLOBANE,COLOBANE,DIENGUI,21,25,115,113,228
FATICK,GOSSAS,COLOBANE,COLOBANE,EDE,24,34,157,154,311
FATICK,GOSSAS,COLOBANE,COLOBANE,"H1 BELEL",2,2,6,14,20
FATICK,GOSSAS,COLOBANE,COLOBANE,"H2 NGOUREYE",28,44,219,238,457
FATICK,GOSSAS,COLOBANE,COLOBANE,"H3 NDIOGNICK",14,18,109,87,196
FATICK,GOSSAS,COLOBANE,COLOBANE,"GAINA MBAR",107,122,521,676,1197
FATICK,GOSSAS,COLOBANE,COLOBANE,"H1 DAROU NDIOGNICK",3,4,8,17,25
FATICK,GOSSAS,COLOBANE,COLOBANE,"KAEL MBOBA",27,39,196,169,365
FATICK,GOSSAS,COLOBANE,COLOBANE,"H1 NDIAMBOUL",11,14,77,57,134
FATICK,GOSSAS,COLOBANE,COLOBANE,"H3 BAILADJI",3,3,25,14,39
FATICK,GOSSAS,COLOBANE,COLOBANE,"KHARAGAINTH (TECK PEULH)",29,30,201,194,395
FATICK,GOSSAS,COLOBANE,COLOBANE,KHAYANE,18,20,122,94,216
FATICK,GOSSAS,COLOBANE,COLOBANE,"H1 KEUR GORY KA",5,5,37,18,55
FATICK,GOSSAS,COLOBANE,COLOBANE,"H2 GNINGUENE",2,3,13,18,31
FATICK,GOSSAS,COLOBANE,COLOBANE,"H4 NDIOUFFENE",2,2,20,16,36
FATICK,GOSSAS,COLOBANE,COLOBANE,MBADIANENE,6,6,24,29,53
FATICK,GOSSAS,COLOBANE,COLOBANE,"H1 NDIAGNE",2,5,39,45,84
FATICK,GOSSAS,COLOBANE,COLOBANE,"MBOBA TIDIANE",20,22,94,90,184
FATICK,GOSSAS,COLOBANE,COLOBANE,"MEDINA MBOBA (MEDINA FALLOU)",11,11,47,43,90
FATICK,GOSSAS,COLOBANE,COLOBANE,MOURE,61,70,340,342,682
FATICK,GOSSAS,COLOBANE,COLOBANE,"H1 LOYENE",8,8,74,53,127
FATICK,GOSSAS,COLOBANE,COLOBANE,NAMASS,5,5,18,14,32
FATICK,GOSSAS,COLOBANE,COLOBANE,"H1 THIERERE GA",10,13,94,77,171
FATICK,GOSSAS,COLOBANE,COLOBANE,"NDIAYENE ET KOHE",25,33,162,186,348
FATICK,GOSSAS,COLOBANE,COLOBANE,"H1 KEUR MOR NDIAYE MBODJI",5,7,34,61,95
FATICK,GOSSAS,COLOBANE,COLOBANE,"H2 KEUR MALICK GUEYE",3,3,15,11,26
FATICK,GOSSAS,COLOBANE,COLOBANE,NDOUMA,5,8,33,36,69
FATICK,GOSSAS,COLOBANE,COLOBANE,"H1 SANGHARY PEULH",13,18,84,109,193
FATICK,GOSSAS,COLOBANE,COLOBANE,"NGAYES (NGAYES KEUR S FALLOU)",30,36,255,203,458
FATICK,GOSSAS,COLOBANE,COLOBANE,"H2 BORTY",23,30,149,164,313
FATICK,GOSSAS,COLOBANE,COLOBANE,"NGUER MADENE",6,6,23,28,51
FATICK,GOSSAS,COLOBANE,COLOBANE,"NGUER MADIEYE DIOP",2,4,11,18,29
FATICK,GOSSAS,COLOBANE,COLOBANE,"H1 THIAMBENE",3,3,19,21,40
FATICK,GOSSAS,COLOBANE,COLOBANE,OUROUR,6,12,41,47,88
FATICK,GOSSAS,COLOBANE,COLOBANE,"SALOYE ET BORTY",42,81,578,506,1084
FATICK,GOSSAS,COLOBANE,COLOBANE,"SANGHARY BEYE",5,11,66,40,106
FATICK,GOSSAS,COLOBANE,COLOBANE,"H1 TALLENE",4,17,91,83,174
FATICK,GOSSAS,COLOBANE,COLOBANE,"TECK KEBE",11,11,26,48,74
FATICK,GOSSAS,COLOBANE,COLOBANE,"TECK MAR",23,23,59,99,158
FATICK,GOSSAS,COLOBANE,COLOBANE,"TECK THYLLA",8,10,29,44,73
FATICK,GOSSAS,COLOBANE,COLOBANE,"H1 BANGADJI",7,7,21,30,51
FATICK,GOSSAS,COLOBANE,COLOBANE,"H2 NDIOBENE",9,10,49,50,99
FATICK,GOSSAS,COLOBANE,COLOBANE,THYSSE,13,20,122,107,229
FATICK,GOSSAS,COLOBANE,COLOBANE,"TOUBA DIACKSAO",23,46,302,293,595
FATICK,GOSSAS,COLOBANE,COLOBANE,"H2 DAROU ABDOU FAYE",3,6,27,27,54
FATICK,GOSSAS,COLOBANE,COLOBANE,"H3 TOUBA THYLLA",17,25,90,117,207
FATICK,GOSSAS,COLOBANE,COLOBANE,"H4 DAROU SALAM BAGDAD",3,4,15,9,24
FATICK,GOSSAS,COLOBANE,COLOBANE,"DAROU MOHINE",8,9,52,42,94
FATICK,GOSSAS,COLOBANE,COLOBANE,"DAROU RAHMANE BAILADJI",30,31,157,143,300
FATICK,GOSSAS,COLOBANE,COLOBANE,"DAROU SALAM  BOKY LODJI",8,19,74,63,137
FATICK,GOSSAS,COLOBANE,COLOBANE,KODIOLEL,20,27,188,205,393
FATICK,GOSSAS,COLOBANE,COLOBANE,"NGAYE MAME BALLA",19,20,68,97,165
FATICK,GOSSAS,COLOBANE,COLOBANE,"TOUBA NDARGOUYE",12,15,78,62,140
FATICK,GOSSAS,COLOBANE,MBAR,BAGDAD,23,32,205,195,400
FATICK,GOSSAS,COLOBANE,MBAR,"BENE COUP COUP 1 ET 2",15,15,91,83,174
FATICK,GOSSAS,COLOBANE,MBAR,"H1 BOULOGNE KATHIE",4,5,69,28,97
FATICK,GOSSAS,COLOBANE,MBAR,"BOUNTOU MBAR",10,11,69,49,118
FATICK,GOSSAS,COLOBANE,MBAR,"H1 GARAGE",6,6,39,18,57
FATICK,GOSSAS,COLOBANE,MBAR,"H2 KEUR AMADOU AISSA BA",2,2,15,17,32
FATICK,GOSSAS,COLOBANE,MBAR,"DABY NGAMA",7,8,50,37,87
FATICK,GOSSAS,COLOBANE,MBAR,"H1 DIMBILORO",4,4,24,17,41
FATICK,GOSSAS,COLOBANE,MBAR,"H2 PEULGA de DABY NGAMA",3,3,16,20,36
FATICK,GOSSAS,COLOBANE,MBAR,"H3 NDAME TOURE",8,10,74,55,129
FATICK,GOSSAS,COLOBANE,MBAR,"DAROU MARNANE 1 ET 2",119,141,793,913,1706
FATICK,GOSSAS,COLOBANE,MBAR,"DAROU MINAME",19,24,93,113,206
FATICK,GOSSAS,COLOBANE,MBAR,"DAROU RAHMANE",22,27,241,254,495
FATICK,GOSSAS,COLOBANE,MBAR,"H1 NDONGUENE",6,9,74,56,130
FATICK,GOSSAS,COLOBANE,MBAR,"H2 DAROU NDIAYE",5,8,39,30,69
FATICK,GOSSAS,COLOBANE,MBAR,"DAROU SAKOR",6,7,63,29,92
FATICK,GOSSAS,COLOBANE,MBAR,"H1 KEUR DIOUMA POUYE",30,61,377,378,755
FATICK,GOSSAS,COLOBANE,MBAR,"H2 KEUR LATYR SARR",5,8,42,42,84
FATICK,GOSSAS,COLOBANE,MBAR,"DAROU SALAM",51,58,349,311,660
FATICK,GOSSAS,COLOBANE,MBAR,"H1 DAROU NDIAYE",5,5,69,35,104
FATICK,GOSSAS,COLOBANE,MBAR,"H2 THIOFELE",9,10,75,51,126
FATICK,GOSSAS,COLOBANE,MBAR,"H3 TEOUL BOCKY",6,6,42,45,87
FATICK,GOSSAS,COLOBANE,MBAR,"DAROU SOURANG",16,29,146,153,299
FATICK,GOSSAS,COLOBANE,MBAR,"H1 PEULGA",3,4,14,16,30
FATICK,GOSSAS,COLOBANE,MBAR,"DEGUERE DIAMAGUENE",15,27,170,185,355
FATICK,GOSSAS,COLOBANE,MBAR,"DEGUERE 1 (KEUR IBRA)",47,67,386,360,746
FATICK,GOSSAS,COLOBANE,MBAR,"DEGUERE 2",41,68,449,408,857
FATICK,GOSSAS,COLOBANE,MBAR,"H1 KEUR GORGUI SENE",1,1,3,4,7
FATICK,GOSSAS,COLOBANE,MBAR,"H2 KEUR IBRAHIMA DIONE",2,7,58,48,106
FATICK,GOSSAS,COLOBANE,MBAR,"H3 KEUR SALIOU BOP",4,5,31,27,58
FATICK,GOSSAS,COLOBANE,MBAR,"DEKHAYE (TEOUROU GAOUDI)",80,119,689,597,1286
FATICK,GOSSAS,COLOBANE,MBAR,"GASSEL (DAROU NDIAYE)",27,38,216,182,398
FATICK,GOSSAS,COLOBANE,MBAR,"H1 KANENE",4,4,23,25,48
FATICK,GOSSAS,COLOBANE,MBAR,KADIEL,46,64,357,346,703
FATICK,GOSSAS,COLOBANE,MBAR,"KEUR AMADOU SEYE",7,7,34,35,69
FATICK,GOSSAS,COLOBANE,MBAR,"KEUR NDIAGA MBAYE",14,20,152,159,311
FATICK,GOSSAS,COLOBANE,MBAR,"H1 DAARA SERIGNE FALLOU",1,1,25,0,25
FATICK,GOSSAS,COLOBANE,MBAR,"H2 KEUR ABDOU NGOM",9,16,71,95,166
FATICK,GOSSAS,COLOBANE,MBAR,"H3 THIEGNE",11,21,117,99,216
FATICK,GOSSAS,COLOBANE,MBAR,"H4 KEUR ABLAYE KA",13,25,117,154,271
FATICK,GOSSAS,COLOBANE,MBAR,"KEUR PAPE TINE",11,14,86,88,174
FATICK,GOSSAS,COLOBANE,MBAR,"KEUR SENY",9,21,113,76,189
FATICK,GOSSAS,COLOBANE,MBAR,"KEUR SERIGNE BARA DIENE",17,22,174,116,290
FATICK,GOSSAS,COLOBANE,MBAR,"H1 BOUNTOU MBAR",7,13,82,77,159
FATICK,GOSSAS,COLOBANE,MBAR,"H2 DAARA LAMSAR",1,1,18,0,18
FATICK,GOSSAS,COLOBANE,MBAR,"KEUR SERIGNE DIAW",11,17,99,110,209
FATICK,GOSSAS,COLOBANE,MBAR,"H1 KEUR NIAYES DIOUF",8,11,100,94,194
FATICK,GOSSAS,COLOBANE,MBAR,"H2 NAYKY",4,10,63,69,132
FATICK,GOSSAS,COLOBANE,MBAR,"KHAYE BARKA",37,42,282,263,545
FATICK,GOSSAS,COLOBANE,MBAR,"KHOUROU M’BACKE",20,21,109,90,199
FATICK,GOSSAS,COLOBANE,MBAR,"H1 KEUR DEMBA KA",2,3,7,10,17
FATICK,GOSSAS,COLOBANE,MBAR,"H2 PEULGA de KHOUROU M’BACKE",7,8,40,30,70
FATICK,GOSSAS,COLOBANE,MBAR,"H3 KEUR KHAR ET KEUR SAER ET NGUEYENE",25,33,125,144,269
FATICK,GOSSAS,COLOBANE,MBAR,"H4 MBOUL",6,7,17,25,42
FATICK,GOSSAS,COLOBANE,MBAR,LANDANG,16,19,110,103,213
FATICK,GOSSAS,COLOBANE,MBAR,"LOUMBY DIAOULE",17,32,205,209,414
FATICK,GOSSAS,COLOBANE,MBAR,"H1 KEUR NDOUMEL FAYE",3,5,25,37,62
FATICK,GOSSAS,COLOBANE,MBAR,"H2 KEUR ADIOUMA DANG",3,9,68,65,133
FATICK,GOSSAS,COLOBANE,MBAR,MAYAYE,28,32,191,151,342
FATICK,GOSSAS,COLOBANE,MBAR,"H1 MBELGOGNE",3,7,50,28,78
FATICK,GOSSAS,COLOBANE,MBAR,"H2 KEUR MANGUE",4,6,49,27,76
FATICK,GOSSAS,COLOBANE,MBAR,"MBAME DJIGANE",19,21,84,82,166
FATICK,GOSSAS,COLOBANE,MBAR,"H3 KEUR MASSEYE DIAGNE",2,3,14,10,24
FATICK,GOSSAS,COLOBANE,MBAR,"MBAR BAWANE",20,20,91,104,195
FATICK,GOSSAS,COLOBANE,MBAR,"H1 KEUR MODOU SENE",8,16,91,81,172
FATICK,GOSSAS,COLOBANE,MBAR,"H2 KEUR MBADE NGOM",15,22,116,95,211
FATICK,GOSSAS,COLOBANE,MBAR,"H3 BAWANE SERERE",12,13,92,99,191
FATICK,GOSSAS,COLOBANE,MBAR,"H4 KEUR DIENE DIOUF",3,5,33,19,52
FATICK,GOSSAS,COLOBANE,MBAR,"MBAR BOUSSOBE",27,36,197,161,358
FATICK,GOSSAS,COLOBANE,MBAR,"MBAR FORAGE",52,77,449,504,953
FATICK,GOSSAS,COLOBANE,MBAR,"MBAR KEURY KAO",94,107,518,561,1079
FATICK,GOSSAS,COLOBANE,MBAR,"MBAR M’BACKE",165,179,1023,940,1963
FATICK,GOSSAS,COLOBANE,MBAR,"MBAR MBENGUENE",96,112,611,671,1282
FATICK,GOSSAS,COLOBANE,MBAR,"MBAR MBOUSSOBE",35,38,205,202,407
FATICK,GOSSAS,COLOBANE,MBAR,"MBAR NDIENE",113,133,689,716,1405
FATICK,GOSSAS,COLOBANE,MBAR,"MBAR SERERE",12,16,90,90,180
FATICK,GOSSAS,COLOBANE,MBAR,"MBAR THIOWOGNE I ET II",90,96,609,512,1121
FATICK,GOSSAS,COLOBANE,MBAR,"MBAR TIDIANE",43,52,289,309,598
FATICK,GOSSAS,COLOBANE,MBAR,"MBELKHOKH SERERE",19,34,226,225,451
FATICK,GOSSAS,COLOBANE,MBAR,"NAMARY DIARGA",15,24,168,155,323
FATICK,GOSSAS,COLOBANE,MBAR,"NAMARY SAMBA",15,17,96,81,177
FATICK,GOSSAS,COLOBANE,MBAR,"H1 GORETE",9,10,53,40,93
FATICK,GOSSAS,COLOBANE,MBAR,"H2 KEUR GUELADIO SOW",2,2,17,17,34
FATICK,GOSSAS,COLOBANE,MBAR,NARGA,23,26,149,115,264
FATICK,GOSSAS,COLOBANE,MBAR,"H1 MESSERE",20,21,137,85,222
FATICK,GOSSAS,COLOBANE,MBAR,NDAYANE,25,40,258,243,501
FATICK,GOSSAS,COLOBANE,MBAR,"H1 KEURY KAW ET MBELONGUE",8,13,83,57,140
FATICK,GOSSAS,COLOBANE,MBAR,NICE,23,25,135,105,240
FATICK,GOSSAS,COLOBANE,MBAR,RANWY,9,16,106,72,178
FATICK,GOSSAS,COLOBANE,MBAR,"H1 KEUR EL HADJI BATHIE BA",8,12,43,49,92
FATICK,GOSSAS,COLOBANE,MBAR,"H2 KEUR DIODJI KA",3,9,64,68,132
FATICK,GOSSAS,COLOBANE,MBAR,"H3 KEUR EL HADJI LATYR FAYE",4,7,57,48,105
FATICK,GOSSAS,COLOBANE,MBAR,"TEODOGNE (PEULGA)",10,15,84,88,172
FATICK,GOSSAS,COLOBANE,MBAR,"TEOUROU BOULAL",9,20,157,149,306
FATICK,GOSSAS,COLOBANE,MBAR,"H1 KEUR IBRAHIMA DIAGNE",5,8,67,71,138
FATICK,GOSSAS,COLOBANE,MBAR,"H2 TOUBA DEKHAYE",6,12,111,84,195
FATICK,GOSSAS,COLOBANE,MBAR,"H3 DEKHAYE KEUR GORGUI POUYE",15,16,119,85,204
FATICK,GOSSAS,COLOBANE,MBAR,"H5 YARY GOUYE",12,21,190,190,380
FATICK,GOSSAS,COLOBANE,MBAR,"THIELLE KAYENE",6,12,105,83,188
FATICK,GOSSAS,COLOBANE,MBAR,"THIELLE PATHIEME",12,18,122,110,232
FATICK,GOSSAS,COLOBANE,MBAR,"H1 KEUR YAYA BA",5,6,30,32,62
FATICK,GOSSAS,COLOBANE,MBAR,THINGUE,18,29,135,162,297
FATICK,GOSSAS,COLOBANE,MBAR,"H1 KEUR MALICK NGOM",12,17,108,95,203
FATICK,GOSSAS,COLOBANE,MBAR,"H2 NDIATTA",5,7,54,36,90
FATICK,GOSSAS,COLOBANE,MBAR,"H3 KEUR BABOU DIOUF",7,15,68,68,136
FATICK,GOSSAS,COLOBANE,MBAR,"H4 TOUCAR",11,13,88,71,159
FATICK,GOSSAS,COLOBANE,MBAR,"H6 THINGUE NDAYANE",3,4,29,27,56
FATICK,GOSSAS,COLOBANE,MBAR,"TIVAOUANE FALL",34,38,252,230,482
FATICK,GOSSAS,COLOBANE,MBAR,"TOUBA COUP COUP",17,26,112,76,188
FATICK,GOSSAS,COLOBANE,MBAR,"TOUBA FALL",28,29,185,193,378
FATICK,GOSSAS,COLOBANE,MBAR,"H4 DAARA SERIGNE MOUSTAPHA",1,1,120,0,120
FATICK,GOSSAS,COLOBANE,MBAR,"TOUBA NDIENE",33,35,296,276,572
FATICK,GOSSAS,COLOBANE,MBAR,"WENDOU MAOUDOU",17,30,166,149,315
FATICK,GOSSAS,COLOBANE,MBAR,"H1 KEUR DJIRE NGOM",14,19,94,102,196
FATICK,GOSSAS,COLOBANE,MBAR,"H2 NIANGUENE",5,14,82,98,180
FATICK,GOSSAS,COLOBANE,MBAR,"WOUROU DIOUNDIO",29,46,258,257,515
FATICK,GOSSAS,COLOBANE,MBAR,"H1 KEUR IBOU KA",5,5,23,34,57
FATICK,GOSSAS,COLOBANE,MBAR,YARGOUYE,39,60,416,188,604
FATICK,GOSSAS,COLOBANE,MBAR,"H1 NDIELEW",20,33,182,190,372
FATICK,GOSSAS,COLOBANE,MBAR,"H2 KEUR MARCEL KAMA",5,5,38,28,66
FATICK,GOSSAS,COLOBANE,MBAR,"H3 PEULGA",12,15,99,84,183
FATICK,GOSSAS,COLOBANE,MBAR,"DAROU BAIRE",28,32,223,196,419
FATICK,GOSSAS,COLOBANE,MBAR,"NDIGUEUL FALL",9,12,40,43,83
FATICK,GOSSAS,OUADIOUR,"NDIENE LAGANE","BELLE 1 (KIRANG)",13,21,115,135,250
FATICK,GOSSAS,OUADIOUR,"NDIENE LAGANE","H1 BELLE 2",17,37,236,224,460
FATICK,GOSSAS,OUADIOUR,"NDIENE LAGANE","H2 NDIOBENE",18,34,218,214,432
FATICK,GOSSAS,OUADIOUR,"NDIENE LAGANE","DIOUDY PEULH",2,3,17,21,38
FATICK,GOSSAS,OUADIOUR,"NDIENE LAGANE","H1 KEUR MAMADOU KA (YOKHOC_DIOUDY PEULH)",14,24,128,101,229
FATICK,GOSSAS,OUADIOUR,"NDIENE LAGANE","H2 KEUR IBRAHIMA SOW",4,6,32,41,73
FATICK,GOSSAS,OUADIOUR,"NDIENE LAGANE","H3 OWANDO",14,21,96,106,202
FATICK,GOSSAS,OUADIOUR,"NDIENE LAGANE","H5 KEUR IBRAHIMA SOW",4,5,29,20,49
FATICK,GOSSAS,OUADIOUR,"NDIENE LAGANE","INA (INA 1)",26,37,243,237,480
FATICK,GOSSAS,OUADIOUR,"NDIENE LAGANE","H1 INA 2 (TEOUROU SERERE)",26,55,288,309,597
FATICK,GOSSAS,OUADIOUR,"NDIENE LAGANE","KEUR ALIOU TOURE",10,13,82,66,148
FATICK,GOSSAS,OUADIOUR,"NDIENE LAGANE","H1 KEUR MBAYE NOEL",3,3,10,15,25
FATICK,GOSSAS,OUADIOUR,"NDIENE LAGANE","H2 KEUR IBRAHIMA NGOM",4,9,73,62,135
FATICK,GOSSAS,OUADIOUR,"NDIENE LAGANE","KEUR MASSAMBA BA",37,57,415,373,788
FATICK,GOSSAS,OUADIOUR,"NDIENE LAGANE","H1 KEUR SAMBA NIANKE",5,12,68,95,163
FATICK,GOSSAS,OUADIOUR,"NDIENE LAGANE","KHAYE MBAYAR",66,70,459,366,825
FATICK,GOSSAS,OUADIOUR,"NDIENE LAGANE","H1 KAYE WALY",32,51,387,328,715
FATICK,GOSSAS,OUADIOUR,"NDIENE LAGANE",MALKA,17,17,139,96,235
FATICK,GOSSAS,OUADIOUR,"NDIENE LAGANE","H1 MOURA",13,28,194,187,381
FATICK,GOSSAS,OUADIOUR,"NDIENE LAGANE","H2 KORTHIEL",14,14,87,70,157
FATICK,GOSSAS,OUADIOUR,"NDIENE LAGANE","H3 TOUTLE",6,14,116,113,229
FATICK,GOSSAS,OUADIOUR,"NDIENE LAGANE","NDIENE LAGANE",258,312,1777,1981,3758
FATICK,GOSSAS,OUADIOUR,"NDIENE LAGANE","H3 DAARAY SIDY",28,33,180,196,376
FATICK,GOSSAS,OUADIOUR,"NDIENE LAGANE","NDOULO MALKA",9,14,102,94,196
FATICK,GOSSAS,OUADIOUR,"NDIENE LAGANE","H1 TOUBA GNEBOUNGUEL",21,43,406,384,790
FATICK,GOSSAS,OUADIOUR,"NDIENE LAGANE","TEOUROU KOSSAM 1",12,19,97,91,188
FATICK,GOSSAS,OUADIOUR,"NDIENE LAGANE","H1 THIEYENE",1,1,5,11,16
FATICK,GOSSAS,OUADIOUR,"NDIENE LAGANE","TEOUROU KOSSAM 2",18,21,131,123,254
FATICK,GOSSAS,OUADIOUR,"NDIENE LAGANE","H1 TINENE",3,6,39,35,74
FATICK,GOSSAS,OUADIOUR,"NDIENE LAGANE","H2 KEUR MALICK NDIAYE",3,4,31,27,58
FATICK,GOSSAS,OUADIOUR,"NDIENE LAGANE","H3 NDONGHENE",13,33,255,212,467
FATICK,GOSSAS,OUADIOUR,"NDIENE LAGANE","TEOUROU MBAYE",14,18,56,48,104
FATICK,GOSSAS,OUADIOUR,"NDIENE LAGANE","THIELLE PATHIEME",7,12,95,85,180
FATICK,GOSSAS,OUADIOUR,"NDIENE LAGANE","H1 PATHIEME",27,52,341,308,649
FATICK,GOSSAS,OUADIOUR,"NDIENE LAGANE","H2 KOUTOURFA",13,24,225,226,451
FATICK,GOSSAS,OUADIOUR,"NDIENE LAGANE","H3 DIOUDY SERERE",20,32,254,252,506
FATICK,GOSSAS,OUADIOUR,"NDIENE LAGANE","GOUYE MEO",15,20,136,154,290
FATICK,GOSSAS,OUADIOUR,"NDIENE LAGANE","TEOUROU NGARY",16,29,177,181,358
FATICK,GOSSAS,OUADIOUR,OUADIOUR,BARKAEL,37,80,502,481,983
FATICK,GOSSAS,OUADIOUR,OUADIOUR,"H1 KANDJI",6,8,41,35,76
FATICK,GOSSAS,OUADIOUR,OUADIOUR,"DAROU BIL",41,43,195,164,359
FATICK,GOSSAS,OUADIOUR,OUADIOUR,"H1 DIOUTH GUEUL",1,2,27,19,46
FATICK,GOSSAS,OUADIOUR,OUADIOUR,"DAROU GUEYE",12,16,77,48,125
FATICK,GOSSAS,OUADIOUR,OUADIOUR,"H1 KEUR DIAM (KEUR IBRAHIMA KA)",3,5,27,19,46
FATICK,GOSSAS,OUADIOUR,OUADIOUR,"DAROU M’BACKE (BILE M’BACKE)",61,74,442,381,823
FATICK,GOSSAS,OUADIOUR,OUADIOUR,DOYOLI,11,18,87,102,189
FATICK,GOSSAS,OUADIOUR,OUADIOUR,"H1 THIEREREGA",5,5,33,21,54
FATICK,GOSSAS,OUADIOUR,OUADIOUR,"KEUR ANDALLA",8,10,40,45,85
FATICK,GOSSAS,OUADIOUR,OUADIOUR,"KEUR BALLA NDIAYE",7,10,57,46,103
FATICK,GOSSAS,OUADIOUR,OUADIOUR,"KEUR KHALY MBOUP",8,11,50,66,116
FATICK,GOSSAS,OUADIOUR,OUADIOUR,"H1 NDOMENE",8,10,56,38,94
FATICK,GOSSAS,OUADIOUR,OUADIOUR,"H2 MBAYENE",1,4,29,26,55
FATICK,GOSSAS,OUADIOUR,OUADIOUR,"KEUR KHAR KANE",30,39,168,178,346
FATICK,GOSSAS,OUADIOUR,OUADIOUR,"KEUR MANIANG",27,51,334,348,682
FATICK,GOSSAS,OUADIOUR,OUADIOUR,"KEUR PATHE SY",5,5,32,25,57
FATICK,GOSSAS,OUADIOUR,OUADIOUR,"H1 PEULGA",2,2,25,7,32
FATICK,GOSSAS,OUADIOUR,OUADIOUR,"KEUR SAMBA GUEYE (TEOUROU NGUEYENE)",11,22,94,106,200
FATICK,GOSSAS,OUADIOUR,OUADIOUR,"KHAYANE MBAMBARA",12,14,114,89,203
FATICK,GOSSAS,OUADIOUR,OUADIOUR,"KHAYANE MOURIDE",3,3,15,15,30
FATICK,GOSSAS,OUADIOUR,OUADIOUR,KOTHIAW,19,21,112,145,257
FATICK,GOSSAS,OUADIOUR,OUADIOUR,"H1 KOTHIAW PEULH",17,20,86,94,180
FATICK,GOSSAS,OUADIOUR,OUADIOUR,"LOUMBEL KELLY 1",33,46,238,221,459
FATICK,GOSSAS,OUADIOUR,OUADIOUR,"H1 KEUR ALY KEBE",1,1,3,3,6
FATICK,GOSSAS,OUADIOUR,OUADIOUR,"H2 PEULGA NDJINY",4,4,31,37,68
FATICK,GOSSAS,OUADIOUR,OUADIOUR,"H3 DEWGA",10,17,76,90,166
FATICK,GOSSAS,OUADIOUR,OUADIOUR,"H4 TENE BOUMACK",2,4,22,23,45
FATICK,GOSSAS,OUADIOUR,OUADIOUR,"H5 MBELLOKHE",4,8,48,53,101
FATICK,GOSSAS,OUADIOUR,OUADIOUR,"LOUMBEL MBAYE",16,39,222,234,456
FATICK,GOSSAS,OUADIOUR,OUADIOUR,"MBOSS NDIAMBOUL",2,3,24,18,42
FATICK,GOSSAS,OUADIOUR,OUADIOUR,MBOUDAYE,24,29,158,160,318
FATICK,GOSSAS,OUADIOUR,OUADIOUR,"H1 MBOUDAYE SERERE",9,12,83,90,173
FATICK,GOSSAS,OUADIOUR,OUADIOUR,"NIANGUE (NDIBA)",7,7,48,53,101
FATICK,GOSSAS,OUADIOUR,OUADIOUR,"H1 KEUR NDIAWAR",11,17,71,61,132
FATICK,GOSSAS,OUADIOUR,OUADIOUR,"H2 NIANGUE",22,23,158,133,291
FATICK,GOSSAS,OUADIOUR,OUADIOUR,"H3 WALO",5,6,35,34,69
FATICK,GOSSAS,OUADIOUR,OUADIOUR,NIOMRE,35,68,387,386,773
FATICK,GOSSAS,OUADIOUR,OUADIOUR,"H1 KEUR DALY DIOP",7,15,125,117,242
FATICK,GOSSAS,OUADIOUR,OUADIOUR,"H2 SARREM",22,43,328,288,616
FATICK,GOSSAS,OUADIOUR,OUADIOUR,"H4 NDIOBO",10,15,133,130,263
FATICK,GOSSAS,OUADIOUR,OUADIOUR,OUADIOUR,57,74,294,316,610
FATICK,GOSSAS,OUADIOUR,OUADIOUR,"H1 TEOUROU DOLE",29,46,336,334,670
FATICK,GOSSAS,OUADIOUR,OUADIOUR,SAMBOCK,14,16,69,83,152
FATICK,GOSSAS,OUADIOUR,OUADIOUR,"TAWA GUEYE",15,18,170,122,292
FATICK,GOSSAS,OUADIOUR,OUADIOUR,"TEOUROU MBEYENE",7,8,40,15,55
FATICK,GOSSAS,OUADIOUR,OUADIOUR,"H1 GOUYE MBAMBARA",4,4,31,24,55
FATICK,GOSSAS,OUADIOUR,OUADIOUR,"THIABE DIENE (KEUR DIENE SENE)",35,64,378,328,706
FATICK,GOSSAS,OUADIOUR,OUADIOUR,"H1 KEUR DIOCKEL NDIAYE",2,2,23,25,48
FATICK,GOSSAS,OUADIOUR,OUADIOUR,"THIABE OUOLOF",30,41,292,215,507
FATICK,GOSSAS,OUADIOUR,OUADIOUR,"THIABE SANOU",15,30,130,104,234
FATICK,GOSSAS,OUADIOUR,OUADIOUR,"THIENABA GOSSAS",120,151,893,817,1710
FATICK,GOSSAS,OUADIOUR,OUADIOUR,THISSE,7,7,24,26,50
FATICK,GOSSAS,OUADIOUR,OUADIOUR,"DAROU RAHMANE",30,38,146,135,281
FATICK,GOSSAS,OUADIOUR,OUADIOUR,"LOUMBEL KELLY 2",38,70,381,396,777
FATICK,GOSSAS,OUADIOUR,"PATAR LIA","BOUNE FOSSOW",36,65,333,345,678
FATICK,GOSSAS,OUADIOUR,"PATAR LIA","H1 KEUR COLY NGOM",2,5,25,35,60
FATICK,GOSSAS,OUADIOUR,"PATAR LIA",BOUSTANE,9,12,74,49,123
FATICK,GOSSAS,OUADIOUR,"PATAR LIA","DAROU SINE",12,27,142,112,254
FATICK,GOSSAS,OUADIOUR,"PATAR LIA","H1 SINE",16,19,68,74,142
FATICK,GOSSAS,OUADIOUR,"PATAR LIA","DIABY KOUNDEL",11,16,82,105,187
FATICK,GOSSAS,OUADIOUR,"PATAR LIA",DIAMBEYE,36,57,222,258,480
FATICK,GOSSAS,OUADIOUR,"PATAR LIA","DIENDER 1",6,10,36,38,74
FATICK,GOSSAS,OUADIOUR,"PATAR LIA","DIENDER 2",10,15,95,72,167
FATICK,GOSSAS,OUADIOUR,"PATAR LIA",GAPASSEL,12,14,93,75,168
FATICK,GOSSAS,OUADIOUR,"PATAR LIA","H1 KEUR NDIAGA LOUM",1,5,26,32,58
FATICK,GOSSAS,OUADIOUR,"PATAR LIA","H2 DAROU SALAM LAKRAM",1,1,26,6,32
FATICK,GOSSAS,OUADIOUR,"PATAR LIA","H3 KEUR IFRA SOW",14,15,84,72,156
FATICK,GOSSAS,OUADIOUR,"PATAR LIA","H4 DAROU MBAYE",11,13,86,74,160
FATICK,GOSSAS,OUADIOUR,"PATAR LIA",GAZEL,8,9,45,44,89
FATICK,GOSSAS,OUADIOUR,"PATAR LIA","H1 MBELEL PALEL",6,7,25,28,53
FATICK,GOSSAS,OUADIOUR,"PATAR LIA","H2 KEUR MODY AINY ET BELOWAL",11,15,126,75,201
FATICK,GOSSAS,OUADIOUR,"PATAR LIA","KEUR DEMBA KHOKHE",15,17,101,89,190
FATICK,GOSSAS,OUADIOUR,"PATAR LIA","KEUR  NDIOUGA (KEUR NDIOUGA FALL)",16,33,133,160,293
FATICK,GOSSAS,OUADIOUR,"PATAR LIA","KEUR ALY NDIAYE",13,13,80,80,160
FATICK,GOSSAS,OUADIOUR,"PATAR LIA","KEUR AMADOU DIOP",3,6,48,41,89
FATICK,GOSSAS,OUADIOUR,"PATAR LIA","KEUR GAYE (GOSSAS VILLAGE)",71,91,465,440,905
FATICK,GOSSAS,OUADIOUR,"PATAR LIA","H1 PAFALL",5,6,35,45,80
FATICK,GOSSAS,OUADIOUR,"PATAR LIA","KEUR MACODOU NDIAYE",8,10,59,62,121
FATICK,GOSSAS,OUADIOUR,"PATAR LIA","H1 SANTHIANE",7,7,49,27,76
FATICK,GOSSAS,OUADIOUR,"PATAR LIA","H2 DIALLAWANE",5,6,44,64,108
FATICK,GOSSAS,OUADIOUR,"PATAR LIA","KEUR MEDOUNE",22,38,150,143,293
FATICK,GOSSAS,OUADIOUR,"PATAR LIA","KEUR YABY",7,12,86,62,148
FATICK,GOSSAS,OUADIOUR,"PATAR LIA","H1 MBASSEL 1",4,8,45,47,92
FATICK,GOSSAS,OUADIOUR,"PATAR LIA","H2 MBASSEL 2",4,8,44,40,84
FATICK,GOSSAS,OUADIOUR,"PATAR LIA","KEUR YORO (KEUR YORO WALY ADAM)",13,19,99,82,181
FATICK,GOSSAS,OUADIOUR,"PATAR LIA","H1 KEUR ABDOU DIAGOTE FAYE",7,7,36,43,79
FATICK,GOSSAS,OUADIOUR,"PATAR LIA","KEUR YORO COUMBA",5,6,25,18,43
FATICK,GOSSAS,OUADIOUR,"PATAR LIA",LAYENNE,19,25,125,112,237
FATICK,GOSSAS,OUADIOUR,"PATAR LIA","H1 PEULGA",9,17,60,51,111
FATICK,GOSSAS,OUADIOUR,"PATAR LIA","H2 KEUR SILLY FAYE",10,10,47,42,89
FATICK,GOSSAS,OUADIOUR,"PATAR LIA",LONDIOR,17,21,122,114,236
FATICK,GOSSAS,OUADIOUR,"PATAR LIA",MBELLANDOCK,7,7,28,25,53
FATICK,GOSSAS,OUADIOUR,"PATAR LIA",MBENGANE,41,43,205,192,397
FATICK,GOSSAS,OUADIOUR,"PATAR LIA",METHE,11,30,154,119,273
FATICK,GOSSAS,OUADIOUR,"PATAR LIA",MOUGOUNIANE,20,27,179,155,334
FATICK,GOSSAS,OUADIOUR,"PATAR LIA","H1 KEUR MALICK SECK",3,6,43,54,97
FATICK,GOSSAS,OUADIOUR,"PATAR LIA",NDIEBEL,46,51,358,298,656
FATICK,GOSSAS,OUADIOUR,"PATAR LIA","H1 KHOKHOTE",5,10,63,58,121
FATICK,GOSSAS,OUADIOUR,"PATAR LIA","NDIOURBEL NDEMBARY",14,16,88,81,169
FATICK,GOSSAS,OUADIOUR,"PATAR LIA","NDOCK DIOUMA COUMBA",8,12,65,67,132
FATICK,GOSSAS,OUADIOUR,"PATAR LIA","NDOCK DIOUMA LEOUROU",29,51,272,227,499
FATICK,GOSSAS,OUADIOUR,"PATAR LIA","NDOCK KEUR TAMSIR",14,19,89,81,170
FATICK,GOSSAS,OUADIOUR,"PATAR LIA","NDOCK PEULH",3,3,18,16,34
FATICK,GOSSAS,OUADIOUR,"PATAR LIA","NDOCK SARE",36,64,362,329,691
FATICK,GOSSAS,OUADIOUR,"PATAR LIA","NDOCK SARE (HOCKY)",5,6,36,29,65
FATICK,GOSSAS,OUADIOUR,"PATAR LIA","H1 KABO",6,6,22,20,42
FATICK,GOSSAS,OUADIOUR,"PATAR LIA","PATAR BANANE",60,81,484,477,961
FATICK,GOSSAS,OUADIOUR,"PATAR LIA","PATAR FISSEL 1",18,22,113,115,228
FATICK,GOSSAS,OUADIOUR,"PATAR LIA","PATAR FISSEL 2 (PATAR BILA)",17,24,128,139,267
FATICK,GOSSAS,OUADIOUR,"PATAR LIA","H1 THIEPPE",6,14,69,65,134
FATICK,GOSSAS,OUADIOUR,"PATAR LIA","H2 WALO",1,1,4,4,8
FATICK,GOSSAS,OUADIOUR,"PATAR LIA","H3 KEUR DJIMITE",3,6,44,39,83
FATICK,GOSSAS,OUADIOUR,"PATAR LIA","H4 DIEGANDOUM",7,8,72,70,142
FATICK,GOSSAS,OUADIOUR,"PATAR LIA","H5 SAKOKY",4,13,55,58,113
FATICK,GOSSAS,OUADIOUR,"PATAR LIA","H6 BADIARA",29,40,323,158,481
FATICK,GOSSAS,OUADIOUR,"PATAR LIA","PATAR LIA (PATAR PEULH)",53,65,263,245,508
FATICK,GOSSAS,OUADIOUR,"PATAR LIA","SAKHMACK OUOLOF",6,7,38,27,65
FATICK,GOSSAS,OUADIOUR,"PATAR LIA","H1 KEUR SAMBA SANOU",6,12,57,80,137
FATICK,GOSSAS,OUADIOUR,"PATAR LIA","SAKHMACK SERERE",32,38,253,208,461
FATICK,GOSSAS,OUADIOUR,"PATAR LIA","KEUR SERIGNE DIAKHATE (MBALEME)",13,16,90,85,175
FATICK,GOSSAS,OUADIOUR,"PATAR LIA","H1 KEUR SERIGNE DIAKHATE",10,13,113,84,197
FATICK,GOSSAS,OUADIOUR,"PATAR LIA","H2 KEUR MODOU YACINE",8,10,74,43,117
FATICK,GOSSAS,OUADIOUR,"PATAR LIA","SOB WADIOGOYE",23,37,198,193,391
FATICK,GOSSAS,OUADIOUR,"PATAR LIA",SOMB,144,187,881,838,1719
FATICK,GOSSAS,OUADIOUR,"PATAR LIA","H1 KEUR WALY",15,17,87,79,166
FATICK,GOSSAS,OUADIOUR,"PATAR LIA","H2 HONDIRA",4,6,47,28,75
FATICK,GOSSAS,OUADIOUR,"PATAR LIA","H3 NGANEME",18,36,185,166,351
FATICK,GOSSAS,OUADIOUR,"PATAR LIA",TOUNE,16,28,171,148,319
FATICK,GOSSAS,OUADIOUR,"PATAR LIA","BOUSTANE ARIFINA",2,2,17,17,34
FATICK,GOSSAS,OUADIOUR,"PATAR LIA","BOUSTANE DIAW",5,6,35,26,61
FATICK,GOSSAS,OUADIOUR,"PATAR LIA","BOUSTANE LO",23,26,178,178,356
FATICK,GOSSAS,OUADIOUR,"PATAR LIA",SOUMBEL,32,67,361,404,765
KOLDA,KOLDA,KOLDA,KOLDA,BANTANGUEL,508,726,2827,2849,5676
KOLDA,KOLDA,KOLDA,KOLDA,"BOUNA KANE",548,743,3541,3435,6976
KOLDA,KOLDA,KOLDA,KOLDA,"BEL AIR",400,428,2078,2008,4086
KOLDA,KOLDA,KOLDA,KOLDA,GADAPARA,675,926,3710,3742,7452
KOLDA,KOLDA,KOLDA,KOLDA,"SARE KEMO",945,1073,4193,4171,8364
KOLDA,KOLDA,KOLDA,KOLDA,"SARE MOUSSA",654,843,3806,3867,7673
KOLDA,KOLDA,KOLDA,KOLDA,"ZONE LYCEE",739,869,3264,3097,6361
KOLDA,KOLDA,KOLDA,KOLDA,MEDINA,1124,1244,4876,4808,9684
KOLDA,KOLDA,KOLDA,KOLDA,"SIKILO NORD",578,722,2784,2698,5482
KOLDA,KOLDA,KOLDA,KOLDA,"SIKILO CENTRE OUEST",830,1048,4389,4436,8825
KOLDA,KOLDA,KOLDA,KOLDA,HILELE,939,1171,4839,5007,9846
KOLDA,KOLDA,KOLDA,KOLDA,NDIOBENE,317,447,2027,1681,3708
KOLDA,KOLDA,KOLDA,KOLDA,"SINTHIANG IDRISSA",380,435,1961,2056,4017
KOLDA,KOLDA,KOLDA,KOLDA,"SINTHIANG TOUNTOUROU",311,406,1762,1733,3495
KOLDA,KOLDA,KOLDA,KOLDA,DOUMASSOU,1028,1458,5955,5974,11929
KOLDA,KOLDA,DIOULACOLON,DIOULACOLON,BANTANCOUTOUYEL,46,57,423,383,806
KOLDA,KOLDA,DIOULACOLON,DIOULACOLON,"BODOYEL ABDOUL",20,21,91,103,194
KOLDA,KOLDA,DIOULACOLON,DIOULACOLON,"BODOYEL TALATA",9,9,61,69,130
KOLDA,KOLDA,DIOULACOLON,DIOULACOLON,"DAIBATOU AMADOU KOSSY",6,6,71,62,133
KOLDA,KOLDA,DIOULACOLON,DIOULACOLON,"DAROU SALAM THIERNO",30,42,305,267,572
KOLDA,KOLDA,DIOULACOLON,DIOULACOLON,"DEMBEL WOURY KAMAKO",4,4,26,36,62
KOLDA,KOLDA,DIOULACOLON,DIOULACOLON,DIADOUDICOUNDA,19,50,352,371,723
KOLDA,KOLDA,DIOULACOLON,DIOULACOLON,DIALICOUNDA,19,23,110,117,227
KOLDA,KOLDA,DIOULACOLON,DIOULACOLON,DIANAH,6,6,32,38,70
KOLDA,KOLDA,DIOULACOLON,DIOULACOLON,"DIARABOUGOU (SARE NGOLA)",5,7,31,30,61
KOLDA,KOLDA,DIOULACOLON,DIOULACOLON,"DIASSANE (SARE MAMADOU MAMA)",4,6,35,39,74
KOLDA,KOLDA,DIOULACOLON,DIOULACOLON,DIEBANG,12,20,108,144,252
KOLDA,KOLDA,DIOULACOLON,DIOULACOLON,DIOUFANA,11,13,73,68,141
KOLDA,KOLDA,DIOULACOLON,DIOULACOLON,DIOULACOLON,83,90,490,519,1009
KOLDA,KOLDA,DIOULACOLON,DIOULACOLON,DIOULAYEL,36,47,321,313,634
KOLDA,KOLDA,DIOULACOLON,DIOULACOLON,FARABA,217,228,882,981,1863
KOLDA,KOLDA,DIOULACOLON,DIOULACOLON,"FASS DIAE",295,319,1326,1288,2614
KOLDA,KOLDA,DIOULACOLON,DIOULACOLON,"GUIRO YORO ALPHA",40,52,362,250,612
KOLDA,KOLDA,DIOULACOLON,DIOULACOLON,"GUIRO YORO MANDOU",13,29,164,173,337
KOLDA,KOLDA,DIOULACOLON,DIOULACOLON,"GUIRO YORO SALMANE",12,13,101,86,187
KOLDA,KOLDA,DIOULACOLON,DIOULACOLON,KANKILING,4,6,42,47,89
KOLDA,KOLDA,DIOULACOLON,DIOULACOLON,LINGUETO,23,27,150,171,321
KOLDA,KOLDA,DIOULACOLON,DIOULACOLON,"MEDINA BOULY",14,16,113,115,228
KOLDA,KOLDA,DIOULACOLON,DIOULACOLON,"MANATO SAKOU (SINTHIANG KIMBA)",10,13,63,92,155
KOLDA,KOLDA,DIOULACOLON,DIOULACOLON,"MARVATA DIOKE (BAYA FOULBE)",19,21,107,116,223
KOLDA,KOLDA,DIOULACOLON,DIOULACOLON,"MEDINA NAMO",10,19,108,90,198
KOLDA,KOLDA,DIOULACOLON,DIOULACOLON,"H1 SINTHIANG SOUARE",2,3,19,21,40
KOLDA,KOLDA,DIOULACOLON,DIOULACOLON,"MISSIRAH BACODAYE (SARE DRAME)",20,22,112,116,228
KOLDA,KOLDA,DIOULACOLON,DIOULACOLON,"MISSIRAH SAMBA",25,37,282,269,551
KOLDA,KOLDA,DIOULACOLON,DIOULACOLON,"SAM PATHE",9,14,88,78,166
KOLDA,KOLDA,DIOULACOLON,DIOULACOLON,"SARE ALFOUSSEYNI",15,16,76,68,144
KOLDA,KOLDA,DIOULACOLON,DIOULACOLON,"SARE COLY MBALLO",2,4,24,30,54
KOLDA,KOLDA,DIOULACOLON,DIOULACOLON,"SARE DEMBA SY",10,13,100,82,182
KOLDA,KOLDA,DIOULACOLON,DIOULACOLON,"SARE DIANAMBE KANDE",4,4,17,11,28
KOLDA,KOLDA,DIOULACOLON,DIOULACOLON,"SARE DIOUBA",6,7,54,43,97
KOLDA,KOLDA,DIOULACOLON,DIOULACOLON,"SARE DOMANG",6,9,57,64,121
KOLDA,KOLDA,DIOULACOLON,DIOULACOLON,"SARE HAMADY",5,6,34,31,65
KOLDA,KOLDA,DIOULACOLON,DIOULACOLON,"SARE KEITA EGUE",13,13,135,75,210
KOLDA,KOLDA,DIOULACOLON,DIOULACOLON,"SARE MAMADY",10,13,123,115,238
KOLDA,KOLDA,DIOULACOLON,DIOULACOLON,"SARE NAMOU",6,9,50,61,111
KOLDA,KOLDA,DIOULACOLON,DIOULACOLON,"SARE OUMAR",24,29,199,200,399
KOLDA,KOLDA,DIOULACOLON,DIOULACOLON,"SARE PATHE BAILO",34,39,197,218,415
KOLDA,KOLDA,DIOULACOLON,DIOULACOLON,"SARE PATHE KAMAKO",30,41,234,308,542
KOLDA,KOLDA,DIOULACOLON,DIOULACOLON,"SARE SAMBA SANE",31,32,218,168,386
KOLDA,KOLDA,DIOULACOLON,DIOULACOLON,"SARE SAMBAROU",14,16,79,67,146
KOLDA,KOLDA,DIOULACOLON,DIOULACOLON,"SARE SAMBOUDIANG",21,36,203,207,410
KOLDA,KOLDA,DIOULACOLON,DIOULACOLON,"SARE YORO BANA",15,32,213,176,389
KOLDA,KOLDA,DIOULACOLON,DIOULACOLON,"SIBERE KANDE",13,14,63,40,103
KOLDA,KOLDA,DIOULACOLON,DIOULACOLON,"SIBERE KOYO",35,43,226,215,441
KOLDA,KOLDA,DIOULACOLON,DIOULACOLON,"SINTHIANG SAMBA COULIBALY",1474,1593,6632,6524,13156
KOLDA,KOLDA,DIOULACOLON,DIOULACOLON,"SINTHIANG THIERNO ABDOULAYE ( SINTHIANG FARBA )",97,104,401,381,782
KOLDA,KOLDA,DIOULACOLON,DIOULACOLON,"TAMINGUEL FERE",16,20,114,116,230
KOLDA,KOLDA,DIOULACOLON,DIOULACOLON,"TAMINGUEL SAMBA DIAO",14,17,100,110,210
KOLDA,KOLDA,DIOULACOLON,DIOULACOLON,"TAMINGUEL SOUMA KANDE",8,13,92,86,178
KOLDA,KOLDA,DIOULACOLON,DIOULACOLON,"TEMENTO DOMEL KOSSI",4,5,18,18,36
KOLDA,KOLDA,DIOULACOLON,DIOULACOLON,"VELIA DEMBEL",6,8,44,33,77
KOLDA,KOLDA,DIOULACOLON,DIOULACOLON,"FASS ABDOULAYE",4,5,26,14,40
KOLDA,KOLDA,DIOULACOLON,"MEDINA EL HADJ","AINOUMADY DIEGA",20,31,205,221,426
KOLDA,KOLDA,DIOULACOLON,"MEDINA EL HADJ","BANTANCOUNTOU MAOUNDE",87,109,553,587,1140
KOLDA,KOLDA,DIOULACOLON,"MEDINA EL HADJ",BERECOLON,19,25,223,223,446
KOLDA,KOLDA,DIOULACOLON,"MEDINA EL HADJ","BOGUEL SAMBA",4,6,51,49,100
KOLDA,KOLDA,DIOULACOLON,"MEDINA EL HADJ","DAIBATOU AMADOU BA",3,3,14,25,39
KOLDA,KOLDA,DIOULACOLON,"MEDINA EL HADJ","DAROU SAMBA",3,5,35,19,54
KOLDA,KOLDA,DIOULACOLON,"MEDINA EL HADJ",DEMABO,35,45,284,280,564
KOLDA,KOLDA,DIOULACOLON,"MEDINA EL HADJ","DIYABOUGOU DEMB0",2,4,21,18,39
KOLDA,KOLDA,DIOULACOLON,"MEDINA EL HADJ","FASS LOUMBATO",5,7,48,58,106
KOLDA,KOLDA,DIOULACOLON,"MEDINA EL HADJ","HAMDALLAYE KANFODIANG",14,18,125,123,248
KOLDA,KOLDA,DIOULACOLON,"MEDINA EL HADJ",KANIAKO,9,12,63,92,155
KOLDA,KOLDA,DIOULACOLON,"MEDINA EL HADJ","KANIAMINA FODE (SARE FODE)",4,5,23,28,51
KOLDA,KOLDA,DIOULACOLON,"MEDINA EL HADJ",KANWALY,14,14,119,117,236
KOLDA,KOLDA,DIOULACOLON,"MEDINA EL HADJ",LINKERING,12,23,166,169,335
KOLDA,KOLDA,DIOULACOLON,"MEDINA EL HADJ","H1 SINTHIANG MANSALY",3,4,29,29,58
KOLDA,KOLDA,DIOULACOLON,"MEDINA EL HADJ","MAKA SAMBA",3,5,25,24,49
KOLDA,KOLDA,DIOULACOLON,"MEDINA EL HADJ","MEDINA BOCAR KANFODIANG",5,9,29,28,57
KOLDA,KOLDA,DIOULACOLON,"MEDINA EL HADJ","MEDINA EL HADJI",144,181,1356,1130,2486
KOLDA,KOLDA,DIOULACOLON,"MEDINA EL HADJ","MEDINA MANSON",5,5,34,34,68
KOLDA,KOLDA,DIOULACOLON,"MEDINA EL HADJ","MEDINA SAMBA KANFODIANG (SARA TENING)",5,7,58,42,100
KOLDA,KOLDA,DIOULACOLON,"MEDINA EL HADJ","MISSIRAH ISSA",41,59,402,341,743
KOLDA,KOLDA,DIOULACOLON,"MEDINA EL HADJ",NDANGANE,8,8,35,41,76
KOLDA,KOLDA,DIOULACOLON,"MEDINA EL HADJ",SAM,7,9,55,63,118
KOLDA,KOLDA,DIOULACOLON,"MEDINA EL HADJ",SANKA,19,28,228,224,452
KOLDA,KOLDA,DIOULACOLON,"MEDINA EL HADJ","SANSANCOTO KAMAKO",34,60,637,686,1323
KOLDA,KOLDA,DIOULACOLON,"MEDINA EL HADJ","H1 MEDINA KAMAKO",1,1,10,10,20
KOLDA,KOLDA,DIOULACOLON,"MEDINA EL HADJ","H2 DAROU KHOUDOSS ( MORY COUNDA )",1,1,46,4,50
KOLDA,KOLDA,DIOULACOLON,"MEDINA EL HADJ","SARE COLY MANDINGUE",3,5,31,35,66
KOLDA,KOLDA,DIOULACOLON,"MEDINA EL HADJ","SARE COLY PEULH",13,18,128,137,265
KOLDA,KOLDA,DIOULACOLON,"MEDINA EL HADJ","SARE DEMBARA",18,22,142,174,316
KOLDA,KOLDA,DIOULACOLON,"MEDINA EL HADJ","SARE GARDY",17,23,91,117,208
KOLDA,KOLDA,DIOULACOLON,"MEDINA EL HADJ","SARE KEDIANG BAKARY",27,37,247,222,469
KOLDA,KOLDA,DIOULACOLON,"MEDINA EL HADJ","SARE KONKO",18,24,188,153,341
KOLDA,KOLDA,DIOULACOLON,"MEDINA EL HADJ","H1 TOUBA FAYDOU",4,6,70,16,86
KOLDA,KOLDA,DIOULACOLON,"MEDINA EL HADJ","SARE KOUBE",62,75,527,494,1021
KOLDA,KOLDA,DIOULACOLON,"MEDINA EL HADJ","SARE KOUMBEL (SARE YORO KOUMBEL)",10,17,119,108,227
KOLDA,KOLDA,DIOULACOLON,"MEDINA EL HADJ","SARE MANSON",22,35,229,179,408
KOLDA,KOLDA,DIOULACOLON,"MEDINA EL HADJ","SARE NDIAYE MAOUNDE",11,18,152,122,274
KOLDA,KOLDA,DIOULACOLON,"MEDINA EL HADJ","H1 SARE NDIAYE POSTE",3,4,38,47,85
KOLDA,KOLDA,DIOULACOLON,"MEDINA EL HADJ","SARE NGOLO",8,10,62,75,137
KOLDA,KOLDA,DIOULACOLON,"MEDINA EL HADJ","SARE SAMBALE",16,16,127,123,250
KOLDA,KOLDA,DIOULACOLON,"MEDINA EL HADJ","H1 TOUBA SADOU DIAMANKA",7,7,46,62,108
KOLDA,KOLDA,DIOULACOLON,"MEDINA EL HADJ","SARE YORO SABALY",4,6,26,33,59
KOLDA,KOLDA,DIOULACOLON,"MEDINA EL HADJ",SENDEBOU,7,10,50,51,101
KOLDA,KOLDA,DIOULACOLON,"MEDINA EL HADJ",SIBIDIANG,4,9,101,90,191
KOLDA,KOLDA,DIOULACOLON,"MEDINA EL HADJ","TEMENTO DEMBA",11,14,93,81,174
KOLDA,KOLDA,DIOULACOLON,"MEDINA EL HADJ","TOUBA LIMA",12,14,84,88,172
KOLDA,KOLDA,DIOULACOLON,"MEDINA EL HADJ","SARE WALY DIAO",10,11,98,103,201
KOLDA,KOLDA,DIOULACOLON,"MEDINA EL HADJ","SINTHIANG TOBO",4,5,19,18,37
KOLDA,KOLDA,DIOULACOLON,"MEDINA EL HADJ","MBALLO COUNDA",2,2,22,14,36
KOLDA,KOLDA,DIOULACOLON,"MEDINA EL HADJ","MEDINA ALPHA SADOU",23,36,210,188,398
KOLDA,KOLDA,DIOULACOLON,"MEDINA EL HADJ","SINTHIANG COLY",3,3,21,14,35
KOLDA,KOLDA,DIOULACOLON,"TANKANTO ESCALE",BAGADADJI,22,27,163,184,347
KOLDA,KOLDA,DIOULACOLON,"TANKANTO ESCALE","BANNI DIEGA",19,40,273,248,521
KOLDA,KOLDA,DIOULACOLON,"TANKANTO ESCALE","BANTANDIANG MORY",4,7,39,34,73
KOLDA,KOLDA,DIOULACOLON,"TANKANTO ESCALE","BANTANKO (SARE BACARY)",15,17,109,102,211
KOLDA,KOLDA,DIOULACOLON,"TANKANTO ESCALE","BOKI SINTHIANG",15,21,118,146,264
KOLDA,KOLDA,DIOULACOLON,"TANKANTO ESCALE","BOUSSOURA MAKA",35,38,179,191,370
KOLDA,KOLDA,DIOULACOLON,"TANKANTO ESCALE","DANDOU DIEGA",7,7,107,58,165
KOLDA,KOLDA,DIOULACOLON,"TANKANTO ESCALE","DANDOU SARA",4,6,47,58,105
KOLDA,KOLDA,DIOULACOLON,"TANKANTO ESCALE","SARE KOUTHIA ( DIARY DIOFA TENING )",4,5,34,37,71
KOLDA,KOLDA,DIOULACOLON,"TANKANTO ESCALE","DIOURA SINTHIANG",9,11,96,107,203
KOLDA,KOLDA,DIOULACOLON,"TANKANTO ESCALE","DJIDA BOUBACAR",3,3,20,17,37
KOLDA,KOLDA,DIOULACOLON,"TANKANTO ESCALE","FANKA BANTANG",12,17,161,141,302
KOLDA,KOLDA,DIOULACOLON,"TANKANTO ESCALE","HAMDALLAYE DIEGA",21,31,241,233,474
KOLDA,KOLDA,DIOULACOLON,"TANKANTO ESCALE",KANKONDRON,7,9,45,44,89
KOLDA,KOLDA,DIOULACOLON,"TANKANTO ESCALE",KONTECOUNDA,9,14,101,81,182
KOLDA,KOLDA,DIOULACOLON,"TANKANTO ESCALE","SARE SEYNI",8,16,95,110,205
KOLDA,KOLDA,DIOULACOLON,"TANKANTO ESCALE","MANA SAMBA DIAMANKA",8,9,69,63,132
KOLDA,KOLDA,DIOULACOLON,"TANKANTO ESCALE","MARAKISSA DIEGA",10,17,117,134,251
KOLDA,KOLDA,DIOULACOLON,"TANKANTO ESCALE","MEDINA BOCAR DIEGA (SARE BOCAR DIEGA)",10,16,139,139,278
KOLDA,KOLDA,DIOULACOLON,"TANKANTO ESCALE","KHALIFATOU MEDINA",2,3,17,21,38
KOLDA,KOLDA,DIOULACOLON,"TANKANTO ESCALE","MEDINA SAMBA DIAMANKA",12,13,145,157,302
KOLDA,KOLDA,DIOULACOLON,"TANKANTO ESCALE","MISSIRAH DEMBA",7,11,54,59,113
KOLDA,KOLDA,DIOULACOLON,"TANKANTO ESCALE","MISSIRAH MAMADOU BASSY",1,2,10,13,23
KOLDA,KOLDA,DIOULACOLON,"TANKANTO ESCALE","NEMA DJIDE",5,6,39,44,83
KOLDA,KOLDA,DIOULACOLON,"TANKANTO ESCALE","NEMA MAMADOU BALDE",6,8,66,65,131
KOLDA,KOLDA,DIOULACOLON,"TANKANTO ESCALE","NEMA MANSA DIAO",5,6,34,27,61
KOLDA,KOLDA,DIOULACOLON,"TANKANTO ESCALE","NEMATABA GABOU",6,9,58,42,100
KOLDA,KOLDA,DIOULACOLON,"TANKANTO ESCALE","NEMATABA IBRAHIMA FATY",1,2,14,14,28
KOLDA,KOLDA,DIOULACOLON,"TANKANTO ESCALE","NEMATABA MANDINGUE",35,74,388,453,841
KOLDA,KOLDA,DIOULACOLON,"TANKANTO ESCALE","NEMATABA MOUNKO",13,16,85,93,178
KOLDA,KOLDA,DIOULACOLON,"TANKANTO ESCALE","OUMOUL KHOURE",61,78,404,402,806
KOLDA,KOLDA,DIOULACOLON,"TANKANTO ESCALE","SARE BACOUM",10,15,74,79,153
KOLDA,KOLDA,DIOULACOLON,"TANKANTO ESCALE","SARE BARA",9,19,204,156,360
KOLDA,KOLDA,DIOULACOLON,"TANKANTO ESCALE","SARE BOCAR SALL (SINTHIANG BOUBACAR SALL)",1,4,11,11,22
KOLDA,KOLDA,DIOULACOLON,"TANKANTO ESCALE","SARE DEMBA SOUNKAROU",30,37,189,188,377
KOLDA,KOLDA,DIOULACOLON,"TANKANTO ESCALE","SARE DEMBOULOU",5,11,87,96,183
KOLDA,KOLDA,DIOULACOLON,"TANKANTO ESCALE","SARE DIALLO",7,13,78,55,133
KOLDA,KOLDA,DIOULACOLON,"TANKANTO ESCALE","SARE DICORY KAMANG",2,3,13,19,32
KOLDA,KOLDA,DIOULACOLON,"TANKANTO ESCALE","SARE DICORY MOUSTAPHA",40,41,207,192,399
KOLDA,KOLDA,DIOULACOLON,"TANKANTO ESCALE","SARE HINA",7,11,71,90,161
KOLDA,KOLDA,DIOULACOLON,"TANKANTO ESCALE","SARE KEITA FODE",16,16,90,99,189
KOLDA,KOLDA,DIOULACOLON,"TANKANTO ESCALE","SARE OUSMANE BALDE",16,19,107,108,215
KOLDA,KOLDA,DIOULACOLON,"TANKANTO ESCALE","SARE SABARY",4,9,66,78,144
KOLDA,KOLDA,DIOULACOLON,"TANKANTO ESCALE","SARE SAMBA DIAMANKA (SINTHIOU SAMBA DIAMANKA)",9,13,86,96,182
KOLDA,KOLDA,DIOULACOLON,"TANKANTO ESCALE","SARE SITAPHA",10,13,99,105,204
KOLDA,KOLDA,DIOULACOLON,"TANKANTO ESCALE","SARE SOUBANG",18,25,147,150,297
KOLDA,KOLDA,DIOULACOLON,"TANKANTO ESCALE","SARE WALOME",50,59,370,413,783
KOLDA,KOLDA,DIOULACOLON,"TANKANTO ESCALE","SARE WALY KAMBADIO (SARE WALY BOKE)",9,15,95,92,187
KOLDA,KOLDA,DIOULACOLON,"TANKANTO ESCALE","SARE YERO BALDE",6,11,78,84,162
KOLDA,KOLDA,DIOULACOLON,"TANKANTO ESCALE","SARE YERO DIAO SOUTOU",39,47,369,347,716
KOLDA,KOLDA,DIOULACOLON,"TANKANTO ESCALE","SARE YORO DIAO DOUBEL",13,16,86,78,164
KOLDA,KOLDA,DIOULACOLON,"TANKANTO ESCALE","SEYKOUR SEMBE",9,12,65,95,160
KOLDA,KOLDA,DIOULACOLON,"TANKANTO ESCALE","SIBIKARANTO SAMBA KANDE",18,32,234,210,444
KOLDA,KOLDA,DIOULACOLON,"TANKANTO ESCALE","SINTHIANG DEMBA KANDE",5,9,56,67,123
KOLDA,KOLDA,DIOULACOLON,"TANKANTO ESCALE","SINTHIANG DIOUMBEMBE",13,15,125,115,240
KOLDA,KOLDA,DIOULACOLON,"TANKANTO ESCALE","SINTHIANG MALICK",7,12,104,76,180
KOLDA,KOLDA,DIOULACOLON,"TANKANTO ESCALE","SINTHIANG MAMADOU SOW",9,17,109,104,213
KOLDA,KOLDA,DIOULACOLON,"TANKANTO ESCALE","SINTHIANG MOUTAROU",2,4,27,25,52
KOLDA,KOLDA,DIOULACOLON,"TANKANTO ESCALE","SINTHIANG NGANSOU",3,6,35,42,77
KOLDA,KOLDA,DIOULACOLON,"TANKANTO ESCALE","SINTHIANG THIERNO DEMBA (SARE ASSANE)",24,39,196,205,401
KOLDA,KOLDA,DIOULACOLON,"TANKANTO ESCALE","H1 SINTHIANG THIERNO DEMBA",4,5,19,20,39
KOLDA,KOLDA,DIOULACOLON,"TANKANTO ESCALE","SINTHIANG YOBA KANDE",3,5,38,36,74
KOLDA,KOLDA,DIOULACOLON,"TANKANTO ESCALE","SINTHIANG YOUSSOUF",17,31,155,162,317
KOLDA,KOLDA,DIOULACOLON,"TANKANTO ESCALE",SOUTOUYEL,12,16,112,78,190
KOLDA,KOLDA,DIOULACOLON,"TANKANTO ESCALE","TABASSAYE THIAPA (SARE WAL THIAPA)",8,8,46,49,95
KOLDA,KOLDA,DIOULACOLON,"TANKANTO ESCALE","H1 SINTHIANG ABDOULAYE",1,2,12,16,28
KOLDA,KOLDA,DIOULACOLON,"TANKANTO ESCALE",TALTO,45,67,392,364,756
KOLDA,KOLDA,DIOULACOLON,"TANKANTO ESCALE","TANKANTO ESCALE",64,71,368,362,730
KOLDA,KOLDA,DIOULACOLON,"TANKANTO ESCALE","TANKANTO PEULH",30,41,301,237,538
KOLDA,KOLDA,DIOULACOLON,"TANKANTO ESCALE","TEMENTO DANSA",5,5,49,51,100
KOLDA,KOLDA,DIOULACOLON,"TANKANTO ESCALE","TEMENTO SOUKEL (SINTHIANG SOUKEL)",17,27,130,141,271
KOLDA,KOLDA,DIOULACOLON,"TANKANTO ESCALE","WAKILARE DEMBA",3,11,88,85,173
KOLDA,KOLDA,DIOULACOLON,"TANKANTO ESCALE","WAKILARE HINA",3,3,21,20,41
KOLDA,KOLDA,DIOULACOLON,"TANKANTO ESCALE","SINTHIOU BACOUM",21,26,197,214,411
KOLDA,KOLDA,DIOULACOLON,"TANKANTO ESCALE","SARE DIAMBOULOU",12,16,85,100,185
KOLDA,KOLDA,DIOULACOLON,"TANKANTO ESCALE","MEDINA SAMBEL",13,36,172,191,363
KOLDA,KOLDA,DIOULACOLON,"TANKANTO ESCALE","KOUMBIDIA SARE SEYNI",1,5,21,25,46
KOLDA,KOLDA,DIOULACOLON,"TANKANTO ESCALE",TALLELE,4,6,33,21,54
KOLDA,KOLDA,DIOULACOLON,"GUIRO YERO BOCAR","BANDIAGARA SANA",7,8,39,27,66
KOLDA,KOLDA,DIOULACOLON,"GUIRO YERO BOCAR","BANTANTO SAMBA",4,5,40,32,72
KOLDA,KOLDA,DIOULACOLON,"GUIRO YERO BOCAR","BERECOLON DEMBA",7,7,41,37,78
KOLDA,KOLDA,DIOULACOLON,"GUIRO YERO BOCAR","BERTHO KOUFFA",18,20,187,170,357
KOLDA,KOLDA,DIOULACOLON,"GUIRO YERO BOCAR",BOUNCOUNTO,3,3,16,11,27
KOLDA,KOLDA,DIOULACOLON,"GUIRO YERO BOCAR","BOUSSOURA BACARY",6,16,112,96,208
KOLDA,KOLDA,DIOULACOLON,"GUIRO YERO BOCAR",DAIFA,22,30,241,242,483
KOLDA,KOLDA,DIOULACOLON,"GUIRO YERO BOCAR","DANDOU SADIO",11,12,58,62,120
KOLDA,KOLDA,DIOULACOLON,"GUIRO YERO BOCAR","DAROU IDJIRATOU",16,18,133,89,222
KOLDA,KOLDA,DIOULACOLON,"GUIRO YERO BOCAR","DAROU ISSA (SARE ISSA)",7,9,34,21,55
KOLDA,KOLDA,DIOULACOLON,"GUIRO YERO BOCAR","DAROU SALAM SECKOU CISSE",7,11,82,85,167
KOLDA,KOLDA,DIOULACOLON,"GUIRO YERO BOCAR",DIAOCOUNDA,11,15,94,77,171
KOLDA,KOLDA,DIOULACOLON,"GUIRO YERO BOCAR","DIYABOUGOU SAMBAYEL",8,8,70,47,117
KOLDA,KOLDA,DIOULACOLON,"GUIRO YERO BOCAR","DIYABOUGOU THIERNO",10,13,88,78,166
KOLDA,KOLDA,DIOULACOLON,"GUIRO YERO BOCAR","H1 MISSIRA MALICK",2,5,41,40,81
KOLDA,KOLDA,DIOULACOLON,"GUIRO YERO BOCAR","DJIDA ABDOULAYE",10,12,69,84,153
KOLDA,KOLDA,DIOULACOLON,"GUIRO YERO BOCAR","FADAGHA MANGUEL",2,4,21,21,42
KOLDA,KOLDA,DIOULACOLON,"GUIRO YERO BOCAR","FARY MBALY",6,6,40,35,75
KOLDA,KOLDA,DIOULACOLON,"GUIRO YERO BOCAR","FASS FADAGHA",9,13,80,78,158
KOLDA,KOLDA,DIOULACOLON,"GUIRO YERO BOCAR",FOULAMORY,23,26,159,166,325
KOLDA,KOLDA,DIOULACOLON,"GUIRO YERO BOCAR","GOUNDAGA GAGNA BOIRO",6,6,30,29,59
KOLDA,KOLDA,DIOULACOLON,"GUIRO YERO BOCAR","GOUNDAGA PATHE",6,9,25,36,61
KOLDA,KOLDA,DIOULACOLON,"GUIRO YERO BOCAR","GUIRO YERO BOCAR",267,370,2758,2773,5531
KOLDA,KOLDA,DIOULACOLON,"GUIRO YERO BOCAR","GUIRO YORO ABDOULAYE",6,6,48,51,99
KOLDA,KOLDA,DIOULACOLON,"GUIRO YERO BOCAR",ILIAO,68,87,395,435,830
KOLDA,KOLDA,DIOULACOLON,"GUIRO YERO BOCAR","KAEL BESSEL",4,7,83,48,131
KOLDA,KOLDA,DIOULACOLON,"GUIRO YERO BOCAR","KAMBEY DARY",9,14,77,80,157
KOLDA,KOLDA,DIOULACOLON,"GUIRO YERO BOCAR",KAMBOUA,45,56,369,404,773
KOLDA,KOLDA,DIOULACOLON,"GUIRO YERO BOCAR","KANDIA SOULEYMANE GANO",7,8,60,58,118
KOLDA,KOLDA,DIOULACOLON,"GUIRO YERO BOCAR","KANDJIA YORO",13,15,98,73,171
KOLDA,KOLDA,DIOULACOLON,"GUIRO YERO BOCAR","KARANTABA ANSOU NDIAYE",9,10,119,100,219
KOLDA,KOLDA,DIOULACOLON,"GUIRO YERO BOCAR",KOYADA,4,9,64,61,125
KOLDA,KOLDA,DIOULACOLON,"GUIRO YERO BOCAR",LINGUETTO,30,33,184,168,352
KOLDA,KOLDA,DIOULACOLON,"GUIRO YERO BOCAR","LINGUEYE ALSEYNI",10,10,47,56,103
KOLDA,KOLDA,DIOULACOLON,"GUIRO YERO BOCAR","MADIYANA OUSMANE",7,8,49,40,89
KOLDA,KOLDA,DIOULACOLON,"GUIRO YERO BOCAR","MEDINA EL HADJI MAMADOU SEYDI",16,19,87,91,178
KOLDA,KOLDA,DIOULACOLON,"GUIRO YERO BOCAR","MADINA NGOURDIA",10,11,112,64,176
KOLDA,KOLDA,DIOULACOLON,"GUIRO YERO BOCAR","MASSA DIEMAROU",7,8,76,54,130
KOLDA,KOLDA,DIOULACOLON,"GUIRO YERO BOCAR",MBALLOCOUNDA,22,39,229,217,446
KOLDA,KOLDA,DIOULACOLON,"GUIRO YERO BOCAR","MEDINA ABDOURAHMANE",3,3,23,29,52
KOLDA,KOLDA,DIOULACOLON,"GUIRO YERO BOCAR","MEDINA KEDDA",5,5,26,23,49
KOLDA,KOLDA,DIOULACOLON,"GUIRO YERO BOCAR","MEDINA SAMBA GNALELE",2,2,11,10,21
KOLDA,KOLDA,DIOULACOLON,"GUIRO YERO BOCAR","MEDINA SORY",3,3,23,15,38
KOLDA,KOLDA,DIOULACOLON,"GUIRO YERO BOCAR","MEDINA TENING",9,11,120,118,238
KOLDA,KOLDA,DIOULACOLON,"GUIRO YERO BOCAR","MISSIRAH IBRAHIMA",6,9,48,56,104
KOLDA,KOLDA,DIOULACOLON,"GUIRO YERO BOCAR","MISSIRAH SAMBA MAMBOUA",3,7,40,40,80
KOLDA,KOLDA,DIOULACOLON,"GUIRO YERO BOCAR",MOLTABA,15,17,113,88,201
KOLDA,KOLDA,DIOULACOLON,"GUIRO YERO BOCAR","NANEKO NDAN",2,4,48,45,93
KOLDA,KOLDA,DIOULACOLON,"GUIRO YERO BOCAR","NEMATABA MAWDY MANSALY",8,10,58,65,123
KOLDA,KOLDA,DIOULACOLON,"GUIRO YERO BOCAR","NEMATABA YERO (SINTHIANG BAMBE)",12,15,122,97,219
KOLDA,KOLDA,DIOULACOLON,"GUIRO YERO BOCAR","NGALIYEL TODIAW",2,2,5,2,7
KOLDA,KOLDA,DIOULACOLON,"GUIRO YERO BOCAR",SAME,13,15,131,113,244
KOLDA,KOLDA,DIOULACOLON,"GUIRO YERO BOCAR","SARE BOCAR",16,17,113,107,220
KOLDA,KOLDA,DIOULACOLON,"GUIRO YERO BOCAR","SARE BOUBA",5,5,32,45,77
KOLDA,KOLDA,DIOULACOLON,"GUIRO YERO BOCAR","SARE DIAOBE (SARE DJINKA)",7,7,45,35,80
KOLDA,KOLDA,DIOULACOLON,"GUIRO YERO BOCAR","SARE FALLY",6,6,45,54,99
KOLDA,KOLDA,DIOULACOLON,"GUIRO YERO BOCAR","SARE FARAH",7,9,44,48,92
KOLDA,KOLDA,DIOULACOLON,"GUIRO YERO BOCAR","SARE GAGNA",31,37,170,192,362
KOLDA,KOLDA,DIOULACOLON,"GUIRO YERO BOCAR","SARE GUIRO",12,13,92,83,175
KOLDA,KOLDA,DIOULACOLON,"GUIRO YERO BOCAR","SARE KEITA",13,14,92,92,184
KOLDA,KOLDA,DIOULACOLON,"GUIRO YERO BOCAR","SARE KONTAYE I",14,15,103,100,203
KOLDA,KOLDA,DIOULACOLON,"GUIRO YERO BOCAR","H1 SARE CONTAYE II",1,1,7,6,13
KOLDA,KOLDA,DIOULACOLON,"GUIRO YERO BOCAR",MASSARA,19,20,127,105,232
KOLDA,KOLDA,DIOULACOLON,"GUIRO YERO BOCAR","SARE SAMBA DJIBEL",28,31,190,176,366
KOLDA,KOLDA,DIOULACOLON,"GUIRO YERO BOCAR","SARE SAMBA NIAMA",15,22,152,146,298
KOLDA,KOLDA,DIOULACOLON,"GUIRO YERO BOCAR","SARE SANDJI",4,6,42,30,72
KOLDA,KOLDA,DIOULACOLON,"GUIRO YERO BOCAR","SARE SANDY",5,7,57,42,99
KOLDA,KOLDA,DIOULACOLON,"GUIRO YERO BOCAR","SARE SOUMA",4,4,31,28,59
KOLDA,KOLDA,DIOULACOLON,"GUIRO YERO BOCAR","SARE YOBA KANY",6,7,55,34,89
KOLDA,KOLDA,DIOULACOLON,"GUIRO YERO BOCAR","SINTHIANG DIOUMA",19,23,152,124,276
KOLDA,KOLDA,DIOULACOLON,"GUIRO YERO BOCAR","SINTHIANG DJIDERE",2,7,42,43,85
KOLDA,KOLDA,DIOULACOLON,"GUIRO YERO BOCAR","SINTHIANG SAMBOU",1,2,29,25,54
KOLDA,KOLDA,DIOULACOLON,"GUIRO YERO BOCAR","SINTHIANG SEYNI",32,35,278,245,523
KOLDA,KOLDA,DIOULACOLON,"GUIRO YERO BOCAR","H1 MEDINA SAMBA BALDE (NANE COYOBA SAMBA)",5,9,58,45,103
KOLDA,KOLDA,DIOULACOLON,"GUIRO YERO BOCAR","TEMENTO SAMBA",36,47,172,164,336
KOLDA,KOLDA,DIOULACOLON,"GUIRO YERO BOCAR","VELINGARA OMAR",8,12,49,53,102
KOLDA,KOLDA,DIOULACOLON,"GUIRO YERO BOCAR","VELINGARA WOULOU",6,7,41,39,80
KOLDA,KOLDA,DIOULACOLON,"GUIRO YERO BOCAR","WAKILARE SORY",9,12,67,77,144
KOLDA,KOLDA,DIOULACOLON,"GUIRO YERO BOCAR","MEDINA AMADOU TIDIANE",3,4,32,22,54
KOLDA,KOLDA,DIOULACOLON,"GUIRO YERO BOCAR","MEDINA ALIOU GAOULO",1,1,6,8,14
KOLDA,KOLDA,DIOULACOLON,"GUIRO YERO BOCAR",KAGNAKO,4,4,24,25,49
KOLDA,KOLDA,DIOULACOLON,SALIKEGNE,"CHATEAU D'EAU",91,107,487,478,965
KOLDA,KOLDA,DIOULACOLON,SALIKEGNE,"DAROU KHAIRY",68,74,408,484,892
KOLDA,KOLDA,DIOULACOLON,SALIKEGNE,KANAMORY,40,50,338,273,611
KOLDA,KOLDA,DIOULACOLON,SALIKEGNE,KOUNTIMA,23,25,152,141,293
KOLDA,KOLDA,DIOULACOLON,SALIKEGNE,MORYCOUNDA,30,68,463,503,966
KOLDA,KOLDA,DIOULACOLON,SALIKEGNE,"NEMA DEMBA",8,8,48,31,79
KOLDA,KOLDA,DIOULACOLON,SALIKEGNE,"SINTHIANG ASSETTE",5,5,38,20,58
KOLDA,KOLDA,DIOULACOLON,SALIKEGNE,SIRAMANSA,60,69,399,378,777
KOLDA,KOLDA,DIOULACOLON,"SARE YOBA DIEGA","DAR SALAM",72,80,419,397,816
KOLDA,KOLDA,DIOULACOLON,"SARE YOBA DIEGA","DOUMASSOU MOSQUEE",46,55,365,308,673
KOLDA,KOLDA,DIOULACOLON,"SARE YOBA DIEGA","DOUMASSOU OUEST",111,117,542,577,1119
KOLDA,KOLDA,DIOULACOLON,"SARE YOBA DIEGA","NEMA KENIE KENIE BATOU",8,13,95,85,180
KOLDA,KOLDA,DIOULACOLON,"SARE YOBA DIEGA","NEMA MANSALY",35,36,191,181,372
KOLDA,KOLDA,DIOULACOLON,"SARE YOBA DIEGA",SANTASSOU,96,117,515,524,1039
KOLDA,KOLDA,MAMPATIM,BAGADADJI,"AFIA SAMBA (SINTHIANG SAMBAYEL)",5,5,17,32,49
KOLDA,KOLDA,MAMPATIM,BAGADADJI,"ALEXANDRIE (KANANKO)",13,20,122,144,266
KOLDA,KOLDA,MAMPATIM,BAGADADJI,AMANATOULAYE,3,4,27,24,51
KOLDA,KOLDA,MAMPATIM,BAGADADJI,BAGADADJI,161,167,806,780,1586
KOLDA,KOLDA,MAMPATIM,BAGADADJI,"BANTAGUEL YERO DIAO",1,1,11,10,21
KOLDA,KOLDA,MAMPATIM,BAGADADJI,"BANTANTO DEMBA (MAHON AGNA)",28,29,119,121,240
KOLDA,KOLDA,MAMPATIM,BAGADADJI,"DAHIRA ABASSE",5,6,34,28,62
KOLDA,KOLDA,MAMPATIM,BAGADADJI,"DAIBATOU MAMADOU SEYDI",11,18,109,114,223
KOLDA,KOLDA,MAMPATIM,BAGADADJI,"DIALICOUNDA (SARE SONIA)",22,24,132,143,275
KOLDA,KOLDA,MAMPATIM,BAGADADJI,"DIAOCOUNDA AMADOU",3,4,29,34,63
KOLDA,KOLDA,MAMPATIM,BAGADADJI,"DINGUIRAYE EL HADJI DEMBEL",9,11,82,83,165
KOLDA,KOLDA,MAMPATIM,BAGADADJI,DOULONDING,5,7,34,26,60
KOLDA,KOLDA,MAMPATIM,BAGADADJI,"SINTHIANG EL HADJI SALIOU ( ELHADJI SALIOU )",26,33,207,198,405
KOLDA,KOLDA,MAMPATIM,BAGADADJI,"HAMDALLAYE BACHIR",13,14,85,74,159
KOLDA,KOLDA,MAMPATIM,BAGADADJI,"HAMDALLAYE THIERNO (DAMANDOU)",14,16,60,61,121
KOLDA,KOLDA,MAMPATIM,BAGADADJI,"HOUBA MOCTAR",4,5,34,38,72
KOLDA,KOLDA,MAMPATIM,BAGADADJI,"IBRAHIMA NIMA",16,20,109,82,191
KOLDA,KOLDA,MAMPATIM,BAGADADJI,"ILIYAO MAMADOU SEYDI",35,35,203,203,406
KOLDA,KOLDA,MAMPATIM,BAGADADJI,KADIAL,3,6,36,35,71
KOLDA,KOLDA,MAMPATIM,BAGADADJI,KAMPISSA,54,63,276,310,586
KOLDA,KOLDA,MAMPATIM,BAGADADJI,LAMOYE,10,11,87,89,176
KOLDA,KOLDA,MAMPATIM,BAGADADJI,LINKERINTO,19,24,185,146,331
KOLDA,KOLDA,MAMPATIM,BAGADADJI,"MAHON OUSMANE",9,9,31,28,59
KOLDA,KOLDA,MAMPATIM,BAGADADJI,MANTHIANCANY,20,24,168,91,259
KOLDA,KOLDA,MAMPATIM,BAGADADJI,"MAOUDO DIOUMA",8,12,74,75,149
KOLDA,KOLDA,MAMPATIM,BAGADADJI,"MEDINA ABDOUL",11,14,78,57,135
KOLDA,KOLDA,MAMPATIM,BAGADADJI,"MEDINA AMADOU (SARE COLY)",15,20,119,84,203
KOLDA,KOLDA,MAMPATIM,BAGADADJI,"MEDINA MAMA SAMBA (SINTHIANG DABO)",14,20,144,141,285
KOLDA,KOLDA,MAMPATIM,BAGADADJI,"MEDINA BOCAR DEMBA (DEMBA OUMA)",18,24,159,133,292
KOLDA,KOLDA,MAMPATIM,BAGADADJI,"MEDINA DALLATOU",15,19,122,100,222
KOLDA,KOLDA,MAMPATIM,BAGADADJI,"MEDINA FODE",22,32,214,212,426
KOLDA,KOLDA,MAMPATIM,BAGADADJI,"MEDINA GUIRO YORO",11,14,89,89,178
KOLDA,KOLDA,MAMPATIM,BAGADADJI,"MEDINA KENOUKOU",20,21,135,125,260
KOLDA,KOLDA,MAMPATIM,BAGADADJI,"MEDINA METABA",8,8,41,31,72
KOLDA,KOLDA,MAMPATIM,BAGADADJI,"MEDINA MOCTAR",15,17,99,82,181
KOLDA,KOLDA,MAMPATIM,BAGADADJI,"MEDINA OUMAR (MARENA)",19,21,125,135,260
KOLDA,KOLDA,MAMPATIM,BAGADADJI,"MEDINA SADIO",22,24,110,112,222
KOLDA,KOLDA,MAMPATIM,BAGADADJI,"MEDINA SAÎDOU BA",46,51,368,356,724
KOLDA,KOLDA,MAMPATIM,BAGADADJI,"MEDINA ALIOU SAMBA",33,40,234,222,456
KOLDA,KOLDA,MAMPATIM,BAGADADJI,"MISSIRAH KAMARANG",24,31,160,148,308
KOLDA,KOLDA,MAMPATIM,BAGADADJI,"MISSIRAH MAMADOU",61,67,362,396,758
KOLDA,KOLDA,MAMPATIM,BAGADADJI,"MISSIRAH OUSMANE",16,17,95,90,185
KOLDA,KOLDA,MAMPATIM,BAGADADJI,"MISSIRAH SAMBA NIAMADIO",20,24,179,165,344
KOLDA,KOLDA,MAMPATIM,BAGADADJI,"MISSIRAH YAYA",8,10,43,47,90
KOLDA,KOLDA,MAMPATIM,BAGADADJI,NDORNA,16,16,81,85,166
KOLDA,KOLDA,MAMPATIM,BAGADADJI,SALAMATA,76,93,497,493,990
KOLDA,KOLDA,MAMPATIM,BAGADADJI,"MAHON SANGARE (SANGHARE MAMBOUA )",3,6,10,14,24
KOLDA,KOLDA,MAMPATIM,BAGADADJI,"H1 MEDINA FASS",10,10,25,35,60
KOLDA,KOLDA,MAMPATIM,BAGADADJI,"SARE LOUNTANG (MAMBOUA)",22,25,139,109,248
KOLDA,KOLDA,MAMPATIM,BAGADADJI,"SARE SAMBA LOBE",21,24,142,140,282
KOLDA,KOLDA,MAMPATIM,BAGADADJI,"SARE SAME",4,5,38,24,62
KOLDA,KOLDA,MAMPATIM,BAGADADJI,"SARE SANDIONG",65,77,310,327,637
KOLDA,KOLDA,MAMPATIM,BAGADADJI,"SARE SARA",87,89,336,354,690
KOLDA,KOLDA,MAMPATIM,BAGADADJI,"SINTHIANG ALONSO",3,4,19,17,36
KOLDA,KOLDA,MAMPATIM,BAGADADJI,"SINTHIANG ALY",12,16,95,80,175
KOLDA,KOLDA,MAMPATIM,BAGADADJI,"SINTHIANG BOCAR",3,3,18,16,34
KOLDA,KOLDA,MAMPATIM,BAGADADJI,"SINTHIANG BOYDO",9,12,75,57,132
KOLDA,KOLDA,MAMPATIM,BAGADADJI,"SINTHIANG DAIBATOU OUMAR",14,16,105,76,181
KOLDA,KOLDA,MAMPATIM,BAGADADJI,"SINTHIANG DEMBA BALDE (MAOUNDE BOUNO)",19,19,122,114,236
KOLDA,KOLDA,MAMPATIM,BAGADADJI,"SINTHIANG DEMBAROU COURO",23,34,220,191,411
KOLDA,KOLDA,MAMPATIM,BAGADADJI,"SINTHIANG DIAHE KILARA",7,7,49,38,87
KOLDA,KOLDA,MAMPATIM,BAGADADJI,"SINTHIANG FODE",2,4,15,17,32
KOLDA,KOLDA,MAMPATIM,BAGADADJI,"SINTHIANG HIMABE",2,3,20,18,38
KOLDA,KOLDA,MAMPATIM,BAGADADJI,"SINTHIANG KOUTHIA",5,7,28,36,64
KOLDA,KOLDA,MAMPATIM,BAGADADJI,"SINTHIANG MAMADOU DIOULDE DIALLO (MAMA DIOULDE)",3,3,13,17,30
KOLDA,KOLDA,MAMPATIM,BAGADADJI,"SINTHIANG MAMADOU GUIRO",11,14,67,82,149
KOLDA,KOLDA,MAMPATIM,BAGADADJI,"SINTHIANG MAMADOU TENING",11,15,115,66,181
KOLDA,KOLDA,MAMPATIM,BAGADADJI,"SINTHIANG MAMADOUYEL AYNE",9,11,64,56,120
KOLDA,KOLDA,MAMPATIM,BAGADADJI,"SINTHIANG MANSALY",10,11,67,71,138
KOLDA,KOLDA,MAMPATIM,BAGADADJI,"SINTHIANG MOUSSA",4,4,20,14,34
KOLDA,KOLDA,MAMPATIM,BAGADADJI,"SINTHIANG SADIO GANO (OUDALA)",15,20,127,159,286
KOLDA,KOLDA,MAMPATIM,BAGADADJI,"SINTHIANG SALIOU",2,2,12,16,28
KOLDA,KOLDA,MAMPATIM,BAGADADJI,"SINTHIANG SAMBA MBALLO (SINTHIANG SAMBA LAO)",4,4,17,25,42
KOLDA,KOLDA,MAMPATIM,BAGADADJI,"SINTHIANG SARA",10,10,67,38,105
KOLDA,KOLDA,MAMPATIM,BAGADADJI,"SINTHIANG SIRING",11,13,70,65,135
KOLDA,KOLDA,MAMPATIM,BAGADADJI,"SINTHIANG SOUMA",22,25,169,132,301
KOLDA,KOLDA,MAMPATIM,BAGADADJI,"SINTHIANG TENING DIAO",11,12,59,64,123
KOLDA,KOLDA,MAMPATIM,BAGADADJI,"SINTHIANG YOUSSOUF",3,4,16,22,38
KOLDA,KOLDA,MAMPATIM,BAGADADJI,TABANDINTO,18,22,127,133,260
KOLDA,KOLDA,MAMPATIM,BAGADADJI,"TEKINAME ILO",15,15,91,71,162
KOLDA,KOLDA,MAMPATIM,BAGADADJI,THIBO,10,11,70,70,140
KOLDA,KOLDA,MAMPATIM,BAGADADJI,"TOUBA MEDINE (DAKA BARKEDJI)",8,12,71,58,129
KOLDA,KOLDA,MAMPATIM,BAGADADJI,"VELINGARA BOCAR ( SARE BOCAR )",18,23,164,154,318
KOLDA,KOLDA,MAMPATIM,BAGADADJI,"WAKILARE KAYEL",22,27,140,146,286
KOLDA,KOLDA,MAMPATIM,BAGADADJI,YASSIRBA,8,8,31,28,59
KOLDA,KOLDA,MAMPATIM,BAGADADJI,"SINTHIANG KEBA",3,4,27,27,54
KOLDA,KOLDA,MAMPATIM,BAGADADJI,"DEMBA KORBALY",11,11,33,33,66
KOLDA,KOLDA,MAMPATIM,BAGADADJI,"SINTHIANG TODIA",11,11,53,45,98
KOLDA,KOLDA,MAMPATIM,BAGADADJI,"SINTHIANG DEMBAYEL",5,6,28,28,56
KOLDA,KOLDA,MAMPATIM,BAGADADJI,"MAHON DAIBATOU ( DAIBATOU )",6,7,18,17,35
KOLDA,KOLDA,MAMPATIM,BAGADADJI,"SINTHIANG OUMAR",4,5,24,16,40
KOLDA,KOLDA,MAMPATIM,BAGADADJI,MOUGNINY,2,4,11,9,20
KOLDA,KOLDA,MAMPATIM,BAGADADJI,"SINTHIANG ABDOUL",5,5,19,21,40
KOLDA,KOLDA,MAMPATIM,BAGADADJI,"SINTHIANG DIOULDE",6,6,35,41,76
KOLDA,KOLDA,MAMPATIM,BAGADADJI,"SARE SEYNI",9,9,82,32,114
KOLDA,KOLDA,MAMPATIM,BAGADADJI,"MEDINA DIATTA( SARE DIATTA)",15,16,84,101,185
KOLDA,KOLDA,MAMPATIM,BAGADADJI,"SINTHIANG SAMBA",1,1,3,3,6
KOLDA,KOLDA,MAMPATIM,COUMBACARA,"AINE MADY DEMBA",24,32,147,136,283
KOLDA,KOLDA,MAMPATIM,COUMBACARA,BAMBADINKA,30,40,295,254,549
KOLDA,KOLDA,MAMPATIM,COUMBACARA,BOUBEREL,38,51,280,248,528
KOLDA,KOLDA,MAMPATIM,COUMBACARA,COUMBACARA,147,164,820,799,1619
KOLDA,KOLDA,MAMPATIM,COUMBACARA,DAMANDOU,3,3,21,11,32
KOLDA,KOLDA,MAMPATIM,COUMBACARA,DAROURAHMANE,4,6,44,34,78
KOLDA,KOLDA,MAMPATIM,COUMBACARA,"DAR SALAM IBRAHIMA",11,17,99,114,213
KOLDA,KOLDA,MAMPATIM,COUMBACARA,"DIALACOUMBY MANDING",44,71,402,454,856
KOLDA,KOLDA,MAMPATIM,COUMBACARA,"H1 SINTHIANG TOBO (TAIBA)",3,3,89,22,111
KOLDA,KOLDA,MAMPATIM,COUMBACARA,"DIALACOUMBY PEUL",21,28,243,244,487
KOLDA,KOLDA,MAMPATIM,COUMBACARA,"H1 SINTHIANG YAYA",7,10,75,75,150
KOLDA,KOLDA,MAMPATIM,COUMBACARA,"DIAMBOUR KOMBO",22,27,188,181,369
KOLDA,KOLDA,MAMPATIM,COUMBACARA,DIBITO,9,14,92,76,168
KOLDA,KOLDA,MAMPATIM,COUMBACARA,DIDIORE,16,19,102,89,191
KOLDA,KOLDA,MAMPATIM,COUMBACARA,GNEGNENE,4,8,65,36,101
KOLDA,KOLDA,MAMPATIM,COUMBACARA,"KANDAGHA HAMADY",15,19,114,115,229
KOLDA,KOLDA,MAMPATIM,COUMBACARA,"KANDAGHA TOBO",14,21,126,120,246
KOLDA,KOLDA,MAMPATIM,COUMBACARA,KANDIONG,11,13,63,62,125
KOLDA,KOLDA,MAMPATIM,COUMBACARA,KANICOR,11,11,60,60,120
KOLDA,KOLDA,MAMPATIM,COUMBACARA,KOUDORA,11,12,117,127,244
KOLDA,KOLDA,MAMPATIM,COUMBACARA,KOULINTO,23,27,124,127,251
KOLDA,KOLDA,MAMPATIM,COUMBACARA,"LINGUE WAL MAMADOU",8,9,69,42,111
KOLDA,KOLDA,MAMPATIM,COUMBACARA,"MAREWE DEMBA MBALLO",10,10,74,61,135
KOLDA,KOLDA,MAMPATIM,COUMBACARA,"MAREWE MOUSSA",5,6,40,38,78
KOLDA,KOLDA,MAMPATIM,COUMBACARA,"MBALLO COUNDA KOUDORA ( SINTHIANG YOBA )",2,4,31,39,70
KOLDA,KOLDA,MAMPATIM,COUMBACARA,"MEDINA ANSOUMANA",18,23,121,142,263
KOLDA,KOLDA,MAMPATIM,COUMBACARA,"MEDINA DEMBA BILO",14,24,110,140,250
KOLDA,KOLDA,MAMPATIM,COUMBACARA,"MEDINA HAMADY ( NIANKANGHA )",7,7,55,45,100
KOLDA,KOLDA,MAMPATIM,COUMBACARA,"MEDINA KEBOU",4,6,29,48,77
KOLDA,KOLDA,MAMPATIM,COUMBACARA,"MEDINA NDONDI",16,18,108,124,232
KOLDA,KOLDA,MAMPATIM,COUMBACARA,"MEDINA TOUNKA",13,17,91,94,185
KOLDA,KOLDA,MAMPATIM,COUMBACARA,"MEDINA YIRA (NIAMPAYO)",6,7,39,54,93
KOLDA,KOLDA,MAMPATIM,COUMBACARA,"SINTHIANG YIRA",4,7,32,36,68
KOLDA,KOLDA,MAMPATIM,COUMBACARA,MESINCOUNDA,1,1,14,12,26
KOLDA,KOLDA,MAMPATIM,COUMBACARA,"MISSIRA DIOMEL",13,17,80,96,176
KOLDA,KOLDA,MAMPATIM,COUMBACARA,"MISSIRA MOUSSA",10,14,88,64,152
KOLDA,KOLDA,MAMPATIM,COUMBACARA,NIANINDIYA,29,30,186,180,366
KOLDA,KOLDA,MAMPATIM,COUMBACARA,"SAGHARE NIAMPAYO",2,3,27,25,52
KOLDA,KOLDA,MAMPATIM,COUMBACARA,"SANE COUNDA",3,4,11,7,18
KOLDA,KOLDA,MAMPATIM,COUMBACARA,"ALETTE FADY",17,27,169,135,304
KOLDA,KOLDA,MAMPATIM,COUMBACARA,"SARE DEMBA SALLE",7,7,35,41,76
KOLDA,KOLDA,MAMPATIM,COUMBACARA,"SARE DEMBEL",6,7,39,29,68
KOLDA,KOLDA,MAMPATIM,COUMBACARA,"SARE DIAME (SARE DIAMOU)",3,5,10,22,32
KOLDA,KOLDA,MAMPATIM,COUMBACARA,"SARE KARFA",11,14,91,118,209
KOLDA,KOLDA,MAMPATIM,COUMBACARA,"SARE KEMADY",2,2,26,17,43
KOLDA,KOLDA,MAMPATIM,COUMBACARA,"H1 SARE LALY",21,24,143,140,283
KOLDA,KOLDA,MAMPATIM,COUMBACARA,"SARE LAO BAMBE",12,16,98,105,203
KOLDA,KOLDA,MAMPATIM,COUMBACARA,"SARE MANSALY",48,49,270,278,548
KOLDA,KOLDA,MAMPATIM,COUMBACARA,"SARE MBOUBOU",11,14,94,62,156
KOLDA,KOLDA,MAMPATIM,COUMBACARA,"SARE NIYEL",14,20,86,97,183
KOLDA,KOLDA,MAMPATIM,COUMBACARA,"SARE SAMBEL",4,4,37,41,78
KOLDA,KOLDA,MAMPATIM,COUMBACARA,"SINTHIANG DABAL",9,12,87,73,160
KOLDA,KOLDA,MAMPATIM,COUMBACARA,"SINTHIANG HERY NIAMADIO",6,10,76,57,133
KOLDA,KOLDA,MAMPATIM,COUMBACARA,"SINTHIANG KEITAYEL",4,4,49,23,72
KOLDA,KOLDA,MAMPATIM,COUMBACARA,"SINTHIANG MAMADOU COUMBA",3,5,27,35,62
KOLDA,KOLDA,MAMPATIM,COUMBACARA,"TEMENTO TOBO",27,30,201,196,397
KOLDA,KOLDA,MAMPATIM,COUMBACARA,THIARAPPE,22,34,252,168,420
KOLDA,KOLDA,MAMPATIM,COUMBACARA,THIEDELY,140,162,915,850,1765
KOLDA,KOLDA,MAMPATIM,COUMBACARA,TOUTOUNE,4,9,45,49,94
KOLDA,KOLDA,MAMPATIM,COUMBACARA,"WAKILARE FODE",10,13,102,98,200
KOLDA,KOLDA,MAMPATIM,COUMBACARA,"H1 MEDINA YIRA IAMPAYO ( SINTHIANG DIOULDE SEYDI )",5,6,49,43,92
KOLDA,KOLDA,MAMPATIM,COUMBACARA,"SINTHIANG FALLY II",4,5,19,26,45
KOLDA,KOLDA,MAMPATIM,MAMPATIM,"AINE MADY YERO (SARE YERO OUSSOU)",29,36,253,163,416
KOLDA,KOLDA,MAMPATIM,MAMPATIM,"BANTANGUEL KASSOUM",20,24,194,191,385
KOLDA,KOLDA,MAMPATIM,MAMPATIM,"BANTANKILING DOULO (SARE DOULOYEL)",13,15,90,83,173
KOLDA,KOLDA,MAMPATIM,MAMPATIM,"DARSALAM MAMADOU TOURE",48,57,319,275,594
KOLDA,KOLDA,MAMPATIM,MAMPATIM,"DIANKANCOUNDA MANDINGUE",13,24,147,139,286
KOLDA,KOLDA,MAMPATIM,MAMPATIM,"DIANKANCOUNDA MAOUNDE",16,25,99,98,197
KOLDA,KOLDA,MAMPATIM,MAMPATIM,"DIANKANCOUNDA OGUEL",81,91,536,444,980
KOLDA,KOLDA,MAMPATIM,MAMPATIM,"DIANKANCOUNDA SOUNTOUKOU",12,13,88,51,139
KOLDA,KOLDA,MAMPATIM,MAMPATIM,"DOUBELSA MBALLO (MBALLOCOUNDA)",10,12,81,57,138
KOLDA,KOLDA,MAMPATIM,MAMPATIM,"FOULADOU YERO (SARE YERO AINE)",30,33,242,227,469
KOLDA,KOLDA,MAMPATIM,MAMPATIM,"SINTHIANG DIOMEL ( GOUNDAGA DIOMEL )",7,9,44,51,95
KOLDA,KOLDA,MAMPATIM,MAMPATIM,GOPPE,9,9,67,45,112
KOLDA,KOLDA,MAMPATIM,MAMPATIM,"KARANTABA TOURY",3,3,18,10,28
KOLDA,KOLDA,MAMPATIM,MAMPATIM,"KATABA SAMBA",22,30,176,181,357
KOLDA,KOLDA,MAMPATIM,MAMPATIM,"KOURTYDIANE (SARE SAMBEL)",30,39,239,249,488
KOLDA,KOLDA,MAMPATIM,MAMPATIM,KOUTHIERA,24,27,206,179,385
KOLDA,KOLDA,MAMPATIM,MAMPATIM,"LINGUEYEL ARFANG",11,14,76,76,152
KOLDA,KOLDA,MAMPATIM,MAMPATIM,"LINGUEL DEMBEL (KOUTHIAKEL)",5,6,41,49,90
KOLDA,KOLDA,MAMPATIM,MAMPATIM,MAMPATIM,426,458,2209,2233,4442
KOLDA,KOLDA,MAMPATIM,MAMPATIM,"MAMPATIM SINTHIANG",6,9,44,37,81
KOLDA,KOLDA,MAMPATIM,MAMPATIM,"SINTHIANG BAKARY ( MAREWE BACARY )",5,7,72,71,143
KOLDA,KOLDA,MAMPATIM,MAMPATIM,"MEDINA THIERNO SABALY",15,17,110,87,197
KOLDA,KOLDA,MAMPATIM,MAMPATIM,"MEDINA META I (SARE META)",61,71,422,384,806
KOLDA,KOLDA,MAMPATIM,MAMPATIM,"MEDINA NIOUGUE (SARE BOUTY)",45,50,250,230,480
KOLDA,KOLDA,MAMPATIM,MAMPATIM,"SINTHIANG SADIO ( MISSIRAH DEMBA SADIO )",95,106,562,595,1157
KOLDA,KOLDA,MAMPATIM,MAMPATIM,"MISSIRAH KALIDIOGO",31,36,203,172,375
KOLDA,KOLDA,MAMPATIM,MAMPATIM,PIDIRO,29,51,294,260,554
KOLDA,KOLDA,MAMPATIM,MAMPATIM,"SARE BAIDARY",12,20,132,123,255
KOLDA,KOLDA,MAMPATIM,MAMPATIM,"SARE BOIDO PITHIAME",19,29,201,168,369
KOLDA,KOLDA,MAMPATIM,MAMPATIM,"SARE DEMBAYEL",59,81,396,456,852
KOLDA,KOLDA,MAMPATIM,MAMPATIM,"SARE GOURDO",3,3,22,22,44
KOLDA,KOLDA,MAMPATIM,MAMPATIM,"SARE KANTA",24,37,299,230,529
KOLDA,KOLDA,MAMPATIM,MAMPATIM,"SARE NDIAILA",24,30,218,188,406
KOLDA,KOLDA,MAMPATIM,MAMPATIM,"SARE NDIOBO HAWA",22,30,127,138,265
KOLDA,KOLDA,MAMPATIM,MAMPATIM,"SARE PATHE BOUYA",52,53,346,364,710
KOLDA,KOLDA,MAMPATIM,MAMPATIM,"SARE YERBEL",16,19,130,152,282
KOLDA,KOLDA,MAMPATIM,MAMPATIM,"SINTHIANG SOUMA ( SIBANOR DIAO )",30,32,249,238,487
KOLDA,KOLDA,MAMPATIM,MAMPATIM,"SINTHIANG DIOULDE (MEDINA DIOULDE)",4,4,27,23,50
KOLDA,KOLDA,MAMPATIM,MAMPATIM,"SINTHIANG KABA",35,40,241,220,461
KOLDA,KOLDA,MAMPATIM,MAMPATIM,"SINTHIANG KELEFA",20,25,135,110,245
KOLDA,KOLDA,MAMPATIM,MAMPATIM,"SINTHIANG OUMAR",1,2,12,11,23
KOLDA,KOLDA,MAMPATIM,MAMPATIM,"SINTHIANG SAMBA DIAO (SINTHIANG GUIRO)",5,9,63,56,119
KOLDA,KOLDA,MAMPATIM,MAMPATIM,"SINTHIANG SAMBA DIOUMA DIAO",4,4,34,34,68
KOLDA,KOLDA,MAMPATIM,MAMPATIM,"SINTHIANG SOUKEL",16,21,160,148,308
KOLDA,KOLDA,MAMPATIM,MAMPATIM,"SINTHIANG YEMBE",10,11,57,59,116
KOLDA,KOLDA,MAMPATIM,MAMPATIM,"TEMENTO DEMBA (SARE DEMBA WOURY )",16,21,110,110,220
KOLDA,KOLDA,MAMPATIM,MAMPATIM,"TEMENTO DIAHE (SARE DIAHE)",32,37,224,186,410
KOLDA,KOLDA,MAMPATIM,MAMPATIM,"SARE ALETTE ( TEMENTO META )",21,29,192,160,352
KOLDA,KOLDA,MAMPATIM,MAMPATIM,"VELINGARA NAFA (SINTHIANG NAFA)",48,60,394,385,779
KOLDA,KOLDA,MAMPATIM,MAMPATIM,"WAKILARE AMADOU (SARE AMADOU)",19,26,123,128,251
KOLDA,KOLDA,MAMPATIM,MAMPATIM,"SARE THIMINTANG ( WAKILARE TOBO )",32,53,283,264,547
KOLDA,KOLDA,MAMPATIM,MAMPATIM,"SINTHIANG SEYDOU",5,5,24,25,49
KOLDA,KOLDA,MAMPATIM,MAMPATIM,"SINTHIANG GUILE",3,3,24,15,39
KOLDA,KOLDA,MAMPATIM,DIALAMBERE,"AFIA OUSMANE",12,12,79,93,172
KOLDA,KOLDA,MAMPATIM,DIALAMBERE,"ALLALOU SAMBA",2,4,18,16,34
KOLDA,KOLDA,MAMPATIM,DIALAMBERE,"BANTANKILING SOUKOUTA",12,16,97,75,172
KOLDA,KOLDA,MAMPATIM,DIALAMBERE,"BANTANKILING WALY",11,16,99,74,173
KOLDA,KOLDA,MAMPATIM,DIALAMBERE,BASSOUM,36,41,237,229,466
KOLDA,KOLDA,MAMPATIM,DIALAMBERE,"BOUGNIA MANGAL (SINTHIANG MANGAL)",17,20,80,76,156
KOLDA,KOLDA,MAMPATIM,DIALAMBERE,"DAIBATOU LAMINE DEMBA (SINTHIANG DEMBA DIE)",11,13,68,65,133
KOLDA,KOLDA,MAMPATIM,DIALAMBERE,DIALAMBERE,101,113,651,653,1304
KOLDA,KOLDA,MAMPATIM,DIALAMBERE,DIAOCOUNDA,20,20,113,94,207
KOLDA,KOLDA,MAMPATIM,DIALAMBERE,DIATTAMINE,52,62,407,374,781
KOLDA,KOLDA,MAMPATIM,DIALAMBERE,"FASS KAHONE",17,20,99,87,186
KOLDA,KOLDA,MAMPATIM,DIALAMBERE,"FODE BAYO",9,16,71,42,113
KOLDA,KOLDA,MAMPATIM,DIALAMBERE,"HAMDALLAYE YORO KANDE",58,62,363,334,697
KOLDA,KOLDA,MAMPATIM,DIALAMBERE,KANDIATOR,48,50,321,284,605
KOLDA,KOLDA,MAMPATIM,DIALAMBERE,"H1 MISSIRAH ABDOULAYE",2,4,15,20,35
KOLDA,KOLDA,MAMPATIM,DIALAMBERE,KENTO,10,14,76,63,139
KOLDA,KOLDA,MAMPATIM,DIALAMBERE,KODIENGUINA,30,39,207,211,418
KOLDA,KOLDA,MAMPATIM,DIALAMBERE,"KOUMAMBOURE MAOUNDE",32,37,240,211,451
KOLDA,KOLDA,MAMPATIM,DIALAMBERE,"MARIBE MARA DIAO",7,7,50,39,89
KOLDA,KOLDA,MAMPATIM,DIALAMBERE,"MEDINA DEMBA ALAOUR",4,6,34,39,73
KOLDA,KOLDA,MAMPATIM,DIALAMBERE,"MEDINA KOUNDIE",46,50,290,227,517
KOLDA,KOLDA,MAMPATIM,DIALAMBERE,"MEDINA MAMADOU ALIOU",17,21,152,120,272
KOLDA,KOLDA,MAMPATIM,DIALAMBERE,"MEDINA WOPA (SINTHIANG WOPA)",3,3,12,16,28
KOLDA,KOLDA,MAMPATIM,DIALAMBERE,"MISSIRAH DIAMANKA (SINTHIANG MAMADOU YANKOR)",10,17,102,115,217
KOLDA,KOLDA,MAMPATIM,DIALAMBERE,NGOKI,94,126,672,599,1271
KOLDA,KOLDA,MAMPATIM,DIALAMBERE,"NGOUDOUMANE BACARY",24,27,213,179,392
KOLDA,KOLDA,MAMPATIM,DIALAMBERE,"NGOUDOUMANE DIENOU",15,18,96,92,188
KOLDA,KOLDA,MAMPATIM,DIALAMBERE,"NGOUNDAGA  ASSANE (NGOUNDAGA YANKOU)",12,16,131,89,220
KOLDA,KOLDA,MAMPATIM,DIALAMBERE,"SARE ANSOU FASSAGNA",19,19,112,89,201
KOLDA,KOLDA,MAMPATIM,DIALAMBERE,"SARE BACARY DIAO",1,1,13,20,33
KOLDA,KOLDA,MAMPATIM,DIALAMBERE,"H1 SINTHIANG MARA",6,10,76,74,150
KOLDA,KOLDA,MAMPATIM,DIALAMBERE,"SARE DEMBA FOREAH",6,10,37,41,78
KOLDA,KOLDA,MAMPATIM,DIALAMBERE,"SARE META (SINTHIANG SIRING)",9,10,68,50,118
KOLDA,KOLDA,MAMPATIM,DIALAMBERE,"SARE YOBA MBALLO",18,27,160,142,302
KOLDA,KOLDA,MAMPATIM,DIALAMBERE,"SINTHIANG ALY",4,4,33,26,59
KOLDA,KOLDA,MAMPATIM,DIALAMBERE,"SINTHIANG BAMBA",5,7,44,51,95
KOLDA,KOLDA,MAMPATIM,DIALAMBERE,"H1 SINTHIANG TALLA",3,3,22,13,35
KOLDA,KOLDA,MAMPATIM,DIALAMBERE,"SINTHIANG BAMBOU",25,29,206,183,389
KOLDA,KOLDA,MAMPATIM,DIALAMBERE,"SINTHIANG BOCAR",8,11,88,67,155
KOLDA,KOLDA,MAMPATIM,DIALAMBERE,"H1 VELINGARA DEMBA",1,1,6,2,8
KOLDA,KOLDA,MAMPATIM,DIALAMBERE,"SINTHIANG COURTIBA (VELINGARA DOUARE)",8,12,98,114,212
KOLDA,KOLDA,MAMPATIM,DIALAMBERE,"SINTHIANG KASSE (TEMENTO KASSE)",4,5,18,30,48
KOLDA,KOLDA,MAMPATIM,DIALAMBERE,"SINTHIANG KEDIARA",9,12,81,60,141
KOLDA,KOLDA,MAMPATIM,DIALAMBERE,"SINTHIANG KEITA",16,20,142,129,271
KOLDA,KOLDA,MAMPATIM,DIALAMBERE,"SINTHIANG KOUMAMBOURE",33,35,230,181,411
KOLDA,KOLDA,MAMPATIM,DIALAMBERE,"SINTHIANG LOUSSI (SARE NGOUNDO)",6,6,48,31,79
KOLDA,KOLDA,MAMPATIM,DIALAMBERE,"SINTHIANG MALANG 1",3,3,30,33,63
KOLDA,KOLDA,MAMPATIM,DIALAMBERE,"SINTHIANG MALANG 2",15,15,105,92,197
KOLDA,KOLDA,MAMPATIM,DIALAMBERE,"SINTHIANG MAMA (SINTHIANG MAMA DOUCOURE)",10,15,87,62,149
KOLDA,KOLDA,MAMPATIM,DIALAMBERE,"SINTHIANG MAMA WONTO (SINTHIANG MAMA BOIRO)",12,13,59,54,113
KOLDA,KOLDA,MAMPATIM,DIALAMBERE,"SINTHIANG MAMADOU",3,4,30,24,54
KOLDA,KOLDA,MAMPATIM,DIALAMBERE,"SINTHIANG MODOU",5,5,35,31,66
KOLDA,KOLDA,MAMPATIM,DIALAMBERE,"SINTHIANG MOUSSA",2,2,30,23,53
KOLDA,KOLDA,MAMPATIM,DIALAMBERE,"H1 SINTHIANG SAGNA",2,2,7,4,11
KOLDA,KOLDA,MAMPATIM,DIALAMBERE,"SINTHIANG SAGNA (SINTHIANG DEMBA)",1,1,4,5,9
KOLDA,KOLDA,MAMPATIM,DIALAMBERE,"SINTHIANG SIRIFOU",8,9,35,26,61
KOLDA,KOLDA,MAMPATIM,DIALAMBERE,"SINTHIANG SONGA",5,6,42,32,74
KOLDA,KOLDA,MAMPATIM,DIALAMBERE,"H1 SINTHIANG MAMADOU BALDE",1,1,18,14,32
KOLDA,KOLDA,MAMPATIM,DIALAMBERE,"SINTHIANG THIERNO AMADOU KOITA",12,14,63,64,127
KOLDA,KOLDA,MAMPATIM,DIALAMBERE,"SINTHIANG WANDY",2,3,11,14,25
KOLDA,KOLDA,MAMPATIM,DIALAMBERE,"SOUGOUFARA PATHE (SARE PATHE DIABA)",9,11,83,56,139
KOLDA,KOLDA,MAMPATIM,DIALAMBERE,"TABAWAL PATHE (SARE PATHE PATA)",14,16,135,138,273
KOLDA,KOLDA,MAMPATIM,DIALAMBERE,"TEMENTO ELY",25,27,182,202,384
KOLDA,KOLDA,MAMPATIM,DIALAMBERE,"TEMENTO HADY DIAO",11,11,74,75,149
KOLDA,KOLDA,MAMPATIM,DIALAMBERE,"THIARA MANDINGUE",43,47,323,369,692
KOLDA,KOLDA,MAMPATIM,DIALAMBERE,"THIARA PEULH",55,58,320,317,637
KOLDA,KOLDA,MAMPATIM,DIALAMBERE,"THIEWAL LAO",32,45,241,232,473
KOLDA,KOLDA,MAMPATIM,DIALAMBERE,"VELINGARA PATHE",9,15,69,81,150
KOLDA,KOLDA,MAMPATIM,DIALAMBERE,"VELINGARA YELE",27,29,224,197,421
KOLDA,KOLDA,MAMPATIM,DIALAMBERE,"VELINGARA YOBA",17,20,79,80,159
KOLDA,KOLDA,MAMPATIM,DIALAMBERE,"SINTHIANG SAMBA DIABOUDING",15,15,75,79,154
KOLDA,KOLDA,MAMPATIM,"MEDINA CHERIF",ANAMBE,125,135,545,551,1096
KOLDA,KOLDA,MAMPATIM,"MEDINA CHERIF","H1 SINTHIANG THIERNO BAILO",21,21,64,53,117
KOLDA,KOLDA,MAMPATIM,"MEDINA CHERIF",AWATABA,38,56,289,285,574
KOLDA,KOLDA,MAMPATIM,"MEDINA CHERIF","BANDIAGARA COLY",43,49,217,211,428
KOLDA,KOLDA,MAMPATIM,"MEDINA CHERIF","H1 SINTHIANG HAMA",3,3,17,6,23
KOLDA,KOLDA,MAMPATIM,"MEDINA CHERIF","BANDIAGARA MODY ( SARE MODY )",9,11,85,75,160
KOLDA,KOLDA,MAMPATIM,"MEDINA CHERIF",BOTTO,15,21,123,114,237
KOLDA,KOLDA,MAMPATIM,"MEDINA CHERIF","DARSALAM SADIO",16,18,136,112,248
KOLDA,KOLDA,MAMPATIM,"MEDINA CHERIF","DIATAFA (DIATAFA THIERNO MBALLO)",25,31,269,163,432
KOLDA,KOLDA,MAMPATIM,"MEDINA CHERIF","DIYABOUGOU KHADRY",22,28,176,182,358
KOLDA,KOLDA,MAMPATIM,"MEDINA CHERIF","DIYABOUGOU KOLY",8,9,45,47,92
KOLDA,KOLDA,MAMPATIM,"MEDINA CHERIF","DOUBEL SYLLA",10,12,81,86,167
KOLDA,KOLDA,MAMPATIM,"MEDINA CHERIF","DOURBALY FOUNTOUNG",11,15,103,80,183
KOLDA,KOLDA,MAMPATIM,"MEDINA CHERIF","GOUNDAGA SARADOU",17,26,202,197,399
KOLDA,KOLDA,MAMPATIM,"MEDINA CHERIF","KEREWANE BOCAR GANO (SARE MBANDY)",14,23,158,131,289
KOLDA,KOLDA,MAMPATIM,"MEDINA CHERIF",KOSSANKE,48,64,368,336,704
KOLDA,KOLDA,MAMPATIM,"MEDINA CHERIF","SARE DIAKANDE ( KOTHIADE KANDE )",9,12,55,61,116
KOLDA,KOLDA,MAMPATIM,"MEDINA CHERIF","KOUKOLON KABA",15,17,73,40,113
KOLDA,KOLDA,MAMPATIM,"MEDINA CHERIF","H1 SINTHIANG BAMBE",4,4,17,6,23
KOLDA,KOLDA,MAMPATIM,"MEDINA CHERIF","KOUKOLON WASSA",19,26,145,126,271
KOLDA,KOLDA,MAMPATIM,"MEDINA CHERIF","KOYAYOMA BOUTY (SARE BOUTY)",28,35,226,205,431
KOLDA,KOLDA,MAMPATIM,"MEDINA CHERIF","LINGUEYEL DIBANE",9,10,54,57,111
KOLDA,KOLDA,MAMPATIM,"MEDINA CHERIF","LINGUEYEL KASSOUM",25,28,152,153,305
KOLDA,KOLDA,MAMPATIM,"MEDINA CHERIF","SARE KABA ( LINKERING DEMBA )",7,10,44,55,99
KOLDA,KOLDA,MAMPATIM,"MEDINA CHERIF","MACINA SEYNY",8,8,70,53,123
KOLDA,KOLDA,MAMPATIM,"MEDINA CHERIF","MBALLO COUNDA KORASSE",21,25,148,102,250
KOLDA,KOLDA,MAMPATIM,"MEDINA CHERIF","MEDINA CHERIF",62,92,502,514,1016
KOLDA,KOLDA,MAMPATIM,"MEDINA CHERIF","MEDINA SAMBA BALDE (SARE SAMBA OURY)",33,39,179,172,351
KOLDA,KOLDA,MAMPATIM,"MEDINA CHERIF","MEDINA SAMBA SABALY",5,6,27,18,45
KOLDA,KOLDA,MAMPATIM,"MEDINA CHERIF","MISSIRAH DICORY (SARE DICORY)",6,6,50,44,94
KOLDA,KOLDA,MAMPATIM,"MEDINA CHERIF","NANY DEMBA (SARE DEMBA DIAO)",24,29,124,136,260
KOLDA,KOLDA,MAMPATIM,"MEDINA CHERIF","NANY DEMBA ( NANY MAOUNDE )",11,11,34,38,72
KOLDA,KOLDA,MAMPATIM,"MEDINA CHERIF",NEMACOUNDA,18,21,150,141,291
KOLDA,KOLDA,MAMPATIM,"MEDINA CHERIF","SARE MAFALY ( NEMATABA OUMAR )",22,30,165,122,287
KOLDA,KOLDA,MAMPATIM,"MEDINA CHERIF",NINKIDJI,31,35,219,192,411
KOLDA,KOLDA,MAMPATIM,"MEDINA CHERIF",SANKAGNA,30,37,304,279,583
KOLDA,KOLDA,MAMPATIM,"MEDINA CHERIF","SARE ANSOU KORASSE",27,29,137,133,270
KOLDA,KOLDA,MAMPATIM,"MEDINA CHERIF","H1 SINTHIANG MEDINA CHERIF",49,55,231,241,472
KOLDA,KOLDA,MAMPATIM,"MEDINA CHERIF","SARE BAILO",6,10,41,50,91
KOLDA,KOLDA,MAMPATIM,"MEDINA CHERIF","SARE GNAKO GANO (SARE KELEFA)",8,9,46,45,91
KOLDA,KOLDA,MAMPATIM,"MEDINA CHERIF","SARE HAMADY",13,16,93,106,199
KOLDA,KOLDA,MAMPATIM,"MEDINA CHERIF","SARE KAREBA",18,19,74,69,143
KOLDA,KOLDA,MAMPATIM,"MEDINA CHERIF","SARE LOUNTANG KORASSE",28,35,186,226,412
KOLDA,KOLDA,MAMPATIM,"MEDINA CHERIF","SARE WALY",20,21,121,100,221
KOLDA,KOLDA,MAMPATIM,"MEDINA CHERIF","SARE YOBA NIAMA",19,26,173,160,333
KOLDA,KOLDA,MAMPATIM,"MEDINA CHERIF","SINTHIANG BOTTO",9,9,29,39,68
KOLDA,KOLDA,MAMPATIM,"MEDINA CHERIF","SINTHIANG BOUNO",9,11,70,57,127
KOLDA,KOLDA,MAMPATIM,"MEDINA CHERIF","SARE DIATTA ( SINTHIANG DIATTA )",6,8,61,53,114
KOLDA,KOLDA,MAMPATIM,"MEDINA CHERIF","SINTHIANG HABIBOU",1,1,8,4,12
KOLDA,KOLDA,MAMPATIM,"MEDINA CHERIF","SARE HANDIN ( SINTHIANG HANDIN )",6,6,41,43,84
KOLDA,KOLDA,MAMPATIM,"MEDINA CHERIF","SINTHIANG KOBA (SARE KOBA)",12,13,91,76,167
KOLDA,KOLDA,MAMPATIM,"MEDINA CHERIF","SINTHIANG PATHE ( SINTHIANG MALE)",10,10,57,66,123
KOLDA,KOLDA,MAMPATIM,"MEDINA CHERIF","SINTHIANG MAMOUDOU (SARE MAMOUDOU)",2,3,20,17,37
KOLDA,KOLDA,MAMPATIM,"MEDINA CHERIF","SARE MOUNDE DIAO ( SARE MAOUNDE DIAO )",37,45,193,165,358
KOLDA,KOLDA,MAMPATIM,"MEDINA CHERIF","SINTHIANG SAMBA DIAO KORASSE (DOUTA DIARRA)",10,12,86,71,157
KOLDA,KOLDA,MAMPATIM,"MEDINA CHERIF","SINTHIANG SEYNI BALDE",10,16,90,76,166
KOLDA,KOLDA,MAMPATIM,"MEDINA CHERIF","SINTHIANG YORO DJINA (SARE YORO)",20,24,132,158,290
KOLDA,KOLDA,MAMPATIM,"MEDINA CHERIF","TEMENTO BOTHIE",48,51,237,211,448
KOLDA,KOLDA,MAMPATIM,"MEDINA CHERIF","TEMENTO SAMBA KORASSE",11,17,102,89,191
KOLDA,KOLDA,MAMPATIM,"MEDINA CHERIF",THIEOULE,18,30,297,243,540
KOLDA,KOLDA,MAMPATIM,"MEDINA CHERIF","VELIA DARI ( SARE DARI )",3,3,27,18,45
KOLDA,KOLDA,MAMPATIM,DABO,"DABO CENTRE",112,138,657,659,1316
KOLDA,KOLDA,MAMPATIM,DABO,GADAPARA,65,70,342,372,714
KOLDA,KOLDA,MAMPATIM,DABO,GOROL,145,198,743,664,1407
KOLDA,KOLDA,MAMPATIM,DABO,HAFIA,74,96,420,384,804
KOLDA,KOLDA,MAMPATIM,DABO,KHORING,56,62,278,293,571
KOLDA,KOLDA,MAMPATIM,DABO,KOULECOUNDA,59,61,447,465,912
KOLDA,KOLDA,MAMPATIM,DABO,"LAS PALMAS",75,88,316,294,610
KOLDA,KOLDA,MAMPATIM,DABO,TABASSAYE,36,44,339,368,707
KOLDA,KOLDA,MAMPATIM,DABO,"TEMENTO DJIDE",61,65,415,466,881
KOLDA,KOLDA,MAMPATIM,DABO,THIAFENA,74,77,381,366,747
KOLDA,KOLDA,MAMPATIM,DABO,"LINGUEYE DEMBA",100,105,427,443,870
KOLDA,KOLDA,MAMPATIM,DABO,"GADAPARA (SINTHIANG MAODO)",6,6,31,41,72
KOLDA,KOLDA,"SARE BIDJI","SARE BIDJI","HAMDALAYE KAMAKO (SARE TAMSIR )",41,41,164,166,330
KOLDA,KOLDA,"SARE BIDJI","SARE BIDJI","BANDIAGARA MOUSSA ( SARE MOUSSA NDOUR )",202,208,1123,1063,2186
KOLDA,KOLDA,"SARE BIDJI","SARE BIDJI",BOGUEL,15,18,78,84,162
KOLDA,KOLDA,"SARE BIDJI","SARE BIDJI","DAMANDOU SADIO (SARE LAMINE)",9,11,94,85,179
KOLDA,KOLDA,"SARE BIDJI","SARE BIDJI","DAROU BAIDAHA",6,8,62,66,128
KOLDA,KOLDA,"SARE BIDJI","SARE BIDJI","SINTHIANG BORY ( DARSALAM BORY )",5,12,60,88,148
KOLDA,KOLDA,"SARE BIDJI","SARE BIDJI","DIAGNETTE DOULO",13,13,102,99,201
KOLDA,KOLDA,"SARE BIDJI","SARE BIDJI","DIAGNETTE SOUBA",10,14,60,59,119
KOLDA,KOLDA,"SARE BIDJI","SARE BIDJI","DIAGNETTE TALELE",7,11,66,73,139
KOLDA,KOLDA,"SARE BIDJI","SARE BIDJI","DIAGNETTE THIERNO",17,21,151,105,256
KOLDA,KOLDA,"SARE BIDJI","SARE BIDJI","H1 DIAGNETTE COPET",10,11,44,42,86
KOLDA,KOLDA,"SARE BIDJI","SARE BIDJI",DIANABO,20,30,207,203,410
KOLDA,KOLDA,"SARE BIDJI","SARE BIDJI","DIATOUMA MAOUNDE",12,13,82,91,173
KOLDA,KOLDA,"SARE BIDJI","SARE BIDJI","DJIDA MARIETOU",13,15,94,69,163
KOLDA,KOLDA,"SARE BIDJI","SARE BIDJI","FASS MOSSORY",7,12,89,78,167
KOLDA,KOLDA,"SARE BIDJI","SARE BIDJI","FOULANDING DOMEL",3,3,16,9,25
KOLDA,KOLDA,"SARE BIDJI","SARE BIDJI","FOULANDING SAMBA KANDE",9,14,72,48,120
KOLDA,KOLDA,"SARE BIDJI","SARE BIDJI","SARE BOCARY (GUIRO YERO BOCAR )",11,17,82,87,169
KOLDA,KOLDA,"SARE BIDJI","SARE BIDJI","BAITYL MOUGADASSE ( DIAMWELY)",22,26,95,111,206
KOLDA,KOLDA,"SARE BIDJI","SARE BIDJI","KANDIO KAMAKO",12,16,91,62,153
KOLDA,KOLDA,"SARE BIDJI","SARE BIDJI","MADINA MOCTAR",19,25,144,127,271
KOLDA,KOLDA,"SARE BIDJI","SARE BIDJI","MARAKISSA TOBEL",4,4,35,31,66
KOLDA,KOLDA,"SARE BIDJI","SARE BIDJI","MEDINA ABDOULAYE",27,31,180,165,345
KOLDA,KOLDA,"SARE BIDJI","SARE BIDJI","MEDINA BOGUEL",15,22,132,126,258
KOLDA,KOLDA,"SARE BIDJI","SARE BIDJI","MEDINA MAMAKOLY",9,19,111,105,216
KOLDA,KOLDA,"SARE BIDJI","SARE BIDJI","MEDINA SADIOUMA",20,29,167,141,308
KOLDA,KOLDA,"SARE BIDJI","SARE BIDJI","MEDINA SOUBA",2,2,12,11,23
KOLDA,KOLDA,"SARE BIDJI","SARE BIDJI","MERIBE DEMBA",37,46,283,241,524
KOLDA,KOLDA,"SARE BIDJI","SARE BIDJI","MARIBE FODE (SARE FODE)",3,4,34,32,66
KOLDA,KOLDA,"SARE BIDJI","SARE BIDJI","MISSIRAH DEMBA",10,15,133,132,265
KOLDA,KOLDA,"SARE BIDJI","SARE BIDJI","MISSIRA NGAYE",4,4,35,13,48
KOLDA,KOLDA,"SARE BIDJI","SARE BIDJI","SARE MOUYA FODE",6,12,83,80,163
KOLDA,KOLDA,"SARE BIDJI","SARE BIDJI","DONGORO DEMBEL",1,1,10,10,20
KOLDA,KOLDA,"SARE BIDJI","SARE BIDJI","DONGORO SANOU",6,7,38,36,74
KOLDA,KOLDA,"SARE BIDJI","SARE BIDJI",NEMOURATOU,22,32,284,284,568
KOLDA,KOLDA,"SARE BIDJI","SARE BIDJI",NIANDIAYE,13,19,118,124,242
KOLDA,KOLDA,"SARE BIDJI","SARE BIDJI","NIMZAT SEYNI",50,52,175,194,369
KOLDA,KOLDA,"SARE BIDJI","SARE BIDJI","PANAMBO MAMADY (SARE MAMADY)",11,22,84,103,187
KOLDA,KOLDA,"SARE BIDJI","SARE BIDJI","SADIALA YOBEL",5,5,29,22,51
KOLDA,KOLDA,"SARE BIDJI","SARE BIDJI","SADIALA ABBA",5,8,66,62,128
KOLDA,KOLDA,"SARE BIDJI","SARE BIDJI","H1 SINTHIANG IBRAHIMA",2,5,17,14,31
KOLDA,KOLDA,"SARE BIDJI","SARE BIDJI","SARE ASSETTE",12,15,115,64,179
KOLDA,KOLDA,"SARE BIDJI","SARE BIDJI","SARE BACARY BINTA",16,18,98,73,171
KOLDA,KOLDA,"SARE BIDJI","SARE BIDJI","SARE BIDJI",55,70,389,337,726
KOLDA,KOLDA,"SARE BIDJI","SARE BIDJI","SARE BILALY",68,90,501,374,875
KOLDA,KOLDA,"SARE BIDJI","SARE BIDJI","SARE DIATA ( SARE BOCAR BALDE )",10,12,108,109,217
KOLDA,KOLDA,"SARE BIDJI","SARE BIDJI","SARE BOCAR SELLOU (SARE BORY)",3,9,60,53,113
KOLDA,KOLDA,"SARE BIDJI","SARE BIDJI","SARE BORY",2,4,30,21,51
KOLDA,KOLDA,"SARE BIDJI","SARE BIDJI","SARE DEMBODO",18,22,145,154,299
KOLDA,KOLDA,"SARE BIDJI","SARE BIDJI","SARE DEMBOTHIE",7,8,75,58,133
KOLDA,KOLDA,"SARE BIDJI","SARE BIDJI","NEMA DIANFO (SARE DIANFO )",81,87,501,420,921
KOLDA,KOLDA,"SARE BIDJI","SARE BIDJI","SARE DIANKO",7,20,117,106,223
KOLDA,KOLDA,"SARE BIDJI","SARE BIDJI","SARE GAGNA",19,52,337,230,567
KOLDA,KOLDA,"SARE BIDJI","SARE BIDJI","H1 DAROU ILLIMOU",1,2,9,6,15
KOLDA,KOLDA,"SARE BIDJI","SARE BIDJI","H2 MEDINA BAYE ( NEMA DIANFO II )",75,75,293,307,600
KOLDA,KOLDA,"SARE BIDJI","SARE BIDJI","SARE GOUNDO MBALLO",14,16,91,86,177
KOLDA,KOLDA,"SARE BIDJI","SARE BIDJI","SARE KEDIANG TOBO",10,15,74,72,146
KOLDA,KOLDA,"SARE BIDJI","SARE BIDJI","SARE KEITA SABALY",10,10,51,66,117
KOLDA,KOLDA,"SARE BIDJI","SARE BIDJI","SARE KOLIDIANG",12,15,85,101,186
KOLDA,KOLDA,"SARE BIDJI","SARE BIDJI","SARE KONONG",7,14,79,47,126
KOLDA,KOLDA,"SARE BIDJI","SARE BIDJI","SARE LALY",7,7,27,27,54
KOLDA,KOLDA,"SARE BIDJI","SARE BIDJI","SARE LAMINE BARRY",4,4,22,15,37
KOLDA,KOLDA,"SARE BIDJI","SARE BIDJI","SARE LAMINE DJIBA",7,9,58,55,113
KOLDA,KOLDA,"SARE BIDJI","SARE BIDJI","SARE MALY DIAMANKA (SARE BADIOU)",5,5,28,28,56
KOLDA,KOLDA,"SARE BIDJI","SARE BIDJI","SARE MAOUNDE DIAO (SINTHIANG OUSMANE)",5,8,48,46,94
KOLDA,KOLDA,"SARE BIDJI","SARE BIDJI","SARE MAOUNDE DIASSY",5,11,60,64,124
KOLDA,KOLDA,"SARE BIDJI","SARE BIDJI","SARE MBEGOU",9,11,49,49,98
KOLDA,KOLDA,"SARE BIDJI","SARE BIDJI","SARE MORY",9,13,66,76,142
KOLDA,KOLDA,"SARE BIDJI","SARE BIDJI","SARE MOUSSA SOW",40,55,216,206,422
KOLDA,KOLDA,"SARE BIDJI","SARE BIDJI","SARE SADA",7,10,43,41,84
KOLDA,KOLDA,"SARE BIDJI","SARE BIDJI","SARE SAMBA DIABA",32,40,250,236,486
KOLDA,KOLDA,"SARE BIDJI","SARE BIDJI","SARE SAMBA THIKA",25,44,284,259,543
KOLDA,KOLDA,"SARE BIDJI","SARE BIDJI","SARE SARA",8,10,73,53,126
KOLDA,KOLDA,"SARE BIDJI","SARE BIDJI","SARE SOUNKAROU",3,20,146,146,292
KOLDA,KOLDA,"SARE BIDJI","SARE BIDJI","SARE TAMSIROU",9,10,105,62,167
KOLDA,KOLDA,"SARE BIDJI","SARE BIDJI","SARE WOUDOU",29,39,304,331,635
KOLDA,KOLDA,"SARE BIDJI","SARE BIDJI","SARE YORO MBALLO",10,11,97,97,194
KOLDA,KOLDA,"SARE BIDJI","SARE BIDJI","SAIBANNDING THIAMA",2,5,30,19,49
KOLDA,KOLDA,"SARE BIDJI","SARE BIDJI",SAICOUR,6,23,152,142,294
KOLDA,KOLDA,"SARE BIDJI","SARE BIDJI","SARE DEMBA MBALLO ( SINTHIANG DEMBA MBALLO )",18,22,131,99,230
KOLDA,KOLDA,"SARE BIDJI","SARE BIDJI","SINTHIANG DIAGO",5,8,45,38,83
KOLDA,KOLDA,"SARE BIDJI","SARE BIDJI","SARE DJIMBY",3,3,18,17,35
KOLDA,KOLDA,"SARE BIDJI","SARE BIDJI","SINTHIANG KANDIO (SARE SAMBA KANDE)",22,31,126,132,258
KOLDA,KOLDA,"SARE BIDJI","SARE BIDJI",SOUKOU,24,26,218,185,403
KOLDA,KOLDA,"SARE BIDJI","SARE BIDJI","TABASSAYE YERO DIAMANKA",10,13,54,51,105
KOLDA,KOLDA,"SARE BIDJI","SARE BIDJI","TAGNOUFA FADY",6,7,34,30,64
KOLDA,KOLDA,"SARE BIDJI","SARE BIDJI","TAGNOUFA PATHE",5,9,48,50,98
KOLDA,KOLDA,"SARE BIDJI","SARE BIDJI","TAGNOUFA YERONDING (TABAYEL SAMBA KAMAKO)",4,9,44,51,95
KOLDA,KOLDA,"SARE BIDJI","SARE BIDJI","TEMENTO GOUNDO  (SARE GOUNDO DIAO)",16,28,185,177,362
KOLDA,KOLDA,"SARE BIDJI","SARE BIDJI","TEMENTO KOLIDIANG",5,5,41,36,77
KOLDA,KOLDA,"SARE BIDJI","SARE BIDJI","SARE ALPHA (TEMENTO SAMBA KAMAKO )",9,9,42,36,78
KOLDA,KOLDA,"SARE BIDJI","SARE BIDJI","THIEWELE BESSELE",7,8,54,49,103
KOLDA,KOLDA,"SARE BIDJI","SARE BIDJI","TOUNKOYE ALETTE",8,10,56,71,127
KOLDA,KOLDA,"SARE BIDJI","SARE BIDJI","VELINGARA BOYDO",7,10,133,87,220
KOLDA,KOLDA,"SARE BIDJI","SARE BIDJI","VELINGARA BOUBEL",28,32,148,132,280
KOLDA,KOLDA,"SARE BIDJI","SARE BIDJI","DIAGNETTE KOUTHIA ( VELINGARA KOUTHIA )",6,11,67,64,131
KOLDA,KOLDA,"SARE BIDJI","SARE BIDJI","MAREWE GOUYDY",4,4,15,12,27
KOLDA,KOLDA,"SARE BIDJI",THIETTY,"BOULAL (MEDINA SANKOU SEYDI)",8,15,83,94,177
KOLDA,KOLDA,"SARE BIDJI",THIETTY,DIASSINA,47,61,296,293,589
KOLDA,KOLDA,"SARE BIDJI",THIETTY,"H1 SINTHIANG SELLOU",1,1,3,2,5
KOLDA,KOLDA,"SARE BIDJI",THIETTY,DIEMEGNINKE,3,6,20,27,47
KOLDA,KOLDA,"SARE BIDJI",THIETTY,DIOUMANA,23,26,128,106,234
KOLDA,KOLDA,"SARE BIDJI",THIETTY,"DIYABOUGOU FATAWORO",7,9,40,40,80
KOLDA,KOLDA,"SARE BIDJI",THIETTY,"GALLO COUNDA (SARE AMADOU)",11,22,153,168,321
KOLDA,KOLDA,"SARE BIDJI",THIETTY,"KOGNIARING PATHE",7,7,23,18,41
KOLDA,KOLDA,"SARE BIDJI",THIETTY,"MEDINA BORA",5,6,32,35,67
KOLDA,KOLDA,"SARE BIDJI",THIETTY,"RAOUNA DJIDERE",4,5,33,28,61
KOLDA,KOLDA,"SARE BIDJI",THIETTY,"SANTANDIANG BOIDO",1,2,13,11,24
KOLDA,KOLDA,"SARE BIDJI",THIETTY,"SARE DEMBA BALDE",7,18,95,107,202
KOLDA,KOLDA,"SARE BIDJI",THIETTY,"SARE DEMBA KANDAYE",11,15,86,66,152
KOLDA,KOLDA,"SARE BIDJI",THIETTY,"SARE DEMBA SABALY",6,6,39,38,77
KOLDA,KOLDA,"SARE BIDJI",THIETTY,"SARE FILY",17,21,137,109,246
KOLDA,KOLDA,"SARE BIDJI",THIETTY,"SARE KANTA",13,22,148,105,253
KOLDA,KOLDA,"SARE BIDJI",THIETTY,"H1 SINTHIANG YERO DIAO",2,2,19,12,31
KOLDA,KOLDA,"SARE BIDJI",THIETTY,"SARE KOBA",4,7,56,39,95
KOLDA,KOLDA,"SARE BIDJI",THIETTY,"SINTHIANG KOUBE",7,15,100,74,174
KOLDA,KOLDA,"SARE BIDJI",THIETTY,"SARE MAGNON",15,16,81,80,161
KOLDA,KOLDA,"SARE BIDJI",THIETTY,"SARE MALY KANDE",13,16,85,78,163
KOLDA,KOLDA,"SARE BIDJI",THIETTY,"SARE MOUSSA ALETTE",5,6,32,23,55
KOLDA,KOLDA,"SARE BIDJI",THIETTY,"SARE SIMALY",29,39,228,213,441
KOLDA,KOLDA,"SARE BIDJI",THIETTY,"SINTHIANG AMADOU KANDE",1,4,12,13,25
KOLDA,KOLDA,"SARE BIDJI",THIETTY,"SINTHIANG DEMBA BALDE",8,11,71,54,125
KOLDA,KOLDA,"SARE BIDJI",THIETTY,"SINTHIANG DEMBA DIAO",3,4,21,19,40
KOLDA,KOLDA,"SARE BIDJI",THIETTY,"SINTHIANG DIAMBOYE",3,7,44,42,86
KOLDA,KOLDA,"SARE BIDJI",THIETTY,"SINTHIANG DIOUTA (SINTHIANG MANGA)",4,8,44,39,83
KOLDA,KOLDA,"SARE BIDJI",THIETTY,"H1 SINTHIANG SAMBA ALETTE",2,4,14,11,25
KOLDA,KOLDA,"SARE BIDJI",THIETTY,"SINTHIANG DJIDERE",4,7,43,34,77
KOLDA,KOLDA,"SARE BIDJI",THIETTY,"SINTHIANG FODE",8,8,74,60,134
KOLDA,KOLDA,"SARE BIDJI",THIETTY,"SINTHIANG GALLO KANDE",1,3,13,19,32
KOLDA,KOLDA,"SARE BIDJI",THIETTY,"SINTHIANG SAMBA KOUDORA",1,5,14,17,31
KOLDA,KOLDA,"SARE BIDJI",THIETTY,"SINTHIANG YABOU",3,3,32,32,64
KOLDA,KOLDA,"SARE BIDJI",THIETTY,"SOUKOTO FATAWORO",11,17,78,82,160
KOLDA,KOLDA,"SARE BIDJI",THIETTY,"TABAYEL  SAMBA SABALY  FATAWORO (SARE SAMBA DJIBA)",11,13,71,77,148
KOLDA,KOLDA,"SARE BIDJI",THIETTY,"H1 SINTHIANG IDRISSA",2,2,14,9,23
KOLDA,KOLDA,"SARE BIDJI",THIETTY,THIETTY,31,37,197,204,401
KOLDA,KOLDA,"SARE BIDJI",THIETTY,"H1 SINTHIANG PATHE BALDE",2,3,17,15,32
KOLDA,KOLDA,"SARE BIDJI",THIETTY,"H2 SINTHIANG YERO DEMMO",3,7,35,36,71
KOLDA,KOLDA,"SARE BIDJI",THIETTY,THIEOUNGAL,7,7,35,23,58
KOLDA,VELINGARA,VELINGARA,VELINGARA,CENTRE,326,518,2146,2153,4299
KOLDA,VELINGARA,VELINGARA,VELINGARA,OUEST,325,429,1923,1919,3842
KOLDA,VELINGARA,VELINGARA,VELINGARA,"SINTHIANG HOULATA",348,515,1894,1878,3772
KOLDA,VELINGARA,VELINGARA,VELINGARA,"VELINGARA PEULH",309,405,1269,1361,2630
KOLDA,VELINGARA,VELINGARA,VELINGARA,"SINTHIANG AIDARA",256,351,1266,1318,2584
KOLDA,VELINGARA,VELINGARA,VELINGARA,"CHÂTEAU D'EAU",509,535,2070,2022,4092
KOLDA,VELINGARA,VELINGARA,VELINGARA,MAREWE,127,133,471,468,939
KOLDA,VELINGARA,VELINGARA,VELINGARA,"SINTHIANG WANBABE",126,136,590,515,1105
KOLDA,VELINGARA,VELINGARA,VELINGARA,NASSOUROULAHI,413,451,1910,1746,3656
KOLDA,VELINGARA,VELINGARA,VELINGARA,HAFIA,273,301,1191,1075,2266
KOLDA,VELINGARA,VELINGARA,VELINGARA,"THIANKAN I",211,265,1231,1230,2461
KOLDA,VELINGARA,VELINGARA,VELINGARA,"THIANKAN II",430,467,2160,1991,4151
KOLDA,VELINGARA,VELINGARA,VELINGARA,"SAMBA I5 ANS",193,290,1317,1398,2715
KOLDA,VELINGARA,VELINGARA,VELINGARA,HLM,72,80,371,325,696
KOLDA,VELINGARA,VELINGARA,VELINGARA,FOULBE,583,818,2992,3231,6223
KOLDA,VELINGARA,BONCONTO,BONCONTO,AFIA,10,10,67,34,101
KOLDA,VELINGARA,BONCONTO,BONCONTO,"H1 DAROU SALAM( SINTHIANG NANGUELY)",7,9,46,41,87
KOLDA,VELINGARA,BONCONTO,BONCONTO,AMANANTOULAYE,24,38,155,123,278
KOLDA,VELINGARA,BONCONTO,BONCONTO,BANDIAGARA,8,8,41,38,79
KOLDA,VELINGARA,BONCONTO,BONCONTO,BANTANCOUNTOU,34,42,220,225,445
KOLDA,VELINGARA,BONCONTO,BONCONTO,"H1 SINTHIANG KAIRABA",2,2,17,10,27
KOLDA,VELINGARA,BONCONTO,BONCONTO,BONCONTO,112,130,545,571,1116
KOLDA,VELINGARA,BONCONTO,BONCONTO,"BONCONTO FOUTA",46,50,248,203,451
KOLDA,VELINGARA,BONCONTO,BONCONTO,"H1 SINTHIANG YOWTOU",14,16,83,66,149
KOLDA,VELINGARA,BONCONTO,BONCONTO,"DAROU IDJIRATOU",161,205,1108,972,2080
KOLDA,VELINGARA,BONCONTO,BONCONTO,"H1 DAROU BARKATOU(SINTHIANG ALIOU)",18,20,165,124,289
KOLDA,VELINGARA,BONCONTO,BONCONTO,"H2 DAROU GADA",32,39,165,166,331
KOLDA,VELINGARA,BONCONTO,BONCONTO,"DAROU SALAM DJIDERE",32,39,173,131,304
KOLDA,VELINGARA,BONCONTO,BONCONTO,"DAROU SALAM SADOU BARRY",8,11,27,48,75
KOLDA,VELINGARA,BONCONTO,BONCONTO,"DIANDIANG GUELADIO",34,45,235,176,411
KOLDA,VELINGARA,BONCONTO,BONCONTO,"DYABOUGOU FODE (MANDOUGOU FODE)",13,14,76,100,176
KOLDA,VELINGARA,BONCONTO,BONCONTO,FASS,14,17,85,83,168
KOLDA,VELINGARA,BONCONTO,BONCONTO,"HAMDALLAYE BARKA",15,16,118,118,236
KOLDA,VELINGARA,BONCONTO,BONCONTO,"HAMDALAYE KOULA",10,10,56,41,97
KOLDA,VELINGARA,BONCONTO,BONCONTO,"KAEL BASSEL",13,18,63,65,128
KOLDA,VELINGARA,BONCONTO,BONCONTO,"H1 MAMEL BOIRO",9,10,34,26,60
KOLDA,VELINGARA,BONCONTO,BONCONTO,"H2 KOUREGA",1,2,8,6,14
KOLDA,VELINGARA,BONCONTO,BONCONTO,"KEREWANE PAKANE",16,17,77,71,148
KOLDA,VELINGARA,BONCONTO,BONCONTO,KODIONTE,26,47,169,174,343
KOLDA,VELINGARA,BONCONTO,BONCONTO,"KOUNDARA KABA",15,23,115,110,225
KOLDA,VELINGARA,BONCONTO,BONCONTO,"H1 SINTHIANG KABA",13,14,66,80,146
KOLDA,VELINGARA,BONCONTO,BONCONTO,MAMPATAYEL,8,8,71,60,131
KOLDA,VELINGARA,BONCONTO,BONCONTO,"MANDOUNKOU KALY",10,10,66,42,108
KOLDA,VELINGARA,BONCONTO,BONCONTO,"MOUNDOUNG KANANKE",12,18,73,56,129
KOLDA,VELINGARA,BONCONTO,BONCONTO,"MOUNTING HAMADY",30,36,211,199,410
KOLDA,VELINGARA,BONCONTO,BONCONTO,"NETERE PAKANE",12,15,46,39,85
KOLDA,VELINGARA,BONCONTO,BONCONTO,"H1 SARE YAYA",5,7,12,21,33
KOLDA,VELINGARA,BONCONTO,BONCONTO,"H2 SARE DIAMALAL",3,3,13,8,21
KOLDA,VELINGARA,BONCONTO,BONCONTO,"H3 SARE ABDOUL",1,1,7,5,12
KOLDA,VELINGARA,BONCONTO,BONCONTO,PAKANE,26,34,153,132,285
KOLDA,VELINGARA,BONCONTO,BONCONTO,"PAKINIA MAOUNDE",20,26,102,125,227
KOLDA,VELINGARA,BONCONTO,BONCONTO,"PATIMCOUTA PAKANE",46,51,202,188,390
KOLDA,VELINGARA,BONCONTO,BONCONTO,"H2 SINTHIANG SARA",1,2,5,4,9
KOLDA,VELINGARA,BONCONTO,BONCONTO,"SAHATOU GOUNASS",32,45,326,244,570
KOLDA,VELINGARA,BONCONTO,BONCONTO,"SARE BOSSODIE",87,104,550,463,1013
KOLDA,VELINGARA,BONCONTO,BONCONTO,"SARE YERO BOULY (SARE BOULY)",5,5,41,42,83
KOLDA,VELINGARA,BONCONTO,BONCONTO,"SINTHIANG BAILO",28,36,139,139,278
KOLDA,VELINGARA,BONCONTO,BONCONTO,"SINTHIANG PAKINIA",48,49,197,223,420
KOLDA,VELINGARA,BONCONTO,BONCONTO,"TEYEL (TEYEL PAKANE)",8,8,44,32,76
KOLDA,VELINGARA,BONCONTO,BONCONTO,THIANCOUNE,46,49,234,165,399
KOLDA,VELINGARA,BONCONTO,BONCONTO,"THIOMOLOCK DIAM",28,33,179,180,359
KOLDA,VELINGARA,BONCONTO,BONCONTO,"THIOMOLOCK TOMBONG",31,40,189,189,378
KOLDA,VELINGARA,BONCONTO,BONCONTO,"H1 SINTHIANG YERO",10,11,25,37,62
KOLDA,VELINGARA,BONCONTO,BONCONTO,"H1 SINTHIANG OUMAR DIA",1,1,8,5,13
KOLDA,VELINGARA,BONCONTO,LINKERING,"AINOUMADY KOUNDIAMA",69,110,547,573,1120
KOLDA,VELINGARA,BONCONTO,LINKERING,AKANE,69,97,522,502,1024
KOLDA,VELINGARA,BONCONTO,LINKERING,BANTAGHEL,7,10,30,27,57
KOLDA,VELINGARA,BONCONTO,LINKERING,"BOUMOUNE (SAMAYE)",62,90,350,333,683
KOLDA,VELINGARA,BONCONTO,LINKERING,BOUSSOURA,20,25,123,103,226
KOLDA,VELINGARA,BONCONTO,LINKERING,DARSALAM,48,61,203,226,429
KOLDA,VELINGARA,BONCONTO,LINKERING,"H1 YAMAL",6,6,18,25,43
KOLDA,VELINGARA,BONCONTO,LINKERING,"DEMBA NIAMA",30,33,144,121,265
KOLDA,VELINGARA,BONCONTO,LINKERING,DIAMWELY,16,18,70,66,136
KOLDA,VELINGARA,BONCONTO,LINKERING,"H1 BANIRE",8,9,24,33,57
KOLDA,VELINGARA,BONCONTO,LINKERING,"HAFIA MBEMBA (KALIFOUROU)",285,310,1233,1145,2378
KOLDA,VELINGARA,BONCONTO,LINKERING,"H1 GANDIANDJIE",10,13,55,48,103
KOLDA,VELINGARA,BONCONTO,LINKERING,ISLAM,113,129,742,734,1476
KOLDA,VELINGARA,BONCONTO,LINKERING,KAKOFA,12,12,47,44,91
KOLDA,VELINGARA,BONCONTO,LINKERING,"KAMBASSE (SARE HOGO)",8,8,29,31,60
KOLDA,VELINGARA,BONCONTO,LINKERING,"H1 OURESSI",22,26,119,139,258
KOLDA,VELINGARA,BONCONTO,LINKERING,KANKELEFA,4,6,46,34,80
KOLDA,VELINGARA,BONCONTO,LINKERING,"H1 SARE NOUMODY",5,5,26,25,51
KOLDA,VELINGARA,BONCONTO,LINKERING,"H2 SINTHIANG COULIWOURY",5,7,38,30,68
KOLDA,VELINGARA,BONCONTO,LINKERING,KANKOUYAMA,18,21,118,112,230
KOLDA,VELINGARA,BONCONTO,LINKERING,KANSAMBA,4,7,29,23,52
KOLDA,VELINGARA,BONCONTO,LINKERING,KAPAYEL,12,12,54,54,108
KOLDA,VELINGARA,BONCONTO,LINKERING,"H1 SINTHIANG ALLAWOU",4,10,32,41,73
KOLDA,VELINGARA,BONCONTO,LINKERING,"H2 SINTHIANG SARA",12,18,84,71,155
KOLDA,VELINGARA,BONCONTO,LINKERING,"KARAMATOU (KOUNTANG)",7,8,26,37,63
KOLDA,VELINGARA,BONCONTO,LINKERING,"KENEBA PAKANE",42,43,175,177,352
KOLDA,VELINGARA,BONCONTO,LINKERING,KOEL,32,43,173,147,320
KOLDA,VELINGARA,BONCONTO,LINKERING,"H1 ALKALY",9,11,55,37,92
KOLDA,VELINGARA,BONCONTO,LINKERING,KOUTADJI,13,16,59,50,109
KOLDA,VELINGARA,BONCONTO,LINKERING,LINKERING,396,432,1877,1921,3798
KOLDA,VELINGARA,BONCONTO,LINKERING,"H1 SARE META (MEDINA META)",4,4,5,4,9
KOLDA,VELINGARA,BONCONTO,LINKERING,"MBALLOCOUNDA PAKANE",15,17,72,69,141
KOLDA,VELINGARA,BONCONTO,LINKERING,"MEDINA KALIFOUROU",8,8,33,34,67
KOLDA,VELINGARA,BONCONTO,LINKERING,"MEDINA SEKOU",51,56,271,242,513
KOLDA,VELINGARA,BONCONTO,LINKERING,"MISSIRAH SAMBA (MOUGNINI)",67,79,404,332,736
KOLDA,VELINGARA,BONCONTO,LINKERING,"H1 SINTHIANG CISSAO",4,4,13,9,22
KOLDA,VELINGARA,BONCONTO,LINKERING,SANSANCOTO,82,111,493,418,911
KOLDA,VELINGARA,BONCONTO,LINKERING,"SARE BAWALA",43,45,210,211,421
KOLDA,VELINGARA,BONCONTO,LINKERING,"SARE OURA",67,68,324,333,657
KOLDA,VELINGARA,BONCONTO,LINKERING,"SARE PATHE",9,12,44,53,97
KOLDA,VELINGARA,BONCONTO,LINKERING,"H1 SINTHIANG YOUNOUSS",1,1,2,3,5
KOLDA,VELINGARA,BONCONTO,LINKERING,"SINTHIANG DIOUMA",6,9,32,27,59
KOLDA,VELINGARA,BONCONTO,LINKERING,"SINTHIANG LINKERING (SARE NIALA)",8,11,44,42,86
KOLDA,VELINGARA,BONCONTO,LINKERING,"H1 DOUNGAL",2,4,19,19,38
KOLDA,VELINGARA,BONCONTO,LINKERING,"TEMENTO MAOUNDE (MALOYEL)",9,14,90,81,171
KOLDA,VELINGARA,BONCONTO,LINKERING,"TEMENTO PAKANE",20,21,133,129,262
KOLDA,VELINGARA,BONCONTO,LINKERING,"H2 SINTHIANG MAMOUDOU",7,7,26,26,52
KOLDA,VELINGARA,BONCONTO,LINKERING,THIAFENE,18,20,83,84,167
KOLDA,VELINGARA,BONCONTO,LINKERING,"H1 MADOUYA",14,18,72,61,133
KOLDA,VELINGARA,BONCONTO,LINKERING,"THIES PAKANE",27,32,203,174,377
KOLDA,VELINGARA,BONCONTO,LINKERING,TONGUIA,85,101,591,648,1239
KOLDA,VELINGARA,BONCONTO,LINKERING,"H1 SARE MOUSSA",11,19,65,64,129
KOLDA,VELINGARA,BONCONTO,LINKERING,"VELINGARA PAKANE",32,45,204,170,374
KOLDA,VELINGARA,BONCONTO,LINKERING,WADYATOULAYE,157,175,952,911,1863
KOLDA,VELINGARA,BONCONTO,"MEDINA GOUNASS",AINEMADY,19,34,259,280,539
KOLDA,VELINGARA,BONCONTO,"MEDINA GOUNASS","H1 ABISSAMA OUNA",10,11,56,54,110
KOLDA,VELINGARA,BONCONTO,"MEDINA GOUNASS","H2 MADINIL ELMI",6,6,49,40,89
KOLDA,VELINGARA,BONCONTO,"MEDINA GOUNASS","AINEMADY ANTENNE",14,14,137,107,244
KOLDA,VELINGARA,BONCONTO,"MEDINA GOUNASS",BARKATOU,148,192,1018,1001,2019
KOLDA,VELINGARA,BONCONTO,"MEDINA GOUNASS",BOUSTANE,11,20,73,72,145
KOLDA,VELINGARA,BONCONTO,"MEDINA GOUNASS",DAYFA,16,17,131,108,239
KOLDA,VELINGARA,BONCONTO,"MEDINA GOUNASS","DEMBA COUMBA",23,31,181,203,384
KOLDA,VELINGARA,BONCONTO,"MEDINA GOUNASS","H1 NIOKOLO",9,9,55,29,84
KOLDA,VELINGARA,BONCONTO,"MEDINA GOUNASS","DEMES COUNDA",8,11,55,55,110
KOLDA,VELINGARA,BONCONTO,"MEDINA GOUNASS",FASS,43,51,407,391,798
KOLDA,VELINGARA,BONCONTO,"MEDINA GOUNASS","H1 BOUSSOURA",15,16,127,104,231
KOLDA,VELINGARA,BONCONTO,"MEDINA GOUNASS","MEDINA DIAM (SINTHIOU THIERNO SAMBA)",12,17,88,78,166
KOLDA,VELINGARA,BONCONTO,"MEDINA GOUNASS","MEDINA GOUNASS",4292,5591,37155,36216,73371
KOLDA,VELINGARA,BONCONTO,"MEDINA GOUNASS","H1 DAMADE",19,22,96,72,168
KOLDA,VELINGARA,BONCONTO,"MEDINA GOUNASS","H2 OUFANY",36,39,273,234,507
KOLDA,VELINGARA,BONCONTO,"MEDINA GOUNASS","H3  BOUSTANE LIMFITAKHI",34,40,271,251,522
KOLDA,VELINGARA,BONCONTO,"MEDINA GOUNASS","MEDINA PAKANE",29,30,198,197,395
KOLDA,VELINGARA,BONCONTO,"MEDINA GOUNASS","MEDINA TOUAT",154,201,1714,1817,3531
KOLDA,VELINGARA,BONCONTO,"MEDINA GOUNASS","MISSIRAH KOUBA",24,29,171,191,362
KOLDA,VELINGARA,BONCONTO,"MEDINA GOUNASS","MISSSIRAH FOURATH (MISSIRAH MEDINE)",68,82,621,554,1175
KOLDA,VELINGARA,BONCONTO,"MEDINA GOUNASS","MOUNDOUNG SANKOULE",26,30,173,169,342
KOLDA,VELINGARA,BONCONTO,"MEDINA GOUNASS",OUBA,22,31,372,238,610
KOLDA,VELINGARA,BONCONTO,"MEDINA GOUNASS","PASSOUNGOU (KINSY RAWDATOU)",23,30,138,140,278
KOLDA,VELINGARA,BONCONTO,"MEDINA GOUNASS","H1 THIANCOUNG BALLA",24,29,138,126,264
KOLDA,VELINGARA,BONCONTO,"MEDINA GOUNASS","H2 THIANCOUNG BOWE",15,20,230,90,320
KOLDA,VELINGARA,BONCONTO,"MEDINA GOUNASS",RABAT,46,51,346,369,715
KOLDA,VELINGARA,BONCONTO,"MEDINA GOUNASS",SADATOU,46,57,396,427,823
KOLDA,VELINGARA,BONCONTO,"MEDINA GOUNASS",SAM,20,23,280,155,435
KOLDA,VELINGARA,BONCONTO,"MEDINA GOUNASS",SOUNATOU,33,39,241,227,468
KOLDA,VELINGARA,BONCONTO,"MEDINA GOUNASS","SOUROUYEL NDIOBO",13,13,108,111,219
KOLDA,VELINGARA,BONCONTO,"MEDINA GOUNASS",TAIBATOU,20,30,148,174,322
KOLDA,VELINGARA,BONCONTO,"MEDINA GOUNASS",TAWBATOU,23,25,220,241,461
KOLDA,VELINGARA,BONCONTO,"MEDINA GOUNASS","H1 FAYDATOU",14,14,135,128,263
KOLDA,VELINGARA,BONCONTO,"MEDINA GOUNASS",TEMENTO,14,15,124,120,244
KOLDA,VELINGARA,BONCONTO,"MEDINA GOUNASS","SARE DIOULDO SOW",7,8,62,70,132
KOLDA,VELINGARA,BONCONTO,"SINTHIANG KOUNDARA","BOLY BANA",18,24,152,128,280
KOLDA,VELINGARA,BONCONTO,"SINTHIANG KOUNDARA",BOULIMBOU,17,44,335,387,722
KOLDA,VELINGARA,BONCONTO,"SINTHIANG KOUNDARA",BOURCOUNDA,41,50,213,214,427
KOLDA,VELINGARA,BONCONTO,"SINTHIANG KOUNDARA",BOUSSOURA,9,9,65,73,138
KOLDA,VELINGARA,BONCONTO,"SINTHIANG KOUNDARA",BOYENGUEL,112,120,649,633,1282
KOLDA,VELINGARA,BONCONTO,"SINTHIANG KOUNDARA","COUMBA DIOUMA",35,41,222,213,435
KOLDA,VELINGARA,BONCONTO,"SINTHIANG KOUNDARA","H2 YERO KEBOU",8,10,80,72,152
KOLDA,VELINGARA,BONCONTO,"SINTHIANG KOUNDARA","COUMBA DIOUMA COLY",12,15,135,106,241
KOLDA,VELINGARA,BONCONTO,"SINTHIANG KOUNDARA","H1 SARE LOUNTANG",5,6,51,49,100
KOLDA,VELINGARA,BONCONTO,"SINTHIANG KOUNDARA",COURBAMBEYE,76,85,642,502,1144
KOLDA,VELINGARA,BONCONTO,"SINTHIANG KOUNDARA","DAROU SALAM MANDA",698,811,2949,2840,5789
KOLDA,VELINGARA,BONCONTO,"SINTHIANG KOUNDARA","DAROU SALAM MANDING",8,8,51,49,100
KOLDA,VELINGARA,BONCONTO,"SINTHIANG KOUNDARA",DIOUM,9,11,116,73,189
KOLDA,VELINGARA,BONCONTO,"SINTHIANG KOUNDARA",DJIDA,25,27,215,183,398
KOLDA,VELINGARA,BONCONTO,"SINTHIANG KOUNDARA","DONGAL MARO",11,14,81,84,165
KOLDA,VELINGARA,BONCONTO,"SINTHIANG KOUNDARA","DYABOUGOU COLY",47,58,310,282,592
KOLDA,VELINGARA,BONCONTO,"SINTHIANG KOUNDARA",FOUDOU,78,87,442,301,743
KOLDA,VELINGARA,BONCONTO,"SINTHIANG KOUNDARA","H1 NAJAF",42,44,159,81,240
KOLDA,VELINGARA,BONCONTO,"SINTHIANG KOUNDARA","H2 SANCOU SAGNA",2,4,51,36,87
KOLDA,VELINGARA,BONCONTO,"SINTHIANG KOUNDARA",GAMBISSARA,22,38,409,430,839
KOLDA,VELINGARA,BONCONTO,"SINTHIANG KOUNDARA","HAMDALAYE MALANG (THIEWIRE)",35,43,169,183,352
KOLDA,VELINGARA,BONCONTO,"SINTHIANG KOUNDARA","HEREMANCONO I",28,39,175,170,345
KOLDA,VELINGARA,BONCONTO,"SINTHIANG KOUNDARA","HEREMANCONO II  (SARE DELLA)",19,27,193,226,419
KOLDA,VELINGARA,BONCONTO,"SINTHIANG KOUNDARA","KALIFOUROU BACARY",7,13,82,62,144
KOLDA,VELINGARA,BONCONTO,"SINTHIANG KOUNDARA",KANDIAMA,17,27,120,111,231
KOLDA,VELINGARA,BONCONTO,"SINTHIANG KOUNDARA",KATABA,22,40,211,194,405
KOLDA,VELINGARA,BONCONTO,"SINTHIANG KOUNDARA","KENEBA SADIO",9,9,70,29,99
KOLDA,VELINGARA,BONCONTO,"SINTHIANG KOUNDARA","H1 SINTHIANG SANOU",9,10,61,27,88
KOLDA,VELINGARA,BONCONTO,"SINTHIANG KOUNDARA",KIRLY,5,11,72,70,142
KOLDA,VELINGARA,BONCONTO,"SINTHIANG KOUNDARA",KOAR,7,8,87,69,156
KOLDA,VELINGARA,BONCONTO,"SINTHIANG KOUNDARA","KOCOUM DOULO",21,24,150,164,314
KOLDA,VELINGARA,BONCONTO,"SINTHIANG KOUNDARA","H1 KOCOUM SAMBA LY",4,4,24,23,47
KOLDA,VELINGARA,BONCONTO,"SINTHIANG KOUNDARA","KOULAYE BALLA",22,23,170,159,329
KOLDA,VELINGARA,BONCONTO,"SINTHIANG KOUNDARA",KOURYANTY,30,37,292,251,543
KOLDA,VELINGARA,BONCONTO,"SINTHIANG KOUNDARA",MALEA,31,37,227,205,432
KOLDA,VELINGARA,BONCONTO,"SINTHIANG KOUNDARA","H1 SINTHIANG NGAGARY",3,3,31,26,57
KOLDA,VELINGARA,BONCONTO,"SINTHIANG KOUNDARA","MANDA DOUANES",274,299,1091,1168,2259
KOLDA,VELINGARA,BONCONTO,"SINTHIANG KOUNDARA","H1 SARE ABIBOU",5,5,18,23,41
KOLDA,VELINGARA,BONCONTO,"SINTHIANG KOUNDARA","MANDA VILLAGE",9,15,86,76,162
KOLDA,VELINGARA,BONCONTO,"SINTHIANG KOUNDARA","MANDING MOUSSA",12,15,81,81,162
KOLDA,VELINGARA,BONCONTO,"SINTHIANG KOUNDARA",MBALLOCOUNDA,33,38,174,119,293
KOLDA,VELINGARA,BONCONTO,"SINTHIANG KOUNDARA","H1 WOROFISS",5,13,58,30,88
KOLDA,VELINGARA,BONCONTO,"SINTHIANG KOUNDARA","H2 PAKANE",5,9,54,26,80
KOLDA,VELINGARA,BONCONTO,"SINTHIANG KOUNDARA","MEDINA AFIA",140,146,794,712,1506
KOLDA,VELINGARA,BONCONTO,"SINTHIANG KOUNDARA","MEDINA CHERIF",40,46,227,250,477
KOLDA,VELINGARA,BONCONTO,"SINTHIANG KOUNDARA","MEDINA KOCOUM",33,53,410,461,871
KOLDA,VELINGARA,BONCONTO,"SINTHIANG KOUNDARA","H1 HAMDALAYE THIERNO",10,13,139,139,278
KOLDA,VELINGARA,BONCONTO,"SINTHIANG KOUNDARA","MISSIRAH PADION",20,22,76,74,150
KOLDA,VELINGARA,BONCONTO,"SINTHIANG KOUNDARA",NAOUDE,19,26,131,124,255
KOLDA,VELINGARA,BONCONTO,"SINTHIANG KOUNDARA",NGANIARE,13,14,69,66,135
KOLDA,VELINGARA,BONCONTO,"SINTHIANG KOUNDARA",NGHAWOL,15,16,86,54,140
KOLDA,VELINGARA,BONCONTO,"SINTHIANG KOUNDARA","RAWADATOU GOULOUMBOU",142,154,799,731,1530
KOLDA,VELINGARA,BONCONTO,"SINTHIANG KOUNDARA",SAMBACOUNDA,20,22,68,79,147
KOLDA,VELINGARA,BONCONTO,"SINTHIANG KOUNDARA","SARE BAKHOULEMA",15,16,73,62,135
KOLDA,VELINGARA,BONCONTO,"SINTHIANG KOUNDARA","H1 DAROU SALAM BALLA",5,5,33,21,54
KOLDA,VELINGARA,BONCONTO,"SINTHIANG KOUNDARA","SARE BALLA (PK XII)",57,61,223,238,461
KOLDA,VELINGARA,BONCONTO,"SINTHIANG KOUNDARA","H1 TAIBATOU ANTENNE PK XII",6,6,51,50,101
KOLDA,VELINGARA,BONCONTO,"SINTHIANG KOUNDARA","SARE BOKY",24,25,135,147,282
KOLDA,VELINGARA,BONCONTO,"SINTHIANG KOUNDARA","H1 SINTHIOU THIERNO",6,6,46,54,100
KOLDA,VELINGARA,BONCONTO,"SINTHIANG KOUNDARA","SARE DEMBA",11,14,83,87,170
KOLDA,VELINGARA,BONCONTO,"SINTHIANG KOUNDARA","SARE DIAOBE",25,31,186,165,351
KOLDA,VELINGARA,BONCONTO,"SINTHIANG KOUNDARA","SARE DIOULDE",62,64,280,278,558
KOLDA,VELINGARA,BONCONTO,"SINTHIANG KOUNDARA","H1 SARE SAMBAYEL SALLA",12,13,75,66,141
KOLDA,VELINGARA,BONCONTO,"SINTHIANG KOUNDARA","H2 SARE AMADOU COUMBA BA",17,21,152,140,292
KOLDA,VELINGARA,BONCONTO,"SINTHIANG KOUNDARA","H3 SARE BELLO",6,8,50,42,92
KOLDA,VELINGARA,BONCONTO,"SINTHIANG KOUNDARA","SARE KOULE DIALLO",9,9,57,50,107
KOLDA,VELINGARA,BONCONTO,"SINTHIANG KOUNDARA","SARE MBAYE",8,8,88,80,168
KOLDA,VELINGARA,BONCONTO,"SINTHIANG KOUNDARA","SARE MODOU",14,14,86,84,170
KOLDA,VELINGARA,BONCONTO,"SINTHIANG KOUNDARA","SARE MODY",4,5,43,42,85
KOLDA,VELINGARA,BONCONTO,"SINTHIANG KOUNDARA","SARE PATHE MANDOU",15,16,159,154,313
KOLDA,VELINGARA,BONCONTO,"SINTHIANG KOUNDARA","SARE SOTO",4,4,42,30,72
KOLDA,VELINGARA,BONCONTO,"SINTHIANG KOUNDARA","SARE WALY",17,20,230,228,458
KOLDA,VELINGARA,BONCONTO,"SINTHIANG KOUNDARA","SARE YORO POULO",14,16,104,127,231
KOLDA,VELINGARA,BONCONTO,"SINTHIANG KOUNDARA",SIMBAYE,17,19,172,140,312
KOLDA,VELINGARA,BONCONTO,"SINTHIANG KOUNDARA","SINTHIANG COUMBA DIOUMA",8,8,45,53,98
KOLDA,VELINGARA,BONCONTO,"SINTHIANG KOUNDARA","SINTHIANG DADY DEME",22,28,164,147,311
KOLDA,VELINGARA,BONCONTO,"SINTHIANG KOUNDARA","SINTHIANG KOUNDARA",226,249,1125,1111,2236
KOLDA,VELINGARA,BONCONTO,"SINTHIANG KOUNDARA","SINTHIANG MAMADOU EGUE",21,34,279,310,589
KOLDA,VELINGARA,BONCONTO,"SINTHIANG KOUNDARA","SINTHIANG GORI",34,36,158,171,329
KOLDA,VELINGARA,BONCONTO,"SINTHIANG KOUNDARA","SINTHIANG SAMBA SOW",9,9,62,60,122
KOLDA,VELINGARA,BONCONTO,"SINTHIANG KOUNDARA","SINTHIANG SARA",11,12,51,54,105
KOLDA,VELINGARA,BONCONTO,"SINTHIANG KOUNDARA","SINTHIOUROU SAMBA FOULAH",35,38,273,208,481
KOLDA,VELINGARA,BONCONTO,"SINTHIANG KOUNDARA",SYCOUNDA,17,20,92,57,149
KOLDA,VELINGARA,BONCONTO,"SINTHIANG KOUNDARA",THIEWAL,32,39,250,247,497
KOLDA,VELINGARA,BONCONTO,"SINTHIANG KOUNDARA","THIEWEL BESSEL",9,10,64,50,114
KOLDA,VELINGARA,BONCONTO,"SINTHIANG KOUNDARA","H1 BOYEBE",6,6,36,35,71
KOLDA,VELINGARA,BONCONTO,"SINTHIANG KOUNDARA",TIMINDALLA,67,81,631,684,1315
KOLDA,VELINGARA,BONCONTO,"SINTHIANG KOUNDARA","H1 SARE BAKANTE",3,3,41,54,95
KOLDA,VELINGARA,BONCONTO,"SINTHIANG KOUNDARA","H2 SARE DIAMOUYA",2,2,33,41,74
KOLDA,VELINGARA,BONCONTO,"SINTHIANG KOUNDARA","WASSADOU KANTORA (SINTHIANG ASSETTE DALLA)",16,18,117,88,205
KOLDA,VELINGARA,BONCONTO,"SINTHIANG KOUNDARA","H1 SINTHIANG LAMABATANG",6,6,59,45,104
KOLDA,VELINGARA,PAKOUR,OUASSADOU,"BAFATA DEMBA",30,35,198,199,397
KOLDA,VELINGARA,PAKOUR,OUASSADOU,BANDIAGARA,13,13,63,54,117
KOLDA,VELINGARA,PAKOUR,OUASSADOU,BOYA,20,24,146,174,320
KOLDA,VELINGARA,PAKOUR,OUASSADOU,"DEMOUSSOR HAMADOU",3,4,12,11,23
KOLDA,VELINGARA,PAKOUR,OUASSADOU,"H1 DEMOUSSOR DEMBA",10,11,62,64,126
KOLDA,VELINGARA,PAKOUR,OUASSADOU,"H2 DEMOUSSOR ANSOU",5,5,31,27,58
KOLDA,VELINGARA,PAKOUR,OUASSADOU,DIALAMBERE,11,12,96,63,159
KOLDA,VELINGARA,PAKOUR,OUASSADOU,DIATTEL,44,57,316,303,619
KOLDA,VELINGARA,PAKOUR,OUASSADOU,DIOULAYEL,17,21,108,105,213
KOLDA,VELINGARA,PAKOUR,OUASSADOU,GAMBISSARA,44,50,275,203,478
KOLDA,VELINGARA,PAKOUR,OUASSADOU,KANARANG,4,7,38,63,101
KOLDA,VELINGARA,PAKOUR,OUASSADOU,KANDECOUNDA,6,9,53,45,98
KOLDA,VELINGARA,PAKOUR,OUASSADOU,"KANEBA DEMBA",20,31,171,101,272
KOLDA,VELINGARA,PAKOUR,OUASSADOU,"H1 MEDINA SADIO",9,11,79,57,136
KOLDA,VELINGARA,PAKOUR,OUASSADOU,KAOUNE,60,76,427,401,828
KOLDA,VELINGARA,PAKOUR,OUASSADOU,"KOULINTO SARE DEMBA ASSETE",20,26,142,147,289
KOLDA,VELINGARA,PAKOUR,OUASSADOU,"H1 SINTHIANG ANSOU",2,2,12,6,18
KOLDA,VELINGARA,PAKOUR,OUASSADOU,"KOLONDINTO FOUTA",26,30,249,206,455
KOLDA,VELINGARA,PAKOUR,OUASSADOU,"KOLONDINTO NIAKO",15,20,173,158,331
KOLDA,VELINGARA,PAKOUR,OUASSADOU,"H1 KANSAMBA",2,5,38,32,70
KOLDA,VELINGARA,PAKOUR,OUASSADOU,KOUMATHIA,10,12,86,94,180
KOLDA,VELINGARA,PAKOUR,OUASSADOU,KOUTHIOYE,40,47,216,235,451
KOLDA,VELINGARA,PAKOUR,OUASSADOU,"H1 SINTHIANG DIOMEL",9,9,33,40,73
KOLDA,VELINGARA,PAKOUR,OUASSADOU,MBALLOCOUNDA,3,3,18,14,32
KOLDA,VELINGARA,PAKOUR,OUASSADOU,"SARE ANSOU",35,35,168,152,320
KOLDA,VELINGARA,PAKOUR,OUASSADOU,"DEMBA COULA",36,49,263,258,521
KOLDA,VELINGARA,PAKOUR,OUASSADOU,"MEDINA POUSSANG",35,51,317,359,676
KOLDA,VELINGARA,PAKOUR,OUASSADOU,"MINA BACARY",11,15,98,93,191
KOLDA,VELINGARA,PAKOUR,OUASSADOU,"MISSIRAH MAOUNDE",3,6,30,27,57
KOLDA,VELINGARA,PAKOUR,OUASSADOU,"H1 SINTHIANG BASSI",7,8,45,48,93
KOLDA,VELINGARA,PAKOUR,OUASSADOU,"MISSIRAH THIOURKI",32,37,194,176,370
KOLDA,VELINGARA,PAKOUR,OUASSADOU,NIANAO,190,213,955,877,1832
KOLDA,VELINGARA,PAKOUR,OUASSADOU,NIANGOURE,73,79,525,480,1005
KOLDA,VELINGARA,PAKOUR,OUASSADOU,OUASSADOU,192,214,1077,1012,2089
KOLDA,VELINGARA,PAKOUR,OUASSADOU,PAYOUNGOU,42,69,436,449,885
KOLDA,VELINGARA,PAKOUR,OUASSADOU,PIRA,20,28,163,168,331
KOLDA,VELINGARA,PAKOUR,OUASSADOU,"PRING MAOUNDE",47,51,307,256,563
KOLDA,VELINGARA,PAKOUR,OUASSADOU,"SAHARICOUNDA (SARE BADIOU)",9,12,75,56,131
KOLDA,VELINGARA,PAKOUR,OUASSADOU,SAMASSASSANG,23,26,131,116,247
KOLDA,VELINGARA,PAKOUR,OUASSADOU,"SARE SAMBA LAO",15,15,88,71,159
KOLDA,VELINGARA,PAKOUR,OUASSADOU,"H1 MEDINA MALANG",1,3,18,25,43
KOLDA,VELINGARA,PAKOUR,OUASSADOU,"SARE DIAE",10,12,72,58,130
KOLDA,VELINGARA,PAKOUR,OUASSADOU,"H1 SARE LALY",6,6,21,20,41
KOLDA,VELINGARA,PAKOUR,OUASSADOU,"SARE HAMADY",22,24,125,104,229
KOLDA,VELINGARA,PAKOUR,OUASSADOU,"H1 SARE BOURANG",13,14,67,55,122
KOLDA,VELINGARA,PAKOUR,OUASSADOU,"H2 SARE SAMBA DIAE",6,7,34,25,59
KOLDA,VELINGARA,PAKOUR,OUASSADOU,"SARE HAMIDOU",10,13,35,24,59
KOLDA,VELINGARA,PAKOUR,OUASSADOU,"SARE KANTA",22,32,171,208,379
KOLDA,VELINGARA,PAKOUR,OUASSADOU,"SARE KOBA",6,10,60,43,103
KOLDA,VELINGARA,PAKOUR,OUASSADOU,"SARE NAFA",18,30,189,159,348
KOLDA,VELINGARA,PAKOUR,OUASSADOU,"SARE OGNA",30,36,318,329,647
KOLDA,VELINGARA,PAKOUR,OUASSADOU,"H1 SARE DEMBAYEL DIAO",12,12,81,87,168
KOLDA,VELINGARA,PAKOUR,OUASSADOU,"H2 SINTHIANG FALY",1,2,8,16,24
KOLDA,VELINGARA,PAKOUR,OUASSADOU,"SARE SADIO",14,15,87,68,155
KOLDA,VELINGARA,PAKOUR,OUASSADOU,"H1 DIOOURBEL (SARE DEMBA BA)",5,8,31,30,61
KOLDA,VELINGARA,PAKOUR,OUASSADOU,"SARE SORI",38,51,213,233,446
KOLDA,VELINGARA,PAKOUR,OUASSADOU,"SARE YERO KANDE",8,9,63,56,119
KOLDA,VELINGARA,PAKOUR,OUASSADOU,SIBIDIANG,4,6,50,48,98
KOLDA,VELINGARA,PAKOUR,OUASSADOU,"SINTHIANG COLY",12,13,69,64,133
KOLDA,VELINGARA,PAKOUR,OUASSADOU,"SINTHIANG DIATEL",6,10,76,75,151
KOLDA,VELINGARA,PAKOUR,OUASSADOU,"SINTHIANG SOULEYMANE",10,10,63,56,119
KOLDA,VELINGARA,PAKOUR,OUASSADOU,THIAYMA,20,21,122,113,235
KOLDA,VELINGARA,PAKOUR,OUASSADOU,"VELINGARA BOUBACAR",12,12,84,93,177
KOLDA,VELINGARA,PAKOUR,OUASSADOU,"MEDINA SAME (SINTHIANG KABA)",19,20,95,84,179
KOLDA,VELINGARA,PAKOUR,OUASSADOU,KOUNTADA,35,39,416,318,734
KOLDA,VELINGARA,PAKOUR,OUASSADOU,"SINTHIANG MADIA",17,17,160,144,304
KOLDA,VELINGARA,PAKOUR,OUASSADOU,"OUASSADOU III",4,10,30,13,43
KOLDA,VELINGARA,PAKOUR,OUASSADOU,"OUASSADOU IV",19,19,58,24,82
KOLDA,VELINGARA,PAKOUR,OUASSADOU,"SALL BANANE",45,45,110,37,147
KOLDA,VELINGARA,PAKOUR,PAROUMBA,BADIOUBATANG,27,40,186,188,374
KOLDA,VELINGARA,PAKOUR,PAROUMBA,"H1 SINTHIANG TAMBA",1,7,30,24,54
KOLDA,VELINGARA,PAKOUR,PAROUMBA,BODORA,30,37,210,189,399
KOLDA,VELINGARA,PAKOUR,PAROUMBA,DAHARATOU,135,185,891,860,1751
KOLDA,VELINGARA,PAKOUR,PAROUMBA,"DARA YERO",27,34,189,173,362
KOLDA,VELINGARA,PAKOUR,PAROUMBA,DIALADIANG,174,233,1082,992,2074
KOLDA,VELINGARA,PAKOUR,PAROUMBA,"H2 SINTHIANG ABDOUL",8,8,51,54,105
KOLDA,VELINGARA,PAKOUR,PAROUMBA,DIANAH,8,10,46,44,90
KOLDA,VELINGARA,PAKOUR,PAROUMBA,"H1 GALLE WOURY",25,33,111,110,221
KOLDA,VELINGARA,PAKOUR,PAROUMBA,"H2 GALLE DJIBY",18,23,69,83,152
KOLDA,VELINGARA,PAKOUR,PAROUMBA,DIARICOUNDA,59,86,442,441,883
KOLDA,VELINGARA,PAKOUR,PAROUMBA,"DIATAMINE SAFERE",21,22,165,128,293
KOLDA,VELINGARA,PAKOUR,PAROUMBA,HOUMANE,76,120,434,466,900
KOLDA,VELINGARA,PAKOUR,PAROUMBA,"H1 SARE YERO",4,7,30,22,52
KOLDA,VELINGARA,PAKOUR,PAROUMBA,"KAEL BESSEL",36,56,251,198,449
KOLDA,VELINGARA,PAKOUR,PAROUMBA,"KALIFOUROU DABA",10,11,54,48,102
KOLDA,VELINGARA,PAKOUR,PAROUMBA,"KAOLACK SEYKOU",14,17,69,89,158
KOLDA,VELINGARA,PAKOUR,PAROUMBA,KATHILATY,60,70,306,307,613
KOLDA,VELINGARA,PAKOUR,PAROUMBA,"H1 BESSOCOUNDA ( SARE MANGAL)",11,21,84,91,175
KOLDA,VELINGARA,PAKOUR,PAROUMBA,"H2 SINDHIE COUSSIRA",4,4,20,19,39
KOLDA,VELINGARA,PAKOUR,PAROUMBA,"KENEBA SAMBA",27,45,206,209,415
KOLDA,VELINGARA,PAKOUR,PAROUMBA,KOLLO,86,107,451,441,892
KOLDA,VELINGARA,PAKOUR,PAROUMBA,KOUFAMBORA,30,67,390,315,705
KOLDA,VELINGARA,PAKOUR,PAROUMBA,KOUMPEBE,19,24,98,91,189
KOLDA,VELINGARA,PAKOUR,PAROUMBA,"MADINA BOBO",31,48,193,190,383
KOLDA,VELINGARA,PAKOUR,PAROUMBA,"H1 MADINA DEMBA",7,9,44,50,94
KOLDA,VELINGARA,PAKOUR,PAROUMBA,"H2 SINTHIANG DIOGO",4,4,21,15,36
KOLDA,VELINGARA,PAKOUR,PAROUMBA,"MADINA BOURE",25,36,199,179,378
KOLDA,VELINGARA,PAKOUR,PAROUMBA,"MADINA MANDOU",65,90,464,444,908
KOLDA,VELINGARA,PAKOUR,PAROUMBA,"MAREWE DEMBA",37,57,260,257,517
KOLDA,VELINGARA,PAKOUR,PAROUMBA,"MATAM MIDIA",46,65,370,337,707
KOLDA,VELINGARA,PAKOUR,PAROUMBA,"PAROUMBA MANDINGUE",61,100,396,373,769
KOLDA,VELINGARA,PAKOUR,PAROUMBA,"H1 SINTHIANG LARY",7,10,30,34,64
KOLDA,VELINGARA,PAKOUR,PAROUMBA,PATIMCOUTA,91,113,609,608,1217
KOLDA,VELINGARA,PAKOUR,PAROUMBA,"SARE NAFA BOIRO",5,6,24,21,45
KOLDA,VELINGARA,PAKOUR,PAROUMBA,"SINTHIANG HANDEBE",3,6,21,18,39
KOLDA,VELINGARA,PAKOUR,PAROUMBA,"SOMA MANDINGUE",34,37,206,200,406
KOLDA,VELINGARA,PAKOUR,PAROUMBA,TEMENTO,179,223,1005,1205,2210
KOLDA,VELINGARA,PAKOUR,PAKOUR,ANAMBECOUTA,55,71,391,359,750
KOLDA,VELINGARA,PAKOUR,PAKOUR,"H1 SINTHIANG FALY",12,19,97,108,205
KOLDA,VELINGARA,PAKOUR,PAKOUR,"H2 SINTHIANG TEMENE",5,7,46,27,73
KOLDA,VELINGARA,PAKOUR,PAKOUR,ARABE,8,16,82,70,152
KOLDA,VELINGARA,PAKOUR,PAKOUR,BOURIA,17,19,121,103,224
KOLDA,VELINGARA,PAKOUR,PAKOUR,DARALABE,49,64,336,340,676
KOLDA,VELINGARA,PAKOUR,PAKOUR,DIANKACOUNDA,17,21,126,124,250
KOLDA,VELINGARA,PAKOUR,PAKOUR,DIAOCOUNDA,79,90,592,580,1172
KOLDA,VELINGARA,PAKOUR,PAKOUR,"SOMA HAMDALLAYE",13,20,98,110,208
KOLDA,VELINGARA,PAKOUR,PAKOUR,KAMBASSE,72,83,522,525,1047
KOLDA,VELINGARA,PAKOUR,PAKOUR,KAOURANE,12,17,88,84,172
KOLDA,VELINGARA,PAKOUR,PAKOUR,"KOPE MAOUNDE",24,29,186,167,353
KOLDA,VELINGARA,PAKOUR,PAKOUR,"LINKETO SAMBA",62,82,494,425,919
KOLDA,VELINGARA,PAKOUR,PAKOUR,"MANATO PEULH",75,94,586,522,1108
KOLDA,VELINGARA,PAKOUR,PAKOUR,"H1 SARE YAYA",7,8,62,43,105
KOLDA,VELINGARA,PAKOUR,PAKOUR,"MAREWE BOURE",19,32,180,154,334
KOLDA,VELINGARA,PAKOUR,PAKOUR,"H1 SINTHIANG BOUBA",5,7,44,47,91
KOLDA,VELINGARA,PAKOUR,PAKOUR,"MAREWE MALANG",26,51,307,252,559
KOLDA,VELINGARA,PAKOUR,PAKOUR,"MEDINA SOUKEL",21,38,249,191,440
KOLDA,VELINGARA,PAKOUR,PAKOUR,PAKOUR,331,383,1960,1865,3825
KOLDA,VELINGARA,PAKOUR,PAKOUR,"H1 SARE AMADOU",15,20,118,96,214
KOLDA,VELINGARA,PAKOUR,PAKOUR,"PAKOUR MAOUNDE",26,32,190,154,344
KOLDA,VELINGARA,PAKOUR,PAKOUR,PANANGHAR,56,93,407,372,779
KOLDA,VELINGARA,PAKOUR,PAKOUR,"POPODIE(SAM MAOUNDE)",39,43,217,187,404
KOLDA,VELINGARA,PAKOUR,PAKOUR,SABALYCOUNDA,7,8,48,31,79
KOLDA,VELINGARA,PAKOUR,PAKOUR,SALIA,20,24,112,104,216
KOLDA,VELINGARA,PAKOUR,PAKOUR,SAMBACOUNDA,58,66,345,349,694
KOLDA,VELINGARA,PAKOUR,PAKOUR,"H1 SINTHIANG IDION",11,19,89,85,174
KOLDA,VELINGARA,PAKOUR,PAKOUR,"SARE GNIRY",8,9,37,43,80
KOLDA,VELINGARA,PAKOUR,PAKOUR,"SARE MAMADY (SINTHIANG DOULA)",9,18,75,81,156
KOLDA,VELINGARA,PAKOUR,PAKOUR,"SARE YORO DIAO",27,27,147,128,275
KOLDA,VELINGARA,PAKOUR,PAKOUR,"THIEWY BESSY SAMBA",11,11,84,75,159
KOLDA,VELINGARA,"SARE COLY SALLE",KANDIA,"BANACOUROU BACARY",5,7,40,44,84
KOLDA,VELINGARA,"SARE COLY SALLE",KANDIA,"H1 SINTHIANG SOUBA",1,1,14,12,26
KOLDA,VELINGARA,"SARE COLY SALLE",KANDIA,"H2 SINTHIANG HAMDALLAYE",5,6,30,31,61
KOLDA,VELINGARA,"SARE COLY SALLE",KANDIA,"BANACOUROU SAMBA",8,13,95,75,170
KOLDA,VELINGARA,"SARE COLY SALLE",KANDIA,"BANTANTO DICORY (SARE YAYA)",7,8,61,59,120
KOLDA,VELINGARA,"SARE COLY SALLE",KANDIA,"BANTANTO SOUNKAROU",25,28,186,192,378
KOLDA,VELINGARA,"SARE COLY SALLE",KANDIA,"BANTANTO THIERNO",4,4,24,21,45
KOLDA,VELINGARA,"SARE COLY SALLE",KANDIA,"BASSY LAMINE (SARE THIERNO BASSY)",16,19,125,135,260
KOLDA,VELINGARA,"SARE COLY SALLE",KANDIA,BOUFENTOU,8,10,79,67,146
KOLDA,VELINGARA,"SARE COLY SALLE",KANDIA,"BOURTO LOUNTANG",12,18,147,145,292
KOLDA,VELINGARA,"SARE COLY SALLE",KANDIA,DAROU,20,40,189,160,349
KOLDA,VELINGARA,"SARE COLY SALLE",KANDIA,DIALAKA,35,54,608,580,1188
KOLDA,VELINGARA,"SARE COLY SALLE",KANDIA,DIALAKEGNY,62,72,431,391,822
KOLDA,VELINGARA,"SARE COLY SALLE",KANDIA,"DIYABOUGOU MOUSSA (SARE MOUSSA)",13,14,155,167,322
KOLDA,VELINGARA,"SARE COLY SALLE",KANDIA,"DJIDA MOUDOU",18,21,382,386,768
KOLDA,VELINGARA,"SARE COLY SALLE",KANDIA,DOUBIROU,63,103,1312,1434,2746
KOLDA,VELINGARA,"SARE COLY SALLE",KANDIA,"HAMDALLAYE DIONCOUNDA",9,10,91,93,184
KOLDA,VELINGARA,"SARE COLY SALLE",KANDIA,"KAEL BESSEL",60,66,324,359,683
KOLDA,VELINGARA,"SARE COLY SALLE",KANDIA,"KAMINACOR DJIDERE",8,8,65,89,154
KOLDA,VELINGARA,"SARE COLY SALLE",KANDIA,"H1 SINTHIANG MOLO",2,3,15,21,36
KOLDA,VELINGARA,"SARE COLY SALLE",KANDIA,KANDIA,93,117,792,782,1574
KOLDA,VELINGARA,"SARE COLY SALLE",KANDIA,"KEDOUGOU DICORY",8,17,101,91,192
KOLDA,VELINGARA,"SARE COLY SALLE",KANDIA,KEREWANE,37,38,349,308,657
KOLDA,VELINGARA,"SARE COLY SALLE",KANDIA,LAMBATARA,56,75,815,778,1593
KOLDA,VELINGARA,"SARE COLY SALLE",KANDIA,"MADINA  ADJA",42,48,324,366,690
KOLDA,VELINGARA,"SARE COLY SALLE",KANDIA,"MADINA DIAMBERE",34,44,427,350,777
KOLDA,VELINGARA,"SARE COLY SALLE",KANDIA,"MEDINA MARY CISSE",55,68,519,579,1098
KOLDA,VELINGARA,"SARE COLY SALLE",KANDIA,MAMPATAYEL,11,13,79,74,153
KOLDA,VELINGARA,"SARE COLY SALLE",KANDIA,"MAREWE DOUDOU KANDE",6,14,87,75,162
KOLDA,VELINGARA,"SARE COLY SALLE",KANDIA,"MBANDOUNCOUNDA (SARE COUNA)",18,19,201,157,358
KOLDA,VELINGARA,"SARE COLY SALLE",KANDIA,"MEDINA EL HADJI SORY",30,44,456,436,892
KOLDA,VELINGARA,"SARE COLY SALLE",KANDIA,"MEDINA MAYE (SARE ALIOU)",10,14,126,116,242
KOLDA,VELINGARA,"SARE COLY SALLE",KANDIA,"MEDINA SAMBA DIALLO",15,16,116,89,205
KOLDA,VELINGARA,"SARE COLY SALLE",KANDIA,MOUNTOUMBA,23,25,157,151,308
KOLDA,VELINGARA,"SARE COLY SALLE",KANDIA,"NETTO ARFANG",12,15,98,78,176
KOLDA,VELINGARA,"SARE COLY SALLE",KANDIA,"NETTO DEMBA DIAO",8,11,88,100,188
KOLDA,VELINGARA,"SARE COLY SALLE",KANDIA,"NETTO ROUKA",14,15,112,119,231
KOLDA,VELINGARA,"SARE COLY SALLE",KANDIA,"SABALICOUNDA GNIMA (SARA HAMADY)",3,4,39,44,83
KOLDA,VELINGARA,"SARE COLY SALLE",KANDIA,"SABALYCOUNDA PAYA (SARE PAYA)",7,8,80,83,163
KOLDA,VELINGARA,"SARE COLY SALLE",KANDIA,"SARE BASSY BOUNDOU",5,8,42,42,84
KOLDA,VELINGARA,"SARE COLY SALLE",KANDIA,"SARE BOULA",11,14,117,103,220
KOLDA,VELINGARA,"SARE COLY SALLE",KANDIA,"SARE BOULEL",32,41,362,317,679
KOLDA,VELINGARA,"SARE COLY SALLE",KANDIA,"SARE COLY TENING",18,22,172,181,353
KOLDA,VELINGARA,"SARE COLY SALLE",KANDIA,"SARE DEMBAYEL",3,3,15,15,30
KOLDA,VELINGARA,"SARE COLY SALLE",KANDIA,"SARE DIAOBE",14,14,137,118,255
KOLDA,VELINGARA,"SARE COLY SALLE",KANDIA,"SARE DICORY (LAMBIDOU DIKORY)",6,7,72,67,139
KOLDA,VELINGARA,"SARE COLY SALLE",KANDIA,"SARE DICORY DIAO (SINTHIANG DICORY)",10,11,77,78,155
KOLDA,VELINGARA,"SARE COLY SALLE",KANDIA,"SARE FILY",14,16,75,76,151
KOLDA,VELINGARA,"SARE COLY SALLE",KANDIA,"SARE GUIRO YOBA",6,11,49,32,81
KOLDA,VELINGARA,"SARE COLY SALLE",KANDIA,"SARE KOURTIBA",6,9,102,65,167
KOLDA,VELINGARA,"SARE COLY SALLE",KANDIA,"SARE MALI",7,7,65,66,131
KOLDA,VELINGARA,"SARE COLY SALLE",KANDIA,"SARE MAMADOU",21,34,337,253,590
KOLDA,VELINGARA,"SARE COLY SALLE",KANDIA,"H1 SINTHIANG DIOULDE",2,2,22,16,38
KOLDA,VELINGARA,"SARE COLY SALLE",KANDIA,"SARE MANKOTO",7,12,60,35,95
KOLDA,VELINGARA,"SARE COLY SALLE",KANDIA,"SARE MOUGNA",7,10,81,58,139
KOLDA,VELINGARA,"SARE COLY SALLE",KANDIA,"SARE NIARY (WELIA NIARY)",21,22,135,107,242
KOLDA,VELINGARA,"SARE COLY SALLE",KANDIA,"SARE PITHIANA",5,8,86,34,120
KOLDA,VELINGARA,"SARE COLY SALLE",KANDIA,"SARE SAMBA KANDE (SARE SAMBA TENING)",20,20,141,139,280
KOLDA,VELINGARA,"SARE COLY SALLE",KANDIA,"SARE SAMBA NETTY",27,37,204,200,404
KOLDA,VELINGARA,"SARE COLY SALLE",KANDIA,"SARE SIDY (MISSIRAH SIDY DIAO)",4,4,35,20,55
KOLDA,VELINGARA,"SARE COLY SALLE",KANDIA,"SARE THIERNO DEMBA",9,13,120,98,218
KOLDA,VELINGARA,"SARE COLY SALLE",KANDIA,"SARE YERO META",25,35,289,241,530
KOLDA,VELINGARA,"SARE COLY SALLE",KANDIA,SIMBY,16,23,227,251,478
KOLDA,VELINGARA,"SARE COLY SALLE",KANDIA,"SINTHIANG BADIONG",16,18,116,146,262
KOLDA,VELINGARA,"SARE COLY SALLE",KANDIA,"SINTHIANG OUINOR",6,6,33,38,71
KOLDA,VELINGARA,"SARE COLY SALLE",KANDIA,"SINTHIANG SABY",28,35,750,626,1376
KOLDA,VELINGARA,"SARE COLY SALLE",KANDIA,"SOUROUYEL MOULAYE",14,29,186,200,386
KOLDA,VELINGARA,"SARE COLY SALLE",KANDIA,"TABADIANG SAMBA",16,17,102,105,207
KOLDA,VELINGARA,"SARE COLY SALLE",KANDIA,"TEMENTO DEMBA MARY (SARE DEMBA MBALLO)",51,59,374,388,762
KOLDA,VELINGARA,"SARE COLY SALLE",KANDIA,"TEMENTO FARAMBA",20,26,169,148,317
KOLDA,VELINGARA,"SARE COLY SALLE",KANDIA,"THIEWAL BESSEL YELA",18,24,121,112,233
KOLDA,VELINGARA,"SARE COLY SALLE",KANDIA,"THIEWAL PATHE",7,8,45,42,87
KOLDA,VELINGARA,"SARE COLY SALLE",KANDIA,"THIEWAL TOBAL (THIEWAL MAMA YORO)",8,11,80,100,180
KOLDA,VELINGARA,"SARE COLY SALLE",KANDIA,"THIBO DEMBA",8,13,81,73,154
KOLDA,VELINGARA,"SARE COLY SALLE",KANDIA,"WELIA AMADOU",12,15,152,119,271
KOLDA,VELINGARA,"SARE COLY SALLE",KANDIA,WOLOTO,11,14,131,121,252
KOLDA,VELINGARA,"SARE COLY SALLE","SARE COLY SALLE",BARRICOUNDA,14,19,126,117,243
KOLDA,VELINGARA,"SARE COLY SALLE","SARE COLY SALLE","H1 SINTHIANG MAMADY BALDE",36,36,181,173,354
KOLDA,VELINGARA,"SARE COLY SALLE","SARE COLY SALLE","BIARO ABDOULAYE",11,11,67,64,131
KOLDA,VELINGARA,"SARE COLY SALLE","SARE COLY SALLE","DARSALAM BOCAR",13,16,71,100,171
KOLDA,VELINGARA,"SARE COLY SALLE","SARE COLY SALLE","DARSALAM DJIBY KANDE",18,19,138,118,256
KOLDA,VELINGARA,"SARE COLY SALLE","SARE COLY SALLE","DARSALAM THIERNO (SINTHIANG THIERNO)",11,13,50,45,95
KOLDA,VELINGARA,"SARE COLY SALLE","SARE COLY SALLE",DINGUIRA,23,27,147,143,290
KOLDA,VELINGARA,"SARE COLY SALLE","SARE COLY SALLE","DIDIORE HAMADY",18,25,148,146,294
KOLDA,VELINGARA,"SARE COLY SALLE","SARE COLY SALLE","DIYABOUGOU YOBA",20,20,86,111,197
KOLDA,VELINGARA,"SARE COLY SALLE","SARE COLY SALLE",DJIMINI,82,96,441,357,798
KOLDA,VELINGARA,"SARE COLY SALLE","SARE COLY SALLE","FOULAMORI DEMBA",26,30,134,132,266
KOLDA,VELINGARA,"SARE COLY SALLE","SARE COLY SALLE","H1 SINTHIANG FOULAMORI SAMBA",3,3,27,25,52
KOLDA,VELINGARA,"SARE COLY SALLE","SARE COLY SALLE","FOULAMORI YERO",19,23,108,108,216
KOLDA,VELINGARA,"SARE COLY SALLE","SARE COLY SALLE","GOUNDAGA SAMBA (SARE SAMBA TALA)",89,92,404,375,779
KOLDA,VELINGARA,"SARE COLY SALLE","SARE COLY SALLE",KANSATANG,42,56,336,309,645
KOLDA,VELINGARA,"SARE COLY SALLE","SARE COLY SALLE","H1 SARE BOCAR",3,5,24,18,42
KOLDA,VELINGARA,"SARE COLY SALLE","SARE COLY SALLE","H2 SINTHIANG MAMADOU",8,12,63,64,127
KOLDA,VELINGARA,"SARE COLY SALLE","SARE COLY SALLE","KENEBA YORO",17,20,151,148,299
KOLDA,VELINGARA,"SARE COLY SALLE","SARE COLY SALLE","KONADJI MALI",40,53,313,289,602
KOLDA,VELINGARA,"SARE COLY SALLE","SARE COLY SALLE",KOPARA,73,84,511,455,966
KOLDA,VELINGARA,"SARE COLY SALLE","SARE COLY SALLE","KOULINTO MOUDOU",14,16,60,50,110
KOLDA,VELINGARA,"SARE COLY SALLE","SARE COLY SALLE","KOUNTANTO DOULO",22,26,162,114,276
KOLDA,VELINGARA,"SARE COLY SALLE","SARE COLY SALLE","MADINA DIAKA (FOFANAYA)",15,17,93,81,174
KOLDA,VELINGARA,"SARE COLY SALLE","SARE COLY SALLE","MADINA DIALLO",62,72,448,474,922
KOLDA,VELINGARA,"SARE COLY SALLE","SARE COLY SALLE","MAMBOYA KEKOUTA",10,13,78,79,157
KOLDA,VELINGARA,"SARE COLY SALLE","SARE COLY SALLE","MAREVE DEMBA DIARRA",16,16,93,81,174
KOLDA,VELINGARA,"SARE COLY SALLE","SARE COLY SALLE","MBALLOCOUNDA THIERNO",30,40,185,170,355
KOLDA,VELINGARA,"SARE COLY SALLE","SARE COLY SALLE","MBALLOCOUNDA WOUDOU",15,18,65,66,131
KOLDA,VELINGARA,"SARE COLY SALLE","SARE COLY SALLE","MISSIRAH BASSI (SARE BASSI)",68,77,319,327,646
KOLDA,VELINGARA,"SARE COLY SALLE","SARE COLY SALLE","MISSIRAH SAMBA (TOUNGOULEL)",48,57,474,492,966
KOLDA,VELINGARA,"SARE COLY SALLE","SARE COLY SALLE",NAMARA,4,4,20,13,33
KOLDA,VELINGARA,"SARE COLY SALLE","SARE COLY SALLE","NETTO HOGO MBALLO",6,6,38,23,61
KOLDA,VELINGARA,"SARE COLY SALLE","SARE COLY SALLE",PASSA,12,13,115,97,212
KOLDA,VELINGARA,"SARE COLY SALLE","SARE COLY SALLE","H1 GALLE DEMBA DIAO",4,4,26,23,49
KOLDA,VELINGARA,"SARE COLY SALLE","SARE COLY SALLE","SANGHARE COLY",26,26,161,144,305
KOLDA,VELINGARA,"SARE COLY SALLE","SARE COLY SALLE","SANTATO DJIBA (SARE DJIBA)",20,29,151,144,295
KOLDA,VELINGARA,"SARE COLY SALLE","SARE COLY SALLE",SAPPY,14,15,71,67,138
KOLDA,VELINGARA,"SARE COLY SALLE","SARE COLY SALLE","SARE BODIO",48,57,350,384,734
KOLDA,VELINGARA,"SARE COLY SALLE","SARE COLY SALLE","SARE COLY SALLE",72,81,507,503,1010
KOLDA,VELINGARA,"SARE COLY SALLE","SARE COLY SALLE","H1 SINTHIANG MANDOU",18,19,193,100,293
KOLDA,VELINGARA,"SARE COLY SALLE","SARE COLY SALLE","SARE DEMBA HOGO (SARE ALETTE)",21,23,134,104,238
KOLDA,VELINGARA,"SARE COLY SALLE","SARE COLY SALLE","SARE DIAOBE",39,48,202,207,409
KOLDA,VELINGARA,"SARE COLY SALLE","SARE COLY SALLE","SARE HAMADY (SINTHIANG HAMADY)",8,14,96,100,196
KOLDA,VELINGARA,"SARE COLY SALLE","SARE COLY SALLE","SARE HOGO",26,26,131,115,246
KOLDA,VELINGARA,"SARE COLY SALLE","SARE COLY SALLE","SARE MANSALY",4,8,46,49,95
KOLDA,VELINGARA,"SARE COLY SALLE","SARE COLY SALLE","SARE SAMBALEL",19,21,109,108,217
KOLDA,VELINGARA,"SARE COLY SALLE","SARE COLY SALLE","SARE SAMBAYEL",17,18,62,62,124
KOLDA,VELINGARA,"SARE COLY SALLE","SARE COLY SALLE","SARE SAMBEL",23,27,183,179,362
KOLDA,VELINGARA,"SARE COLY SALLE","SARE COLY SALLE","SARE SAMBOU",24,27,141,172,313
KOLDA,VELINGARA,"SARE COLY SALLE","SARE COLY SALLE","SARE SAME BATI",86,102,599,583,1182
KOLDA,VELINGARA,"SARE COLY SALLE","SARE COLY SALLE","SARE SAWADI (SARE BOUKA)",39,40,245,236,481
KOLDA,VELINGARA,"SARE COLY SALLE","SARE COLY SALLE","SARE SOKHNA (BIARO SOKHNA)",15,16,115,138,253
KOLDA,VELINGARA,"SARE COLY SALLE","SARE COLY SALLE","SARE SOUROUYEL MANIGUE",41,47,264,269,533
KOLDA,VELINGARA,"SARE COLY SALLE","SARE COLY SALLE","SARE YERO META (SARE YERO BALDE)",55,58,230,241,471
KOLDA,VELINGARA,"SARE COLY SALLE","SARE COLY SALLE","SARE YEROYEL",108,133,699,638,1337
KOLDA,VELINGARA,"SARE COLY SALLE","SARE COLY SALLE","SARE YORO WALO",58,60,331,287,618
KOLDA,VELINGARA,"SARE COLY SALLE","SARE COLY SALLE","SINTHIANG ALONSO",9,10,31,31,62
KOLDA,VELINGARA,"SARE COLY SALLE","SARE COLY SALLE","SINTHIANG MANDIANG",17,19,84,78,162
KOLDA,VELINGARA,"SARE COLY SALLE","SARE COLY SALLE","SINTHIANG OUINOR",60,63,382,318,700
KOLDA,VELINGARA,"SARE COLY SALLE","SARE COLY SALLE","SINTHIANG PASSA",20,22,153,140,293
KOLDA,VELINGARA,"SARE COLY SALLE","SARE COLY SALLE","SOUROUYEL SAMBA",15,15,68,71,139
KOLDA,VELINGARA,"SARE COLY SALLE","SARE COLY SALLE","TABANDINTO MOLO DIAO",7,9,65,58,123
KOLDA,VELINGARA,"SARE COLY SALLE","SARE COLY SALLE","TEMENTO KOUTAYEL",20,21,102,72,174
KOLDA,VELINGARA,"SARE COLY SALLE","SARE COLY SALLE","TEYEL FARING",113,132,639,590,1229
KOLDA,VELINGARA,"SARE COLY SALLE","SARE COLY SALLE","H1 SINTHIANG LADDE",14,20,67,72,139
KOLDA,VELINGARA,"SARE COLY SALLE","SARE COLY SALLE",TRAO,15,21,133,122,255
KOLDA,VELINGARA,"SARE COLY SALLE","SARE COLY SALLE","WAKILARE SAWADI",7,7,39,44,83
KOLDA,VELINGARA,"SARE COLY SALLE","SARE COLY SALLE","WELIA KHALIFA",8,9,48,56,104
KOLDA,VELINGARA,"SARE COLY SALLE","SARE COLY SALLE","TEMANTO MOUTAROU",9,9,34,33,67
KOLDA,VELINGARA,"SARE COLY SALLE",NEMATABA,"AMADARA (SARE AMADARA)",34,35,183,187,370
KOLDA,VELINGARA,"SARE COLY SALLE",NEMATABA,"BADIARA CAMPEMENT",15,24,112,111,223
KOLDA,VELINGARA,"SARE COLY SALLE",NEMATABA,"H1 FASS GOUNASS (SINTHIANG GOUNASS)",5,5,24,34,58
KOLDA,VELINGARA,"SARE COLY SALLE",NEMATABA,"BADIARA FILY (BADIARA LAOBE)",5,7,38,32,70
KOLDA,VELINGARA,"SARE COLY SALLE",NEMATABA,BAGAYOGO,28,36,155,154,309
KOLDA,VELINGARA,"SARE COLY SALLE",NEMATABA,"DANFA COUNDA",9,9,56,35,91
KOLDA,VELINGARA,"SARE COLY SALLE",NEMATABA,"DIAMWELY PATHE",12,15,102,97,199
KOLDA,VELINGARA,"SARE COLY SALLE",NEMATABA,"DIAMWELY YORO",50,60,216,226,442
KOLDA,VELINGARA,"SARE COLY SALLE",NEMATABA,"DINGUIRY SENEGAL",1,1,9,5,14
KOLDA,VELINGARA,"SARE COLY SALLE",NEMATABA,"HAMDALLAYE ALMAMY",18,22,150,162,312
KOLDA,VELINGARA,"SARE COLY SALLE",NEMATABA,KANDABI,10,12,80,81,161
KOLDA,VELINGARA,"SARE COLY SALLE",NEMATABA,"H1 SINTHIANG DEMBA",8,8,78,51,129
KOLDA,VELINGARA,"SARE COLY SALLE",NEMATABA,"H2 SINTHIANG MOUSSA",1,2,7,8,15
KOLDA,VELINGARA,"SARE COLY SALLE",NEMATABA,"KOULANDIALA (SINTHIANG KOULANDIALA)",30,33,183,223,406
KOLDA,VELINGARA,"SARE COLY SALLE",NEMATABA,KOUMBATHIRY,10,12,69,65,134
KOLDA,VELINGARA,"SARE COLY SALLE",NEMATABA,KOUMERA,20,22,117,140,257
KOLDA,VELINGARA,"SARE COLY SALLE",NEMATABA,"H1 SINTHIANG BOULY",3,3,19,18,37
KOLDA,VELINGARA,"SARE COLY SALLE",NEMATABA,KOUTOUCOUNDA,47,51,287,231,518
KOLDA,VELINGARA,"SARE COLY SALLE",NEMATABA,"MADINA MAOUNDE (SARE MAOUNDE BANA)",19,28,152,150,302
KOLDA,VELINGARA,"SARE COLY SALLE",NEMATABA,"MADINA SELLOU",17,24,89,67,156
KOLDA,VELINGARA,"SARE COLY SALLE",NEMATABA,MANKACOUNDA,79,93,483,501,984
KOLDA,VELINGARA,"SARE COLY SALLE",NEMATABA,"MEDINA DINGUIRAYE",188,197,935,874,1809
KOLDA,VELINGARA,"SARE COLY SALLE",NEMATABA,NEMATABA,72,90,383,348,731
KOLDA,VELINGARA,"SARE COLY SALLE",NEMATABA,"NIORO CHERIF",6,6,60,60,120
KOLDA,VELINGARA,"SARE COLY SALLE",NEMATABA,"H1 SINTHIANG META",3,3,19,29,48
KOLDA,VELINGARA,"SARE COLY SALLE",NEMATABA,"SARE AYE SABALY",13,13,80,78,158
KOLDA,VELINGARA,"SARE COLY SALLE",NEMATABA,"SARE KOKE",8,8,50,45,95
KOLDA,VELINGARA,"SARE COLY SALLE",NEMATABA,"SARE MBIROU",26,28,133,149,282
KOLDA,VELINGARA,"SARE COLY SALLE",NEMATABA,"SARE NAGUE",39,52,607,564,1171
KOLDA,VELINGARA,"SARE COLY SALLE",NEMATABA,"SARE SANKOULE",18,20,156,182,338
KOLDA,VELINGARA,"SARE COLY SALLE",NEMATABA,"H1 SARE YERO GALLE DIOLA",2,2,6,5,11
KOLDA,VELINGARA,"SARE COLY SALLE",NEMATABA,"SARE WALY",11,12,37,42,79
KOLDA,VELINGARA,"SARE COLY SALLE",NEMATABA,"SARE YIRA",25,28,142,102,244
KOLDA,VELINGARA,"SARE COLY SALLE",NEMATABA,"SINTHIANG DARA",19,25,84,84,168
KOLDA,VELINGARA,"SARE COLY SALLE",NEMATABA,"SINTHIANG KABA",16,18,134,126,260
KOLDA,VELINGARA,"SARE COLY SALLE",NEMATABA,"SINTHIANG MANGA SARA",29,36,174,156,330
KOLDA,VELINGARA,"SARE COLY SALLE",NEMATABA,"SINTHIANG MISSIRAH",37,38,197,171,368
KOLDA,VELINGARA,"SARE COLY SALLE",NEMATABA,"SINTHIANG TALLA",12,12,55,49,104
KOLDA,VELINGARA,"SARE COLY SALLE",NEMATABA,"WELIA SIBY",16,22,147,138,285
KOLDA,VELINGARA,"SARE COLY SALLE",NEMATABA,"DAROU SALAM",4,4,12,19,31
KOLDA,VELINGARA,"SARE COLY SALLE",NEMATABA,"SINTHIANG ABDOULAYE",6,10,38,26,64
KOLDA,VELINGARA,"SARE COLY SALLE",KANDIAYE,"BAMAKO SAMBA",39,42,279,263,542
KOLDA,VELINGARA,"SARE COLY SALLE",KANDIAYE,"COUMBACARA BELLA",3,3,15,23,38
KOLDA,VELINGARA,"SARE COLY SALLE",KANDIAYE,"DAROU SALAM KAIRA",6,9,34,47,81
KOLDA,VELINGARA,"SARE COLY SALLE",KANDIAYE,"H1 SYLLAYENNE",3,3,12,8,20
KOLDA,VELINGARA,"SARE COLY SALLE",KANDIAYE,"DAROU SALAM MAMADOU",25,27,128,95,223
KOLDA,VELINGARA,"SARE COLY SALLE",KANDIAYE,"H1 LAILA",11,15,54,46,100
KOLDA,VELINGARA,"SARE COLY SALLE",KANDIAYE,"DARSALAM CHERIF",17,23,143,123,266
KOLDA,VELINGARA,"SARE COLY SALLE",KANDIAYE,"DIAMWELY MAMADOU",36,50,218,219,437
KOLDA,VELINGARA,"SARE COLY SALLE",KANDIAYE,"FASS PATHE KANDE",17,19,119,114,233
KOLDA,VELINGARA,"SARE COLY SALLE",KANDIAYE,"HAMDALLAYE BORY",5,7,37,43,80
KOLDA,VELINGARA,"SARE COLY SALLE",KANDIAYE,"HAMDALLAYE DEMBA",41,46,240,227,467
KOLDA,VELINGARA,"SARE COLY SALLE",KANDIAYE,"HORETEINDIE (SARE META)",37,41,230,220,450
KOLDA,VELINGARA,"SARE COLY SALLE",KANDIAYE,KALIFOUROU,5,6,29,29,58
KOLDA,VELINGARA,"SARE COLY SALLE",KANDIAYE,KANDIAYE,43,43,182,165,347
KOLDA,VELINGARA,"SARE COLY SALLE",KANDIAYE,"H1 KANDIAYE FOUTA",11,14,58,75,133
KOLDA,VELINGARA,"SARE COLY SALLE",KANDIAYE,KANKELIFA,12,16,130,130,260
KOLDA,VELINGARA,"SARE COLY SALLE",KANDIAYE,"KOLDA MOLO",17,19,95,100,195
KOLDA,VELINGARA,"SARE COLY SALLE",KANDIAYE,"H1 SARE SADIO",9,9,41,45,86
KOLDA,VELINGARA,"SARE COLY SALLE",KANDIAYE,LINGUEWAL,37,49,380,345,725
KOLDA,VELINGARA,"SARE COLY SALLE",KANDIAYE,"MADINA DIANGUETTE",16,23,100,78,178
KOLDA,VELINGARA,"SARE COLY SALLE",KANDIAYE,"H1 SINTHIANG AMADOU BAILO",11,13,55,74,129
KOLDA,VELINGARA,"SARE COLY SALLE",KANDIAYE,"MADINA PATHE (SARE PATHE)",7,9,57,51,108
KOLDA,VELINGARA,"SARE COLY SALLE",KANDIAYE,"MAMBOYA ALI",28,38,195,189,384
KOLDA,VELINGARA,"SARE COLY SALLE",KANDIAYE,"H1 SINTHIANG MANGA DIAO",9,9,38,33,71
KOLDA,VELINGARA,"SARE COLY SALLE",KANDIAYE,"H2 MAMBOYA MAOUNDE (MAMBOYA SAMBA)",3,6,34,33,67
KOLDA,VELINGARA,"SARE COLY SALLE",KANDIAYE,"MAREWE ABDOU II",16,18,73,56,129
KOLDA,VELINGARA,"SARE COLY SALLE",KANDIAYE,"H1 GALLE SADOU",9,13,58,33,91
KOLDA,VELINGARA,"SARE COLY SALLE",KANDIAYE,"MAYEL ROUNDE (MAYEL FATIM)",22,26,107,101,208
KOLDA,VELINGARA,"SARE COLY SALLE",KANDIAYE,"MBALLOCOUNDA YERO (SARE YERO BA)",5,5,45,17,62
KOLDA,VELINGARA,"SARE COLY SALLE",KANDIAYE,"MEDINA MAOUNDE BA",25,36,278,208,486
KOLDA,VELINGARA,"SARE COLY SALLE",KANDIAYE,"H1 SINTHIANG DEMBA BOBO",8,9,44,42,86
KOLDA,VELINGARA,"SARE COLY SALLE",KANDIAYE,"MISSIRAH MAMADOU",34,40,182,159,341
KOLDA,VELINGARA,"SARE COLY SALLE",KANDIAYE,"MISSIRAH SAMBA SABALY (SARE SAMBOULA)",5,6,33,20,53
KOLDA,VELINGARA,"SARE COLY SALLE",KANDIAYE,"NDIANDOUBA MBAWNE",64,70,353,280,633
KOLDA,VELINGARA,"SARE COLY SALLE",KANDIAYE,"NGOUMBOU COLY",15,17,98,72,170
KOLDA,VELINGARA,"SARE COLY SALLE",KANDIAYE,"H1 NGOUMBOU BALLOU",7,7,32,24,56
KOLDA,VELINGARA,"SARE COLY SALLE",KANDIAYE,NGOUNDAGA,29,30,210,194,404
KOLDA,VELINGARA,"SARE COLY SALLE",KANDIAYE,NIAPPO,27,31,171,166,337
KOLDA,VELINGARA,"SARE COLY SALLE",KANDIAYE,"SARE BOURA (SAME)",13,18,86,95,181
KOLDA,VELINGARA,"SARE COLY SALLE",KANDIAYE,"SARE DIAE",24,27,263,217,480
KOLDA,VELINGARA,"SARE COLY SALLE",KANDIAYE,"SARE DJIGUI",15,17,71,56,127
KOLDA,VELINGARA,"SARE COLY SALLE",KANDIAYE,"SARE FARING",13,15,55,58,113
KOLDA,VELINGARA,"SARE COLY SALLE",KANDIAYE,"SARE KONKONYEL (SARE KOUCO)",17,19,82,97,179
KOLDA,VELINGARA,"SARE COLY SALLE",KANDIAYE,"SARE KOUTAYEL",13,13,76,85,161
KOLDA,VELINGARA,"SARE COLY SALLE",KANDIAYE,"SARE LABALE",10,10,40,58,98
KOLDA,VELINGARA,"SARE COLY SALLE",KANDIAYE,"SARE MADIA ( SARE MADIA SALLA)",19,21,113,96,209
KOLDA,VELINGARA,"SARE COLY SALLE",KANDIAYE,"SARE NIANTHIO (DABO NIANTHIO)",32,35,225,196,421
KOLDA,VELINGARA,"SARE COLY SALLE",KANDIAYE,"SARE YERO BOUKA",20,20,131,104,235
KOLDA,VELINGARA,"SARE COLY SALLE",KANDIAYE,"SARE YERO TENING (MEDINA YERO)",17,28,161,122,283
KOLDA,VELINGARA,"SARE COLY SALLE",KANDIAYE,"SARE YORO GANO",19,20,112,102,214
KOLDA,VELINGARA,"SARE COLY SALLE",KANDIAYE,"SARE YORO SOUDY",13,16,77,79,156
KOLDA,VELINGARA,"SARE COLY SALLE",KANDIAYE,"SINTHIANG BAILO",6,9,31,24,55
KOLDA,VELINGARA,"SARE COLY SALLE",KANDIAYE,"SINTHIANG KANDIAYE",10,10,41,43,84
KOLDA,VELINGARA,"SARE COLY SALLE",KANDIAYE,"SINTHIANG THIAPA",18,24,97,102,199
KOLDA,VELINGARA,"SARE COLY SALLE",KANDIAYE,"SINTHIANG THIERNO",10,11,88,80,168
KOLDA,VELINGARA,"SARE COLY SALLE",KANDIAYE,"TABADINTO SEYDY",6,6,46,46,92
KOLDA,VELINGARA,"SARE COLY SALLE",KANDIAYE,"TABAWAL MADY (SARE MADY)",29,32,169,152,321
KOLDA,VELINGARA,"SARE COLY SALLE",KANDIAYE,TACOUDIALA,42,51,333,359,692
KOLDA,VELINGARA,"SARE COLY SALLE",KANDIAYE,"TEMENTO ALLA DIEYE (SARE MOLO)",14,19,120,105,225
KOLDA,VELINGARA,"SARE COLY SALLE",KANDIAYE,"TEMENTO BOURAHIMA",22,24,82,88,170
KOLDA,VELINGARA,"SARE COLY SALLE",KANDIAYE,"TEMENTO MADIA",22,23,116,120,236
KOLDA,VELINGARA,"SARE COLY SALLE",KANDIAYE,THIANCACOLY,35,36,181,178,359
KOLDA,VELINGARA,"SARE COLY SALLE",KANDIAYE,"THIBO SADIO",17,19,109,105,214
KOLDA,VELINGARA,"SARE COLY SALLE",KANDIAYE,"THIEWI BESSI DICORY",6,6,29,48,77
KOLDA,VELINGARA,"SARE COLY SALLE",KANDIAYE,"THIEWI BESSI MODOU",12,14,56,70,126
KOLDA,VELINGARA,"SARE COLY SALLE",KANDIAYE,THIOUBOUCK,15,23,116,106,222
KOLDA,VELINGARA,"SARE COLY SALLE",KANDIAYE,THIOUWANGHA,2,3,11,14,25
KOLDA,VELINGARA,"SARE COLY SALLE",KANDIAYE,"WAKILARE KEITA",16,17,114,103,217
KOLDA,VELINGARA,"SARE COLY SALLE",KANDIAYE,"H1 SARE LOUNTANG",5,5,22,21,43
KOLDA,VELINGARA,"SARE COLY SALLE",KANDIAYE,YIRICOYE,18,23,134,101,235
KOLDA,VELINGARA,"SARE COLY SALLE","DIAOBE KABENDOU",DIALICOUNDA,234,244,1170,1063,2233
KOLDA,VELINGARA,"SARE COLY SALLE","DIAOBE KABENDOU","DIAOBE II",459,628,2174,1968,4142
KOLDA,VELINGARA,"SARE COLY SALLE","DIAOBE KABENDOU","GAMBISARA TALATA",123,132,638,539,1177
KOLDA,VELINGARA,"SARE COLY SALLE","DIAOBE KABENDOU","KABENDOU I",259,291,1537,1669,3206
KOLDA,VELINGARA,"SARE COLY SALLE","DIAOBE KABENDOU",MAREWE,27,34,195,172,367
KOLDA,VELINGARA,"SARE COLY SALLE","DIAOBE KABENDOU","MAREWE SAMBA SABALY",129,135,794,736,1530
KOLDA,VELINGARA,"SARE COLY SALLE","DIAOBE KABENDOU","MEDINA SAMBA KANDE",218,245,1230,1071,2301
KOLDA,VELINGARA,"SARE COLY SALLE","DIAOBE KABENDOU","SARE BALING",12,32,90,83,173
KOLDA,VELINGARA,"SARE COLY SALLE","DIAOBE KABENDOU","SARE MAOUNDE BOTHIE",274,307,1208,1163,2371
KOLDA,VELINGARA,"SARE COLY SALLE","DIAOBE KABENDOU","SARE YOBA",34,36,200,164,364
KOLDA,VELINGARA,"SARE COLY SALLE","DIAOBE KABENDOU","SINTHIANG AÏDARA",83,140,379,376,755
KOLDA,VELINGARA,"SARE COLY SALLE","DIAOBE KABENDOU",SOUTOURE,139,155,897,769,1666
KOLDA,VELINGARA,"SARE COLY SALLE","DIAOBE KABENDOU","DIAOBE I EST",324,461,1965,1983,3948
KOLDA,VELINGARA,"SARE COLY SALLE","DIAOBE KABENDOU","KABENDOU II",147,164,820,839,1659
KOLDA,VELINGARA,"SARE COLY SALLE","DIAOBE KABENDOU","DIAOBE 3",524,769,2862,2584,5446
KOLDA,VELINGARA,"SARE COLY SALLE","DIAOBE KABENDOU","KABENDOU II DEMBO KEBE",130,147,789,803,1592
KOLDA,VELINGARA,"SARE COLY SALLE","DIAOBE KABENDOU","DIAOBE I OUEST",245,283,1357,1242,2599
KOLDA,VELINGARA,"SARE COLY SALLE","DIAOBE KABENDOU","DIAOBE 4",323,355,1537,1212,2749
KOLDA,VELINGARA,"SARE COLY SALLE","DIAOBE KABENDOU","DIAOBE 4 MODY BOYE",299,355,1635,1498,3133
KOLDA,VELINGARA,"SARE COLY SALLE",KOUNKANE,KOULANDIALA,100,108,486,494,980
KOLDA,VELINGARA,"SARE COLY SALLE",KOUNKANE,"MADINA OUMAR",16,17,81,79,160
KOLDA,VELINGARA,"SARE COLY SALLE",KOUNKANE,"NDORNA BOUNDA",50,64,367,319,686
KOLDA,VELINGARA,"SARE COLY SALLE",KOUNKANE,"SARE BOURANG",55,58,328,263,591
KOLDA,VELINGARA,"SARE COLY SALLE",KOUNKANE,"SARE KALIKOU",14,17,71,60,131
KOLDA,VELINGARA,"SARE COLY SALLE",KOUNKANE,"SARE PATHE",4,7,42,42,84
KOLDA,VELINGARA,"SARE COLY SALLE",KOUNKANE,"SINTHIANG SAMBA LABA",8,9,48,57,105
KOLDA,VELINGARA,"SARE COLY SALLE",KOUNKANE,"THIANFARA KOBA",43,46,250,245,495
KOLDA,VELINGARA,"SARE COLY SALLE",KOUNKANE,"THIANFARA MAOUNDE",39,42,225,164,389
KOLDA,VELINGARA,"SARE COLY SALLE",KOUNKANE,"CHÂTEAU D'EAU  BANTANGUEL",33,33,141,151,292
KOLDA,VELINGARA,"SARE COLY SALLE",KOUNKANE,"DAROU SALAM KOUNKANE",141,159,749,723,1472
KOLDA,VELINGARA,"SARE COLY SALLE",KOUNKANE,"DOULA SOW I",105,114,478,503,981
KOLDA,VELINGARA,"SARE COLY SALLE",KOUNKANE,"DOULA SOW II",107,118,511,477,988
KOLDA,VELINGARA,"SARE COLY SALLE",KOUNKANE,ESCALE,127,138,808,748,1556
KOLDA,VELINGARA,"SARE COLY SALLE",KOUNKANE,"KOUNKANE IDY",161,193,647,671,1318
KOLDA,VELINGARA,"SARE COLY SALLE",KOUNKANE,"KOUNKANE ELHADJI YAYA",100,135,567,669,1236
KOLDA,VELINGARA,"SARE COLY SALLE",KOUNKANE,"TIDIANE SIDIGUI I",121,155,747,747,1494
KOLDA,VELINGARA,"SARE COLY SALLE",KOUNKANE,"TIDIANE SIDIGUI II",136,154,722,713,1435
KOLDA,VELINGARA,"SARE COLY SALLE",KOUNKANE,"DIARE DIAREA",135,159,966,857,1823
KOLDA,"MEDINA YORO FOULAH","MEDINA YORO FOULAH","MEDINA YORO FOULAH","BOUNDOU MBALLO",73,85,324,342,666
KOLDA,"MEDINA YORO FOULAH","MEDINA YORO FOULAH","MEDINA YORO FOULAH",KIKALA,82,90,350,342,692
KOLDA,"MEDINA YORO FOULAH","MEDINA YORO FOULAH","MEDINA YORO FOULAH","LALY DEME",148,161,663,564,1227
KOLDA,"MEDINA YORO FOULAH","MEDINA YORO FOULAH","MEDINA YORO FOULAH","MEDINA NDIAYENE",38,44,189,174,363
KOLDA,"MEDINA YORO FOULAH","MEDINA YORO FOULAH","MEDINA YORO FOULAH",NEMATABA,10,14,77,75,152
KOLDA,"MEDINA YORO FOULAH","MEDINA YORO FOULAH","MEDINA YORO FOULAH",SANTHIABA,107,124,460,365,825
KOLDA,"MEDINA YORO FOULAH","MEDINA YORO FOULAH","MEDINA YORO FOULAH","SARE DEMBA DIEWO",11,17,98,98,196
KOLDA,"MEDINA YORO FOULAH","MEDINA YORO FOULAH","MEDINA YORO FOULAH","SARE YORO DOUBE",54,56,274,225,499
KOLDA,"MEDINA YORO FOULAH","MEDINA YORO FOULAH","MEDINA YORO FOULAH","SINTHIANG DAOUDA SARR",11,12,66,54,120
KOLDA,"MEDINA YORO FOULAH","MEDINA YORO FOULAH","MEDINA YORO FOULAH","SINTHIANG HADJI DIALLO (SINTHIANG DIAOUBE)",10,10,73,63,136
KOLDA,"MEDINA YORO FOULAH","MEDINA YORO FOULAH","MEDINA YORO FOULAH","SINTHIANG KOUNA",4,5,33,27,60
KOLDA,"MEDINA YORO FOULAH",FAFACOUROU,FAFACOUROU,"ARTOULAYE DANFACOUNDA (ARTOULAYE WASSIATOU)",6,7,66,51,117
KOLDA,"MEDINA YORO FOULAH",FAFACOUROU,FAFACOUROU,"BAMBADINKA (SARE SALOUM)",22,25,232,159,391
KOLDA,"MEDINA YORO FOULAH",FAFACOUROU,FAFACOUROU,"BANTA (SINTHIANG WANDOU)",7,9,64,63,127
KOLDA,"MEDINA YORO FOULAH",FAFACOUROU,FAFACOUROU,BODOYEL,12,17,83,84,167
KOLDA,"MEDINA YORO FOULAH",FAFACOUROU,FAFACOUROU,"DIAM SYLLA",1,1,9,10,19
KOLDA,"MEDINA YORO FOULAH",FAFACOUROU,FAFACOUROU,DIBAMANG,13,14,123,138,261
KOLDA,"MEDINA YORO FOULAH",FAFACOUROU,FAFACOUROU,FAFACOUROU,97,101,545,556,1101
KOLDA,"MEDINA YORO FOULAH",FAFACOUROU,FAFACOUROU,"H1 SARE YEROYEL",5,5,31,26,57
KOLDA,"MEDINA YORO FOULAH",FAFACOUROU,FAFACOUROU,"H2 SINTHIANG WOUNDESSA (ELHADJI SORRY)",2,4,19,27,46
KOLDA,"MEDINA YORO FOULAH",FAFACOUROU,FAFACOUROU,"KONADJI SINTHIANG",17,24,192,167,359
KOLDA,"MEDINA YORO FOULAH",FAFACOUROU,FAFACOUROU,"KOROP MAOUNDE (KOROP)",10,16,165,116,281
KOLDA,"MEDINA YORO FOULAH",FAFACOUROU,FAFACOUROU,"LINGUEYEL SADA",2,5,22,32,54
KOLDA,"MEDINA YORO FOULAH",FAFACOUROU,FAFACOUROU,"LINGUEYEL SAMBA (SINTHIANG SAMBANA)",12,15,141,107,248
KOLDA,"MEDINA YORO FOULAH",FAFACOUROU,FAFACOUROU,"MAREWE COLY(SINTHIANG COLY)",8,13,97,95,192
KOLDA,"MEDINA YORO FOULAH",FAFACOUROU,FAFACOUROU,"MARIBE THIERNO (SARE THIERNO)",5,7,40,42,82
KOLDA,"MEDINA YORO FOULAH",FAFACOUROU,FAFACOUROU,"MASSIDY OMAR (MASSIDY)",11,11,109,86,195
KOLDA,"MEDINA YORO FOULAH",FAFACOUROU,FAFACOUROU,"MEDINA SAMBA",1,4,37,30,67
KOLDA,"MEDINA YORO FOULAH",FAFACOUROU,FAFACOUROU,"MEDINA YOUSSOUF",2,3,15,16,31
KOLDA,"MEDINA YORO FOULAH",FAFACOUROU,FAFACOUROU,"MEDINATOU SALAM (SARE DINGA)",23,30,256,180,436
KOLDA,"MEDINA YORO FOULAH",FAFACOUROU,FAFACOUROU,"MISSIRAH KOUTAYEL",15,32,309,203,512
KOLDA,"MEDINA YORO FOULAH",FAFACOUROU,FAFACOUROU,"MOUÏTABA ABDOULAYE",6,6,55,59,114
KOLDA,"MEDINA YORO FOULAH",FAFACOUROU,FAFACOUROU,PAKIDY,8,8,39,36,75
KOLDA,"MEDINA YORO FOULAH",FAFACOUROU,FAFACOUROU,"SARE DICKEL",19,26,195,163,358
KOLDA,"MEDINA YORO FOULAH",FAFACOUROU,FAFACOUROU,"SARE BACARY",5,5,46,45,91
KOLDA,"MEDINA YORO FOULAH",FAFACOUROU,FAFACOUROU,"SARE BOURE",13,18,165,176,341
KOLDA,"MEDINA YORO FOULAH",FAFACOUROU,FAFACOUROU,"SARE TALLA (SINTHIANG TALLA)",8,8,39,46,85
KOLDA,"MEDINA YORO FOULAH",FAFACOUROU,FAFACOUROU,"SINTHIANG AMEROU",9,9,40,51,91
KOLDA,"MEDINA YORO FOULAH",FAFACOUROU,FAFACOUROU,"SINTHIANG BANDIAYE",17,23,229,174,403
KOLDA,"MEDINA YORO FOULAH",FAFACOUROU,FAFACOUROU,"SINTHIANG BARA",4,7,39,35,74
KOLDA,"MEDINA YORO FOULAH",FAFACOUROU,FAFACOUROU,"SINTHIANG DAROU",4,6,17,18,35
KOLDA,"MEDINA YORO FOULAH",FAFACOUROU,FAFACOUROU,"SINTHIANG DEMBA NGOUDOUROU",13,15,86,74,160
KOLDA,"MEDINA YORO FOULAH",FAFACOUROU,FAFACOUROU,"SINTHIANG DEMBAYEL",5,5,32,32,64
KOLDA,"MEDINA YORO FOULAH",FAFACOUROU,FAFACOUROU,"SINTHIANG DIAHE",19,26,257,233,490
KOLDA,"MEDINA YORO FOULAH",FAFACOUROU,FAFACOUROU,"SINTHIANG DIALÒ",9,15,93,93,186
KOLDA,"MEDINA YORO FOULAH",FAFACOUROU,FAFACOUROU,"SINTHIANG DIAMANKA",26,26,219,143,362
KOLDA,"MEDINA YORO FOULAH",FAFACOUROU,FAFACOUROU,"SINTHIANG DIOMSINE",8,8,39,34,73
KOLDA,"MEDINA YORO FOULAH",FAFACOUROU,FAFACOUROU,"SINTHIANG DIOUMOU",6,8,63,53,116
KOLDA,"MEDINA YORO FOULAH",FAFACOUROU,FAFACOUROU,"SINTHIANG ILLO",1,3,15,16,31
KOLDA,"MEDINA YORO FOULAH",FAFACOUROU,FAFACOUROU,"SINTHIANG  YOBAROU KANDE",4,4,34,28,62
KOLDA,"MEDINA YORO FOULAH",FAFACOUROU,FAFACOUROU,"SINTHIANG DJIDE",6,6,44,54,98
KOLDA,"MEDINA YORO FOULAH",FAFACOUROU,FAFACOUROU,"SINTHIANG KOUTAYEL",14,17,150,136,286
KOLDA,"MEDINA YORO FOULAH",FAFACOUROU,FAFACOUROU,"SINTHIANG MOUSSA",5,5,40,27,67
KOLDA,"MEDINA YORO FOULAH",FAFACOUROU,FAFACOUROU,"SINTHIANG NIOUKHOUBA (THIEYEL DEMBA)",5,7,63,57,120
KOLDA,"MEDINA YORO FOULAH",FAFACOUROU,FAFACOUROU,PADIARA,18,28,230,214,444
KOLDA,"MEDINA YORO FOULAH",FAFACOUROU,FAFACOUROU,"SINTHIANG PICKO",10,10,63,58,121
KOLDA,"MEDINA YORO FOULAH",FAFACOUROU,FAFACOUROU,"SINTHIANG SAMBA DJIWO",5,9,66,69,135
KOLDA,"MEDINA YORO FOULAH",FAFACOUROU,FAFACOUROU,"SINTHIANG SAMBA NIAMADIO",3,7,50,43,93
KOLDA,"MEDINA YORO FOULAH",FAFACOUROU,FAFACOUROU,"MEDINA SOUNKAROU 1",10,12,79,55,134
KOLDA,"MEDINA YORO FOULAH",FAFACOUROU,FAFACOUROU,"SINTHIANG SORY",3,4,32,18,50
KOLDA,"MEDINA YORO FOULAH",FAFACOUROU,FAFACOUROU,"SINTHIANG SORY (SARE SORY META)",1,3,18,12,30
KOLDA,"MEDINA YORO FOULAH",FAFACOUROU,FAFACOUROU,"SINTHIANG SOUMBOU",3,3,28,21,49
KOLDA,"MEDINA YORO FOULAH",FAFACOUROU,FAFACOUROU,"MEDINA SOUNKAROU 2",2,3,18,19,37
KOLDA,"MEDINA YORO FOULAH",FAFACOUROU,FAFACOUROU,"SINTHIANG YORO DIAMANKA",49,68,361,367,728
KOLDA,"MEDINA YORO FOULAH",FAFACOUROU,FAFACOUROU,"SOTO FODE DEME",13,16,146,106,252
KOLDA,"MEDINA YORO FOULAH",FAFACOUROU,FAFACOUROU,"TEMENTO DICORY",10,12,101,71,172
KOLDA,"MEDINA YORO FOULAH",FAFACOUROU,FAFACOUROU,"WELIA BOYDO",6,8,56,85,141
KOLDA,"MEDINA YORO FOULAH",FAFACOUROU,BADION,"AKOUNDE MOUNDIOUROU (SARE MOUNDIOUROU)",22,25,198,154,352
KOLDA,"MEDINA YORO FOULAH",FAFACOUROU,BADION,"AKOUNDE SOULEYMANE (SARE SAWADI)",38,43,247,235,482
KOLDA,"MEDINA YORO FOULAH",FAFACOUROU,BADION,"H1 MADINA DAROU SALAM",1,2,5,2,7
KOLDA,"MEDINA YORO FOULAH",FAFACOUROU,BADION,BADION,64,76,686,417,1103
KOLDA,"MEDINA YORO FOULAH",FAFACOUROU,BADION,"H1 SINTHIANG HAROUNA",2,2,11,13,24
KOLDA,"MEDINA YORO FOULAH",FAFACOUROU,BADION,"BASSET OUSSEYNOU",7,7,47,53,100
KOLDA,"MEDINA YORO FOULAH",FAFACOUROU,BADION,BELKI,3,9,28,36,64
KOLDA,"MEDINA YORO FOULAH",FAFACOUROU,BADION,BOUBOUCOUNDA,13,14,114,125,239
KOLDA,"MEDINA YORO FOULAH",FAFACOUROU,BADION,"DIOULANGUEL BOUTANG",16,42,383,276,659
KOLDA,"MEDINA YORO FOULAH",FAFACOUROU,BADION,DIRIMANO,7,7,46,51,97
KOLDA,"MEDINA YORO FOULAH",FAFACOUROU,BADION,"FOUMIHARA(SARE DADY)",15,20,198,148,346
KOLDA,"MEDINA YORO FOULAH",FAFACOUROU,BADION,"KADIOLE DIAWANDO (SARE KADIARY DIAWANDO)",7,11,91,104,195
KOLDA,"MEDINA YORO FOULAH",FAFACOUROU,BADION,KONDIALA,33,37,307,262,569
KOLDA,"MEDINA YORO FOULAH",FAFACOUROU,BADION,"KOUMBALY WOURA",17,23,165,177,342
KOLDA,"MEDINA YORO FOULAH",FAFACOUROU,BADION,KOUNTHIOUDE,14,20,101,124,225
KOLDA,"MEDINA YORO FOULAH",FAFACOUROU,BADION,LINGUEDIE,22,25,347,361,708
KOLDA,"MEDINA YORO FOULAH",FAFACOUROU,BADION,"LINGUEWAL FAYCORY",11,13,81,83,164
KOLDA,"MEDINA YORO FOULAH",FAFACOUROU,BADION,"H1 SINTHIANG KEITA",25,27,154,127,281
KOLDA,"MEDINA YORO FOULAH",FAFACOUROU,BADION,"H2 SINTHIANG MAMAO",1,1,2,0,2
KOLDA,"MEDINA YORO FOULAH",FAFACOUROU,BADION,"LINKEDIANG (SARE BACARY)",12,15,115,114,229
KOLDA,"MEDINA YORO FOULAH",FAFACOUROU,BADION,"MEDINA BOUBACAR",6,7,49,40,89
KOLDA,"MEDINA YORO FOULAH",FAFACOUROU,BADION,"MEDINA DEME",12,16,109,138,247
KOLDA,"MEDINA YORO FOULAH",FAFACOUROU,BADION,"MEDINA DIAMBOYE",7,11,85,74,159
KOLDA,"MEDINA YORO FOULAH",FAFACOUROU,BADION,"MEDINA NANGO",11,12,101,91,192
KOLDA,"MEDINA YORO FOULAH",FAFACOUROU,BADION,"MEDINA THIEWEL BALDE",2,2,6,10,16
KOLDA,"MEDINA YORO FOULAH",FAFACOUROU,BADION,"NEMATABA TENING",6,7,77,65,142
KOLDA,"MEDINA YORO FOULAH",FAFACOUROU,BADION,"NGALIEL AMADOU",8,8,51,39,90
KOLDA,"MEDINA YORO FOULAH",FAFACOUROU,BADION,"NGALIEL MAGNO",8,18,102,99,201
KOLDA,"MEDINA YORO FOULAH",FAFACOUROU,BADION,"PIAYE BOURE",25,34,389,370,759
KOLDA,"MEDINA YORO FOULAH",FAFACOUROU,BADION,"PIAYE PATHE (SARE MAMADY)",6,12,123,102,225
KOLDA,"MEDINA YORO FOULAH",FAFACOUROU,BADION,SAMBARDE,18,34,365,328,693
KOLDA,"MEDINA YORO FOULAH",FAFACOUROU,BADION,"SARE BOIDO MALY",37,48,453,408,861
KOLDA,"MEDINA YORO FOULAH",FAFACOUROU,BADION,"SARE BOURAMA",2,4,30,40,70
KOLDA,"MEDINA YORO FOULAH",FAFACOUROU,BADION,"SARE BOYDO MAROUNE",4,5,36,35,71
KOLDA,"MEDINA YORO FOULAH",FAFACOUROU,BADION,"SARE COLY CAMARA",6,9,71,70,141
KOLDA,"MEDINA YORO FOULAH",FAFACOUROU,BADION,"SARE DEMBA COUMBA",4,6,70,45,115
KOLDA,"MEDINA YORO FOULAH",FAFACOUROU,BADION,"SARE DEMBA SOW",7,12,109,75,184
KOLDA,"MEDINA YORO FOULAH",FAFACOUROU,BADION,"SARE DIANKO",14,21,109,132,241
KOLDA,"MEDINA YORO FOULAH",FAFACOUROU,BADION,"SARE GAGNA (SARE LALY)",3,3,26,19,45
KOLDA,"MEDINA YORO FOULAH",FAFACOUROU,BADION,"SARE KANIMA",1,2,13,13,26
KOLDA,"MEDINA YORO FOULAH",FAFACOUROU,BADION,"SARE META MBALLO (SARE ASSETTE)",2,3,16,20,36
KOLDA,"MEDINA YORO FOULAH",FAFACOUROU,BADION,"SARE MOUSSAYEL",42,47,291,243,534
KOLDA,"MEDINA YORO FOULAH",FAFACOUROU,BADION,"SARE NDIOBO (MEDINA NDIOBO)",35,38,327,291,618
KOLDA,"MEDINA YORO FOULAH",FAFACOUROU,BADION,"SARE NDIOBO (SARE NDIOBO FRANCE)",6,15,66,62,128
KOLDA,"MEDINA YORO FOULAH",FAFACOUROU,BADION,"SARE NDOUMBE",31,39,182,200,382
KOLDA,"MEDINA YORO FOULAH",FAFACOUROU,BADION,"SARE PATHE AWA",15,24,253,265,518
KOLDA,"MEDINA YORO FOULAH",FAFACOUROU,BADION,"SARE PATHE COLY",10,13,93,76,169
KOLDA,"MEDINA YORO FOULAH",FAFACOUROU,BADION,"SARE PATHE COUMBA",10,11,96,100,196
KOLDA,"MEDINA YORO FOULAH",FAFACOUROU,BADION,"SARE SAMBA KOTO",2,5,40,31,71
KOLDA,"MEDINA YORO FOULAH",FAFACOUROU,BADION,"SARE SANOU",5,6,61,41,102
KOLDA,"MEDINA YORO FOULAH",FAFACOUROU,BADION,"SARE TENING MARA (TENING META)",15,15,105,100,205
KOLDA,"MEDINA YORO FOULAH",FAFACOUROU,BADION,"SARE TENING MBALLO",8,8,50,40,90
KOLDA,"MEDINA YORO FOULAH",FAFACOUROU,BADION,"SARE WALY",4,8,79,87,166
KOLDA,"MEDINA YORO FOULAH",FAFACOUROU,BADION,"SARE YERO MBALLO",6,8,43,41,84
KOLDA,"MEDINA YORO FOULAH",FAFACOUROU,BADION,"SARE YORO BAMBI",19,21,133,151,284
KOLDA,"MEDINA YORO FOULAH",FAFACOUROU,BADION,"SARE YORO DIALLO (SARE YORO BOYE)",8,12,147,104,251
KOLDA,"MEDINA YORO FOULAH",FAFACOUROU,BADION,SIBIDIANG,6,8,51,45,96
KOLDA,"MEDINA YORO FOULAH",FAFACOUROU,BADION,"SINTHIANG ABDOULAYE",8,12,87,78,165
KOLDA,"MEDINA YORO FOULAH",FAFACOUROU,BADION,"SINTHIANG SOLLAROU",3,4,23,24,47
KOLDA,"MEDINA YORO FOULAH",FAFACOUROU,BADION,"SINTHIANG COLY",12,15,160,151,311
KOLDA,"MEDINA YORO FOULAH",FAFACOUROU,BADION,DARSALAM,12,17,166,143,309
KOLDA,"MEDINA YORO FOULAH",FAFACOUROU,BADION,"SINTHIANG EL HADJI DEMBA",3,6,34,36,70
KOLDA,"MEDINA YORO FOULAH",FAFACOUROU,BADION,"SARE META TAMBA",1,1,7,13,20
KOLDA,"MEDINA YORO FOULAH",FAFACOUROU,BADION,"SINTHIANG POULO (SINTHIANG THIABA)",15,18,159,140,299
KOLDA,"MEDINA YORO FOULAH",FAFACOUROU,BADION,"SINTHIANG SARA (SARE KHADRY)",7,12,51,50,101
KOLDA,"MEDINA YORO FOULAH",FAFACOUROU,BADION,"SINTHIANG SORY",5,5,28,27,55
KOLDA,"MEDINA YORO FOULAH",FAFACOUROU,BADION,"SINTHIANG TENING BALDE",7,8,34,39,73
KOLDA,"MEDINA YORO FOULAH",FAFACOUROU,BADION,"SINTHIANG WALY",24,41,249,207,456
KOLDA,"MEDINA YORO FOULAH",FAFACOUROU,BADION,"TABAYEL BOURAMA",1,2,17,10,27
KOLDA,"MEDINA YORO FOULAH",FAFACOUROU,BADION,"THIEWEL BESSEL",19,24,190,184,374
KOLDA,"MEDINA YORO FOULAH",FAFACOUROU,BADION,"THIEWEL GOUMALO",15,19,112,143,255
KOLDA,"MEDINA YORO FOULAH",FAFACOUROU,BADION,"VELINGARA DIOUHE(SARE SAMBA TENING)",38,42,290,274,564
KOLDA,"MEDINA YORO FOULAH",FAFACOUROU,BADION,"VELINGARA OMAR",4,5,27,40,67
KOLDA,"MEDINA YORO FOULAH",NDORNA,NDORNA,BALKAMISSA,13,19,75,80,155
KOLDA,"MEDINA YORO FOULAH",NDORNA,NDORNA,BOGNANGHO,13,25,133,116,249
KOLDA,"MEDINA YORO FOULAH",NDORNA,NDORNA,"BOUROUNKOUDNE TOUMANY (BOUROUNKOUNE MAOUNDE)",11,18,98,72,170
KOLDA,"MEDINA YORO FOULAH",NDORNA,NDORNA,"BOUROUNKOUNDE WOPA",6,8,39,37,76
KOLDA,"MEDINA YORO FOULAH",NDORNA,NDORNA,BOUYOUNGOU,93,94,468,418,886
KOLDA,"MEDINA YORO FOULAH",NDORNA,NDORNA,"DELEKOU PATHE",6,14,58,55,113
KOLDA,"MEDINA YORO FOULAH",NDORNA,NDORNA,"DELEKOU SARE MBALLO",6,6,27,23,50
KOLDA,"MEDINA YORO FOULAH",NDORNA,NDORNA,"DIALABA DIERY",9,12,51,49,100
KOLDA,"MEDINA YORO FOULAH",NDORNA,NDORNA,"DIALABA MAOUNDE",7,9,84,46,130
KOLDA,"MEDINA YORO FOULAH",NDORNA,NDORNA,"DJIFING COLY",18,21,127,88,215
KOLDA,"MEDINA YORO FOULAH",NDORNA,NDORNA,"DJIFING KADIALY (SARE KADIALY)",1,3,23,9,32
KOLDA,"MEDINA YORO FOULAH",NDORNA,NDORNA,"DJIFING MAMADOU (SARE MAMADOU)",6,14,78,30,108
KOLDA,"MEDINA YORO FOULAH",NDORNA,NDORNA,"DJIFING YAKATA",8,16,71,65,136
KOLDA,"MEDINA YORO FOULAH",NDORNA,NDORNA,"FARA DIAMEL",16,27,79,88,167
KOLDA,"MEDINA YORO FOULAH",NDORNA,NDORNA,"FARA TOUNKOUME",7,10,44,47,91
KOLDA,"MEDINA YORO FOULAH",NDORNA,NDORNA,"FATOTO DEMBA (SARE SAMBOUROU)",8,8,33,21,54
KOLDA,"MEDINA YORO FOULAH",NDORNA,NDORNA,"GOMBANTANG FODE (SARE DEMBOUKA)",10,20,96,74,170
KOLDA,"MEDINA YORO FOULAH",NDORNA,NDORNA,"HAMDALLAYE MAMADOU DIALLO I",15,22,124,89,213
KOLDA,"MEDINA YORO FOULAH",NDORNA,NDORNA,KADJIMOR,17,37,118,134,252
KOLDA,"MEDINA YORO FOULAH",NDORNA,NDORNA,"H1 SINTHIANG MAMADOU BAKARY",6,20,39,36,75
KOLDA,"MEDINA YORO FOULAH",NDORNA,NDORNA,"KOGNARING DIANAMBE",4,9,43,39,82
KOLDA,"MEDINA YORO FOULAH",NDORNA,NDORNA,KOKOLE,24,35,165,154,319
KOLDA,"MEDINA YORO FOULAH",NDORNA,NDORNA,"H1 SINTHIANG MARO",2,4,21,18,39
KOLDA,"MEDINA YORO FOULAH",NDORNA,NDORNA,LINKEDIANG,22,70,173,150,323
KOLDA,"MEDINA YORO FOULAH",NDORNA,NDORNA,MBAYENE,25,36,190,133,323
KOLDA,"MEDINA YORO FOULAH",NDORNA,NDORNA,"MEDINA DIATTA SANE",32,46,231,197,428
KOLDA,"MEDINA YORO FOULAH",NDORNA,NDORNA,"MEDINA DJIFING (DJIFING MAMADOU)",17,50,155,151,306
KOLDA,"MEDINA YORO FOULAH",NDORNA,NDORNA,"MEDINA FASS",14,23,118,117,235
KOLDA,"MEDINA YORO FOULAH",NDORNA,NDORNA,"MISSIRAH DIATTA BALDE",20,26,93,83,176
KOLDA,"MEDINA YORO FOULAH",NDORNA,NDORNA,NANEKO,15,26,112,98,210
KOLDA,"MEDINA YORO FOULAH",NDORNA,NDORNA,"H1 SARE ALIOU SOW",3,4,20,11,31
KOLDA,"MEDINA YORO FOULAH",NDORNA,NDORNA,NDORNA,77,84,300,289,589
KOLDA,"MEDINA YORO FOULAH",NDORNA,NDORNA,"SARE BACARY (SINTHIANG SAMBA DIENOUBA)",8,14,50,51,101
KOLDA,"MEDINA YORO FOULAH",NDORNA,NDORNA,"SARE BAKARY NDOUDIOU (SINTHIANG BAKARY NDOUDIOU)",9,20,45,46,91
KOLDA,"MEDINA YORO FOULAH",NDORNA,NDORNA,"SARE BODIO (SINTHIANG BODIO)",7,9,37,40,77
KOLDA,"MEDINA YORO FOULAH",NDORNA,NDORNA,"SARE DEMBA SABALY",14,20,96,77,173
KOLDA,"MEDINA YORO FOULAH",NDORNA,NDORNA,"SARE DEMBAYEL",3,5,35,40,75
KOLDA,"MEDINA YORO FOULAH",NDORNA,NDORNA,"SARE DIAOBE",27,39,183,157,340
KOLDA,"MEDINA YORO FOULAH",NDORNA,NDORNA,"SARE MANSALY",4,7,35,35,70
KOLDA,"MEDINA YORO FOULAH",NDORNA,NDORNA,"SARE MODOU I",5,9,46,53,99
KOLDA,"MEDINA YORO FOULAH",NDORNA,NDORNA,"SARE MODOU II",8,12,63,66,129
KOLDA,"MEDINA YORO FOULAH",NDORNA,NDORNA,"SARE MORY",9,18,118,70,188
KOLDA,"MEDINA YORO FOULAH",NDORNA,NDORNA,"SARE SAMBA DABO",6,9,29,31,60
KOLDA,"MEDINA YORO FOULAH",NDORNA,NDORNA,"SARE SEYNI",6,13,53,56,109
KOLDA,"MEDINA YORO FOULAH",NDORNA,NDORNA,"SARE THIERNO SEYDI (SINTHIANG THIERNO SEYDI)",3,6,23,13,36
KOLDA,"MEDINA YORO FOULAH",NDORNA,NDORNA,"SARE TOUMANY (SINTHIANG TOUMANY)",6,7,40,43,83
KOLDA,"MEDINA YORO FOULAH",NDORNA,NDORNA,SINTHIANDING,8,13,61,50,111
KOLDA,"MEDINA YORO FOULAH",NDORNA,NDORNA,"SINTHIANG ABDOULAYE BALDE",8,12,46,53,99
KOLDA,"MEDINA YORO FOULAH",NDORNA,NDORNA,"SINTHIANG ABDOULAYE DIAMANKA",7,10,66,63,129
KOLDA,"MEDINA YORO FOULAH",NDORNA,NDORNA,"SINTHIANG ALIOU DIAO",10,16,72,94,166
KOLDA,"MEDINA YORO FOULAH",NDORNA,NDORNA,"SINTHIANG ALIOU DIALLO",6,9,46,37,83
KOLDA,"MEDINA YORO FOULAH",NDORNA,NDORNA,"SINTHIANG AMADOU DIAMANKA (SINTHIANG AMADOU NDARA)",5,8,25,26,51
KOLDA,"MEDINA YORO FOULAH",NDORNA,NDORNA,"SINTHIANG CHERIF",16,31,99,109,208
KOLDA,"MEDINA YORO FOULAH",NDORNA,NDORNA,"SINTHIANG DAOUDA",3,4,34,18,52
KOLDA,"MEDINA YORO FOULAH",NDORNA,NDORNA,"H1 SARE BAILELE",6,6,50,47,97
KOLDA,"MEDINA YORO FOULAH",NDORNA,NDORNA,"H2 SINTHIANG IBEL",2,3,14,13,27
KOLDA,"MEDINA YORO FOULAH",NDORNA,NDORNA,"SINTHIANG DEMBA THIEKA",4,14,41,29,70
KOLDA,"MEDINA YORO FOULAH",NDORNA,NDORNA,"SINTHIANG FARANG",5,7,17,16,33
KOLDA,"MEDINA YORO FOULAH",NDORNA,NDORNA,"SINTHIANG FODE",3,4,29,33,62
KOLDA,"MEDINA YORO FOULAH",NDORNA,NDORNA,"SINTHIANG HABIBOU",16,16,82,82,164
KOLDA,"MEDINA YORO FOULAH",NDORNA,NDORNA,"MADINA IBRAHIMA",7,7,43,44,87
KOLDA,"MEDINA YORO FOULAH",NDORNA,NDORNA,"SINTHIANG MADIA (SARE MADIA)",6,7,23,23,46
KOLDA,"MEDINA YORO FOULAH",NDORNA,NDORNA,"SINTHIANG MALLY (SARE MALLY)",8,12,45,43,88
KOLDA,"MEDINA YORO FOULAH",NDORNA,NDORNA,"SINTHIANG MAMA",12,16,72,58,130
KOLDA,"MEDINA YORO FOULAH",NDORNA,NDORNA,"SINTHIANG MAMADOU FANNE",3,7,23,23,46
KOLDA,"MEDINA YORO FOULAH",NDORNA,NDORNA,"SINTHIANG MAOUNDE DIEWO",3,12,20,21,41
KOLDA,"MEDINA YORO FOULAH",NDORNA,NDORNA,"SINTHIANG OUMAR",1,1,11,13,24
KOLDA,"MEDINA YORO FOULAH",NDORNA,NDORNA,"SINTHIANG OUSSEYNOU",18,22,110,110,220
KOLDA,"MEDINA YORO FOULAH",NDORNA,NDORNA,"SINTHIANG PATHE ARETA",7,11,46,32,78
KOLDA,"MEDINA YORO FOULAH",NDORNA,NDORNA,"SINTHIANG PATHE DIANAMBE",12,33,73,59,132
KOLDA,"MEDINA YORO FOULAH",NDORNA,NDORNA,"SINTHIANG PATHE MAOUNDE (PATHE MAOUNDE)",1,1,6,7,13
KOLDA,"MEDINA YORO FOULAH",NDORNA,NDORNA,"SINTHIANG PATHE SY",3,6,34,18,52
KOLDA,"MEDINA YORO FOULAH",NDORNA,NDORNA,"SINTHIANG SAN BANNA",2,12,15,18,33
KOLDA,"MEDINA YORO FOULAH",NDORNA,NDORNA,"SINTHIANG SECK (DAROU KHADIRINE)",19,20,111,105,216
KOLDA,"MEDINA YORO FOULAH",NDORNA,NDORNA,"SINTHIANG SIMON",3,4,18,20,38
KOLDA,"MEDINA YORO FOULAH",NDORNA,NDORNA,"SINTHIANG SOUBA DIANAMBE",2,13,27,30,57
KOLDA,"MEDINA YORO FOULAH",NDORNA,NDORNA,"SINTHIANG SOUBA MARAN",1,3,14,14,28
KOLDA,"MEDINA YORO FOULAH",NDORNA,NDORNA,"SINTHIANG SOULEYE",21,22,97,89,186
KOLDA,"MEDINA YORO FOULAH",NDORNA,NDORNA,"SINTHIANG THIERNO",9,15,63,79,142
KOLDA,"MEDINA YORO FOULAH",NDORNA,NDORNA,"H1 TIVAOUANE BOUBOU DIAL SY",20,21,139,55,194
KOLDA,"MEDINA YORO FOULAH",NDORNA,NDORNA,"SINTHIANG WOURA MBALLO",3,4,24,21,45
KOLDA,"MEDINA YORO FOULAH",NDORNA,NDORNA,SOBOULDE,79,111,738,441,1179
KOLDA,"MEDINA YORO FOULAH",NDORNA,NDORNA,"H1 SINTHIANG DICORY",3,4,19,18,37
KOLDA,"MEDINA YORO FOULAH",NDORNA,NDORNA,"H2 SINTHIANG OUMAR GOUNDO",2,6,31,24,55
KOLDA,"MEDINA YORO FOULAH",NDORNA,NDORNA,"H3 MADINA CHEIKH TIDIANE",1,1,31,0,31
KOLDA,"MEDINA YORO FOULAH",NDORNA,NDORNA,"SARE ALETTE",12,19,126,105,231
KOLDA,"MEDINA YORO FOULAH",NDORNA,NDORNA,"SOULABALY MAOUNDE",56,73,317,330,647
KOLDA,"MEDINA YORO FOULAH",NDORNA,NDORNA,"H1 MEDINATOUL MOUNAWARA ( CARREFOUR NDORNA)",19,21,69,73,142
KOLDA,"MEDINA YORO FOULAH",NDORNA,NDORNA,"TANKON FARA",109,127,763,652,1415
KOLDA,"MEDINA YORO FOULAH",NDORNA,NDORNA,"TEMENTO SOULEYMANE",4,6,27,25,52
KOLDA,"MEDINA YORO FOULAH",NDORNA,NDORNA,"THIARA MEDINA YORO FOULAH",12,14,84,51,135
KOLDA,"MEDINA YORO FOULAH",NDORNA,NDORNA,"TIMBI MEDINA",1,3,13,14,27
KOLDA,"MEDINA YORO FOULAH",NDORNA,NDORNA,"TOUGOUDE BALLA",11,15,74,62,136
KOLDA,"MEDINA YORO FOULAH",NDORNA,NDORNA,"H1 SINTHIAN MODY",2,3,14,14,28
KOLDA,"MEDINA YORO FOULAH",NDORNA,NDORNA,"H2 SINTHIAN YERO",1,2,11,5,16
KOLDA,"MEDINA YORO FOULAH",NDORNA,NDORNA,"TOUGOUDE WALY",4,6,30,48,78
KOLDA,"MEDINA YORO FOULAH",NDORNA,NDORNA,"H1 SINTHIANG DEMBA TORODO",1,4,25,22,47
KOLDA,"MEDINA YORO FOULAH",NDORNA,NDORNA,"VELINGARA MADIA (SINTHIANG VELINGARA)",5,5,30,14,44
KOLDA,"MEDINA YORO FOULAH",NDORNA,NDORNA,"VELINGARA SOTO",5,6,31,45,76
KOLDA,"MEDINA YORO FOULAH",NDORNA,NDORNA,"WAKILARE WOURA BALDE",6,11,44,34,78
KOLDA,"MEDINA YORO FOULAH",NDORNA,NDORNA,"PATHE FANTA BALDE",1,1,11,19,30
KOLDA,"MEDINA YORO FOULAH",NDORNA,NDORNA,"SINTHIAN SAMBA BATHIE",2,4,18,11,29
KOLDA,"MEDINA YORO FOULAH",NDORNA,NDORNA,"SINTHIAN SAMBA SOUNTOU",1,5,23,17,40
KOLDA,"MEDINA YORO FOULAH",NDORNA,NDORNA,"WELLIYA SAMBA",2,2,10,5,15
KOLDA,"MEDINA YORO FOULAH",NDORNA,NDORNA,"SINTHIANG BOUBACAR",2,3,9,15,24
KOLDA,"MEDINA YORO FOULAH",NDORNA,NDORNA,"SINTHIANG HASANA",2,3,16,20,36
KOLDA,"MEDINA YORO FOULAH",NDORNA,NDORNA,"SINTHIANG DEMBA SARANG",2,2,15,16,31
KOLDA,"MEDINA YORO FOULAH",NDORNA,NDORNA,"MEDINA MAMADOU",1,1,9,5,14
KOLDA,"MEDINA YORO FOULAH",NDORNA,NDORNA,"SINTHIANG DJIBI",8,9,29,31,60
KOLDA,"MEDINA YORO FOULAH",NDORNA,NDORNA,"SINTHIANG AMADOU TOBOLI",1,1,3,13,16
KOLDA,"MEDINA YORO FOULAH",NDORNA,NDORNA,"SINTHIANG OUSMANE",3,3,19,18,37
KOLDA,"MEDINA YORO FOULAH",NDORNA,BIGNARABE,"AFIA BACARY EL HADJI",9,15,116,104,220
KOLDA,"MEDINA YORO FOULAH",NDORNA,BIGNARABE,"AFIA BAKARY DEMBA (SARE FARBA)",10,11,57,51,108
KOLDA,"MEDINA YORO FOULAH",NDORNA,BIGNARABE,"BANDIAGARA SEKOUNA",3,5,66,25,91
KOLDA,"MEDINA YORO FOULAH",NDORNA,BIGNARABE,BIGNARABE,21,26,111,129,240
KOLDA,"MEDINA YORO FOULAH",NDORNA,BIGNARABE,"BOUSSOURA SORY I",21,30,182,148,330
KOLDA,"MEDINA YORO FOULAH",NDORNA,BIGNARABE,"BOUSSOURA SORY II",6,7,49,29,78
KOLDA,"MEDINA YORO FOULAH",NDORNA,BIGNARABE,"DAIBATOU BACOR",13,20,120,120,240
KOLDA,"MEDINA YORO FOULAH",NDORNA,BIGNARABE,"H1 SINTHIANG SAMBOU",1,2,10,15,25
KOLDA,"MEDINA YORO FOULAH",NDORNA,BIGNARABE,"H2 SINTHIANG LAMA",6,10,38,41,79
KOLDA,"MEDINA YORO FOULAH",NDORNA,BIGNARABE,"DAYBATOU YORO BALDE",6,7,9,17,26
KOLDA,"MEDINA YORO FOULAH",NDORNA,BIGNARABE,"GALLOUYEL DEMBA",20,29,169,145,314
KOLDA,"MEDINA YORO FOULAH",NDORNA,BIGNARABE,"GOUNDAGA BAILO",3,5,30,20,50
KOLDA,"MEDINA YORO FOULAH",NDORNA,BIGNARABE,"KADIAMARY (SARE DIOUBEL)",17,19,93,72,165
KOLDA,"MEDINA YORO FOULAH",NDORNA,BIGNARABE,"KEREWANE MAHY",10,12,81,59,140
KOLDA,"MEDINA YORO FOULAH",NDORNA,BIGNARABE,"MARAKISSA THIERNOYEL",11,16,138,92,230
KOLDA,"MEDINA YORO FOULAH",NDORNA,BIGNARABE,"MEDINA DAIBATOU",9,10,62,45,107
KOLDA,"MEDINA YORO FOULAH",NDORNA,BIGNARABE,"MEDINA KOUNFARANG",13,17,86,75,161
KOLDA,"MEDINA YORO FOULAH",NDORNA,BIGNARABE,"MISSIRAH COLY",11,11,54,50,104
KOLDA,"MEDINA YORO FOULAH",NDORNA,BIGNARABE,SANANKORO,29,30,181,175,356
KOLDA,"MEDINA YORO FOULAH",NDORNA,BIGNARABE,"SANTAKOYE (DAROU KHAIRA)",65,76,446,441,887
KOLDA,"MEDINA YORO FOULAH",NDORNA,BIGNARABE,"SARE BAKARY WASSA",7,9,36,50,86
KOLDA,"MEDINA YORO FOULAH",NDORNA,BIGNARABE,"SARE BOIDO",4,5,16,15,31
KOLDA,"MEDINA YORO FOULAH",NDORNA,BIGNARABE,"SARE MBEMBA TOURE",6,10,36,24,60
KOLDA,"MEDINA YORO FOULAH",NDORNA,BIGNARABE,"SARE DIATTA MBALLO",21,24,111,110,221
KOLDA,"MEDINA YORO FOULAH",NDORNA,BIGNARABE,"SARE GUELADIO",34,40,183,176,359
KOLDA,"MEDINA YORO FOULAH",NDORNA,BIGNARABE,"H1 NDIOBENE GNAMPAPOU",3,3,19,15,34
KOLDA,"MEDINA YORO FOULAH",NDORNA,BIGNARABE,"SARE GUIRO",9,9,46,45,91
KOLDA,"MEDINA YORO FOULAH",NDORNA,BIGNARABE,"SARE HAMIDOU DIAO",26,27,223,143,366
KOLDA,"MEDINA YORO FOULAH",NDORNA,BIGNARABE,"H1 SARE PATHE WARE",2,2,21,12,33
KOLDA,"MEDINA YORO FOULAH",NDORNA,BIGNARABE,"SARE MADIOU",53,58,261,233,494
KOLDA,"MEDINA YORO FOULAH",NDORNA,BIGNARABE,"SARE MALY",4,4,22,27,49
KOLDA,"MEDINA YORO FOULAH",NDORNA,BIGNARABE,"SARE MAMADOU TOURE",7,7,10,7,17
KOLDA,"MEDINA YORO FOULAH",NDORNA,BIGNARABE,"H1 SINTHIANG ALIOU DIAME SOW",5,5,30,21,51
KOLDA,"MEDINA YORO FOULAH",NDORNA,BIGNARABE,"SARE OUMAR KANDE (TALIYEL)",24,36,235,206,441
KOLDA,"MEDINA YORO FOULAH",NDORNA,BIGNARABE,"SARE SAMBA DIAO",6,7,44,44,88
KOLDA,"MEDINA YORO FOULAH",NDORNA,BIGNARABE,"SARE SAWADI (TOBO)",16,16,134,98,232
KOLDA,"MEDINA YORO FOULAH",NDORNA,BIGNARABE,"SINTHIANG ADAMA",4,4,39,25,64
KOLDA,"MEDINA YORO FOULAH",NDORNA,BIGNARABE,"SINTHIANG BOCAR",11,18,84,80,164
KOLDA,"MEDINA YORO FOULAH",NDORNA,BIGNARABE,SOSSOUTO,34,40,281,232,513
KOLDA,"MEDINA YORO FOULAH",NDORNA,BIGNARABE,TAMASSANKA,23,25,124,110,234
KOLDA,"MEDINA YORO FOULAH",NDORNA,BIGNARABE,"TAWFEKH SERIGNE LO",1,1,3,0,3
KOLDA,"MEDINA YORO FOULAH",NDORNA,BIGNARABE,"TEMENTO SAMBA",12,13,73,83,156
KOLDA,"MEDINA YORO FOULAH",NDORNA,BIGNARABE,"H1 TABOWAL SOUBA",2,4,15,13,28
KOLDA,"MEDINA YORO FOULAH",NDORNA,BOUROUCO,AINOUMANE,46,51,327,385,712
KOLDA,"MEDINA YORO FOULAH",NDORNA,BOUROUCO,"H1 DIAMAGADIO",9,10,73,89,162
KOLDA,"MEDINA YORO FOULAH",NDORNA,BOUROUCO,"BOUROUCO BIRANE CISSE",61,73,553,575,1128
KOLDA,"MEDINA YORO FOULAH",NDORNA,BOUROUCO,"H1 SINTHIOU MAMADOU NIANG",20,23,146,138,284
KOLDA,"MEDINA YORO FOULAH",NDORNA,BOUROUCO,"H2 SINTHIOU SEYDOU NDIAYE",10,10,58,66,124
KOLDA,"MEDINA YORO FOULAH",NDORNA,BOUROUCO,"H3 SINTHIOU ASSANE DIALLO",8,20,95,102,197
KOLDA,"MEDINA YORO FOULAH",NDORNA,BOUROUCO,"DAROU PAKATHIAR",102,120,725,805,1530
KOLDA,"MEDINA YORO FOULAH",NDORNA,BOUROUCO,"DAROU SALAM SECK",67,77,494,553,1047
KOLDA,"MEDINA YORO FOULAH",NDORNA,BOUROUCO,"FASS MBAYENE",25,33,162,223,385
KOLDA,"MEDINA YORO FOULAH",NDORNA,BOUROUCO,"FASS NDIENGUENE",61,72,485,512,997
KOLDA,"MEDINA YORO FOULAH",NDORNA,BOUROUCO,"H1 YAOUNDAR MAOUNDE",8,13,59,49,108
KOLDA,"MEDINA YORO FOULAH",NDORNA,BOUROUCO,"H2 YAOUNDAR SARA",11,15,68,67,135
KOLDA,"MEDINA YORO FOULAH",NDORNA,BOUROUCO,"H3 DIMISKA DEMBA",22,26,232,154,386
KOLDA,"MEDINA YORO FOULAH",NDORNA,BOUROUCO,"H4 DJIDA LEMOU (DJIDA LAMINE BA)",9,12,124,86,210
KOLDA,"MEDINA YORO FOULAH",NDORNA,BOUROUCO,"HAMDALLAYE (HAMDALLAYE MAMADOU DIALLO II)",102,119,708,705,1413
KOLDA,"MEDINA YORO FOULAH",NDORNA,BOUROUCO,"H1 MALANTA",2,3,26,13,39
KOLDA,"MEDINA YORO FOULAH",NDORNA,BOUROUCO,LAMSAR,39,48,282,285,567
KOLDA,"MEDINA YORO FOULAH",NDORNA,BOUROUCO,LOYENE,60,62,347,459,806
KOLDA,"MEDINA YORO FOULAH",NDORNA,BOUROUCO,"MADINA MBAYENE",10,16,55,24,79
KOLDA,"MEDINA YORO FOULAH",NDORNA,BOUROUCO,"MEDINA DINGUIRAYE (DINGUIRAYE)",131,153,841,920,1761
KOLDA,"MEDINA YORO FOULAH",NDORNA,BOUROUCO,"MEDINA KHAIRE",30,33,238,227,465
KOLDA,"MEDINA YORO FOULAH",NDORNA,BOUROUCO,"H1 YALAL",10,12,93,67,160
KOLDA,"MEDINA YORO FOULAH",NDORNA,BOUROUCO,"MEDINA MANDAKH",247,281,1673,1655,3328
KOLDA,"MEDINA YORO FOULAH",NDORNA,BOUROUCO,"MEDINA NDIAO",49,50,319,271,590
KOLDA,"MEDINA YORO FOULAH",NDORNA,BOUROUCO,"H1 YAOUNDAR META",12,20,93,93,186
KOLDA,"MEDINA YORO FOULAH",NDORNA,BOUROUCO,"H2 YAOUNDAR YOUSSOUF",29,43,231,252,483
KOLDA,"MEDINA YORO FOULAH",NDORNA,BOUROUCO,"MEDINA PASSY",82,128,864,853,1717
KOLDA,"MEDINA YORO FOULAH",NDORNA,BOUROUCO,"H1 SINTHIANG ALADJI TOUNTOUROUNG",10,11,63,66,129
KOLDA,"MEDINA YORO FOULAH",NDORNA,BOUROUCO,"H2 SINTHIANG ALADJI KOUNLERE",13,14,68,50,118
KOLDA,"MEDINA YORO FOULAH",NDORNA,BOUROUCO,"H3 SINTHIOU DEBE",14,18,111,97,208
KOLDA,"MEDINA YORO FOULAH",NDORNA,BOUROUCO,"MEDINA SAYINDING (SARE THIERNO)",27,44,210,220,430
KOLDA,"MEDINA YORO FOULAH",NDORNA,BOUROUCO,"H1 SINTHIOU SAMBA DIOP",5,10,32,43,75
KOLDA,"MEDINA YORO FOULAH",NDORNA,BOUROUCO,"MEDINA SILLY",74,95,574,638,1212
KOLDA,"MEDINA YORO FOULAH",NDORNA,BOUROUCO,"H1 THIABA (DAROU DIAMWELY)",6,7,38,35,73
KOLDA,"MEDINA YORO FOULAH",NDORNA,BOUROUCO,"MISSIRAH ALPHA DEME",26,34,189,177,366
KOLDA,"MEDINA YORO FOULAH",NDORNA,BOUROUCO,"NIASSENE TAMASSINA",42,56,379,389,768
KOLDA,"MEDINA YORO FOULAH",NDORNA,BOUROUCO,"SARE DEMBA CISSE",18,35,116,137,253
KOLDA,"MEDINA YORO FOULAH",NDORNA,BOUROUCO,"SARE DORO THIAM",43,70,341,347,688
KOLDA,"MEDINA YORO FOULAH",NDORNA,BOUROUCO,"SARE MOUSSA LOUM (MISSIRAH LOUMENE)",30,33,255,281,536
KOLDA,"MEDINA YORO FOULAH",NDORNA,BOUROUCO,"SARE SAMA",46,73,411,383,794
KOLDA,"MEDINA YORO FOULAH",NDORNA,BOUROUCO,"SARE SAMBA CISSE",83,139,698,705,1403
KOLDA,"MEDINA YORO FOULAH",NDORNA,BOUROUCO,"H1 SINTHIOU MOUSSA DIALLO",30,40,256,207,463
KOLDA,"MEDINA YORO FOULAH",NDORNA,BOUROUCO,"H2 TOUBA NDIAYENE",1,1,7,10,17
KOLDA,"MEDINA YORO FOULAH",NDORNA,BOUROUCO,"SARE YORO SY (SINTHIOU YORO SY)",56,90,481,588,1069
KOLDA,"MEDINA YORO FOULAH",NDORNA,BOUROUCO,"H1 NEMA TOUCOULEUR (NEMA SAMBA SALL)",13,15,105,114,219
KOLDA,"MEDINA YORO FOULAH",NDORNA,BOUROUCO,"SAYINDING DAOUDA",20,23,161,140,301
KOLDA,"MEDINA YORO FOULAH",NDORNA,BOUROUCO,"SAYINDING MAOUNDE",7,11,55,61,116
KOLDA,"MEDINA YORO FOULAH",NDORNA,BOUROUCO,"SINTHIOU PATHE NDIADO (SARE PATHE)",19,29,171,136,307
KOLDA,"MEDINA YORO FOULAH",NDORNA,BOUROUCO,"SINTHIOU BOUDOUCK",21,27,160,120,280
KOLDA,"MEDINA YORO FOULAH",NDORNA,BOUROUCO,"SANTHI CHEIKH NIASSE",51,57,343,318,661
KOLDA,"MEDINA YORO FOULAH",NDORNA,BOUROUCO,"SINTHIOU KAMI SADIO",7,7,25,42,67
KOLDA,"MEDINA YORO FOULAH",NDORNA,BOUROUCO,"SINTHIOU MALI",8,12,56,54,110
KOLDA,"MEDINA YORO FOULAH",NDORNA,BOUROUCO,"SINTHIOU SAMBA GUEYE",26,34,185,188,373
KOLDA,"MEDINA YORO FOULAH",NDORNA,BOUROUCO,"H1 TEMENTO OUSMANE GUEYE",12,15,65,77,142
KOLDA,"MEDINA YORO FOULAH",NDORNA,BOUROUCO,TAIBA,65,78,460,495,955
KOLDA,"MEDINA YORO FOULAH",NDORNA,BOUROUCO,"TOUBA KANEL",25,31,151,215,366
KOLDA,"MEDINA YORO FOULAH",NDORNA,BOUROUCO,"TOUBA THIECKENE",108,150,1081,948,2029
KOLDA,"MEDINA YORO FOULAH",NDORNA,BOUROUCO,YEDOULAYE,90,107,661,816,1477
KOLDA,"MEDINA YORO FOULAH",NDORNA,BOUROUCO,"YILIME (SINTHIOU DEMBA SYLLA)",27,34,144,166,310
KOLDA,"MEDINA YORO FOULAH",NDORNA,BOUROUCO,"MADINA KOSSY",5,10,70,41,111
KOLDA,"MEDINA YORO FOULAH",NDORNA,BOUROUCO,"MEDINA NDILLY",4,4,18,18,36
KOLDA,"MEDINA YORO FOULAH",NDORNA,KOULINTO,"ALABOURY (SARE YOBA)",3,3,28,20,48
KOLDA,"MEDINA YORO FOULAH",NDORNA,KOULINTO,"BELLY NAOUDE",17,18,162,177,339
KOLDA,"MEDINA YORO FOULAH",NDORNA,KOULINTO,"H1 SARE ALET",6,6,33,44,77
KOLDA,"MEDINA YORO FOULAH",NDORNA,KOULINTO,"BOULEL DADY",13,16,114,108,222
KOLDA,"MEDINA YORO FOULAH",NDORNA,KOULINTO,"H1 SINTHIANG DIARGA BOUYA",4,9,42,40,82
KOLDA,"MEDINA YORO FOULAH",NDORNA,KOULINTO,"H2 SINTHIANG DIODOU",3,5,38,26,64
KOLDA,"MEDINA YORO FOULAH",NDORNA,KOULINTO,"HAMDALLAYE MOUSSA",11,14,122,97,219
KOLDA,"MEDINA YORO FOULAH",NDORNA,KOULINTO,"ISLAM THIERNO SALIOU",3,7,82,47,129
KOLDA,"MEDINA YORO FOULAH",NDORNA,KOULINTO,"KADIAMARY DEMBA",15,20,141,119,260
KOLDA,"MEDINA YORO FOULAH",NDORNA,KOULINTO,KANSONKO,4,5,47,28,75
KOLDA,"MEDINA YORO FOULAH",NDORNA,KOULINTO,"KATHIE MANDINGUE",8,10,61,57,118
KOLDA,"MEDINA YORO FOULAH",NDORNA,KOULINTO,"KATHIE PEULH",5,6,43,42,85
KOLDA,"MEDINA YORO FOULAH",NDORNA,KOULINTO,"KOKOLE DIARGA",8,12,70,58,128
KOLDA,"MEDINA YORO FOULAH",NDORNA,KOULINTO,KOULINTO,20,20,82,94,176
KOLDA,"MEDINA YORO FOULAH",NDORNA,KOULINTO,"H1 DAROU SALAM AMADOU DIALLO",7,7,41,48,89
KOLDA,"MEDINA YORO FOULAH",NDORNA,KOULINTO,"H2 DAROU MAMADOU",4,4,27,32,59
KOLDA,"MEDINA YORO FOULAH",NDORNA,KOULINTO,"H3 SINTHIANG SAMBA",3,3,14,14,28
KOLDA,"MEDINA YORO FOULAH",NDORNA,KOULINTO,"H4 SINTHIANG SEYDOU",1,2,18,13,31
KOLDA,"MEDINA YORO FOULAH",NDORNA,KOULINTO,"H5 SINTHIANG BOCAR",4,7,32,34,66
KOLDA,"MEDINA YORO FOULAH",NDORNA,KOULINTO,"KOUMBIDIANG MOUSTAPHA (KOUMBIDIANG SEKOU)",4,4,30,29,59
KOLDA,"MEDINA YORO FOULAH",NDORNA,KOULINTO,"LABE THIERNO",14,14,105,94,199
KOLDA,"MEDINA YORO FOULAH",NDORNA,KOULINTO,"MANKAGNY MOUNDIOUROU",5,12,74,65,139
KOLDA,"MEDINA YORO FOULAH",NDORNA,KOULINTO,"MAREWE SORY",4,4,20,11,31
KOLDA,"MEDINA YORO FOULAH",NDORNA,KOULINTO,"MEDINA EL HADJI SADOU (WARBET)",10,11,62,87,149
KOLDA,"MEDINA YORO FOULAH",NDORNA,KOULINTO,"MEDINA MAMADOU SOULEYE",4,7,43,38,81
KOLDA,"MEDINA YORO FOULAH",NDORNA,KOULINTO,"MISSIRAH EL HADJI MAMADOU BOWE",9,14,110,127,237
KOLDA,"MEDINA YORO FOULAH",NDORNA,KOULINTO,"MISSIRAH EL HADJI OUMAR KANDE (DIAMBANOUTA)",69,90,701,585,1286
KOLDA,"MEDINA YORO FOULAH",NDORNA,KOULINTO,"MISSIRAH EL HADJI OUSMANE (KATABA OUSMANE)",9,12,86,84,170
KOLDA,"MEDINA YORO FOULAH",NDORNA,KOULINTO,"H1 KATABA FARING",2,2,15,22,37
KOLDA,"MEDINA YORO FOULAH",NDORNA,KOULINTO,"H2 KATABA MOUSSA",6,10,86,77,163
KOLDA,"MEDINA YORO FOULAH",NDORNA,KOULINTO,"H3 SARE NDIOBO",4,5,48,36,84
KOLDA,"MEDINA YORO FOULAH",NDORNA,KOULINTO,"H4 SINTHIANG IBEL",6,6,27,31,58
KOLDA,"MEDINA YORO FOULAH",NDORNA,KOULINTO,"SARE BODIO",4,5,22,12,34
KOLDA,"MEDINA YORO FOULAH",NDORNA,KOULINTO,"SARE HABIBOU",9,11,87,70,157
KOLDA,"MEDINA YORO FOULAH",NDORNA,KOULINTO,"H2 SINTHIANG MAMA GALLE",2,3,16,15,31
KOLDA,"MEDINA YORO FOULAH",NDORNA,KOULINTO,"H3 SINTHIANG SECKOU",2,3,19,15,34
KOLDA,"MEDINA YORO FOULAH",NDORNA,KOULINTO,"H4 SAMBOULOUNG",3,5,16,23,39
KOLDA,"MEDINA YORO FOULAH",NDORNA,KOULINTO,"SARE KEITA (SIRADIOUBA)",12,13,74,75,149
KOLDA,"MEDINA YORO FOULAH",NDORNA,KOULINTO,"SARE KONKO",7,9,56,49,105
KOLDA,"MEDINA YORO FOULAH",NDORNA,KOULINTO,"SARE KOUPE",13,24,93,83,176
KOLDA,"MEDINA YORO FOULAH",NDORNA,KOULINTO,"SARE SADA MBALLO",3,4,29,23,52
KOLDA,"MEDINA YORO FOULAH",NDORNA,KOULINTO,"SARE SANA (SINTHIANG SANA)",5,8,85,68,153
KOLDA,"MEDINA YORO FOULAH",NDORNA,KOULINTO,"SINTHIANG  SARADOU",2,2,25,14,39
KOLDA,"MEDINA YORO FOULAH",NDORNA,KOULINTO,"SARE YAYA MBALLO",6,8,81,83,164
KOLDA,"MEDINA YORO FOULAH",NDORNA,KOULINTO,"SINTHIANG BOUBOU",10,10,96,91,187
KOLDA,"MEDINA YORO FOULAH",NDORNA,KOULINTO,"SINTHIANG BOURE",11,18,136,128,264
KOLDA,"MEDINA YORO FOULAH",NDORNA,KOULINTO,"H1 SINTHIANG SACKOU",4,5,32,27,59
KOLDA,"MEDINA YORO FOULAH",NDORNA,KOULINTO,"H2 SINTHIANG EL HADJI SALIOU",3,5,43,37,80
KOLDA,"MEDINA YORO FOULAH",NDORNA,KOULINTO,"SINTHIANG DAROU SALAM (SINTHIANG DOULO)",15,18,119,144,263
KOLDA,"MEDINA YORO FOULAH",NDORNA,KOULINTO,"SINTHIANG DIOULDE BALDE(SANTHIAGO AMADOU)",6,8,76,68,144
KOLDA,"MEDINA YORO FOULAH",NDORNA,KOULINTO,"SINTHIANG DOULEL",7,7,59,51,110
KOLDA,"MEDINA YORO FOULAH",NDORNA,KOULINTO,"SINTHIANG GALLO KANDE",2,3,14,16,30
KOLDA,"MEDINA YORO FOULAH",NDORNA,KOULINTO,"SINTHIANG GARDI (SARE GARDI)",8,11,67,67,134
KOLDA,"MEDINA YORO FOULAH",NDORNA,KOULINTO,"SINTHIANG KHOUNOUSSY (KHOUNOUSSY DIALIMANG)",8,10,77,71,148
KOLDA,"MEDINA YORO FOULAH",NDORNA,KOULINTO,"SINTHIANG MONDE MBALLO",1,2,12,13,25
KOLDA,"MEDINA YORO FOULAH",NDORNA,KOULINTO,"SINTHIANG MOUSSA KANDE",9,9,79,74,153
KOLDA,"MEDINA YORO FOULAH",NDORNA,KOULINTO,"SINTHIANG NIAMA",7,8,38,36,74
KOLDA,"MEDINA YORO FOULAH",NDORNA,KOULINTO,"SINTHIANG OUMAR (SARE OUMAR)",6,7,61,62,123
KOLDA,"MEDINA YORO FOULAH",NDORNA,KOULINTO,"SINTHIANG SALIOU PENDA",2,4,22,23,45
KOLDA,"MEDINA YORO FOULAH",NDORNA,KOULINTO,"SINTHIANG SOBOULDE (SOBOULDE MBAGNICK)",8,9,59,46,105
KOLDA,"MEDINA YORO FOULAH",NDORNA,KOULINTO,"TOUBA SANKOUNG",22,24,136,110,246
KOLDA,"MEDINA YORO FOULAH",NDORNA,KOULINTO,"WASSADOU SAMBA SABALY (SARE SAMBA GOUNDO)",20,26,152,139,291
KOLDA,"MEDINA YORO FOULAH",NDORNA,KOULINTO,YIRICOYE,4,5,19,26,45
KOLDA,"MEDINA YORO FOULAH",NDORNA,KOULINTO,"SINTHIANG AMADOU",1,2,15,13,28
KOLDA,"MEDINA YORO FOULAH",NIAMING,DINGUIRAYE,ABECOUTA,61,90,511,487,998
KOLDA,"MEDINA YORO FOULAH",NIAMING,DINGUIRAYE,"BELAL (BELAL SENEGAL)",24,28,199,174,373
KOLDA,"MEDINA YORO FOULAH",NIAMING,DINGUIRAYE,"DABIYA SENEGAL",10,12,53,45,98
KOLDA,"MEDINA YORO FOULAH",NIAMING,DINGUIRAYE,DOBONCOUNDA,31,36,259,233,492
KOLDA,"MEDINA YORO FOULAH",NIAMING,DINGUIRAYE,"DAROU KHOUMENE",33,40,286,250,536
KOLDA,"MEDINA YORO FOULAH",NIAMING,DINGUIRAYE,"DAROU SALAMOU (DAROU KAYENE)",32,44,246,272,518
KOLDA,"MEDINA YORO FOULAH",NIAMING,DINGUIRAYE,DINGUIRAYE,61,75,458,431,889
KOLDA,"MEDINA YORO FOULAH",NIAMING,DINGUIRAYE,FRANCOUNDA,3,14,137,102,239
KOLDA,"MEDINA YORO FOULAH",NIAMING,DINGUIRAYE,"GOUNASS I",38,56,347,327,674
KOLDA,"MEDINA YORO FOULAH",NIAMING,DINGUIRAYE,"GOUNASS II",32,33,204,157,361
KOLDA,"MEDINA YORO FOULAH",NIAMING,DINGUIRAYE,GOUNDIOUROU,5,9,66,66,132
KOLDA,"MEDINA YORO FOULAH",NIAMING,DINGUIRAYE,"HAMDALLAYE ALPHA",39,55,350,352,702
KOLDA,"MEDINA YORO FOULAH",NIAMING,DINGUIRAYE,HELINHINA,17,20,157,152,309
KOLDA,"MEDINA YORO FOULAH",NIAMING,DINGUIRAYE,KANEL,69,89,633,650,1283
KOLDA,"MEDINA YORO FOULAH",NIAMING,DINGUIRAYE,KOKOUNTO,16,21,146,132,278
KOLDA,"MEDINA YORO FOULAH",NIAMING,DINGUIRAYE,"LINGUEYEL SARA BALDE",5,6,36,30,66
KOLDA,"MEDINA YORO FOULAH",NIAMING,DINGUIRAYE,"H1 SARE SEYNI",2,2,20,25,45
KOLDA,"MEDINA YORO FOULAH",NIAMING,DINGUIRAYE,"MAREWE MAOUNDE",17,19,140,157,297
KOLDA,"MEDINA YORO FOULAH",NIAMING,DINGUIRAYE,MBALLOCOUNDA,26,34,305,277,582
KOLDA,"MEDINA YORO FOULAH",NIAMING,DINGUIRAYE,"MEDINA KOYRI",37,43,389,350,739
KOLDA,"MEDINA YORO FOULAH",NIAMING,DINGUIRAYE,"MEDINA MALAFI (SINTHIANG MEDINA MALAFI)",51,66,398,371,769
KOLDA,"MEDINA YORO FOULAH",NIAMING,DINGUIRAYE,"MEDINA PATHE",33,46,282,295,577
KOLDA,"MEDINA YORO FOULAH",NIAMING,DINGUIRAYE,"MEDINA SAHETTE",8,12,83,92,175
KOLDA,"MEDINA YORO FOULAH",NIAMING,DINGUIRAYE,"MEDINA THIALENE",31,42,178,202,380
KOLDA,"MEDINA YORO FOULAH",NIAMING,DINGUIRAYE,MINAL,11,16,87,90,177
KOLDA,"MEDINA YORO FOULAH",NIAMING,DINGUIRAYE,"MISSIRAH THIARENE",37,43,290,250,540
KOLDA,"MEDINA YORO FOULAH",NIAMING,DINGUIRAYE,"NDAWENE (KEUR MODOU DIOP)",21,30,170,184,354
KOLDA,"MEDINA YORO FOULAH",NIAMING,DINGUIRAYE,"NDIOBENE ALY",7,11,53,51,104
KOLDA,"MEDINA YORO FOULAH",NIAMING,DINGUIRAYE,"SAMBA SEBO (SINTHIANG SAMBA SEBO)",11,16,100,129,229
KOLDA,"MEDINA YORO FOULAH",NIAMING,DINGUIRAYE,SANGOULE,58,66,303,278,581
KOLDA,"MEDINA YORO FOULAH",NIAMING,DINGUIRAYE,"H1 SINTHIANG DIARRA SOW",8,10,87,51,138
KOLDA,"MEDINA YORO FOULAH",NIAMING,DINGUIRAYE,"H2 SINTHIANG PATHE DIAMANKA",4,4,18,25,43
KOLDA,"MEDINA YORO FOULAH",NIAMING,DINGUIRAYE,SARABA,33,36,204,152,356
KOLDA,"MEDINA YORO FOULAH",NIAMING,DINGUIRAYE,"SARE DICORY",1,3,11,16,27
KOLDA,"MEDINA YORO FOULAH",NIAMING,DINGUIRAYE,"SARE HELLA",25,26,124,121,245
KOLDA,"MEDINA YORO FOULAH",NIAMING,DINGUIRAYE,"SARE PATHE AMADOU",9,10,43,47,90
KOLDA,"MEDINA YORO FOULAH",NIAMING,DINGUIRAYE,"SARE SARADOU",69,100,545,507,1052
KOLDA,"MEDINA YORO FOULAH",NIAMING,DINGUIRAYE,"SEYDOU MBAYE",8,8,71,41,112
KOLDA,"MEDINA YORO FOULAH",NIAMING,DINGUIRAYE,"SINTHIANG BABOU DEME (TAWA KALTOU)",93,105,467,408,875
KOLDA,"MEDINA YORO FOULAH",NIAMING,DINGUIRAYE,"SINTHIANG FALAYE",4,9,33,38,71
KOLDA,"MEDINA YORO FOULAH",NIAMING,DINGUIRAYE,"SINTHIANG IFRA",48,81,382,411,793
KOLDA,"MEDINA YORO FOULAH",NIAMING,DINGUIRAYE,"SINTHIANG WOPA",18,22,154,172,326
KOLDA,"MEDINA YORO FOULAH",NIAMING,DINGUIRAYE,THIAMENE,44,48,302,269,571
KOLDA,"MEDINA YORO FOULAH",NIAMING,DINGUIRAYE,"THIARENE FODE",17,18,86,73,159
KOLDA,"MEDINA YORO FOULAH",NIAMING,DINGUIRAYE,"THIOUTY (SINTHIANG SADIO)",8,10,95,64,159
KOLDA,"MEDINA YORO FOULAH",NIAMING,KEREWANE,AINOUMANE,18,23,206,217,423
KOLDA,"MEDINA YORO FOULAH",NIAMING,KEREWANE,"ARAFAT EL HADJI OMAR",21,41,258,216,474
KOLDA,"MEDINA YORO FOULAH",NIAMING,KEREWANE,"SARE ALY",11,12,77,60,137
KOLDA,"MEDINA YORO FOULAH",NIAMING,KEREWANE,"BANANTO NGALING",3,3,12,9,21
KOLDA,"MEDINA YORO FOULAH",NIAMING,KEREWANE,"BANANTO WALY",4,6,41,38,79
KOLDA,"MEDINA YORO FOULAH",NIAMING,KEREWANE,"BANY THIERNO DIALLO",6,6,32,30,62
KOLDA,"MEDINA YORO FOULAH",NIAMING,KEREWANE,"BOUNDOU SAMBOU",40,44,291,327,618
KOLDA,"MEDINA YORO FOULAH",NIAMING,KEREWANE,"DAROU KHOUDOSS",73,79,542,533,1075
KOLDA,"MEDINA YORO FOULAH",NIAMING,KEREWANE,"DAROU NAHIM (DAROU NIAPI)",17,21,116,135,251
KOLDA,"MEDINA YORO FOULAH",NIAMING,KEREWANE,"DAROU RILWANE",5,5,15,22,37
KOLDA,"MEDINA YORO FOULAH",NIAMING,KEREWANE,"DAROU SALAM",45,64,419,480,899
KOLDA,"MEDINA YORO FOULAH",NIAMING,KEREWANE,"DAROU THIENDOU (DAROU SALAM)",10,15,90,92,182
KOLDA,"MEDINA YORO FOULAH",NIAMING,KEREWANE,"DIABA SENEGAL",41,47,283,298,581
KOLDA,"MEDINA YORO FOULAH",NIAMING,KEREWANE,DIAKHALY,37,51,384,320,704
KOLDA,"MEDINA YORO FOULAH",NIAMING,KEREWANE,DIAMOUGUEL,15,20,172,124,296
KOLDA,"MEDINA YORO FOULAH",NIAMING,KEREWANE,DIAROUME,23,30,128,142,270
KOLDA,"MEDINA YORO FOULAH",NIAMING,KEREWANE,"DIEYDANY TOUMANI",10,13,110,103,213
KOLDA,"MEDINA YORO FOULAH",NIAMING,KEREWANE,"DIMISKA (KHORE WOUGNANKI)",62,68,530,551,1081
KOLDA,"MEDINA YORO FOULAH",NIAMING,KEREWANE,DIYABOUGOU,26,36,490,502,992
KOLDA,"MEDINA YORO FOULAH",NIAMING,KEREWANE,DJIDA,18,19,108,116,224
KOLDA,"MEDINA YORO FOULAH",NIAMING,KEREWANE,"FASS TOBENE",44,60,421,329,750
KOLDA,"MEDINA YORO FOULAH",NIAMING,KEREWANE,FIRDAWSI,62,67,373,403,776
KOLDA,"MEDINA YORO FOULAH",NIAMING,KEREWANE,"HAMDALLAYE SAMB MBAYE",69,78,387,448,835
KOLDA,"MEDINA YORO FOULAH",NIAMING,KEREWANE,"HAMDALLAYE YORO DIALLO",8,12,131,104,235
KOLDA,"MEDINA YORO FOULAH",NIAMING,KEREWANE,KAWSARA,4,8,23,29,52
KOLDA,"MEDINA YORO FOULAH",NIAMING,KEREWANE,"H1 KHORE GNIWA",3,3,6,8,14
KOLDA,"MEDINA YORO FOULAH",NIAMING,KEREWANE,KEREWANE,104,119,1296,1097,2393
KOLDA,"MEDINA YORO FOULAH",NIAMING,KEREWANE,"KEUR ABDOU SARR",13,16,83,80,163
KOLDA,"MEDINA YORO FOULAH",NIAMING,KEREWANE,"KOEL NIORO",52,58,344,293,637
KOLDA,"MEDINA YORO FOULAH",NIAMING,KEREWANE,"LEBA ALIOU (LEBA NIASSENE)",11,18,129,106,235
KOLDA,"MEDINA YORO FOULAH",NIAMING,KEREWANE,"LEBA DAWORO",19,41,207,281,488
KOLDA,"MEDINA YORO FOULAH",NIAMING,KEREWANE,"LEBA MAMADOU DIALLO",6,7,29,45,74
KOLDA,"MEDINA YORO FOULAH",NIAMING,KEREWANE,"MAKA ABDOU SALL",18,26,241,235,476
KOLDA,"MEDINA YORO FOULAH",NIAMING,KEREWANE,MAKAYEL,12,20,144,140,284
KOLDA,"MEDINA YORO FOULAH",NIAMING,KEREWANE,"MEDINA ALPHA(SINTHIANG GUIRO)",25,29,187,116,303
KOLDA,"MEDINA YORO FOULAH",NIAMING,KEREWANE,"MEDINA BIRANE",2,5,46,39,85
KOLDA,"MEDINA YORO FOULAH",NIAMING,KEREWANE,"MEDINA HAMDALLAYE",5,6,35,42,77
KOLDA,"MEDINA YORO FOULAH",NIAMING,KEREWANE,"MEDINA MBAYENE (WOUGNANKI)",63,96,773,730,1503
KOLDA,"MEDINA YORO FOULAH",NIAMING,KEREWANE,"MEDINA SIMBY",3,5,33,48,81
KOLDA,"MEDINA YORO FOULAH",NIAMING,KEREWANE,"MEDINA TELLY (SINTHIANG TELLY)",23,23,56,51,107
KOLDA,"MEDINA YORO FOULAH",NIAMING,KEREWANE,"MEO NDIOBENE (SOURAYEL)",117,150,1595,1345,2940
KOLDA,"MEDINA YORO FOULAH",NIAMING,KEREWANE,MINNA,42,55,250,284,534
KOLDA,"MEDINA YORO FOULAH",NIAMING,KEREWANE,"MISSIRAH DIAKHALY",44,55,923,880,1803
KOLDA,"MEDINA YORO FOULAH",NIAMING,KEREWANE,"MISSIRAH MAMADOU",36,39,161,112,273
KOLDA,"MEDINA YORO FOULAH",NIAMING,KEREWANE,"MISSIRAH SAMBA MBENGUE",10,10,80,68,148
KOLDA,"MEDINA YORO FOULAH",NIAMING,KEREWANE,NDIAWENE,21,23,119,112,231
KOLDA,"MEDINA YORO FOULAH",NIAMING,KEREWANE,"NGAYENE SENEGAL",73,115,810,841,1651
KOLDA,"MEDINA YORO FOULAH",NIAMING,KEREWANE,"H1 SANTE YALLA",1,1,33,8,41
KOLDA,"MEDINA YORO FOULAH",NIAMING,KEREWANE,NGOUDOUROU,83,89,453,446,899
KOLDA,"MEDINA YORO FOULAH",NIAMING,KEREWANE,"NIORO KATIM",35,40,271,229,500
KOLDA,"MEDINA YORO FOULAH",NIAMING,KEREWANE,"PASSY NDARY",18,29,178,216,394
KOLDA,"MEDINA YORO FOULAH",NIAMING,KEREWANE,"SAM NGUEYENE",17,39,265,258,523
KOLDA,"MEDINA YORO FOULAH",NIAMING,KEREWANE,"SINTHIANG LATHIRY (TOUBA FOULADOU)",71,104,555,551,1106
KOLDA,"MEDINA YORO FOULAH",NIAMING,KEREWANE,"SARE BACARY (MEDINA GOUNASS)",6,8,56,49,105
KOLDA,"MEDINA YORO FOULAH",NIAMING,KEREWANE,"SARE BACARY GALLO",17,21,106,95,201
KOLDA,"MEDINA YORO FOULAH",NIAMING,KEREWANE,"SARE BAKARY (MARO)",26,34,177,204,381
KOLDA,"MEDINA YORO FOULAH",NIAMING,KEREWANE,"SARE DELLO",36,40,289,240,529
KOLDA,"MEDINA YORO FOULAH",NIAMING,KEREWANE,"SARE DEMBA",8,13,98,83,181
KOLDA,"MEDINA YORO FOULAH",NIAMING,KEREWANE,"SARE KEITA",29,38,267,224,491
KOLDA,"MEDINA YORO FOULAH",NIAMING,KEREWANE,"SARE MAMADOU ANDA",12,16,114,94,208
KOLDA,"MEDINA YORO FOULAH",NIAMING,KEREWANE,"SARE MANSA",27,35,718,263,981
KOLDA,"MEDINA YORO FOULAH",NIAMING,KEREWANE,"SARE MODY ROKHY",13,14,98,71,169
KOLDA,"MEDINA YORO FOULAH",NIAMING,KEREWANE,"SARE PATHE",9,12,90,92,182
KOLDA,"MEDINA YORO FOULAH",NIAMING,KEREWANE,"SARE SAMBEL",12,12,69,68,137
KOLDA,"MEDINA YORO FOULAH",NIAMING,KEREWANE,"SARE SAMETA",19,23,134,146,280
KOLDA,"MEDINA YORO FOULAH",NIAMING,KEREWANE,"SARE WOURI",8,9,48,35,83
KOLDA,"MEDINA YORO FOULAH",NIAMING,KEREWANE,"SARE YORO BOUKA",17,17,97,87,184
KOLDA,"MEDINA YORO FOULAH",NIAMING,KEREWANE,"SARE YORO BOUYA",34,43,297,333,630
KOLDA,"MEDINA YORO FOULAH",NIAMING,KEREWANE,"SINTHIANG ALY BADIANE (SARE ALY BADIANE)",6,6,33,40,73
KOLDA,"MEDINA YORO FOULAH",NIAMING,KEREWANE,"SINTHIANG BAHAROU",4,6,33,31,64
KOLDA,"MEDINA YORO FOULAH",NIAMING,KEREWANE,"SINTHIANG BAIDY",5,6,44,39,83
KOLDA,"MEDINA YORO FOULAH",NIAMING,KEREWANE,"SINTHIANG BOURE",13,15,95,106,201
KOLDA,"MEDINA YORO FOULAH",NIAMING,KEREWANE,"SINTHIANG DOUKY (MEDINA DIALLOBE)",4,4,44,25,69
KOLDA,"MEDINA YORO FOULAH",NIAMING,KEREWANE,"SINTHIANG KELEFA (SINTHIANG MANGA)",20,32,157,139,296
KOLDA,"MEDINA YORO FOULAH",NIAMING,KEREWANE,"SINTHIANG MAMA (SINTHIOU YAFARBO)",6,11,93,82,175
KOLDA,"MEDINA YORO FOULAH",NIAMING,KEREWANE,"SINTHIANG NGANCOURANG",7,7,42,42,84
KOLDA,"MEDINA YORO FOULAH",NIAMING,KEREWANE,"SINTHIANG SAMBA",4,5,18,18,36
KOLDA,"MEDINA YORO FOULAH",NIAMING,KEREWANE,"SINTHIANG SEKHOU",8,16,112,104,216
KOLDA,"MEDINA YORO FOULAH",NIAMING,KEREWANE,"SINTHIANG SORY",18,20,135,125,260
KOLDA,"MEDINA YORO FOULAH",NIAMING,KEREWANE,"SINTHIANG TORO",9,11,63,52,115
KOLDA,"MEDINA YORO FOULAH",NIAMING,KEREWANE,"SINTHIOU DIMBOU",28,54,325,319,644
KOLDA,"MEDINA YORO FOULAH",NIAMING,KEREWANE,"SINTHIOU DJIDE",31,35,246,175,421
KOLDA,"MEDINA YORO FOULAH",NIAMING,KEREWANE,"SINTHIOU MANDAKH",4,11,72,83,155
KOLDA,"MEDINA YORO FOULAH",NIAMING,KEREWANE,"SINTHIOU OUMAR SARR(TOUMBOUNG)",12,16,119,100,219
KOLDA,"MEDINA YORO FOULAH",NIAMING,KEREWANE,"SINTHIOU TAMBA (SARE TAMBA)",14,26,258,189,447
KOLDA,"MEDINA YORO FOULAH",NIAMING,KEREWANE,"H1 SINTHIANG OUMAR",3,3,18,18,36
KOLDA,"MEDINA YORO FOULAH",NIAMING,KEREWANE,"TEMENTO SORY (SARE SORY)",11,13,121,109,230
KOLDA,"MEDINA YORO FOULAH",NIAMING,KEREWANE,THIADJI,18,19,149,147,296
KOLDA,"MEDINA YORO FOULAH",NIAMING,KEREWANE,THIANGAYE,24,32,226,223,449
KOLDA,"MEDINA YORO FOULAH",NIAMING,KEREWANE,"TOUBA KELIMANE",44,59,370,382,752
KOLDA,"MEDINA YORO FOULAH",NIAMING,KEREWANE,"TOUBA THIECKENE",24,29,203,176,379
KOLDA,"MEDINA YORO FOULAH",NIAMING,KEREWANE,TOUBACOUTA,26,37,173,153,326
KOLDA,"MEDINA YORO FOULAH",NIAMING,KEREWANE,"VELINGARA LALY (SARE NGAYE)",22,33,158,165,323
KOLDA,"MEDINA YORO FOULAH",NIAMING,KEREWANE,"VELINGARA OGO",2,3,36,27,63
KOLDA,"MEDINA YORO FOULAH",NIAMING,KEREWANE,"WAKILARE SARA",7,7,45,42,87
KOLDA,"MEDINA YORO FOULAH",NIAMING,KEREWANE,"WOURO PANA",38,50,268,243,511
KOLDA,"MEDINA YORO FOULAH",NIAMING,KEREWANE,YAFARBO,5,5,19,21,40
KOLDA,"MEDINA YORO FOULAH",NIAMING,KEREWANE,DIAMAGADIO,1,1,4,4,8
KOLDA,"MEDINA YORO FOULAH",NIAMING,NIAMING,FANDANA,11,14,86,97,183
KOLDA,"MEDINA YORO FOULAH",NIAMING,NIAMING,FATICOUNDA,10,11,53,56,109
KOLDA,"MEDINA YORO FOULAH",NIAMING,NIAMING,"H1 SINTHIANG SEYDOU",11,11,61,58,119
KOLDA,"MEDINA YORO FOULAH",NIAMING,NIAMING,KIBASSA,69,88,420,352,772
KOLDA,"MEDINA YORO FOULAH",NIAMING,NIAMING,KOULOR,29,40,200,199,399
KOLDA,"MEDINA YORO FOULAH",NIAMING,NIAMING,"KOURKOUR BALLA (MEDINA NGAYENE)",70,94,775,661,1436
KOLDA,"MEDINA YORO FOULAH",NIAMING,NIAMING,"KOURKOUR SALY",19,20,144,144,288
KOLDA,"MEDINA YORO FOULAH",NIAMING,NIAMING,"LAMOYE (SARE NEMA)",42,42,179,199,378
KOLDA,"MEDINA YORO FOULAH",NIAMING,NIAMING,"H1 SINTHIANG ALDIOUMA",3,3,20,13,33
KOLDA,"MEDINA YORO FOULAH",NIAMING,NIAMING,"LINGUEYEL GALLO BALDE",9,12,82,62,144
KOLDA,"MEDINA YORO FOULAH",NIAMING,NIAMING,"LINGUEYEL PATHE DIAO",28,38,310,248,558
KOLDA,"MEDINA YORO FOULAH",NIAMING,NIAMING,"MAREWE KELEFA",9,24,116,115,231
KOLDA,"MEDINA YORO FOULAH",NIAMING,NIAMING,"MAREWE SAMBA",16,19,125,103,228
KOLDA,"MEDINA YORO FOULAH",NIAMING,NIAMING,"MAROUM KARFA",9,11,62,57,119
KOLDA,"MEDINA YORO FOULAH",NIAMING,NIAMING,"MAROUM MAOUNDE",23,30,295,227,522
KOLDA,"MEDINA YORO FOULAH",NIAMING,NIAMING,MBANE,12,23,126,128,254
KOLDA,"MEDINA YORO FOULAH",NIAMING,NIAMING,"MEDINA DIMBO (SARE SARA)",15,17,83,79,162
KOLDA,"MEDINA YORO FOULAH",NIAMING,NIAMING,"MEO NDIOBENE",25,35,222,226,448
KOLDA,"MEDINA YORO FOULAH",NIAMING,NIAMING,"MISSIRAH MBOYENNE",29,42,527,468,995
KOLDA,"MEDINA YORO FOULAH",NIAMING,NIAMING,"NDIMB (AINOUMANE)",5,10,48,54,102
KOLDA,"MEDINA YORO FOULAH",NIAMING,NIAMING,NDIORENE,57,62,352,344,696
KOLDA,"MEDINA YORO FOULAH",NIAMING,NIAMING,"NIAMING(SARE MALICK)",98,136,733,704,1437
KOLDA,"MEDINA YORO FOULAH",NIAMING,NIAMING,"SAM YORO GUEYE",50,73,598,635,1233
KOLDA,"MEDINA YORO FOULAH",NIAMING,NIAMING,"SARE ASSETTE",15,18,106,111,217
KOLDA,"MEDINA YORO FOULAH",NIAMING,NIAMING,"SARE DEMBA SIRA",9,10,99,90,189
KOLDA,"MEDINA YORO FOULAH",NIAMING,NIAMING,"SINTHIANG DIANKE",8,8,66,77,143
KOLDA,"MEDINA YORO FOULAH",NIAMING,NIAMING,"SARE DICORY I",10,11,39,44,83
KOLDA,"MEDINA YORO FOULAH",NIAMING,NIAMING,"SARE HAROUNA (NDIOBENE AROUNA)",48,53,303,286,589
KOLDA,"MEDINA YORO FOULAH",NIAMING,NIAMING,"SARE MAMADOU SY (SINTHIANG DEMANE FALL)",17,19,107,102,209
KOLDA,"MEDINA YORO FOULAH",NIAMING,NIAMING,"SARE MAOUNDE YAFA",19,26,183,182,365
KOLDA,"MEDINA YORO FOULAH",NIAMING,NIAMING,"SARE SAMBA LABO (SINTHIANG LABO)",10,10,49,43,92
KOLDA,"MEDINA YORO FOULAH",NIAMING,NIAMING,"SINTHIANG SAMBA TENING",25,37,256,194,450
KOLDA,"MEDINA YORO FOULAH",NIAMING,NIAMING,"SINTHIANG DIABEL BALDE",15,22,169,112,281
KOLDA,"MEDINA YORO FOULAH",NIAMING,NIAMING,"SINTHIANG EL HADJI SALIOU SECK (KAWSARA)",31,39,291,236,527
KOLDA,"MEDINA YORO FOULAH",NIAMING,NIAMING,"SINTHIANG KONCOROU",3,3,10,10,20
KOLDA,"MEDINA YORO FOULAH",NIAMING,NIAMING,"SINTHIANG MAMA",1,7,45,54,99
KOLDA,"MEDINA YORO FOULAH",NIAMING,NIAMING,"SINTHIANG MANSALY",8,11,72,82,154
KOLDA,"MEDINA YORO FOULAH",NIAMING,NIAMING,"SINTHIANG MAOUNDE",9,11,114,85,199
KOLDA,"MEDINA YORO FOULAH",NIAMING,NIAMING,"MEDINA NGAYENE",20,31,167,165,332
KOLDA,"MEDINA YORO FOULAH",NIAMING,NIAMING,TABANANY,37,41,214,238,452
KOLDA,"MEDINA YORO FOULAH",NIAMING,NIAMING,THIALENE,47,87,567,642,1209
KOLDA,"MEDINA YORO FOULAH",NIAMING,NIAMING,"TOUBA MBOYENE",94,127,1160,1077,2237
KOLDA,"MEDINA YORO FOULAH",NIAMING,NIAMING,"WELIA BOUNKA",15,21,122,102,224
KOLDA,"MEDINA YORO FOULAH",NIAMING,NIAMING,"WORBE SOUNKAROU",7,13,81,72,153
KOLDA,"MEDINA YORO FOULAH",NIAMING,NIAMING,"MEDINA THIALENE",47,54,373,340,713
KOLDA,"MEDINA YORO FOULAH",NIAMING,NIAMING,"H1 DARSALAM",5,5,48,21,69
KOLDA,"MEDINA YORO FOULAH",NIAMING,PATA,"BOUNDOU MEDINE",81,88,553,538,1091
KOLDA,"MEDINA YORO FOULAH",NIAMING,PATA,ESCALE,37,48,214,194,408
KOLDA,"MEDINA YORO FOULAH",NIAMING,PATA,"GRANDE MOSQUEE",39,45,252,277,529
KOLDA,"MEDINA YORO FOULAH",NIAMING,PATA,"MISSIRAH ABARY (SARE MAMADOU)",15,18,86,83,169
KOLDA,"MEDINA YORO FOULAH",NIAMING,PATA,NEMA,73,88,326,308,634
KOLDA,"MEDINA YORO FOULAH",NIAMING,PATA,"SINTHIOU COUTOU",13,16,114,107,221
KOLDA,"MEDINA YORO FOULAH",NIAMING,PATA,SOUDOUWELLY,22,43,586,627,1213
MATAM,MATAM,MATAM,MATAM,DIAMEL,227,303,2092,1842,3934
MATAM,MATAM,MATAM,MATAM,GANDE,447,653,3838,3033,6871
MATAM,MATAM,MATAM,MATAM,"GOUREL SERIGNE",557,796,3494,2685,6179
MATAM,MATAM,MATAM,MATAM,NAWEL,188,283,1666,1512,3178
MATAM,MATAM,MATAM,MATAM,TANTADJI,262,449,2265,1554,3819
MATAM,MATAM,MATAM,MATAM,THIAYDE,142,273,2182,1532,3714
MATAM,MATAM,OUROSSOGUI,OUROSSOGUI,"AINOUMADY I",70,118,651,556,1207
MATAM,MATAM,OUROSSOGUI,OUROSSOGUI,"AINOUMADY II",131,205,1559,1104,2663
MATAM,MATAM,OUROSSOGUI,OUROSSOGUI,"MANGO I",92,143,824,669,1493
MATAM,MATAM,OUROSSOGUI,OUROSSOGUI,"MANGO II (DAROU SALAM)",87,153,951,686,1637
MATAM,MATAM,OUROSSOGUI,OUROSSOGUI,"MANGO III",174,239,1461,1029,2490
MATAM,MATAM,OUROSSOGUI,OUROSSOGUI,"MODERNE I",203,372,1408,1042,2450
MATAM,MATAM,OUROSSOGUI,OUROSSOGUI,"MODERNE II",218,415,1723,1046,2769
MATAM,MATAM,OUROSSOGUI,OUROSSOGUI,"MODERNE III",693,950,4796,3369,8165
MATAM,MATAM,OUROSSOGUI,OUROSSOGUI,"WINDE I",174,314,1839,1311,3150
MATAM,MATAM,OUROSSOGUI,OUROSSOGUI,"WINDE II",54,115,618,580,1198
MATAM,MATAM,"AGNAM CIVOL","AGNAM CIVOL","AGNAM BALNABE",37,45,194,230,424
MATAM,MATAM,"AGNAM CIVOL","AGNAM CIVOL","AGNAM CIVOL",296,406,2525,2041,4566
MATAM,MATAM,"AGNAM CIVOL","AGNAM CIVOL","H1 EDIT",12,20,104,94,198
MATAM,MATAM,"AGNAM CIVOL","AGNAM CIVOL","AGNAM GODO",159,211,1169,1101,2270
MATAM,MATAM,"AGNAM CIVOL","AGNAM CIVOL","AGNAM GOLY",302,419,2715,2616,5331
MATAM,MATAM,"AGNAM CIVOL","AGNAM CIVOL","AGNAM LIDOUBE",111,132,597,653,1250
MATAM,MATAM,"AGNAM CIVOL","AGNAM CIVOL","AGNAM THIODAYE",384,547,3069,2740,5809
MATAM,MATAM,"AGNAM CIVOL","AGNAM CIVOL","AGNAM TOULEL THIALE",101,147,785,750,1535
MATAM,MATAM,"AGNAM CIVOL","AGNAM CIVOL","H1 FETE DIABY",44,60,268,283,551
MATAM,MATAM,"AGNAM CIVOL","AGNAM CIVOL","H2 TOULDE",1,3,21,24,45
MATAM,MATAM,"AGNAM CIVOL","AGNAM CIVOL","AGNAM WOURO CIRE",108,166,1091,879,1970
MATAM,MATAM,"AGNAM CIVOL","AGNAM CIVOL","H1 NDOUSSADJI OURO SAMBA DJINDE",23,59,152,174,326
MATAM,MATAM,"AGNAM CIVOL","AGNAM CIVOL","H2 DEBODJI I OURO ELHADJI DEMBA DIERY SOW",5,11,46,45,91
MATAM,MATAM,"AGNAM CIVOL","AGNAM CIVOL","H3 LOUMBY LESS DEBODJI (WOURO MAMADOU ALASSANE)",5,9,34,31,65
MATAM,MATAM,"AGNAM CIVOL","AGNAM CIVOL","H4 LOUMBY LESS",8,17,58,59,117
MATAM,MATAM,"AGNAM CIVOL","AGNAM CIVOL","AGNAM YEROYABE",42,54,261,287,548
MATAM,MATAM,"AGNAM CIVOL","AGNAM CIVOL","H2 BAGONDE YERO YABE",62,84,429,344,773
MATAM,MATAM,"AGNAM CIVOL","AGNAM CIVOL","KANGAL KARADJI",21,25,112,114,226
MATAM,MATAM,"AGNAM CIVOL","AGNAM CIVOL","MBERLA BELE",61,91,483,496,979
MATAM,MATAM,"AGNAM CIVOL","AGNAM CIVOL","H1 GOUREL MOUSSA GALLO SOW",4,4,20,14,34
MATAM,MATAM,"AGNAM CIVOL","AGNAM CIVOL","H2 GOUREL MOUSSA BA",5,7,38,39,77
MATAM,MATAM,"AGNAM CIVOL","AGNAM CIVOL","H3 WOYNDOU BOTHIE",8,9,41,36,77
MATAM,MATAM,"AGNAM CIVOL","AGNAM CIVOL","H4 BELLA",22,29,129,143,272
MATAM,MATAM,"AGNAM CIVOL","AGNAM CIVOL","H5 OURO MBARGO",3,4,22,19,41
MATAM,MATAM,"AGNAM CIVOL","AGNAM CIVOL","H6 MBEDA",8,10,42,49,91
MATAM,MATAM,"AGNAM CIVOL","AGNAM CIVOL","H7 OURO NGOUBEL",5,6,29,29,58
MATAM,MATAM,"AGNAM CIVOL","AGNAM CIVOL","NDIAFFANE BELLY THINDE",53,78,339,333,672
MATAM,MATAM,"AGNAM CIVOL","AGNAM CIVOL","H1 WORO THILOUKI",11,13,75,72,147
MATAM,MATAM,"AGNAM CIVOL","AGNAM CIVOL","H2 YILAM",1,5,29,31,60
MATAM,MATAM,"AGNAM CIVOL","AGNAM CIVOL","NDIAFFANE SOROKOUM",121,154,756,735,1491
MATAM,MATAM,"AGNAM CIVOL","AGNAM CIVOL","SINTHIOU BOUMAKA",80,114,585,612,1197
MATAM,MATAM,"AGNAM CIVOL","AGNAM CIVOL","SINTHIOU CIREMATOU",72,107,763,586,1349
MATAM,MATAM,"AGNAM CIVOL","AGNAM CIVOL","SYLLA WORGO",48,68,324,394,718
MATAM,MATAM,"AGNAM CIVOL",OREFONDE,"ASNDE BALLA",86,109,606,649,1255
MATAM,MATAM,"AGNAM CIVOL",OREFONDE,"DABIA OREFONDE",93,121,833,639,1472
MATAM,MATAM,"AGNAM CIVOL",OREFONDE,"DIORBIVOL PECHEURS",105,154,770,613,1383
MATAM,MATAM,"AGNAM CIVOL",OREFONDE,"DIORBIVOL STATION",16,20,81,85,166
MATAM,MATAM,"AGNAM CIVOL",OREFONDE,"H1 FELOU",28,44,225,203,428
MATAM,MATAM,"AGNAM CIVOL",OREFONDE,DIOWGUEL,61,76,304,397,701
MATAM,MATAM,"AGNAM CIVOL",OREFONDE,HODIO,63,90,480,495,975
MATAM,MATAM,"AGNAM CIVOL",OREFONDE,"LOUMBAL BALADJI",291,412,1602,1914,3516
MATAM,MATAM,"AGNAM CIVOL",OREFONDE,"H1 THIANGUEL",37,58,238,227,465
MATAM,MATAM,"AGNAM CIVOL",OREFONDE,"LOUMBY SANDARABE",36,56,250,232,482
MATAM,MATAM,"AGNAM CIVOL",OREFONDE,"H1 WORO LAGOU",9,24,101,120,221
MATAM,MATAM,"AGNAM CIVOL",OREFONDE,"H2 MBAGOU",6,9,50,51,101
MATAM,MATAM,"AGNAM CIVOL",OREFONDE,"H3 LOUNKA LABAL",11,14,67,59,126
MATAM,MATAM,"AGNAM CIVOL",OREFONDE,"H4 WENDOU BOULBI",10,19,113,88,201
MATAM,MATAM,"AGNAM CIVOL",OREFONDE,"H5 GOUREL SIDY BAYEL",3,7,27,34,61
MATAM,MATAM,"AGNAM CIVOL",OREFONDE,"H6 NDOUSSADJI",16,21,119,106,225
MATAM,MATAM,"AGNAM CIVOL",OREFONDE,"H7 PEGOUKI",7,8,45,42,87
MATAM,MATAM,"AGNAM CIVOL",OREFONDE,"H8 GADDU",6,7,43,39,82
MATAM,MATAM,"AGNAM CIVOL",OREFONDE,"H9 KAWRANE",12,22,70,60,130
MATAM,MATAM,"AGNAM CIVOL",OREFONDE,"H10 THIAGNARDE",10,13,77,57,134
MATAM,MATAM,"AGNAM CIVOL",OREFONDE,"H11 WOURO FAFABE",11,14,76,77,153
MATAM,MATAM,"AGNAM CIVOL",OREFONDE,"H12 DENDOUDI",30,41,200,191,391
MATAM,MATAM,"AGNAM CIVOL",OREFONDE,"H13 KAMA",15,22,99,98,197
MATAM,MATAM,"AGNAM CIVOL",OREFONDE,NDIAKIR,78,117,557,657,1214
MATAM,MATAM,"AGNAM CIVOL",OREFONDE,"H1 BOUNGOU TIWCONE",13,30,144,152,296
MATAM,MATAM,"AGNAM CIVOL",OREFONDE,OREFONDE,645,854,5028,3703,8731
MATAM,MATAM,"AGNAM CIVOL",OREFONDE,"OURO MOLLO",68,79,433,472,905
MATAM,MATAM,"AGNAM CIVOL",OREFONDE,"H1 GOUREL MAMADOU COUMBA  DOUSS",6,6,35,29,64
MATAM,MATAM,"AGNAM CIVOL",OREFONDE,"H2 BADIYA",19,31,154,172,326
MATAM,MATAM,"AGNAM CIVOL",OREFONDE,"H3 NGOLOUM",42,54,296,264,560
MATAM,MATAM,"AGNAM CIVOL",OREFONDE,THIASKY,39,55,309,291,600
MATAM,MATAM,"AGNAM CIVOL",OREFONDE,"H1 BELEL BADY",10,10,72,79,151
MATAM,MATAM,"AGNAM CIVOL",DABIA,BARGA,63,75,283,273,556
MATAM,MATAM,"AGNAM CIVOL",DABIA,"H1 GOUREL DIERY",10,12,73,56,129
MATAM,MATAM,"AGNAM CIVOL",DABIA,"DABIA ODEDJI",283,353,2343,1816,4159
MATAM,MATAM,"AGNAM CIVOL",DABIA,"H2 BOFFAL",9,12,65,54,119
MATAM,MATAM,"AGNAM CIVOL",DABIA,"H1 KOFFEL",10,15,82,76,158
MATAM,MATAM,"AGNAM CIVOL",DABIA,"DIAL PECHEURS",77,107,644,658,1302
MATAM,MATAM,"AGNAM CIVOL",DABIA,"DIAL PEULH",52,64,532,425,957
MATAM,MATAM,"AGNAM CIVOL",DABIA,DIONGTO,72,92,372,417,789
MATAM,MATAM,"AGNAM CIVOL",DABIA,"GABABE PECHEURS",104,142,773,722,1495
MATAM,MATAM,"AGNAM CIVOL",DABIA,"H1 GABABE PEULH",6,7,27,32,59
MATAM,MATAM,"AGNAM CIVOL",DABIA,"GOUDOUDE DIOBES",114,151,530,602,1132
MATAM,MATAM,"AGNAM CIVOL",DABIA,"GOUDOUDE NDOUETBES",194,244,1287,1319,2606
MATAM,MATAM,"AGNAM CIVOL",DABIA,"H1 DONGUEL",2,4,13,18,31
MATAM,MATAM,"AGNAM CIVOL",DABIA,"H2 GUELEL",5,6,43,24,67
MATAM,MATAM,"AGNAM CIVOL",DABIA,"H3 AHNAMBE",14,40,207,151,358
MATAM,MATAM,"AGNAM CIVOL",DABIA,"KOBILO DIADIABE",203,296,1481,1540,3021
MATAM,MATAM,"AGNAM CIVOL",DABIA,"H1 WOURO DEMBA DJIBI",7,8,43,31,74
MATAM,MATAM,"AGNAM CIVOL",DABIA,"H2 GNYRI DIAMA",3,3,11,10,21
MATAM,MATAM,"AGNAM CIVOL",DABIA,"H3 DABBANO DIAOBE DEMBA",16,28,129,129,258
MATAM,MATAM,"AGNAM CIVOL",DABIA,"H4 YANGADE",11,13,82,78,160
MATAM,MATAM,"AGNAM CIVOL",DABIA,"H5 NGANDONE",11,12,63,58,121
MATAM,MATAM,"AGNAM CIVOL",DABIA,"H6 DIAKEL",5,5,27,31,58
MATAM,MATAM,"AGNAM CIVOL",DABIA,"H7 DEMBOUBE",13,16,63,87,150
MATAM,MATAM,"AGNAM CIVOL",DABIA,"H8 WOURO ABOU SAMBA BOLO",2,3,16,15,31
MATAM,MATAM,"AGNAM CIVOL",DABIA,"H9 WOURO ALY WELE",7,8,33,30,63
MATAM,MATAM,"AGNAM CIVOL",DABIA,"KOBILO TOROBE",149,224,1571,1309,2880
MATAM,MATAM,"AGNAM CIVOL",DABIA,"KOBILO DIAKESBE",113,151,945,960,1905
MATAM,MATAM,"AGNAM CIVOL",DABIA,"MOLLE WALO",30,41,263,257,520
MATAM,MATAM,"AGNAM CIVOL",DABIA,"SARE LIOU",106,167,763,850,1613
MATAM,MATAM,"AGNAM CIVOL",DABIA,"H1 PARIS LIOU",18,21,73,73,146
MATAM,MATAM,"AGNAM CIVOL",DABIA,"H2 BABA YORO DIALLO",7,10,37,36,73
MATAM,MATAM,"AGNAM CIVOL",DABIA,"H4 DARRA SALAM",17,22,95,112,207
MATAM,MATAM,"AGNAM CIVOL",DABIA,"H3 PARIS LIOU (GUESSE)",2,2,8,5,13
MATAM,MATAM,"AGNAM CIVOL",DABIA,"SINTHIOU DIAMDIOR",64,78,520,492,1012
MATAM,MATAM,"AGNAM CIVOL",DABIA,SYLLANABE,97,129,725,634,1359
MATAM,MATAM,"AGNAM CIVOL",DABIA,"TABE DOW",60,109,497,494,991
MATAM,MATAM,"AGNAM CIVOL",DABIA,"TABE LESS",25,49,202,196,398
MATAM,MATAM,"AGNAM CIVOL",DABIA,"H1 NDIOUMOUYEL",15,23,102,104,206
MATAM,MATAM,"AGNAM CIVOL",NGUIDJILONE,"ALY OURY",194,297,2206,1948,4154
MATAM,MATAM,"AGNAM CIVOL",NGUIDJILONE,KEDELE,70,115,576,634,1210
MATAM,MATAM,"AGNAM CIVOL",NGUIDJILONE,"NGUIDJILOGNE LODJOU",339,445,2666,2343,5009
MATAM,MATAM,"AGNAM CIVOL",NGUIDJILONE,"NGUIDJILOGNE SOMONO",45,64,499,459,958
MATAM,MATAM,"AGNAM CIVOL",NGUIDJILONE,"NGUIDJILONE VELINGARA",203,260,1688,1404,3092
MATAM,MATAM,"AGNAM CIVOL",THILOGNE,BADEL,44,71,486,300,786
MATAM,MATAM,"AGNAM CIVOL",THILOGNE,"DIABE SALA",137,197,1513,936,2449
MATAM,MATAM,"AGNAM CIVOL",THILOGNE,DIAWANBE,61,89,611,460,1071
MATAM,MATAM,"AGNAM CIVOL",THILOGNE,GAMOUKOU,94,106,651,446,1097
MATAM,MATAM,"AGNAM CIVOL",THILOGNE,GOLLERE,161,281,1349,1061,2410
MATAM,MATAM,"AGNAM CIVOL",THILOGNE,BARINABE,123,161,1207,707,1914
MATAM,MATAM,"AGNAM CIVOL",THILOGNE,"MEDINA KANDIE PAWEL",40,50,238,235,473
MATAM,MATAM,"AGNAM CIVOL",THILOGNE,MOLE,89,123,731,543,1274
MATAM,MATAM,"AGNAM CIVOL",THILOGNE,NDIOUFNABE,97,121,687,549,1236
MATAM,MATAM,"AGNAM CIVOL",THILOGNE,"SINTHIOU BOUKARY",75,107,476,423,899
MATAM,MATAM,"AGNAM CIVOL",THILOGNE,THIAMBE,51,89,482,403,885
MATAM,MATAM,"AGNAM CIVOL",THILOGNE,"THILOGNE TOKOSSEL",46,58,305,245,550
MATAM,MATAM,OGO,BOKIDIAWE,"BALEL NDIAKIRY",13,15,91,101,192
MATAM,MATAM,OGO,BOKIDIAWE,"BALEL PATHE",29,59,291,276,567
MATAM,MATAM,OGO,BOKIDIAWE,"H1 IWI",6,16,76,90,166
MATAM,MATAM,OGO,BOKIDIAWE,"H2 DIACRE",6,7,42,50,92
MATAM,MATAM,OGO,BOKIDIAWE,"BOKIDIAWE SONINKE (SARAKOLE)",525,752,6031,4381,10412
MATAM,MATAM,OGO,BOKIDIAWE,"BOKIDIAWE TOUCOULEUR",130,164,1329,847,2176
MATAM,MATAM,OGO,BOKIDIAWE,"H2 OURO DEMBA THILA",10,16,110,100,210
MATAM,MATAM,OGO,BOKIDIAWE,"H3 OURO OLEL DIALLO",1,1,10,6,16
MATAM,MATAM,OGO,BOKIDIAWE,"DIOLOL DIAOBE",61,110,761,712,1473
MATAM,MATAM,OGO,BOKIDIAWE,"DIOLOL YALALBE",32,56,280,345,625
MATAM,MATAM,OGO,BOKIDIAWE,DIOWOL,57,71,419,401,820
MATAM,MATAM,OGO,BOKIDIAWE,"H3 DOBOU",4,7,47,64,111
MATAM,MATAM,OGO,BOKIDIAWE,DONDOU,473,636,4090,3799,7889
MATAM,MATAM,OGO,BOKIDIAWE,"H1 OURO GOBI ( NDIAWEDY)",14,15,89,71,160
MATAM,MATAM,OGO,BOKIDIAWE,"H2 AINOUMADY",3,3,12,9,21
MATAM,MATAM,OGO,BOKIDIAWE,"DOUMGA OURO ALPHA",352,512,2526,2325,4851
MATAM,MATAM,OGO,BOKIDIAWE,"H1 L'AN 2000",6,14,39,28,67
MATAM,MATAM,OGO,BOKIDIAWE,"DOUMGA OURO THIERNO",136,177,1205,1119,2324
MATAM,MATAM,OGO,BOKIDIAWE,"H1 DAROU SALAM",22,32,212,229,441
MATAM,MATAM,OGO,BOKIDIAWE,"DOUMGA RINDIAW",169,223,1019,1191,2210
MATAM,MATAM,OGO,BOKIDIAWE,"H2 DOUMGA II",10,13,73,97,170
MATAM,MATAM,OGO,BOKIDIAWE,GAOL,205,271,1255,1302,2557
MATAM,MATAM,OGO,BOKIDIAWE,GAODAL,177,236,1308,1410,2718
MATAM,MATAM,OGO,BOKIDIAWE,"H6 GAFEDJI SAMBA ALY",4,6,39,36,75
MATAM,MATAM,OGO,BOKIDIAWE,"H7 GOREL KALIDOU BA",1,3,18,29,47
MATAM,MATAM,OGO,BOKIDIAWE,"H8 GOUREL SIDIKI DIA",5,6,34,37,71
MATAM,MATAM,OGO,BOKIDIAWE,"DIAMEL GAODAL",95,133,909,861,1770
MATAM,MATAM,OGO,BOKIDIAWE,GUIRAYE,126,153,776,881,1657
MATAM,MATAM,OGO,BOKIDIAWE,"H1 GUIRAYE PEULH",5,8,35,39,74
MATAM,MATAM,OGO,BOKIDIAWE,"H2 LOUGUERE DIANDJOL",5,10,46,44,90
MATAM,MATAM,OGO,BOKIDIAWE,KATOTE,89,112,645,720,1365
MATAM,MATAM,OGO,BOKIDIAWE,"H1 MODI BOULA",32,43,210,289,499
MATAM,MATAM,OGO,BOKIDIAWE,"KAWEL DIALLOUBE",81,140,672,887,1559
MATAM,MATAM,OGO,BOKIDIAWE,"H1 KEUR MALICK SAMBOU",2,2,9,10,19
MATAM,MATAM,OGO,BOKIDIAWE,"H2 KEUR DIAWO DIALLO",1,3,11,18,29
MATAM,MATAM,OGO,BOKIDIAWE,"H3 GOUREL ABDOULAYE DIALLO",3,5,37,36,73
MATAM,MATAM,OGO,BOKIDIAWE,"H4 GOUREL HAMIDOU BA",7,15,57,78,135
MATAM,MATAM,OGO,BOKIDIAWE,"H5 LAW LAW",24,36,197,208,405
MATAM,MATAM,OGO,BOKIDIAWE,"H6 GOUREL SAMBA NAYO BA",4,9,44,34,78
MATAM,MATAM,OGO,BOKIDIAWE,"H7 FETE SADDEL",23,31,139,138,277
MATAM,MATAM,OGO,BOKIDIAWE,"H8 LOUGUERE MOURTOKY",12,14,81,71,152
MATAM,MATAM,OGO,BOKIDIAWE,"H9 LOUGUERE BOUBOU SARR",18,20,117,100,217
MATAM,MATAM,OGO,BOKIDIAWE,"H10 INIS",3,6,26,28,54
MATAM,MATAM,OGO,BOKIDIAWE,"H11 OURO MAMADOU KIBEU",2,7,33,41,74
MATAM,MATAM,OGO,BOKIDIAWE,"H12 INIS MOURTOKI",5,5,27,20,47
MATAM,MATAM,OGO,BOKIDIAWE,"KAWEL KANGAL",17,26,142,180,322
MATAM,MATAM,OGO,BOKIDIAWE,"KIRIRE I  (DIERI)",46,68,406,407,813
MATAM,MATAM,OGO,BOKIDIAWE,"KIRIRE II  (WALO)",69,97,567,562,1129
MATAM,MATAM,OGO,BOKIDIAWE,"MBAKHNA DOW",97,177,1339,1352,2691
MATAM,MATAM,OGO,BOKIDIAWE,"H1 FALABOGUEL",8,12,66,57,123
MATAM,MATAM,OGO,BOKIDIAWE,"MBAKHNA LESS",75,110,753,852,1605
MATAM,MATAM,OGO,BOKIDIAWE,"H1 OLIWAW",1,4,20,22,42
MATAM,MATAM,OGO,BOKIDIAWE,"H2 TARETTE",24,55,240,259,499
MATAM,MATAM,OGO,BOKIDIAWE,"H5 THIEBE GOUNOL",5,5,37,29,66
MATAM,MATAM,OGO,BOKIDIAWE,"H6 FALOBARKA",10,17,100,78,178
MATAM,MATAM,OGO,BOKIDIAWE,"H7 RANOUA",39,58,388,382,770
MATAM,MATAM,OGO,BOKIDIAWE,"H8 BICHIRI",4,6,40,43,83
MATAM,MATAM,OGO,BOKIDIAWE,"H9 LOBOUDOU RANWA",6,10,45,56,101
MATAM,MATAM,OGO,BOKIDIAWE,"H10 FILCALE",9,16,83,103,186
MATAM,MATAM,OGO,BOKIDIAWE,"H12 BALEL BARKEDJI",12,22,103,121,224
MATAM,MATAM,OGO,BOKIDIAWE,MBOLOYEL,130,150,1401,1168,2569
MATAM,MATAM,OGO,BOKIDIAWE,MOW,51,75,525,454,979
MATAM,MATAM,OGO,BOKIDIAWE,"H2 GOUREL YORO SARA BA",1,1,17,10,27
MATAM,MATAM,OGO,BOKIDIAWE,"H4 SANGAYEL DIAOBE",11,17,128,115,243
MATAM,MATAM,OGO,BOKIDIAWE,"PADE BOYNGAL",30,43,213,254,467
MATAM,MATAM,OGO,BOKIDIAWE,SADEL,361,491,3152,2878,6030
MATAM,MATAM,OGO,BOKIDIAWE,"H1 DIERIEL BAMAMBE",26,47,226,213,439
MATAM,MATAM,OGO,BOKIDIAWE,"H2 LOUGUERE LAYEL",17,27,145,120,265
MATAM,MATAM,OGO,BOKIDIAWE,"H3 FONDE SAMBA MALI",20,31,199,198,397
MATAM,MATAM,OGO,BOKIDIAWE,DOUNDE,3,4,22,15,37
MATAM,MATAM,OGO,BOKIDIAWE,"SARACOURA DIALLOUBE",79,108,712,670,1382
MATAM,MATAM,OGO,BOKIDIAWE,"SARACOURA THIOUTY",25,39,209,215,424
MATAM,MATAM,OGO,BOKIDIAWE,SAWATOUNA,18,26,117,127,244
MATAM,MATAM,OGO,BOKIDIAWE,"THIEHEL SEBE",80,102,685,807,1492
MATAM,MATAM,OGO,BOKIDIAWE,DIALANE,5,6,53,47,100
MATAM,MATAM,OGO,BOKIDIAWE,"DIOFOL (THIOFOL)",16,17,84,99,183
MATAM,MATAM,OGO,BOKIDIAWE,DOUGA,15,17,90,85,175
MATAM,MATAM,OGO,BOKIDIAWE,"SANGAYEL BOUNGOU",5,5,32,48,80
MATAM,MATAM,OGO,"NABADJI CIVOL",BINKE,2,2,17,3,20
MATAM,MATAM,OGO,"NABADJI CIVOL","BOYNADJI ROUMDE",132,204,1272,1174,2446
MATAM,MATAM,OGO,"NABADJI CIVOL","BOYNADJI SINTHIOU",207,331,1988,1922,3910
MATAM,MATAM,OGO,"NABADJI CIVOL","H1 KAWEL SALLY",13,21,91,98,189
MATAM,MATAM,OGO,"NABADJI CIVOL",BOKISSABOUDOU,96,149,867,950,1817
MATAM,MATAM,OGO,"NABADJI CIVOL","H1 BELAL",1,1,8,5,13
MATAM,MATAM,OGO,"NABADJI CIVOL",DIENGA,57,87,678,628,1306
MATAM,MATAM,OGO,"NABADJI CIVOL","H1 SAYBOBE",8,11,82,73,155
MATAM,MATAM,OGO,"NABADJI CIVOL","FETE  NIEBE",115,186,1376,1551,2927
MATAM,MATAM,OGO,"NABADJI CIVOL","H1 TEKINGUEL",1,2,10,16,26
MATAM,MATAM,OGO,"NABADJI CIVOL","GOUREL MOUSSA",3,12,95,61,156
MATAM,MATAM,OGO,"NABADJI CIVOL",HONTORBE,41,92,438,470,908
MATAM,MATAM,OGO,"NABADJI CIVOL","H1 PAMBY OUOLOF",7,10,86,81,167
MATAM,MATAM,OGO,"NABADJI CIVOL","H2 GASSEL",19,38,188,199,387
MATAM,MATAM,OGO,"NABADJI CIVOL","H3 PAMBY TOUCOULEUR",10,23,157,149,306
MATAM,MATAM,OGO,"NABADJI CIVOL","H4 BINGUEL MORTODE",6,7,38,42,80
MATAM,MATAM,OGO,"NABADJI CIVOL","H6 GOUREL LATHIEL",4,17,81,90,171
MATAM,MATAM,OGO,"NABADJI CIVOL",KOUNDEL,83,122,692,712,1404
MATAM,MATAM,OGO,"NABADJI CIVOL","H2 GOUREL DEMBA RACINE",5,9,47,33,80
MATAM,MATAM,OGO,"NABADJI CIVOL","H3 TOULEL TOUPE",11,22,86,89,175
MATAM,MATAM,OGO,"NABADJI CIVOL","H4 DASIRDE",5,7,34,36,70
MATAM,MATAM,OGO,"NABADJI CIVOL","MOGO YALALBE",34,72,430,472,902
MATAM,MATAM,OGO,"NABADJI CIVOL","NABADJI CIVOL",408,558,3275,3152,6427
MATAM,MATAM,OGO,"NABADJI CIVOL","H1 WOURO YERO NIEBEL",6,15,60,73,133
MATAM,MATAM,OGO,"NABADJI CIVOL","H2 DOUBEL",3,4,14,23,37
MATAM,MATAM,OGO,"NABADJI CIVOL","NDOULOUMADJI DEMBE",459,625,3357,3429,6786
MATAM,MATAM,OGO,"NABADJI CIVOL","H1 VIRAGE",10,29,73,100,173
MATAM,MATAM,OGO,"NABADJI CIVOL","H2 WOURO BAHOROU",4,12,44,25,69
MATAM,MATAM,OGO,"NABADJI CIVOL","H3 WALY SOMA",1,2,21,7,28
MATAM,MATAM,OGO,"NABADJI CIVOL","H4 MBELONE AMADOU NDAO",1,1,1,0,1
MATAM,MATAM,OGO,"NABADJI CIVOL","H5 MBOTNGUEL",1,10,33,31,64
MATAM,MATAM,OGO,"NABADJI CIVOL","NDOULOUMADJI FOUNEBE",224,292,1628,2045,3673
MATAM,MATAM,OGO,"NABADJI CIVOL","H1 DAROGUEL I",9,13,63,59,122
MATAM,MATAM,OGO,"NABADJI CIVOL","H2 DAROGUEL II",6,8,49,47,96
MATAM,MATAM,OGO,"NABADJI CIVOL","H3 DAROGUEL III",23,31,177,172,349
MATAM,MATAM,OGO,"NABADJI CIVOL","H4 WOURO KADIEL",1,4,8,20,28
MATAM,MATAM,OGO,"NABADJI CIVOL",SARADJI,34,51,313,303,616
MATAM,MATAM,OGO,"NABADJI CIVOL","H1 BARADJI GOUMEL BAADA",4,4,22,23,45
MATAM,MATAM,OGO,"NABADJI CIVOL","SEDO ABBAS",142,194,1163,1147,2310
MATAM,MATAM,OGO,"NABADJI CIVOL","SEDO SEBE",292,413,1850,2435,4285
MATAM,MATAM,OGO,"NABADJI CIVOL","SINTHIOU MBAL",85,140,962,714,1676
MATAM,MATAM,OGO,"NABADJI CIVOL","H1 GOUREL ADAMA BA",23,33,151,169,320
MATAM,MATAM,OGO,"NABADJI CIVOL","SINTHIOU MOGO",117,177,1002,991,1993
MATAM,MATAM,OGO,"NABADJI CIVOL",SIRIWORO,37,63,436,377,813
MATAM,MATAM,OGO,"NABADJI CIVOL","TAIBA NGUEYENNE",203,268,1894,1988,3882
MATAM,MATAM,OGO,"NABADJI CIVOL","H1 LONGUEL",13,19,92,87,179
MATAM,MATAM,OGO,"NABADJI CIVOL","H2 WOURO ABOU KELEFA",3,3,20,18,38
MATAM,MATAM,OGO,"NABADJI CIVOL","H3 BINGUEL DADI",9,10,54,55,109
MATAM,MATAM,OGO,"NABADJI CIVOL","H4 DIALAMBANI",1,1,6,3,9
MATAM,MATAM,OGO,"NABADJI CIVOL","H5 WOURO YERO NDONGO",6,6,45,44,89
MATAM,MATAM,OGO,"NABADJI CIVOL","H6 DARE",23,29,126,128,254
MATAM,MATAM,OGO,"NABADJI CIVOL",THIARENE,254,356,2013,2614,4627
MATAM,MATAM,OGO,"NABADJI CIVOL",THIOUBALEL,74,98,517,521,1038
MATAM,MATAM,OGO,"NABADJI CIVOL","H1 THIARNGAL",14,30,137,145,282
MATAM,MATAM,OGO,"NABADJI CIVOL","H3 PEROU",6,12,51,59,110
MATAM,MATAM,OGO,"NABADJI CIVOL","TIGUERE CIRE",191,249,1620,1606,3226
MATAM,MATAM,OGO,"NABADJI CIVOL","H1 ANDA",25,57,277,265,542
MATAM,MATAM,OGO,"NABADJI CIVOL","H2 PETHIETE",9,21,99,76,175
MATAM,MATAM,OGO,"NABADJI CIVOL","H3 THIOFOL",9,20,94,99,193
MATAM,MATAM,OGO,"NABADJI CIVOL","TIGUERE YENE",113,132,620,665,1285
MATAM,MATAM,OGO,"NABADJI CIVOL","H1 GOUREL DORO",5,5,26,35,61
MATAM,MATAM,OGO,"NABADJI CIVOL","H2 MANDIOWA",15,33,167,112,279
MATAM,MATAM,OGO,"NABADJI CIVOL","H3 GOUREL KOUNIARY",14,19,65,68,133
MATAM,MATAM,OGO,"NABADJI CIVOL",WOUDOUROU,318,454,3459,2971,6430
MATAM,MATAM,OGO,"NABADJI CIVOL","H1 LANEL",5,8,44,39,83
MATAM,MATAM,OGO,"NABADJI CIVOL","H2 BOWEL SENEGAL",18,20,148,141,289
MATAM,MATAM,OGO,"NABADJI CIVOL","H3 DIAMI SANO",8,8,34,49,83
MATAM,MATAM,OGO,"NABADJI CIVOL","H4 ALY WOPA",2,4,21,34,55
MATAM,MATAM,OGO,"NABADJI CIVOL","H5 LAWOL DIAOBE",10,14,88,68,156
MATAM,MATAM,OGO,"NABADJI CIVOL","H6 WOURO ASSETTE",3,6,40,26,66
MATAM,MATAM,OGO,"NABADJI CIVOL","H7 BELEL BEYNI",7,8,63,50,113
MATAM,MATAM,OGO,"NABADJI CIVOL",MBANANE,47,73,468,405,873
MATAM,MATAM,OGO,"NABADJI CIVOL",NDAFEDJI,2,2,10,11,21
MATAM,MATAM,OGO,"NABADJI CIVOL",NIMA,61,84,504,573,1077
MATAM,MATAM,OGO,"NABADJI CIVOL","SEDO SANDARABE",30,33,205,177,382
MATAM,MATAM,OGO,"NABADJI CIVOL","SINTHIOU BRA",10,20,93,70,163
MATAM,MATAM,OGO,"NABADJI CIVOL","SINTHIOU TAPSIR",11,19,100,99,199
MATAM,MATAM,OGO,"NABADJI CIVOL",THIAMMA,28,46,349,330,679
MATAM,MATAM,OGO,"NABADJI CIVOL",TOWDE,2,4,38,10,48
MATAM,MATAM,OGO,"NABADJI CIVOL","WOURO DOMBEL",12,18,96,72,168
MATAM,MATAM,OGO,OGO,"BELINAÏDE MBAÏLA",168,239,1500,1548,3048
MATAM,MATAM,OGO,OGO,"H1 WOURO HAERE",3,3,23,21,44
MATAM,MATAM,OGO,OGO,DANTHIADY,257,398,2253,2401,4654
MATAM,MATAM,OGO,OGO,"H1 DAROUL BAIDA",13,26,120,123,243
MATAM,MATAM,OGO,OGO,"H2 DOW BOULLI",15,29,179,194,373
MATAM,MATAM,OGO,OGO,"H3 KAWEL DANTHIADY",26,43,253,218,471
MATAM,MATAM,OGO,OGO,"H6 WOURO FAFABE",2,2,13,18,31
MATAM,MATAM,OGO,OGO,"H7 DIOUDIW DANTHIADY",1,1,7,15,22
MATAM,MATAM,OGO,OGO,"DIANDIOLY TOUCOULEUR",188,273,1589,1647,3236
MATAM,MATAM,OGO,OGO,"H4 WOURO WODABE",29,47,256,243,499
MATAM,MATAM,OGO,OGO,"H5 WOURO SAMBA BABAYEL",3,4,25,18,43
MATAM,MATAM,OGO,OGO,"H6 FETERE",4,6,32,31,63
MATAM,MATAM,OGO,OGO,"DIKANABE (DIKA)",20,30,177,163,340
MATAM,MATAM,OGO,OGO,GALOYABE,106,139,964,972,1936
MATAM,MATAM,OGO,OGO,"H1 KAWEL GALOYABE",23,56,294,288,582
MATAM,MATAM,OGO,OGO,GANABALOL,54,80,632,680,1312
MATAM,MATAM,OGO,OGO,GARLY,119,149,736,636,1372
MATAM,MATAM,OGO,OGO,"H1 SOWANDOU",7,7,30,30,60
MATAM,MATAM,OGO,OGO,"H2 BELLY DIALLO",16,21,141,128,269
MATAM,MATAM,OGO,OGO,"H4 GOUREL DIOBBE",13,13,79,74,153
MATAM,MATAM,OGO,OGO,"H5 SARGANA",7,12,75,68,143
MATAM,MATAM,OGO,OGO,HAMARABE,87,112,733,828,1561
MATAM,MATAM,OGO,OGO,"H1 OURO GALOROU",1,5,21,15,36
MATAM,MATAM,OGO,OGO,"H4 BELY AGABE",5,10,54,56,110
MATAM,MATAM,OGO,OGO,HOMBO,141,228,1310,1254,2564
MATAM,MATAM,OGO,OGO,LAMBANGO,78,121,559,679,1238
MATAM,MATAM,OGO,OGO,"LEWE NGUENAR",84,150,1032,1107,2139
MATAM,MATAM,OGO,OGO,"LOUMBOL ALLOUKI",35,66,243,197,440
MATAM,MATAM,OGO,OGO,"H7 DOURE",14,25,84,85,169
MATAM,MATAM,OGO,OGO,"LOUMBOL AMAR",15,31,170,190,360
MATAM,MATAM,OGO,OGO,"H2 LAMTAKE",7,9,71,69,140
MATAM,MATAM,OGO,OGO,"H3 MBEBA",10,14,89,84,173
MATAM,MATAM,OGO,OGO,"H4 KARAYAL",5,9,40,31,71
MATAM,MATAM,OGO,OGO,"H5 BEELI JAMMOULE",2,2,41,37,78
MATAM,MATAM,OGO,OGO,MBELONE,48,77,393,372,765
MATAM,MATAM,OGO,OGO,DENDOUDY,77,109,527,586,1113
MATAM,MATAM,OGO,OGO,"H1 DIWE",3,3,21,15,36
MATAM,MATAM,OGO,OGO,"H2 LOURANKA",25,32,164,159,323
MATAM,MATAM,OGO,OGO,OGO,379,503,3688,3260,6948
MATAM,MATAM,OGO,OGO,"H2 DOPPERE",29,42,259,268,527
MATAM,MATAM,OGO,OGO,"H3 LOUGUERE COLY",9,14,46,62,108
MATAM,MATAM,OGO,OGO,"H4 GOUREL HOUSSEYNI",6,16,74,53,127
MATAM,MATAM,OGO,OGO,"H5 WOURO ABLAYE SOW (ADO)",33,58,247,253,500
MATAM,MATAM,OGO,OGO,"H6 WOURO AMADOU HAROUNA",41,47,197,157,354
MATAM,MATAM,OGO,OGO,"MARSA GALOYABE",6,7,51,60,111
MATAM,MATAM,OGO,OGO,"SINTHIOU GARBA COLIABE",225,319,1877,1916,3793
MATAM,MATAM,OGO,OGO,"SINTHIOU GARBA FALBE",99,138,1110,1004,2114
MATAM,MATAM,OGO,OGO,"SINTHIOU GARBA GANKY",131,167,1309,1345,2654
MATAM,MATAM,OGO,OGO,"H2 GOUREL NDIKIRI",5,6,25,36,61
MATAM,MATAM,OGO,OGO,"SINTHIOU GARBA GOUREL DOW",26,46,196,280,476
MATAM,MATAM,OGO,OGO,"SINTHIOU GARBA (WOURO ALY) OBOSS",41,57,296,353,649
MATAM,MATAM,OGO,OGO,"SINTHIOU LAMBE",18,22,159,194,353
MATAM,MATAM,OGO,OGO,THIAMBE,164,210,1437,1295,2732
MATAM,MATAM,OGO,OGO,"THIANCONE BOGUEL",113,141,981,1058,2039
MATAM,MATAM,OGO,OGO,"THIANCONE HIRAYE",145,187,1214,1117,2331
MATAM,MATAM,OGO,OGO,"THIANCONE MODY MAKA",20,26,209,180,389
MATAM,MATAM,OGO,OGO,"WASSACODE MBAÏLA",98,126,828,1055,1883
MATAM,MATAM,OGO,OGO,"WASSACODE THIOUTY (THIOUTINCOBE)",72,88,588,698,1286
MATAM,MATAM,OGO,OGO,ALANA,19,25,147,159,306
MATAM,MATAM,OGO,OGO,"BEELI BOULBE",3,6,19,19,38
MATAM,MATAM,OGO,OGO,"BELLY THIOWY",48,65,386,372,758
MATAM,MATAM,OGO,OGO,"DAROU SALAM II",87,122,693,495,1188
MATAM,MATAM,OGO,OGO,"DIANDIOLY BAMBARA",22,28,175,130,305
MATAM,MATAM,OGO,OGO,FABOLY,17,26,130,163,293
MATAM,MATAM,OGO,OGO,FORSOU,11,21,129,104,233
MATAM,MATAM,OGO,OGO,"GOUREL BARRY",4,10,75,97,172
MATAM,MATAM,OGO,OGO,"GOUREL BOUBOU",11,13,69,53,122
MATAM,MATAM,OGO,OGO,LEGUI,4,5,30,29,59
MATAM,MATAM,OGO,OGO,"MADINA SANDE",13,28,146,145,291
MATAM,MATAM,OGO,OGO,"MOJO GUELE",6,7,25,27,52
MATAM,MATAM,OGO,OGO,NDOULOUGOU,25,42,169,175,344
MATAM,MATAM,OGO,OGO,"OURO GADIARY (MARSA)",29,41,203,222,425
MATAM,MATAM,OGO,OGO,"OURO SAMBA MODY BA",17,30,100,93,193
MATAM,MATAM,OGO,OGO,"SINTHIOU GARBA (MADINA FASS)",42,69,428,389,817
MATAM,MATAM,OGO,OGO,THIEWE,22,42,220,166,386
MATAM,MATAM,OGO,OGO,"WOURO ALY NDOULORY",5,8,27,40,67
MATAM,KANEL,KANEL,KANEL,"ALLAH YIDDI LAO",69,102,576,595,1171
MATAM,KANEL,KANEL,KANEL,HOHA,163,233,1365,1252,2617
MATAM,KANEL,KANEL,KANEL,"KANEL II",131,181,1329,893,2222
MATAM,KANEL,KANEL,KANEL,THIELOL,196,329,2323,2204,4527
MATAM,KANEL,KANEL,KANEL,YIRLA,73,113,796,732,1528
MATAM,KANEL,KANEL,KANEL,BELAL,140,205,1295,874,2169
MATAM,KANEL,KANEL,KANEL,"MADINA THIELOL",63,86,606,404,1010
MATAM,KANEL,ORKADIERE,BOKILADJI,ADABERE,188,230,1726,1752,3478
MATAM,KANEL,ORKADIERE,BOKILADJI,ALANA,68,85,833,834,1667
MATAM,KANEL,ORKADIERE,BOKILADJI,"H1 KOLY",21,26,231,241,472
MATAM,KANEL,ORKADIERE,BOKILADJI,"H2 BOULIBANY",2,2,29,22,51
MATAM,KANEL,ORKADIERE,BOKILADJI,"APPE DIALLOUBE",23,34,341,401,742
MATAM,KANEL,ORKADIERE,BOKILADJI,"APPE DIAOUBE",43,54,515,533,1048
MATAM,KANEL,ORKADIERE,BOKILADJI,"H1 THIAMBE (APPE DESILE)",7,10,70,74,144
MATAM,KANEL,ORKADIERE,BOKILADJI,"APPE RANGHABE (APPE DEMBA GOUROU)",7,8,92,71,163
MATAM,KANEL,ORKADIERE,BOKILADJI,"APPE SAKOBE",22,28,366,361,727
MATAM,KANEL,ORKADIERE,BOKILADJI,BABANGOL,41,64,646,828,1474
MATAM,KANEL,ORKADIERE,BOKILADJI,"H1 GOUREL YERO ALY SALL",7,9,64,55,119
MATAM,KANEL,ORKADIERE,BOKILADJI,BOKILADJI,137,219,1322,1310,2632
MATAM,KANEL,ORKADIERE,BOKILADJI,"H1 DAROU SALAM",31,56,452,373,825
MATAM,KANEL,ORKADIERE,BOKILADJI,"H2 MAYEL KADIE",21,36,230,243,473
MATAM,KANEL,ORKADIERE,BOKILADJI,"H3 ARAFAT",9,23,116,103,219
MATAM,KANEL,ORKADIERE,BOKILADJI,"BONDJI NDIOBO (BONDJI BOCA MALICK)",18,22,251,286,537
MATAM,KANEL,ORKADIERE,BOKILADJI,"H1 VALIDIALA MAMADOU SAMBA",17,22,212,217,429
MATAM,KANEL,ORKADIERE,BOKILADJI,"BONDJI WALI",111,140,1168,1178,2346
MATAM,KANEL,ORKADIERE,BOKILADJI,FADIAR,71,103,737,729,1466
MATAM,KANEL,ORKADIERE,BOKILADJI,"GANGUEL MAKA",146,261,2009,2097,4106
MATAM,KANEL,ORKADIERE,BOKILADJI,"H1 OUROU SARA FAMORY",3,20,78,85,163
MATAM,KANEL,ORKADIERE,BOKILADJI,"H2 SADATOU GANGUEL",20,24,164,143,307
MATAM,KANEL,ORKADIERE,BOKILADJI,"GANGUEL MAMADOU DEMBA",1,1,12,13,25
MATAM,KANEL,ORKADIERE,BOKILADJI,"H1 GOUREL YORO HAMADOU BA",12,15,102,100,202
MATAM,KANEL,ORKADIERE,BOKILADJI,"H2 KOYINIGUEL",12,17,120,146,266
MATAM,KANEL,ORKADIERE,BOKILADJI,"H3 THIELE",8,12,101,125,226
MATAM,KANEL,ORKADIERE,BOKILADJI,"GAOUDE BOFFE",60,72,425,436,861
MATAM,KANEL,ORKADIERE,BOKILADJI,"GAOUDE WAYAMBE",16,18,219,196,415
MATAM,KANEL,ORKADIERE,BOKILADJI,KAWAL,105,140,1114,1224,2338
MATAM,KANEL,ORKADIERE,BOKILADJI,"H1 KOYINIGUEL",2,2,27,41,68
MATAM,KANEL,ORKADIERE,BOKILADJI,LOBALY,177,214,2139,2070,4209
MATAM,KANEL,ORKADIERE,BOKILADJI,NIAROUWAL,30,39,456,472,928
MATAM,KANEL,ORKADIERE,BOKILADJI,"H1 DEBELE MANE",2,2,25,35,60
MATAM,KANEL,ORKADIERE,BOKILADJI,"OURO MBOULEL",64,75,893,820,1713
MATAM,KANEL,ORKADIERE,BOKILADJI,"H2 GOUREL GUEDA",7,8,136,119,255
MATAM,KANEL,ORKADIERE,BOKILADJI,"OURO SILA MAKA",2,2,29,23,52
MATAM,KANEL,ORKADIERE,BOKILADJI,"SINTHIOU DEMBA",14,24,154,155,309
MATAM,KANEL,ORKADIERE,BOKILADJI,"SINTHIOU FADIAR (BOULONKADJI)",97,140,1213,1328,2541
MATAM,KANEL,ORKADIERE,BOKILADJI,"TATA BATHILY",14,20,184,202,386
MATAM,KANEL,ORKADIERE,BOKILADJI,"H1 MBOMBOYAOBE",3,7,58,56,114
MATAM,KANEL,ORKADIERE,BOKILADJI,THIAGNAF,135,179,1122,999,2121
MATAM,KANEL,ORKADIERE,BOKILADJI,"H1 GOUREL SAMBOROU BOKAREL",1,2,11,18,29
MATAM,KANEL,ORKADIERE,BOKILADJI,THIAWALOL,33,43,557,480,1037
MATAM,KANEL,ORKADIERE,BOKILADJI,"YACINE LACKE",201,245,2112,2164,4276
MATAM,KANEL,ORKADIERE,BOKILADJI,"LEWEL BALI DEYBATOU",12,17,79,66,145
MATAM,KANEL,ORKADIERE,ORKADIERE,BALEL,65,92,573,603,1176
MATAM,KANEL,ORKADIERE,ORKADIERE,BARKATOU,103,127,1079,1064,2143
MATAM,KANEL,ORKADIERE,ORKADIERE,BARKEVY,46,60,334,302,636
MATAM,KANEL,ORKADIERE,ORKADIERE,DIELLA,220,275,2186,2323,4509
MATAM,KANEL,ORKADIERE,ORKADIERE,DJINTHING,15,19,152,183,335
MATAM,KANEL,ORKADIERE,ORKADIERE,"GANGUEL SOULE",233,278,2349,2150,4499
MATAM,KANEL,ORKADIERE,ORKADIERE,"H1 KOLA MAMOUDOU FARY BARRY",2,5,41,37,78
MATAM,KANEL,ORKADIERE,ORKADIERE,GASSAMBERRY,101,127,1077,1016,2093
MATAM,KANEL,ORKADIERE,ORKADIERE,"H1 AÏNOUMADY",28,37,256,244,500
MATAM,KANEL,ORKADIERE,ORKADIERE,GOUMAL,98,114,780,955,1735
MATAM,KANEL,ORKADIERE,ORKADIERE,"GOURIKI COLLIABE",131,158,1284,1371,2655
MATAM,KANEL,ORKADIERE,ORKADIERE,"GOURIKY SAMBA DIOM",51,72,621,610,1231
MATAM,KANEL,ORKADIERE,ORKADIERE,HOULDE,28,42,337,283,620
MATAM,KANEL,ORKADIERE,ORKADIERE,ORKADIERE,513,697,6049,5161,11210
MATAM,KANEL,ORKADIERE,ORKADIERE,"H1 POYI",7,8,42,57,99
MATAM,KANEL,ORKADIERE,ORKADIERE,"H2 DJIWOYSSI",10,15,94,88,182
MATAM,KANEL,ORKADIERE,ORKADIERE,PADALAL,136,191,1873,1759,3632
MATAM,KANEL,ORKADIERE,ORKADIERE,"H1 KOLA SEBBE",8,17,129,134,263
MATAM,KANEL,ORKADIERE,ORKADIERE,"H2 KOUBAR",5,8,62,60,122
MATAM,KANEL,ORKADIERE,ORKADIERE,"POLEL AWLOUBE",47,65,431,429,860
MATAM,KANEL,ORKADIERE,ORKADIERE,"POLEL DIAOUBE",225,288,2016,2002,4018
MATAM,KANEL,ORKADIERE,ORKADIERE,"SINTHIANE DIOUDE LESS",32,49,383,306,689
MATAM,KANEL,ORKADIERE,ORKADIERE,"H1 SINTHIANE DIOUDE DOW",35,44,360,347,707
MATAM,KANEL,ORKADIERE,ORKADIERE,"H2 DIROU DIROU",18,24,139,164,303
MATAM,KANEL,ORKADIERE,ORKADIERE,"H3 WOURO SAMBA MALI",13,17,66,71,137
MATAM,KANEL,ORKADIERE,ORKADIERE,"H4 SAMANGAYE",4,8,54,48,102
MATAM,KANEL,ORKADIERE,ORKADIERE,"H5 BOKI",10,14,93,70,163
MATAM,KANEL,ORKADIERE,ORKADIERE,"H6 BALLELE",9,19,115,94,209
MATAM,KANEL,ORKADIERE,ORKADIERE,"SINTHIOU POLELE",45,81,584,521,1105
MATAM,KANEL,ORKADIERE,ORKADIERE,"WALLI DIALA",13,25,244,203,447
MATAM,KANEL,ORKADIERE,ORKADIERE,"WENDOU BOSSEABE",416,635,4206,4626,8832
MATAM,KANEL,ORKADIERE,ORKADIERE,FASS,34,45,405,356,761
MATAM,KANEL,ORKADIERE,AOURE,AOURE,487,767,4952,4813,9765
MATAM,KANEL,ORKADIERE,AOURE,BOKKISSABOUDOU,69,109,873,952,1825
MATAM,KANEL,ORKADIERE,AOURE,BOULBY,39,51,442,512,954
MATAM,KANEL,ORKADIERE,AOURE,"H1 OUFANY",1,1,7,6,13
MATAM,KANEL,ORKADIERE,AOURE,"BOULONNE SAMBA DIADIE",19,31,281,341,622
MATAM,KANEL,ORKADIERE,AOURE,DIALLOUBE,263,350,2455,2523,4978
MATAM,KANEL,ORKADIERE,AOURE,"H1 WOURO DIOM",10,17,91,92,183
MATAM,KANEL,ORKADIERE,AOURE,"H2 GOUREL MODY GAGNO",11,12,51,46,97
MATAM,KANEL,ORKADIERE,AOURE,DIAMOUGUEL,315,442,2924,3137,6061
MATAM,KANEL,ORKADIERE,AOURE,"DIAOBE KOBILO (SAHADATOU)",81,178,737,856,1593
MATAM,KANEL,ORKADIERE,AOURE,"H1 KONY",10,14,93,98,191
MATAM,KANEL,ORKADIERE,AOURE,DOUNDE,214,289,1868,1880,3748
MATAM,KANEL,ORKADIERE,AOURE,"H1 DOUNDE REFUGIES",68,100,852,648,1500
MATAM,KANEL,ORKADIERE,AOURE,"DOUDE BAGUE",37,67,595,681,1276
MATAM,KANEL,ORKADIERE,AOURE,"H1 DENDOULI",14,23,167,206,373
MATAM,KANEL,ORKADIERE,AOURE,GODIOWEL,47,93,670,644,1314
MATAM,KANEL,ORKADIERE,AOURE,"H1 GUEWEUL",10,21,146,151,297
MATAM,KANEL,ORKADIERE,AOURE,"H2 BODODIE",20,28,174,200,374
MATAM,KANEL,ORKADIERE,AOURE,"GOUREL DARA",22,44,337,335,672
MATAM,KANEL,ORKADIERE,AOURE,"H1 BITELE",4,16,85,67,152
MATAM,KANEL,ORKADIERE,AOURE,"HAMDALLAYE (GOUREL THIERNO)",49,110,784,740,1524
MATAM,KANEL,ORKADIERE,AOURE,"ISTIGA AMADOU",16,36,173,132,305
MATAM,KANEL,ORKADIERE,AOURE,"H1 GOUREL SAMBA DEMBA SY",1,4,8,4,12
MATAM,KANEL,ORKADIERE,AOURE,KOLY,20,24,180,173,353
MATAM,KANEL,ORKADIERE,AOURE,LOBOUGAL,17,30,252,246,498
MATAM,KANEL,ORKADIERE,AOURE,"H1 ACARE",13,18,123,138,261
MATAM,KANEL,ORKADIERE,AOURE,"H2 SENEGA",1,1,6,0,6
MATAM,KANEL,ORKADIERE,AOURE,"LOUGUE NODY",21,31,222,260,482
MATAM,KANEL,ORKADIERE,AOURE,"H1 FASS",2,4,44,38,82
MATAM,KANEL,ORKADIERE,AOURE,MAYEL,16,29,282,254,536
MATAM,KANEL,ORKADIERE,AOURE,"H1 HOUTOROU (GOUREL MAISSA FALL)",1,2,14,23,37
MATAM,KANEL,ORKADIERE,AOURE,NDIOTTE,117,145,976,986,1962
MATAM,KANEL,ORKADIERE,AOURE,"H1 GOUREL SAMBA ISMA (GOUREL ADAMA) (SAM)",1,1,4,0,4
MATAM,KANEL,ORKADIERE,AOURE,NIANGANA,25,48,476,508,984
MATAM,KANEL,ORKADIERE,AOURE,"OURO HAMATH",14,21,201,231,432
MATAM,KANEL,ORKADIERE,AOURE,"OURO DARA",16,27,136,128,264
MATAM,KANEL,ORKADIERE,AOURE,PARAWOL,4,7,53,86,139
MATAM,KANEL,ORKADIERE,AOURE,"H1 AYNOUMADY",3,3,23,32,55
MATAM,KANEL,ORKADIERE,AOURE,PATOUKY,33,43,401,499,900
MATAM,KANEL,ORKADIERE,AOURE,"SANGHAYEL DIAOBE",7,16,43,54,97
MATAM,KANEL,ORKADIERE,AOURE,"SANGHAYEL GALOYABE",19,30,92,136,228
MATAM,KANEL,ORKADIERE,AOURE,SENDOU,35,45,503,430,933
MATAM,KANEL,ORKADIERE,AOURE,SENOYEL,18,23,233,246,479
MATAM,KANEL,ORKADIERE,AOURE,SILOROU,24,30,284,248,532
MATAM,KANEL,ORKADIERE,AOURE,"H1 BOUSRA",4,4,31,29,60
MATAM,KANEL,ORKADIERE,AOURE,"SINTHIOU SILEYE",22,40,391,434,825
MATAM,KANEL,ORKADIERE,AOURE,"H1 GOUREL PATHE",4,6,30,47,77
MATAM,KANEL,ORKADIERE,AOURE,"SINTHIOU WALEL",36,71,503,519,1022
MATAM,KANEL,ORKADIERE,AOURE,"H1 SALAMATOU",13,21,164,153,317
MATAM,KANEL,ORKADIERE,AOURE,"THINGOLELE WAMBABE",12,14,121,120,241
MATAM,KANEL,ORKADIERE,AOURE,"THINGOLELE DEMBA DJIBY",16,25,257,313,570
MATAM,KANEL,ORKADIERE,AOURE,WALEL,104,150,1055,1070,2125
MATAM,KANEL,ORKADIERE,AOURE,"H1 GOULALY",4,4,38,33,71
MATAM,KANEL,ORKADIERE,AOURE,"YERIMALE FOULABE",21,34,226,257,483
MATAM,KANEL,ORKADIERE,AOURE,"YERIMALE TOROBE",134,183,1466,1449,2915
MATAM,KANEL,ORKADIERE,DEMBANCANE,"CITE FORAGE",62,77,522,468,990
MATAM,KANEL,ORKADIERE,DEMBANCANE,SONADIS,30,37,277,283,560
MATAM,KANEL,ORKADIERE,DEMBANCANE,VERMA,41,45,454,496,950
MATAM,KANEL,ORKADIERE,DEMBANCANE,KOMONKANY,53,72,667,728,1395
MATAM,KANEL,ORKADIERE,DEMBANCANE,HORONKANY,31,40,240,312,552
MATAM,KANEL,ORKADIERE,DEMBANCANE,SOUKARANKANY,13,14,129,154,283
MATAM,KANEL,ORKADIERE,DEMBANCANE,KASSANKANY,46,64,542,509,1051
MATAM,KANEL,ORKADIERE,OUAOUNDE,"DAROU SALAM",49,59,417,382,799
MATAM,KANEL,ORKADIERE,OUAOUNDE,SOMONO,36,58,466,428,894
MATAM,KANEL,ORKADIERE,OUAOUNDE,SOUBALO,73,127,780,738,1518
MATAM,KANEL,ORKADIERE,OUAOUNDE,"WAOUNDE I",365,504,3080,3085,6165
MATAM,KANEL,ORKADIERE,SEMME,"DAROU SALAM",50,65,692,508,1200
MATAM,KANEL,ORKADIERE,SEMME,"GRANDE MOSQUEE",75,103,877,831,1708
MATAM,KANEL,ORKADIERE,SEMME,ROUMDE,83,117,741,826,1567
MATAM,KANEL,ORKADIERE,SEMME,"SINTHIOU BALLA",78,124,857,797,1654
MATAM,KANEL,ORKADIERE,SEMME,MADIYANA,75,106,630,709,1339
MATAM,KANEL,ORKADIERE,SEMME,ALWAR,110,138,922,823,1745
MATAM,KANEL,"WOURO SIDY",NDENDORY,"ANDI YARI",40,65,478,424,902
MATAM,KANEL,"WOURO SIDY",NDENDORY,"H1 ALANA DIEGUESSE",6,11,47,60,107
MATAM,KANEL,"WOURO SIDY",NDENDORY,BANGASSY,61,114,589,632,1221
MATAM,KANEL,"WOURO SIDY",NDENDORY,BAPALEL,112,141,1433,1096,2529
MATAM,KANEL,"WOURO SIDY",NDENDORY,"BARMATHIAL (AINOUMADY)",44,70,443,451,894
MATAM,KANEL,"WOURO SIDY",NDENDORY,"H1 SINTHIANE BARMATHIAL",41,53,493,433,926
MATAM,KANEL,"WOURO SIDY",NDENDORY,DEYBA,27,37,287,284,571
MATAM,KANEL,"WOURO SIDY",NDENDORY,"H1 GOUREL DOW",10,12,68,71,139
MATAM,KANEL,"WOURO SIDY",NDENDORY,"H2 CARRIERE",17,27,162,157,319
MATAM,KANEL,"WOURO SIDY",NDENDORY,"H3 FARSOU KEBA",7,12,108,102,210
MATAM,KANEL,"WOURO SIDY",NDENDORY,"H4 BOYENGUEL",39,74,377,391,768
MATAM,KANEL,"WOURO SIDY",NDENDORY,DIAMALY,34,55,293,313,606
MATAM,KANEL,"WOURO SIDY",NDENDORY,"H1 LOUMBOL TALLANDE",5,6,29,26,55
MATAM,KANEL,"WOURO SIDY",NDENDORY,"H2 LOUMBOL MAWNDOU",6,8,63,46,109
MATAM,KANEL,"WOURO SIDY",NDENDORY,"DAROU SALAM",15,22,142,145,287
MATAM,KANEL,"WOURO SIDY",NDENDORY,"GOUREL HADJI",46,100,655,575,1230
MATAM,KANEL,"WOURO SIDY",NDENDORY,"H1 LOUMBOL SARA",5,7,42,46,88
MATAM,KANEL,"WOURO SIDY",NDENDORY,"H2 WINEDE DIABY",1,1,15,9,24
MATAM,KANEL,"WOURO SIDY",NDENDORY,KELLOL,47,70,526,513,1039
MATAM,KANEL,"WOURO SIDY",NDENDORY,"H1 BELLEL KELLY",10,19,124,129,253
MATAM,KANEL,"WOURO SIDY",NDENDORY,"H2 GOUREL SIRANABE",6,9,51,26,77
MATAM,KANEL,"WOURO SIDY",NDENDORY,LORDOUGA,39,62,521,477,998
MATAM,KANEL,"WOURO SIDY",NDENDORY,"H1 GOUREL MALAW DIALLO",8,9,109,132,241
MATAM,KANEL,"WOURO SIDY",NDENDORY,"H2 GOUREL BAROU",1,2,3,8,11
MATAM,KANEL,"WOURO SIDY",NDENDORY,"H3 GOUREL SAMBA DIARRA",1,6,34,32,66
MATAM,KANEL,"WOURO SIDY",NDENDORY,"H4 GOUREL NIAKA (FETANGA)",2,5,39,37,76
MATAM,KANEL,"WOURO SIDY",NDENDORY,"MEDINA KOLEL",29,41,213,242,455
MATAM,KANEL,"WOURO SIDY",NDENDORY,"H1 GOUREL DIADIA",1,1,9,7,16
MATAM,KANEL,"WOURO SIDY",NDENDORY,"H2 GOUREL SAMBA BA",1,3,12,9,21
MATAM,KANEL,"WOURO SIDY",NDENDORY,"H3 GOUREL BODY",30,50,305,335,640
MATAM,KANEL,"WOURO SIDY",NDENDORY,"H4 BELE NDENDY",1,3,18,26,44
MATAM,KANEL,"WOURO SIDY",NDENDORY,NDENDORY,354,502,3596,3615,7211
MATAM,KANEL,"WOURO SIDY",NDENDORY,"H1 NDIAYENBE",14,29,169,166,335
MATAM,KANEL,"WOURO SIDY",NDENDORY,"H2 BOUKELY SOW",10,24,138,95,233
MATAM,KANEL,"WOURO SIDY",NDENDORY,"H3 WOURO ABDOULAYE GOREL",14,34,155,147,302
MATAM,KANEL,"WOURO SIDY",NDENDORY,"H4 NASSOUROULAYE",37,84,418,448,866
MATAM,KANEL,"WOURO SIDY",NDENDORY,"H5 BABANGOL",36,63,337,339,676
MATAM,KANEL,"WOURO SIDY",NDENDORY,ORNDOLDE,346,474,3729,3667,7396
MATAM,KANEL,"WOURO SIDY",NDENDORY,SAVADOGUEL,7,11,71,75,146
MATAM,KANEL,"WOURO SIDY",NDENDORY,"H1 GOUREL HAMADY",9,10,25,28,53
MATAM,KANEL,"WOURO SIDY",NDENDORY,"H2 GOUREL SARA COULIBALY",1,2,31,31,62
MATAM,KANEL,"WOURO SIDY",NDENDORY,"H3 DOKIROU",2,9,81,82,163
MATAM,KANEL,"WOURO SIDY",NDENDORY,"H4 FORA (GOWEL)",3,5,7,8,15
MATAM,KANEL,"WOURO SIDY",NDENDORY,"H5 SADATOU",1,1,8,0,8
MATAM,KANEL,"WOURO SIDY",NDENDORY,"SENO PALEL",255,378,2631,2557,5188
MATAM,KANEL,"WOURO SIDY",NDENDORY,NGANO,186,246,2134,1847,3981
MATAM,KANEL,"WOURO SIDY",NDENDORY,"H1 DAROU NEMA",4,12,51,39,90
MATAM,KANEL,"WOURO SIDY",NDENDORY,"H2 POUDAL",8,21,111,91,202
MATAM,KANEL,"WOURO SIDY",NDENDORY,"H3 LEWONE (GOUREL GALLO)",2,3,27,25,52
MATAM,KANEL,"WOURO SIDY",NDENDORY,TEKINGUEL,176,229,1769,1855,3624
MATAM,KANEL,"WOURO SIDY",NDENDORY,"H1 GOUREL COULY SOW",5,9,37,62,99
MATAM,KANEL,"WOURO SIDY",NDENDORY,"WENDOU NODI",160,241,1911,1836,3747
MATAM,KANEL,"WOURO SIDY",NDENDORY,"SOMONO NGANO",6,15,101,114,215
MATAM,KANEL,"WOURO SIDY",NDENDORY,"SALOR DIAWBE",14,16,103,103,206
MATAM,KANEL,"WOURO SIDY",NDENDORY,MANDIOUMBA,76,85,564,492,1056
MATAM,KANEL,"WOURO SIDY",NDENDORY,"MADINA GALO",4,9,64,53,117
MATAM,KANEL,"WOURO SIDY","WOURO SIDY",BABINGUEL,6,16,121,118,239
MATAM,KANEL,"WOURO SIDY","WOURO SIDY","H1 WINDE NIAWRE",5,9,30,36,66
MATAM,KANEL,"WOURO SIDY","WOURO SIDY","H2 GOUREL ALASSANE BA",2,4,23,20,43
MATAM,KANEL,"WOURO SIDY","WOURO SIDY",BOKIDIARAL,9,16,66,57,123
MATAM,KANEL,"WOURO SIDY","WOURO SIDY",BOW,154,190,1201,1157,2358
MATAM,KANEL,"WOURO SIDY","WOURO SIDY","H1 GOUREL BOW PEULH",6,9,70,74,144
MATAM,KANEL,"WOURO SIDY","WOURO SIDY","H3 HAANDARE",2,6,48,43,91
MATAM,KANEL,"WOURO SIDY","WOURO SIDY","H4 GOUREL ISSA BOLO",13,18,120,103,223
MATAM,KANEL,"WOURO SIDY","WOURO SIDY","H5 GOUREL MOYE",3,3,32,27,59
MATAM,KANEL,"WOURO SIDY","WOURO SIDY",NAIKY,18,36,153,156,309
MATAM,KANEL,"WOURO SIDY","WOURO SIDY","H1 GOUREL TOROBE",4,8,20,20,40
MATAM,KANEL,"WOURO SIDY","WOURO SIDY","H2 BOKI WALO",1,2,20,19,39
MATAM,KANEL,"WOURO SIDY","WOURO SIDY","FOUMIHARA DIAMWELY",63,91,610,671,1281
MATAM,KANEL,"WOURO SIDY","WOURO SIDY","DOLOL SOUBALO",42,58,378,418,796
MATAM,KANEL,"WOURO SIDY","WOURO SIDY","FETE BOWAL",28,47,185,137,322
MATAM,KANEL,"WOURO SIDY","WOURO SIDY","H1 GOUREL DOW",7,13,47,35,82
MATAM,KANEL,"WOURO SIDY","WOURO SIDY","H3 WENDOU DIANAL (FETE DIANAL)",12,71,144,108,252
MATAM,KANEL,"WOURO SIDY","WOURO SIDY","H4 OURO SAMBA DJINGOUDI BA",5,37,48,77,125
MATAM,KANEL,"WOURO SIDY","WOURO SIDY","H5 FETE KODIOLI",3,15,55,40,95
MATAM,KANEL,"WOURO SIDY","WOURO SIDY","H6 GOUREL DEMBA MODI SOW",1,2,8,4,12
MATAM,KANEL,"WOURO SIDY","WOURO SIDY","PETE BOWE MBAILA",51,114,483,468,951
MATAM,KANEL,"WOURO SIDY","WOURO SIDY","H1 WOURO MODY SALA",5,5,26,31,57
MATAM,KANEL,"WOURO SIDY","WOURO SIDY","H2 WOURO MARY",4,10,21,13,34
MATAM,KANEL,"WOURO SIDY","WOURO SIDY","H3 WOURO MAMADOU DEMBA",7,16,56,49,105
MATAM,KANEL,"WOURO SIDY","WOURO SIDY","H4 WOURO HAMA NIANG",2,3,14,15,29
MATAM,KANEL,"WOURO SIDY","WOURO SIDY","H5 WOURO SEYDOU MALAL",4,5,21,19,40
MATAM,KANEL,"WOURO SIDY","WOURO SIDY","FETE FOWROU",20,60,177,193,370
MATAM,KANEL,"WOURO SIDY","WOURO SIDY","H1 YOUNGHA",6,9,44,41,85
MATAM,KANEL,"WOURO SIDY","WOURO SIDY","H2 OURO BOULO",11,14,70,69,139
MATAM,KANEL,"WOURO SIDY","WOURO SIDY","FORA DIAWARA",36,56,531,479,1010
MATAM,KANEL,"WOURO SIDY","WOURO SIDY","H1 FORA GALOYA",37,63,434,452,886
MATAM,KANEL,"WOURO SIDY","WOURO SIDY","FOUMIHARA DEMBOUBE",74,107,741,764,1505
MATAM,KANEL,"WOURO SIDY","WOURO SIDY","H1 GOUREL MALLE",17,22,133,117,250
MATAM,KANEL,"WOURO SIDY","WOURO SIDY","FOUMIHARA DIOBE",79,112,742,724,1466
MATAM,KANEL,"WOURO SIDY","WOURO SIDY","H1 ARAFAT",2,2,23,17,40
MATAM,KANEL,"WOURO SIDY","WOURO SIDY","GASKA NORWA",6,10,47,55,102
MATAM,KANEL,"WOURO SIDY","WOURO SIDY",GASSABE,8,20,82,84,166
MATAM,KANEL,"WOURO SIDY","WOURO SIDY","H1 ALASSERY (WOURO SAMBA KAWAL)",6,12,51,50,101
MATAM,KANEL,"WOURO SIDY","WOURO SIDY","H2 MADINA HAMA MODY",3,10,36,35,71
MATAM,KANEL,"WOURO SIDY","WOURO SIDY","H3 AINOUMADY (GOUREL HAROUNA)",1,3,15,13,28
MATAM,KANEL,"WOURO SIDY","WOURO SIDY","H4 MADINA SAMBA KOTHIAR (GOUREL SEBBE)",5,7,33,35,68
MATAM,KANEL,"WOURO SIDY","WOURO SIDY",GASSEL,4,7,44,37,81
MATAM,KANEL,"WOURO SIDY","WOURO SIDY","H1 WOURO TERRY",2,4,19,21,40
MATAM,KANEL,"WOURO SIDY","WOURO SIDY",GOUREL,11,24,97,80,177
MATAM,KANEL,"WOURO SIDY","WOURO SIDY","H1 BOULI DOW",5,10,37,42,79
MATAM,KANEL,"WOURO SIDY","WOURO SIDY","H2 SEKOUROU DIALLO",4,5,30,26,56
MATAM,KANEL,"WOURO SIDY","WOURO SIDY",KAWEL,14,26,98,123,221
MATAM,KANEL,"WOURO SIDY","WOURO SIDY","H1 BINGUEL",3,6,15,28,43
MATAM,KANEL,"WOURO SIDY","WOURO SIDY","H2 GOUREL DEMBA SOW",2,8,20,16,36
MATAM,KANEL,"WOURO SIDY","WOURO SIDY",KOLIMALDI,7,10,44,41,85
MATAM,KANEL,"WOURO SIDY","WOURO SIDY","HI DIANDJA SIRANABE",5,13,44,36,80
MATAM,KANEL,"WOURO SIDY","WOURO SIDY","LEWE DAMGA",45,78,542,500,1042
MATAM,KANEL,"WOURO SIDY","WOURO SIDY","H1 DOW BOULY LEWE",8,30,118,115,233
MATAM,KANEL,"WOURO SIDY","WOURO SIDY",LORA,10,44,121,117,238
MATAM,KANEL,"WOURO SIDY","WOURO SIDY",LOTOKE,62,102,567,460,1027
MATAM,KANEL,"WOURO SIDY","WOURO SIDY","LOUGUERE MBABA",25,92,197,206,403
MATAM,KANEL,"WOURO SIDY","WOURO SIDY","H1 SINTHIOU BOWE",4,16,27,34,61
MATAM,KANEL,"WOURO SIDY","WOURO SIDY",MALANDOU,30,58,387,330,717
MATAM,KANEL,"WOURO SIDY","WOURO SIDY",MBOUNGUIEL,18,36,215,212,427
MATAM,KANEL,"WOURO SIDY","WOURO SIDY","H1 NALEL WOURO IDY",1,1,16,16,32
MATAM,KANEL,"WOURO SIDY","WOURO SIDY","H2 GOUREL ALASSANE",7,12,49,49,98
MATAM,KANEL,"WOURO SIDY","WOURO SIDY","H3 VELINGARA WOURO DEMBA DIAO",4,6,22,30,52
MATAM,KANEL,"WOURO SIDY","WOURO SIDY",MBOUNG,32,62,287,234,521
MATAM,KANEL,"WOURO SIDY","WOURO SIDY","H1 GOUREL AMADOU TIDIANE BA",4,11,39,40,79
MATAM,KANEL,"WOURO SIDY","WOURO SIDY","H3 GOUREL DEMBA PATHE",2,3,8,12,20
MATAM,KANEL,"WOURO SIDY","WOURO SIDY","H4 WOURO SILEY",5,6,30,35,65
MATAM,KANEL,"WOURO SIDY","WOURO SIDY","H5 GOUREL TIDIANE BA",2,2,12,21,33
MATAM,KANEL,"WOURO SIDY","WOURO SIDY","H6 MADINA SIRENABE",8,17,104,69,173
MATAM,KANEL,"WOURO SIDY","WOURO SIDY","H7 WOURO LAKOR",2,3,21,16,37
MATAM,KANEL,"WOURO SIDY","WOURO SIDY","H8 GOUREL BAFFI",5,7,39,32,71
MATAM,KANEL,"WOURO SIDY","WOURO SIDY","MADINA TOROBE",163,214,1410,1487,2897
MATAM,KANEL,"WOURO SIDY","WOURO SIDY","H1 GOUREL YERO NDJIBA",22,33,160,177,337
MATAM,KANEL,"WOURO SIDY","WOURO SIDY","H2 GOUREL SIRENABE",9,14,62,66,128
MATAM,KANEL,"WOURO SIDY","WOURO SIDY",NABA,6,20,79,58,137
MATAM,KANEL,"WOURO SIDY","WOURO SIDY",NAMARY,36,56,274,237,511
MATAM,KANEL,"WOURO SIDY","WOURO SIDY","H1 BAAL",3,3,14,15,29
MATAM,KANEL,"WOURO SIDY","WOURO SIDY","H2 WOURO YAYAYEL",4,7,27,37,64
MATAM,KANEL,"WOURO SIDY","WOURO SIDY","NDIARY NDIOFA",5,12,35,33,68
MATAM,KANEL,"WOURO SIDY","WOURO SIDY",NGAR,18,30,168,146,314
MATAM,KANEL,"WOURO SIDY","WOURO SIDY","H1 WOURO GOREL",4,6,23,25,48
MATAM,KANEL,"WOURO SIDY","WOURO SIDY","H2 WOURO SEYDOU MAMADOU",3,11,34,34,68
MATAM,KANEL,"WOURO SIDY","WOURO SIDY","OURO CEBO",10,18,67,45,112
MATAM,KANEL,"WOURO SIDY","WOURO SIDY","H1 OURO MAMOUDOU",5,10,46,59,105
MATAM,KANEL,"WOURO SIDY","WOURO SIDY","H2 OURO ASSERE",10,18,110,76,186
MATAM,KANEL,"WOURO SIDY","WOURO SIDY","H3 NIAROUWEL WOURO ABDI BA",11,18,115,94,209
MATAM,KANEL,"WOURO SIDY","WOURO SIDY","H4 THIEWELE",12,27,96,77,173
MATAM,KANEL,"WOURO SIDY","WOURO SIDY","OURO SIDI",141,218,1389,1517,2906
MATAM,KANEL,"WOURO SIDY","WOURO SIDY","RANEROU ORIENTAL",17,30,120,115,235
MATAM,KANEL,"WOURO SIDY","WOURO SIDY","H1 NIAROUWEL",8,32,54,67,121
MATAM,KANEL,"WOURO SIDY","WOURO SIDY","H2 NIAROUWEL (OURO PATHE MBAYE)",7,11,50,47,97
MATAM,KANEL,"WOURO SIDY","WOURO SIDY","H3 GOUREL HAMADI PATHE",6,29,50,50,100
MATAM,KANEL,"WOURO SIDY","WOURO SIDY","H5 GOUREL OUSMANE YAYA",5,15,56,72,128
MATAM,KANEL,"WOURO SIDY","WOURO SIDY","H6 NASROULLAH (GOUREL DEMBA IFRA)",3,5,47,45,92
MATAM,KANEL,"WOURO SIDY","WOURO SIDY","H7 SAMBA OUMAR BA",1,2,13,14,27
MATAM,KANEL,"WOURO SIDY","WOURO SIDY","H8 SEKOUROU DIALLO",6,49,55,61,116
MATAM,KANEL,"WOURO SIDY","WOURO SIDY","H9 GOUREL NGAIDO",2,3,15,20,35
MATAM,KANEL,"WOURO SIDY","WOURO SIDY","H10 GOUREL AMADOU",3,6,29,29,58
MATAM,KANEL,"WOURO SIDY","WOURO SIDY","H11 GOUREL BAKARY",1,3,3,0,3
MATAM,KANEL,"WOURO SIDY","WOURO SIDY",SINTHIANE,188,312,2425,2178,4603
MATAM,KANEL,"WOURO SIDY","WOURO SIDY","H1 GOUREL HAMADY",9,14,99,95,194
MATAM,KANEL,"WOURO SIDY","WOURO SIDY","SORINGHO PULAAR",104,146,915,896,1811
MATAM,KANEL,"WOURO SIDY","WOURO SIDY","SORINGHO SEBBE",190,273,1950,2112,4062
MATAM,KANEL,"WOURO SIDY","WOURO SIDY",SOSSOBE,18,38,131,114,245
MATAM,KANEL,"WOURO SIDY","WOURO SIDY","H1 OURO BAROU",5,8,38,35,73
MATAM,KANEL,"WOURO SIDY","WOURO SIDY","THIALY MAKA",139,177,1138,1183,2321
MATAM,KANEL,"WOURO SIDY","WOURO SIDY","H1 GOUREL YEROYEL",3,3,13,39,52
MATAM,KANEL,"WOURO SIDY","WOURO SIDY","THIALY SOUBALO",74,108,811,846,1657
MATAM,KANEL,"WOURO SIDY","WOURO SIDY","H1 MBELONE",15,20,181,191,372
MATAM,KANEL,"WOURO SIDY","WOURO SIDY","H3 DEMBAK",18,29,201,199,400
MATAM,KANEL,"WOURO SIDY","WOURO SIDY",THIEMPING,239,299,2093,2157,4250
MATAM,KANEL,"WOURO SIDY","WOURO SIDY","H1 CROIX ROUGE",8,8,85,73,158
MATAM,KANEL,"WOURO SIDY","WOURO SIDY",THIODORDE,5,18,39,45,84
MATAM,KANEL,"WOURO SIDY","WOURO SIDY","TOUBE DIAOUBE",6,17,71,73,144
MATAM,KANEL,"WOURO SIDY","WOURO SIDY","H1 BINGUEL (WOURO KORKA)",2,3,22,21,43
MATAM,KANEL,"WOURO SIDY","WOURO SIDY","TOUBE KAHE",9,16,91,87,178
MATAM,KANEL,"WOURO SIDY","WOURO SIDY","TOUBEL BALI",13,21,90,88,178
MATAM,KANEL,"WOURO SIDY","WOURO SIDY","H1 WENDOUCOLE",4,9,39,37,76
MATAM,KANEL,"WOURO SIDY","WOURO SIDY","TOUBERE AMADOU",8,19,86,79,165
MATAM,KANEL,"WOURO SIDY","WOURO SIDY","H1 MADINA",3,16,72,86,158
MATAM,KANEL,"WOURO SIDY","WOURO SIDY","H2 MADIE FERLO",1,1,9,9,18
MATAM,KANEL,"WOURO SIDY","WOURO SIDY",WABINDOU,10,22,130,124,254
MATAM,KANEL,"WOURO SIDY","WOURO SIDY","H1 WINDE DJOYE",7,12,58,64,122
MATAM,KANEL,"WOURO SIDY","WOURO SIDY","H2 WINDI DIOHI (MBALKA)",18,33,143,158,301
MATAM,KANEL,"WOURO SIDY","WOURO SIDY","H3 WOURO MBOYBA",9,21,92,83,175
MATAM,KANEL,"WOURO SIDY","WOURO SIDY","H4 BODOWOL",11,18,79,80,159
MATAM,KANEL,"WOURO SIDY","WOURO SIDY","H5 OURO AMADOU LAWEL",6,17,73,62,135
MATAM,KANEL,"WOURO SIDY","WOURO SIDY","H6 WOURO DIABEL",8,12,83,60,143
MATAM,KANEL,"WOURO SIDY","WOURO SIDY","WENDOU ALY",27,46,250,233,483
MATAM,KANEL,"WOURO SIDY","WOURO SIDY","WOURO DEMBA SOW",6,10,41,28,69
MATAM,KANEL,"WOURO SIDY","WOURO SIDY","WOURO HAMADY PATHE",2,4,16,17,33
MATAM,KANEL,"WOURO SIDY","HAMADY HOUNARE",FASS,108,137,721,665,1386
MATAM,KANEL,"WOURO SIDY","HAMADY HOUNARE",MABOUBE,90,158,1053,1154,2207
MATAM,KANEL,"WOURO SIDY","HAMADY HOUNARE",GOREE,51,82,518,513,1031
MATAM,KANEL,"WOURO SIDY","HAMADY HOUNARE",HAIRE,99,137,1109,971,2080
MATAM,KANEL,"WOURO SIDY","HAMADY HOUNARE",DJINGUE,146,206,1654,1516,3170
MATAM,KANEL,"WOURO SIDY","HAMADY HOUNARE",SONINKE,107,142,1278,1494,2772
MATAM,KANEL,"WOURO SIDY","SINTHIOU BAMAMBE BANADJI",BANADJI,213,314,2795,2232,5027
MATAM,KANEL,"WOURO SIDY","SINTHIOU BAMAMBE BANADJI","FASS DIAWBE",25,37,228,233,461
MATAM,KANEL,"WOURO SIDY","SINTHIOU BAMAMBE BANADJI","NGAPOUGOU I",77,136,1189,1066,2255
MATAM,KANEL,"WOURO SIDY","SINTHIOU BAMAMBE BANADJI","NGAPOUGOU II",121,182,1492,1364,2856
MATAM,KANEL,"WOURO SIDY","SINTHIOU BAMAMBE BANADJI","NGAPOUGOU III",92,123,1007,866,1873
MATAM,KANEL,"WOURO SIDY","SINTHIOU BAMAMBE BANADJI","NIAROUWAL I",144,196,1555,1458,3013
MATAM,KANEL,"WOURO SIDY","SINTHIOU BAMAMBE BANADJI","NIAROUWAL II",88,172,1614,1359,2973
MATAM,KANEL,"WOURO SIDY","SINTHIOU BAMAMBE BANADJI","NIAROUWAL III",97,117,892,698,1590
MATAM,KANEL,ORKADIERE,ODOBERE,"CITE POSTE",105,118,870,809,1679
MATAM,KANEL,ORKADIERE,ODOBERE,"DOW KODE",85,103,664,633,1297
MATAM,KANEL,ORKADIERE,ODOBERE,"HACOUNDE WOURO",45,58,500,367,867
MATAM,KANEL,ORKADIERE,ODOBERE,HLM,76,102,822,784,1606
MATAM,KANEL,ORKADIERE,ODOBERE,NGOULOUM,49,68,485,453,938
MATAM,KANEL,ORKADIERE,ODOBERE,YENAKE,43,59,551,446,997
MATAM,"RANEROU FERLO",RANEROU,RANEROU,"BILLE FAFABE",8,9,27,40,67
MATAM,"RANEROU FERLO",RANEROU,RANEROU,"GOUREL SARA",34,72,205,182,387
MATAM,"RANEROU FERLO",RANEROU,RANEROU,NELBY,154,222,866,696,1562
MATAM,"RANEROU FERLO",RANEROU,RANEROU,RANEROU,264,370,1398,1234,2632
MATAM,"RANEROU FERLO",VELINGARA,"LOUGRE THIOLY","BADAGOR DOUNDE",24,51,207,194,401
MATAM,"RANEROU FERLO",VELINGARA,"LOUGRE THIOLY","H1 BADAGOR I",36,76,312,276,588
MATAM,"RANEROU FERLO",VELINGARA,"LOUGRE THIOLY","H2 REDINGOR",15,32,147,134,281
MATAM,"RANEROU FERLO",VELINGARA,"LOUGRE THIOLY","BADAGOR II (MBOYLOCK)",26,42,209,178,387
MATAM,"RANEROU FERLO",VELINGARA,"LOUGRE THIOLY",DAYOUTE,18,45,164,163,327
MATAM,"RANEROU FERLO",VELINGARA,"LOUGRE THIOLY","H1 BOULY DAYOUTE",14,17,91,95,186
MATAM,"RANEROU FERLO",VELINGARA,"LOUGRE THIOLY","GALLET I",17,31,97,102,199
MATAM,"RANEROU FERLO",VELINGARA,"LOUGRE THIOLY","H1 OURO THILLY",3,5,11,18,29
MATAM,"RANEROU FERLO",VELINGARA,"LOUGRE THIOLY","H2 DOULO BANDJO",5,8,17,21,38
MATAM,"RANEROU FERLO",VELINGARA,"LOUGRE THIOLY","GALLET II",15,16,50,49,99
MATAM,"RANEROU FERLO",VELINGARA,"LOUGRE THIOLY","H1 OURO NDIOBO",10,15,47,43,90
MATAM,"RANEROU FERLO",VELINGARA,"LOUGRE THIOLY","GUIRDE LATHIE",42,61,224,213,437
MATAM,"RANEROU FERLO",VELINGARA,"LOUGRE THIOLY","H3 WENDOU DIABE",14,16,71,65,136
MATAM,"RANEROU FERLO",VELINGARA,"LOUGRE THIOLY","KOSSAS DIAOBE",16,32,113,112,225
MATAM,"RANEROU FERLO",VELINGARA,"LOUGRE THIOLY","KOSSAS NAMARY",28,99,220,214,434
MATAM,"RANEROU FERLO",VELINGARA,"LOUGRE THIOLY","H1 KOSSAS MBAYNABES",9,42,57,37,94
MATAM,"RANEROU FERLO",VELINGARA,"LOUGRE THIOLY","H2 BELEL WODIERE",9,35,103,121,224
MATAM,"RANEROU FERLO",VELINGARA,"LOUGRE THIOLY","LOUGUERE THIOLY DIALLOUBE I",11,21,65,66,131
MATAM,"RANEROU FERLO",VELINGARA,"LOUGRE THIOLY","H1 THIENEL",3,9,33,29,62
MATAM,"RANEROU FERLO",VELINGARA,"LOUGRE THIOLY","H2 LOUGUERE THIOLLY DIALLOUBE II",20,36,120,122,242
MATAM,"RANEROU FERLO",VELINGARA,"LOUGRE THIOLY","LOUGUERE THIOLY FAFABES IV",4,10,24,26,50
MATAM,"RANEROU FERLO",VELINGARA,"LOUGRE THIOLY","H1 BALDJI",20,33,119,103,222
MATAM,"RANEROU FERLO",VELINGARA,"LOUGRE THIOLY","LOUGUERE THIOLY FAFABES II",11,29,273,222,495
MATAM,"RANEROU FERLO",VELINGARA,"LOUGRE THIOLY","LOUGUERE THIOLY FAFABES III",8,22,55,55,110
MATAM,"RANEROU FERLO",VELINGARA,"LOUGRE THIOLY","LOUGUERE THIOLY FAFABES I",68,86,309,279,588
MATAM,"RANEROU FERLO",VELINGARA,"LOUGRE THIOLY","H1 SADOKH THILY",11,22,80,74,154
MATAM,"RANEROU FERLO",VELINGARA,"LOUGRE THIOLY","H2 BELEL NELBY",17,35,178,152,330
MATAM,"RANEROU FERLO",VELINGARA,"LOUGRE THIOLY","H3 MOURTOGAL",3,5,13,14,27
MATAM,"RANEROU FERLO",VELINGARA,"LOUGRE THIOLY","H4 BELEL AGABE",8,9,39,33,72
MATAM,"RANEROU FERLO",VELINGARA,"LOUGRE THIOLY","H5 WEUDOU NDAMDY SILEYE",3,5,29,17,46
MATAM,"RANEROU FERLO",VELINGARA,"LOUGRE THIOLY","H6 WENDOU YOUBA",4,4,21,19,40
MATAM,"RANEROU FERLO",VELINGARA,"LOUGRE THIOLY","H7 LOUMBOL WODABE (WOURO ALLO)",6,12,42,38,80
MATAM,"RANEROU FERLO",VELINGARA,"LOUGRE THIOLY","H8 FETA BALDE",31,91,139,159,298
MATAM,"RANEROU FERLO",VELINGARA,"LOUGRE THIOLY","H9 WENDOU NDAMDY WANDE",12,34,96,51,147
MATAM,"RANEROU FERLO",VELINGARA,"LOUGRE THIOLY","H10 SENO NGOLDE",13,28,92,58,150
MATAM,"RANEROU FERLO",VELINGARA,"LOUGRE THIOLY","H11 WENDOU BOKI TOLKI",5,10,19,21,40
MATAM,"RANEROU FERLO",VELINGARA,"LOUGRE THIOLY","H12 WINDE SENO",22,61,97,94,191
MATAM,"RANEROU FERLO",VELINGARA,"LOUGRE THIOLY","H13 KAWEL WOURO DEMBAROU",6,6,28,20,48
MATAM,"RANEROU FERLO",VELINGARA,"LOUGRE THIOLY","LOUGUERE THIOLY MAURE I",13,18,52,64,116
MATAM,"RANEROU FERLO",VELINGARA,"LOUGRE THIOLY","H1 BELEL DIGOUNGUEL",3,7,21,22,43
MATAM,"RANEROU FERLO",VELINGARA,"LOUGRE THIOLY","H2 THIENEL",5,11,35,43,78
MATAM,"RANEROU FERLO",VELINGARA,"LOUGRE THIOLY","LOUGUERE THIOLY MAURE II",6,10,34,37,71
MATAM,"RANEROU FERLO",VELINGARA,"LOUGRE THIOLY","LOUMBINOL AYRANCOBE",14,22,88,93,181
MATAM,"RANEROU FERLO",VELINGARA,"LOUGRE THIOLY","LOUMINOL DIAOBE",17,56,109,77,186
MATAM,"RANEROU FERLO",VELINGARA,"LOUGRE THIOLY",MBELONE,10,16,62,63,125
MATAM,"RANEROU FERLO",VELINGARA,"LOUGRE THIOLY","NDIAYENE FAFABES (NDIAYENE SENO)",54,64,265,227,492
MATAM,"RANEROU FERLO",VELINGARA,"LOUGRE THIOLY","H1 KALOYE DJOLOF",8,11,37,41,78
MATAM,"RANEROU FERLO",VELINGARA,"LOUGRE THIOLY","H2 BOWDE BALEDJI",19,24,75,94,169
MATAM,"RANEROU FERLO",VELINGARA,"LOUGRE THIOLY","H3 DIAMFABOU",18,33,132,120,252
MATAM,"RANEROU FERLO",VELINGARA,"LOUGRE THIOLY","NDIAYENE LATHIE (NDIAYENE WOLOF)",10,17,70,81,151
MATAM,"RANEROU FERLO",VELINGARA,"LOUGRE THIOLY","SADOCK I",6,15,46,49,95
MATAM,"RANEROU FERLO",VELINGARA,"LOUGRE THIOLY","SADOCK II",4,7,46,31,77
MATAM,"RANEROU FERLO",VELINGARA,"LOUGRE THIOLY","SADOCK III",2,5,14,18,32
MATAM,"RANEROU FERLO",VELINGARA,"LOUGRE THIOLY",THIOUKOUNGAL,24,58,200,203,403
MATAM,"RANEROU FERLO",VELINGARA,"LOUGRE THIOLY","H1 TOULEL BOWDE",18,39,143,122,265
MATAM,"RANEROU FERLO",VELINGARA,"LOUGRE THIOLY","H2 BOWDAL",13,39,147,163,310
MATAM,"RANEROU FERLO",VELINGARA,"LOUGRE THIOLY","BOULOGNE SAMBA RACKY",7,11,39,43,82
MATAM,"RANEROU FERLO",VELINGARA,"LOUGRE THIOLY","BOULOGNE II",3,14,40,39,79
MATAM,"RANEROU FERLO",VELINGARA,"LOUGRE THIOLY","LOUGUERE THIOLY THIANOR",1,4,11,13,24
MATAM,"RANEROU FERLO",VELINGARA,"LOUGRE THIOLY","LOUGUERE THIOLY WOLOF",4,9,33,30,63
MATAM,"RANEROU FERLO",VELINGARA,VELINGARA,ADIA,43,80,351,338,689
MATAM,"RANEROU FERLO",VELINGARA,VELINGARA,"BELEL TOUFLE",15,29,127,100,227
MATAM,"RANEROU FERLO",VELINGARA,VELINGARA,BODEDJI,6,38,71,85,156
MATAM,"RANEROU FERLO",VELINGARA,VELINGARA,"H1 KOUKADY",6,54,95,95,190
MATAM,"RANEROU FERLO",VELINGARA,VELINGARA,"H2 NDIAM THIOLE",9,43,88,69,157
MATAM,"RANEROU FERLO",VELINGARA,VELINGARA,"H3 DIONGRE",5,21,74,63,137
MATAM,"RANEROU FERLO",VELINGARA,VELINGARA,"H4 WOURO ALADJI DEME",2,8,43,24,67
MATAM,"RANEROU FERLO",VELINGARA,VELINGARA,"H5 BODEDJI II",11,45,137,96,233
MATAM,"RANEROU FERLO",VELINGARA,VELINGARA,"BAGNANOL I",9,13,55,52,107
MATAM,"RANEROU FERLO",VELINGARA,VELINGARA,"H1 ROMNA",36,65,301,275,576
MATAM,"RANEROU FERLO",VELINGARA,VELINGARA,"BAGNANOL II",37,60,259,233,492
MATAM,"RANEROU FERLO",VELINGARA,VELINGARA,"BOKI MBONA NDIAO",24,55,228,207,435
MATAM,"RANEROU FERLO",VELINGARA,VELINGARA,"BOKI MBONA NDIENGUEL",8,18,78,52,130
MATAM,"RANEROU FERLO",VELINGARA,VELINGARA,"BOKI NDAR",14,25,115,120,235
MATAM,"RANEROU FERLO",VELINGARA,VELINGARA,"H1 ANANDOUR",6,14,65,66,131
MATAM,"RANEROU FERLO",VELINGARA,VELINGARA,"H2 ADANDOUR",10,11,37,42,79
MATAM,"RANEROU FERLO",VELINGARA,VELINGARA,"H3 KAWEL",7,12,55,51,106
MATAM,"RANEROU FERLO",VELINGARA,VELINGARA,"BOULOGNE BALI",30,66,280,234,514
MATAM,"RANEROU FERLO",VELINGARA,VELINGARA,"H1 NDINDY NDIAYE",19,25,144,112,256
MATAM,"RANEROU FERLO",VELINGARA,VELINGARA,"BOULOGNE THIEKEYE",28,46,188,159,347
MATAM,"RANEROU FERLO",VELINGARA,VELINGARA,"BOULY BOGUEL",13,29,139,134,273
MATAM,"RANEROU FERLO",VELINGARA,VELINGARA,"H1 WENDOU YORO",10,18,69,68,137
MATAM,"RANEROU FERLO",VELINGARA,VELINGARA,"H2 WINDE KELLE",5,11,65,43,108
MATAM,"RANEROU FERLO",VELINGARA,VELINGARA,"BOUNDOU MBABA BARKEDJI",16,50,223,181,404
MATAM,"RANEROU FERLO",VELINGARA,VELINGARA,"BOUNDOU MBABA MBOURLOGNE",5,16,69,75,144
MATAM,"RANEROU FERLO",VELINGARA,VELINGARA,"BOUNDOU MBABA SINTHIOU",21,85,245,249,494
MATAM,"RANEROU FERLO",VELINGARA,VELINGARA,"H1 WOURO HAMDIATOU (CROISEMENT)",1,4,9,7,16
MATAM,"RANEROU FERLO",VELINGARA,VELINGARA,"H2 NGONOR",2,15,55,63,118
MATAM,"RANEROU FERLO",VELINGARA,VELINGARA,DANTHIALY,3,5,22,25,47
MATAM,"RANEROU FERLO",VELINGARA,VELINGARA,"DAROU RAHMANE BOUNDOU MBABA",8,13,40,48,88
MATAM,"RANEROU FERLO",VELINGARA,VELINGARA,"H2 SINTHIOU DIAM WELY",1,8,24,27,51
MATAM,"RANEROU FERLO",VELINGARA,VELINGARA,"H3 MBOUNDOU MBABA SONDAGE",5,28,122,124,246
MATAM,"RANEROU FERLO",VELINGARA,VELINGARA,"H4 MEDINA NDIAYE",11,15,84,83,167
MATAM,"RANEROU FERLO",VELINGARA,VELINGARA,"DAYANE DIABY",7,19,87,61,148
MATAM,"RANEROU FERLO",VELINGARA,VELINGARA,"DAYANE GASSEL I",13,28,125,97,222
MATAM,"RANEROU FERLO",VELINGARA,VELINGARA,"DAYANE GUELODE",30,55,242,178,420
MATAM,"RANEROU FERLO",VELINGARA,VELINGARA,"DAYANE KODIELY",25,58,271,271,542
MATAM,"RANEROU FERLO",VELINGARA,VELINGARA,"DAYANE MBOURDI",11,30,122,111,233
MATAM,"RANEROU FERLO",VELINGARA,VELINGARA,"H1 TOUBA MBELA",1,4,24,12,36
MATAM,"RANEROU FERLO",VELINGARA,VELINGARA,"DAYANE SELLE",16,31,141,133,274
MATAM,"RANEROU FERLO",VELINGARA,VELINGARA,DEMEREDJI,12,23,79,88,167
MATAM,"RANEROU FERLO",VELINGARA,VELINGARA,"DIAM WELI",5,12,49,44,93
MATAM,"RANEROU FERLO",VELINGARA,VELINGARA,"VELINGARA FASS",39,43,191,181,372
MATAM,"RANEROU FERLO",VELINGARA,VELINGARA,"H1 BELEL DIABY",12,31,133,116,249
MATAM,"RANEROU FERLO",VELINGARA,VELINGARA,"H2 MODIANE OUROURBE",17,23,89,88,177
MATAM,"RANEROU FERLO",VELINGARA,VELINGARA,GAMBOL,12,20,82,61,143
MATAM,"RANEROU FERLO",VELINGARA,VELINGARA,"H1 WOURO NDELLE (BELEL KODIOLY)",6,18,82,70,152
MATAM,"RANEROU FERLO",VELINGARA,VELINGARA,"H2 SINTHIANE YARE LAO",7,14,60,48,108
MATAM,"RANEROU FERLO",VELINGARA,VELINGARA,"KHOL KHOL  I",6,10,60,39,99
MATAM,"RANEROU FERLO",VELINGARA,VELINGARA,"H1 WENDOU PATHE I",7,14,39,36,75
MATAM,"RANEROU FERLO",VELINGARA,VELINGARA,"KHOL KHOL II",15,28,147,121,268
MATAM,"RANEROU FERLO",VELINGARA,VELINGARA,"H1 LAM",9,14,44,56,100
MATAM,"RANEROU FERLO",VELINGARA,VELINGARA,KOUSSOUS,28,55,266,228,494
MATAM,"RANEROU FERLO",VELINGARA,VELINGARA,"H1 WENDOU GUELOKI",7,22,60,51,111
MATAM,"RANEROU FERLO",VELINGARA,VELINGARA,"H2 WOURO ADAMA BOGAL",4,5,24,17,41
MATAM,"RANEROU FERLO",VELINGARA,VELINGARA,"H3 WOURO PATHE",4,4,15,14,29
MATAM,"RANEROU FERLO",VELINGARA,VELINGARA,"H5 WENDOU GUELOKY",25,38,145,163,308
MATAM,"RANEROU FERLO",VELINGARA,VELINGARA,"H6 KOUSSOUS II",13,26,68,63,131
MATAM,"RANEROU FERLO",VELINGARA,VELINGARA,"LOUMBOL DAKA",12,22,65,81,146
MATAM,"RANEROU FERLO",VELINGARA,VELINGARA,"H1 DADY DIAWE",15,27,83,115,198
MATAM,"RANEROU FERLO",VELINGARA,VELINGARA,"H2 BELEL KELLY",2,2,5,12,17
MATAM,"RANEROU FERLO",VELINGARA,VELINGARA,"MBAKEDJI  ALPHA",13,21,111,99,210
MATAM,"RANEROU FERLO",VELINGARA,VELINGARA,"H1 BOULI MBAKEDJI",2,10,23,31,54
MATAM,"RANEROU FERLO",VELINGARA,VELINGARA,"MBAKEDJI SAMBA NIAKI",36,52,256,247,503
MATAM,"RANEROU FERLO",VELINGARA,VELINGARA,"H1 MADINA DAOUDA",4,7,26,24,50
MATAM,"RANEROU FERLO",VELINGARA,VELINGARA,"H2 WABINDOU",18,32,168,168,336
MATAM,"RANEROU FERLO",VELINGARA,VELINGARA,MBELOGNE,6,7,46,37,83
MATAM,"RANEROU FERLO",VELINGARA,VELINGARA,"H1 MBELONE OUROURBE",12,14,64,65,129
MATAM,"RANEROU FERLO",VELINGARA,VELINGARA,"MBEM MBEM",45,96,326,321,647
MATAM,"RANEROU FERLO",VELINGARA,VELINGARA,"H1 WENDOU GAOUDY",3,10,21,22,43
MATAM,"RANEROU FERLO",VELINGARA,VELINGARA,"H2 KOROBEL",20,35,109,109,218
MATAM,"RANEROU FERLO",VELINGARA,VELINGARA,"H3 BOUDRA",14,27,80,75,155
MATAM,"RANEROU FERLO",VELINGARA,VELINGARA,"H4 MBELONE BOULBE",1,1,2,2,4
MATAM,"RANEROU FERLO",VELINGARA,VELINGARA,"H6 OUKOUROU",1,5,22,19,41
MATAM,"RANEROU FERLO",VELINGARA,VELINGARA,"H7 OURO WENDOU BOKE",11,23,88,102,190
MATAM,"RANEROU FERLO",VELINGARA,VELINGARA,"H8 WENDOU PATHE II",7,26,56,59,115
MATAM,"RANEROU FERLO",VELINGARA,VELINGARA,"H9 KOYLE  KORAP (WOURO AMADOU SAMBA NDOUB)",5,14,27,43,70
MATAM,"RANEROU FERLO",VELINGARA,VELINGARA,"H10 KORAP",18,25,141,110,251
MATAM,"RANEROU FERLO",VELINGARA,VELINGARA,"H11 PETEL KOLY",2,4,12,7,19
MATAM,"RANEROU FERLO",VELINGARA,VELINGARA,"MBONAYE I",15,23,121,98,219
MATAM,"RANEROU FERLO",VELINGARA,VELINGARA,"MBONAYE II",12,19,74,92,166
MATAM,"RANEROU FERLO",VELINGARA,VELINGARA,"MEDINA BABABE (MISSIRAH HABOBE)",17,55,262,227,489
MATAM,"RANEROU FERLO",VELINGARA,VELINGARA,"MADINA MBEM MBEM",29,48,256,178,434
MATAM,"RANEROU FERLO",VELINGARA,VELINGARA,"H1 KAHE",8,15,80,64,144
MATAM,"RANEROU FERLO",VELINGARA,VELINGARA,"H2 DOLI KADJIE",7,8,31,41,72
MATAM,"RANEROU FERLO",VELINGARA,VELINGARA,"H3 WENDOU FOSSE",8,14,69,56,125
MATAM,"RANEROU FERLO",VELINGARA,VELINGARA,"H4 WENDOU KOBA",9,50,140,106,246
MATAM,"RANEROU FERLO",VELINGARA,VELINGARA,NDIANOYE,27,76,327,301,628
MATAM,"RANEROU FERLO",VELINGARA,VELINGARA,"H1 TOUBA FIRDAWSI",2,5,12,8,20
MATAM,"RANEROU FERLO",VELINGARA,VELINGARA,"H2 DAROU KHOUDOUS",1,7,38,24,62
MATAM,"RANEROU FERLO",VELINGARA,VELINGARA,"H3 NGUINTH BIGUEL",12,30,77,77,154
MATAM,"RANEROU FERLO",VELINGARA,VELINGARA,"H4 TOUBA DIOUFFENE (KEUR KOUMACK )",4,9,28,23,51
MATAM,"RANEROU FERLO",VELINGARA,VELINGARA,"H5 ARI HARA",4,7,17,37,54
MATAM,"RANEROU FERLO",VELINGARA,VELINGARA,"NDIOGO GOUYE",9,17,76,69,145
MATAM,"RANEROU FERLO",VELINGARA,VELINGARA,"NDIOGO NDIEGEL",17,27,146,130,276
MATAM,"RANEROU FERLO",VELINGARA,VELINGARA,"H1 DADY DIAWE BOGUE",3,7,23,20,43
MATAM,"RANEROU FERLO",VELINGARA,VELINGARA,NELBI,5,16,63,72,135
MATAM,"RANEROU FERLO",VELINGARA,VELINGARA,"H1 BELAL",4,12,16,28,44
MATAM,"RANEROU FERLO",VELINGARA,VELINGARA,"H2 WENDOU NIARGOO",4,13,27,22,49
MATAM,"RANEROU FERLO",VELINGARA,VELINGARA,"H3 WENDOU DIAMMY",6,10,49,39,88
MATAM,"RANEROU FERLO",VELINGARA,VELINGARA,NIAROUWEL,9,16,73,62,135
MATAM,"RANEROU FERLO",VELINGARA,VELINGARA,"H1 SINTHIOU OUSMANE (WOURO OUSMANE)",9,9,51,46,97
MATAM,"RANEROU FERLO",VELINGARA,VELINGARA,"H2 NDIOLOYEL",8,21,75,76,151
MATAM,"RANEROU FERLO",VELINGARA,VELINGARA,REWANE,23,31,116,111,227
MATAM,"RANEROU FERLO",VELINGARA,VELINGARA,"H1 BELLY LAMDAM",10,11,41,51,92
MATAM,"RANEROU FERLO",VELINGARA,VELINGARA,"LOUMBY PATHE DJIBEL",16,43,216,155,371
MATAM,"RANEROU FERLO",VELINGARA,VELINGARA,"H1 DAROU SALAM LOUMBY",18,30,155,120,275
MATAM,"RANEROU FERLO",VELINGARA,VELINGARA,"H2 SOUNAYEL",3,11,30,20,50
MATAM,"RANEROU FERLO",VELINGARA,VELINGARA,"H3 BELEL BONDIE",6,30,74,57,131
MATAM,"RANEROU FERLO",VELINGARA,VELINGARA,"SAB SABRE DIAM DIAM",11,11,54,43,97
MATAM,"RANEROU FERLO",VELINGARA,VELINGARA,"H1 SAB SABRE SERERE",6,9,57,44,101
MATAM,"RANEROU FERLO",VELINGARA,VELINGARA,"H2 TOUBA AFIA",17,32,88,75,163
MATAM,"RANEROU FERLO",VELINGARA,VELINGARA,SALDAW,8,14,47,57,104
MATAM,"RANEROU FERLO",VELINGARA,VELINGARA,"H1 BOLEYEL",1,1,8,6,14
MATAM,"RANEROU FERLO",VELINGARA,VELINGARA,"H2 THIANGAL MOURIDE",10,17,73,62,135
MATAM,"RANEROU FERLO",VELINGARA,VELINGARA,SESSOUM,8,29,128,125,253
MATAM,"RANEROU FERLO",VELINGARA,VELINGARA,"SESSOUM DOUBEL",26,50,261,214,475
MATAM,"RANEROU FERLO",VELINGARA,VELINGARA,"H1 TOUBA VELINGARA",15,19,131,60,191
MATAM,"RANEROU FERLO",VELINGARA,VELINGARA,SEWELDE,11,13,83,64,147
MATAM,"RANEROU FERLO",VELINGARA,VELINGARA,"BELEL TOUFLE SINTHIOU",17,31,153,139,292
MATAM,"RANEROU FERLO",VELINGARA,VELINGARA,SOUSSET,15,20,73,77,150
MATAM,"RANEROU FERLO",VELINGARA,VELINGARA,THIAFALY,11,13,46,58,104
MATAM,"RANEROU FERLO",VELINGARA,VELINGARA,"THIASKY BISNABE",10,15,63,74,137
MATAM,"RANEROU FERLO",VELINGARA,VELINGARA,"H1 BOULY THIASKY",3,5,18,15,33
MATAM,"RANEROU FERLO",VELINGARA,VELINGARA,"THIASKY DIOUANABE",5,11,33,48,81
MATAM,"RANEROU FERLO",VELINGARA,VELINGARA,THIAYANGUEL,10,17,75,68,143
MATAM,"RANEROU FERLO",VELINGARA,VELINGARA,"H1 BELEL BONDJI",1,5,23,25,48
MATAM,"RANEROU FERLO",VELINGARA,VELINGARA,"THIONOKH DIABY",29,42,217,172,389
MATAM,"RANEROU FERLO",VELINGARA,VELINGARA,"H1 BEEL BACOURE",3,9,22,25,47
MATAM,"RANEROU FERLO",VELINGARA,VELINGARA,"THIONOKH SANGHE",143,221,1115,954,2069
MATAM,"RANEROU FERLO",VELINGARA,VELINGARA,"H2 SINTHIANE BILALI",16,38,101,97,198
MATAM,"RANEROU FERLO",VELINGARA,VELINGARA,"H3 LOUMBY SAMBA",15,23,95,93,188
MATAM,"RANEROU FERLO",VELINGARA,VELINGARA,"H3 WOULIE DIE",15,38,171,144,315
MATAM,"RANEROU FERLO",VELINGARA,VELINGARA,"VELINGARA LAOBE",18,30,99,115,214
MATAM,"RANEROU FERLO",VELINGARA,VELINGARA,"VELINGARA MAURE I",85,110,464,367,831
MATAM,"RANEROU FERLO",VELINGARA,VELINGARA,"VELINGARA MAURE II",45,48,211,185,396
MATAM,"RANEROU FERLO",VELINGARA,VELINGARA,"VELINGARA NDIALAL",14,25,105,103,208
MATAM,"RANEROU FERLO",VELINGARA,VELINGARA,"H1 NENAYE DIAM",10,19,70,73,143
MATAM,"RANEROU FERLO",VELINGARA,VELINGARA,"H2 THIALLA",7,8,38,41,79
MATAM,"RANEROU FERLO",VELINGARA,VELINGARA,"H3 SEWELDE II",8,14,69,62,131
MATAM,"RANEROU FERLO",VELINGARA,VELINGARA,"VELINGARA NDIAO",17,29,102,113,215
MATAM,"RANEROU FERLO",VELINGARA,VELINGARA,"VELINGARA WOLOF I",41,48,195,129,324
MATAM,"RANEROU FERLO",VELINGARA,VELINGARA,"H1 BOKE OULI (AMADOU SAMBA DOUNGOU)",3,3,17,15,32
MATAM,"RANEROU FERLO",VELINGARA,VELINGARA,"H2 MODIANE DIAOBE",6,13,43,40,83
MATAM,"RANEROU FERLO",VELINGARA,VELINGARA,"H3 GUELEMOUNE",6,12,46,35,81
MATAM,"RANEROU FERLO",VELINGARA,VELINGARA,"VELINGARA OUROURBE",8,15,67,68,135
MATAM,"RANEROU FERLO",VELINGARA,VELINGARA,"H1 THIANGAL OUROURBE",13,18,72,75,147
MATAM,"RANEROU FERLO",VELINGARA,VELINGARA,"VELINGARA THIANOR",26,29,123,90,213
MATAM,"RANEROU FERLO",VELINGARA,VELINGARA,"WENDOU BOKI",7,11,54,34,88
MATAM,"RANEROU FERLO",VELINGARA,VELINGARA,"WENDOU ILO",13,24,90,91,181
MATAM,"RANEROU FERLO",VELINGARA,VELINGARA,"H3 WENDOU KOLE (VILANENE DJOLOF)",6,6,38,23,61
MATAM,"RANEROU FERLO",VELINGARA,VELINGARA,"WENDOU NAMARY",20,35,153,112,265
MATAM,"RANEROU FERLO",VELINGARA,VELINGARA,"WENDOU THIOMBEL",5,21,66,66,132
MATAM,"RANEROU FERLO",VELINGARA,VELINGARA,"H1 WOULIE DIE SERERE (ALDIOUMA THIAW)",7,10,44,43,87
MATAM,"RANEROU FERLO",VELINGARA,VELINGARA,"H2 KEUR MBAYE BEYE (MBEYENE)",5,6,13,18,31
MATAM,"RANEROU FERLO",VELINGARA,VELINGARA,SOROKHOUM,19,36,115,134,249
MATAM,"RANEROU FERLO",VELINGARA,VELINGARA,"H1 SORRO",7,20,96,83,179
MATAM,"RANEROU FERLO",VELINGARA,VELINGARA,BANDIAGARA,5,16,100,69,169
MATAM,"RANEROU FERLO",VELINGARA,VELINGARA,"BELLY POUNEDJI",7,11,67,56,123
MATAM,"RANEROU FERLO",VELINGARA,VELINGARA,BINGUEL,4,28,132,112,244
MATAM,"RANEROU FERLO",VELINGARA,VELINGARA,"BINGUEL DIALLOUBE",5,5,23,19,42
MATAM,"RANEROU FERLO",VELINGARA,VELINGARA,"BOKY THIAYGUAL",7,20,65,58,123
MATAM,"RANEROU FERLO",VELINGARA,VELINGARA,"BOULY REWANE",14,17,81,72,153
MATAM,"RANEROU FERLO",VELINGARA,VELINGARA,"DAROU MINAM",7,20,101,106,207
MATAM,"RANEROU FERLO",VELINGARA,VELINGARA,"DAROU SALAM",4,19,30,49,79
MATAM,"RANEROU FERLO",VELINGARA,VELINGARA,"DAYANE GASSEL II",20,52,203,179,382
MATAM,"RANEROU FERLO",VELINGARA,VELINGARA,DIAMEL,3,6,16,17,33
MATAM,"RANEROU FERLO",VELINGARA,VELINGARA,DIOBORONE,6,18,73,75,148
MATAM,"RANEROU FERLO",VELINGARA,VELINGARA,KAHONE,22,43,186,146,332
MATAM,"RANEROU FERLO",VELINGARA,VELINGARA,"LOUMBI DIABY",6,21,74,65,139
MATAM,"RANEROU FERLO",VELINGARA,VELINGARA,"LOUMBOL WODABE",6,30,121,118,239
MATAM,"RANEROU FERLO",VELINGARA,VELINGARA,"NALEL MAMADOU DIEYNI",5,7,29,23,52
MATAM,"RANEROU FERLO",VELINGARA,VELINGARA,"NGOLDE OUROULBE",2,11,42,63,105
MATAM,"RANEROU FERLO",VELINGARA,VELINGARA,"SINTHIOU WODABE",5,24,113,98,211
MATAM,"RANEROU FERLO",VELINGARA,VELINGARA,"TOUBA BOKI MBONA",16,17,94,71,165
MATAM,"RANEROU FERLO",VELINGARA,VELINGARA,"TOUBA NDAWENE",4,11,40,21,61
MATAM,"RANEROU FERLO",VELINGARA,VELINGARA,"VELINGARA WOLOF II",20,22,116,116,232
MATAM,"RANEROU FERLO",VELINGARA,VELINGARA,WOPPA,21,51,168,122,290
MATAM,"RANEROU FERLO",VELINGARA,VELINGARA,"H1 BOKY DIOULKY",8,12,48,49,97
MATAM,"RANEROU FERLO",VELINGARA,OUDALAYE,"ALPHA OUMAR NDONGO",21,36,197,206,403
MATAM,"RANEROU FERLO",VELINGARA,OUDALAYE,"H1 FETE NIARWAL",10,22,125,101,226
MATAM,"RANEROU FERLO",VELINGARA,OUDALAYE,"H2 GOUREL KALIDOU SAMBA",1,3,14,12,26
MATAM,"RANEROU FERLO",VELINGARA,OUDALAYE,"H3 GOUREL ADAMA DIALLO",1,2,8,11,19
MATAM,"RANEROU FERLO",VELINGARA,OUDALAYE,"H4 NASROULAH",10,17,77,97,174
MATAM,"RANEROU FERLO",VELINGARA,OUDALAYE,"H5 GOUREL BAIDY YAYA",9,17,82,91,173
MATAM,"RANEROU FERLO",VELINGARA,OUDALAYE,"H6 GOUREL EL HADJI GUEYE NDIAYE",6,10,41,42,83
MATAM,"RANEROU FERLO",VELINGARA,OUDALAYE,"H7 OURO CIRE NDIAYE",10,11,56,39,95
MATAM,"RANEROU FERLO",VELINGARA,OUDALAYE,BOGHAL,2,2,26,32,58
MATAM,"RANEROU FERLO",VELINGARA,OUDALAYE,"BOULA TALLY",22,25,119,99,218
MATAM,"RANEROU FERLO",VELINGARA,OUDALAYE,"H1 WOURO SAMBA BIEDJI BA",3,3,17,16,33
MATAM,"RANEROU FERLO",VELINGARA,OUDALAYE,"BOULOGNE SENO",39,66,283,249,532
MATAM,"RANEROU FERLO",VELINGARA,OUDALAYE,"H1 WOURO TERY BA",2,5,21,31,52
MATAM,"RANEROU FERLO",VELINGARA,OUDALAYE,"H2 WOURO SAMBA MOUSSA BA",7,12,43,42,85
MATAM,"RANEROU FERLO",VELINGARA,OUDALAYE,"H3 ASSERE KODIEL",13,16,71,76,147
MATAM,"RANEROU FERLO",VELINGARA,OUDALAYE,"H4 BELLY LAOBE",11,17,69,62,131
MATAM,"RANEROU FERLO",VELINGARA,OUDALAYE,"H5 BARKATOU WOURO SAMBA SEMOU",16,21,110,100,210
MATAM,"RANEROU FERLO",VELINGARA,OUDALAYE,"H6 THIALOTE",9,13,61,53,114
MATAM,"RANEROU FERLO",VELINGARA,OUDALAYE,"H1 WOURO ALADJI THILEL",2,8,25,28,53
MATAM,"RANEROU FERLO",VELINGARA,OUDALAYE,BOUTOUDJI,17,39,189,192,381
MATAM,"RANEROU FERLO",VELINGARA,OUDALAYE,"H1 OURO MAMADOU HANNE",2,3,17,19,36
MATAM,"RANEROU FERLO",VELINGARA,OUDALAYE,"H2 NIAROUWEL",6,8,36,27,63
MATAM,"RANEROU FERLO",VELINGARA,OUDALAYE,"H3 WOURO BATHIOROU",4,4,27,20,47
MATAM,"RANEROU FERLO",VELINGARA,OUDALAYE,"H4 BARDIAL",4,13,55,48,103
MATAM,"RANEROU FERLO",VELINGARA,OUDALAYE,"H5 WOURO FALL",5,10,40,48,88
MATAM,"RANEROU FERLO",VELINGARA,OUDALAYE,"H6 DEMBA SINTHIOU (WOURO MOLO)",4,8,34,41,75
MATAM,"RANEROU FERLO",VELINGARA,OUDALAYE,"H7 OURO MAMA DOUHA",6,12,62,53,115
MATAM,"RANEROU FERLO",VELINGARA,OUDALAYE,"H8 WOURO THIEDOWO",3,7,24,27,51
MATAM,"RANEROU FERLO",VELINGARA,OUDALAYE,"H9 WOURO KALIDOU BAYAL",7,15,53,57,110
MATAM,"RANEROU FERLO",VELINGARA,OUDALAYE,"CIVIABE OCCIDENTAL",20,32,117,107,224
MATAM,"RANEROU FERLO",VELINGARA,OUDALAYE,"H1 FOUYNDOU",3,5,26,14,40
MATAM,"RANEROU FERLO",VELINGARA,OUDALAYE,"CIVIABE ORIENTAL (SALALATOU)",68,149,638,739,1377
MATAM,"RANEROU FERLO",VELINGARA,OUDALAYE,"H1 WENDOU GUELOKI (WOURO THIERNO BINTA)",1,6,21,15,36
MATAM,"RANEROU FERLO",VELINGARA,OUDALAYE,"H2 TOUBE SEGA",6,9,50,50,100
MATAM,"RANEROU FERLO",VELINGARA,OUDALAYE,"H3 WOURO SABERE",6,11,45,53,98
MATAM,"RANEROU FERLO",VELINGARA,OUDALAYE,"H4 WOURO ABOU DEMBA KOYLI",2,2,14,9,23
MATAM,"RANEROU FERLO",VELINGARA,OUDALAYE,"H5 WOURO ABLAYE  DEMBA DALA",1,1,10,10,20
MATAM,"RANEROU FERLO",VELINGARA,OUDALAYE,"H6 WOURO ABOU BELOU",1,1,14,9,23
MATAM,"RANEROU FERLO",VELINGARA,OUDALAYE,"H7 WOURO DJIBABOU",2,5,21,18,39
MATAM,"RANEROU FERLO",VELINGARA,OUDALAYE,"H8 WOURO DJIBY TALL",1,7,18,22,40
MATAM,"RANEROU FERLO",VELINGARA,OUDALAYE,"H9 BELEL KEDE",1,1,3,12,15
MATAM,"RANEROU FERLO",VELINGARA,OUDALAYE,"H10 BELEL KEDE",20,28,155,159,314
MATAM,"RANEROU FERLO",VELINGARA,OUDALAYE,"H11 WOURO THIBY",3,7,33,32,65
MATAM,"RANEROU FERLO",VELINGARA,OUDALAYE,"H12 WOURO SAMBA MALAL",5,8,49,54,103
MATAM,"RANEROU FERLO",VELINGARA,OUDALAYE,"H13 WOURO ABDOULAYE ALASSANE",1,2,11,15,26
MATAM,"RANEROU FERLO",VELINGARA,OUDALAYE,"H14 WOURO MALICK",2,2,12,9,21
MATAM,"RANEROU FERLO",VELINGARA,OUDALAYE,"H15 WOURO ABASS SOW",3,8,23,30,53
MATAM,"RANEROU FERLO",VELINGARA,OUDALAYE,"H16 WOURO SAMBA GUIDIEL",3,4,14,20,34
MATAM,"RANEROU FERLO",VELINGARA,OUDALAYE,"H17 WOURO YALALBE",9,12,57,47,104
MATAM,"RANEROU FERLO",VELINGARA,OUDALAYE,"H18 WOURO YERO DIARGA (FAFABE)",7,12,50,37,87
MATAM,"RANEROU FERLO",VELINGARA,OUDALAYE,"H19 BELEL SILINGAWI",9,17,74,77,151
MATAM,"RANEROU FERLO",VELINGARA,OUDALAYE,"H20 DIABI MARK",14,16,77,80,157
MATAM,"RANEROU FERLO",VELINGARA,OUDALAYE,"H21 NALDOU BOGUEL",1,1,5,4,9
MATAM,"RANEROU FERLO",VELINGARA,OUDALAYE,"H22 MADINA SALAMATOUL",7,9,45,35,80
MATAM,"RANEROU FERLO",VELINGARA,OUDALAYE,"H23 WOURO MISSIRAH (AMADOU SILEYE)",3,3,28,25,53
MATAM,"RANEROU FERLO",VELINGARA,OUDALAYE,"H24 WOURO MAMADOU THILEL",1,5,23,11,34
MATAM,"RANEROU FERLO",VELINGARA,OUDALAYE,"DAROU SALAM",21,35,139,125,264
MATAM,"RANEROU FERLO",VELINGARA,OUDALAYE,"H1 PETEL de DAROU SALAM",12,25,79,55,134
MATAM,"RANEROU FERLO",VELINGARA,OUDALAYE,"DAROU NEMA I",2,4,11,7,18
MATAM,"RANEROU FERLO",VELINGARA,OUDALAYE,"H5 SENO TOKOSSEL",6,6,26,18,44
MATAM,"RANEROU FERLO",VELINGARA,OUDALAYE,"H6 SENO LOMBO",9,25,47,8,55
MATAM,"RANEROU FERLO",VELINGARA,OUDALAYE,"DOUBY DORO",31,37,179,172,351
MATAM,"RANEROU FERLO",VELINGARA,OUDALAYE,"H1 OURO MAMADOU HAMA",1,6,33,42,75
MATAM,"RANEROU FERLO",VELINGARA,OUDALAYE,"H2 OURO MAMADOU",36,74,333,345,678
MATAM,"RANEROU FERLO",VELINGARA,OUDALAYE,"H3 OURO CHERIF",9,15,50,51,101
MATAM,"RANEROU FERLO",VELINGARA,OUDALAYE,"H4 OURO BOYE",4,8,41,40,81
MATAM,"RANEROU FERLO",VELINGARA,OUDALAYE,"H5 WOURO SAMBOGUEL",5,13,58,61,119
MATAM,"RANEROU FERLO",VELINGARA,OUDALAYE,"H6 WOURO DIAGA",1,4,12,15,27
MATAM,"RANEROU FERLO",VELINGARA,OUDALAYE,"H7 WOURO KALIDOU DEMBA GNABA",1,2,8,9,17
MATAM,"RANEROU FERLO",VELINGARA,OUDALAYE,"H8 WOURO ADAMA DIALLO",1,5,17,10,27
MATAM,"RANEROU FERLO",VELINGARA,OUDALAYE,"H9 WENDOU SEMBANO",6,17,56,38,94
MATAM,"RANEROU FERLO",VELINGARA,OUDALAYE,"H10 WOURO LALODJI",11,20,71,79,150
MATAM,"RANEROU FERLO",VELINGARA,OUDALAYE,DOUNOUBEL,26,81,334,387,721
MATAM,"RANEROU FERLO",VELINGARA,OUDALAYE,"H1 PETHIEL",47,100,372,396,768
MATAM,"RANEROU FERLO",VELINGARA,OUDALAYE,"H2 PETHIEL TOUFERE",59,73,261,276,537
MATAM,"RANEROU FERLO",VELINGARA,OUDALAYE,"H3 BOULELE",12,14,81,70,151
MATAM,"RANEROU FERLO",VELINGARA,OUDALAYE,"H4 WEINDOU FOUYNDOU",4,6,27,27,54
MATAM,"RANEROU FERLO",VELINGARA,OUDALAYE,"H5 WOURO MAMADOU YERO",1,5,32,34,66
MATAM,"RANEROU FERLO",VELINGARA,OUDALAYE,"H6 WOURO DEMBA IDY BA",2,3,16,23,39
MATAM,"RANEROU FERLO",VELINGARA,OUDALAYE,"H7 WOURO BINGUEL",4,7,18,25,43
MATAM,"RANEROU FERLO",VELINGARA,OUDALAYE,"H8 WOURO FORY",2,4,29,13,42
MATAM,"RANEROU FERLO",VELINGARA,OUDALAYE,"FASS FERLO",33,42,165,196,361
MATAM,"RANEROU FERLO",VELINGARA,OUDALAYE,"H1 HAIRE NGODIOU",25,52,198,220,418
MATAM,"RANEROU FERLO",VELINGARA,OUDALAYE,"H2 DIABY CIRE",4,4,22,18,40
MATAM,"RANEROU FERLO",VELINGARA,OUDALAYE,"H3 KAWEL",8,16,51,48,99
MATAM,"RANEROU FERLO",VELINGARA,OUDALAYE,"FOURDOU MBAILA",52,79,270,253,523
MATAM,"RANEROU FERLO",VELINGARA,OUDALAYE,"H1 GOUREL DEMBA ASSETOU BA",9,11,43,41,84
MATAM,"RANEROU FERLO",VELINGARA,OUDALAYE,"H2 YAWARA",16,21,103,71,174
MATAM,"RANEROU FERLO",VELINGARA,OUDALAYE,"H3 NDAMARAME SAMBA MODY",44,138,250,254,504
MATAM,"RANEROU FERLO",VELINGARA,OUDALAYE,"GASSE DORO",16,28,135,115,250
MATAM,"RANEROU FERLO",VELINGARA,OUDALAYE,"GASSE DIABE",43,60,302,264,566
MATAM,"RANEROU FERLO",VELINGARA,OUDALAYE,"H1 WENDOU MAOUNDOU",17,25,105,115,220
MATAM,"RANEROU FERLO",VELINGARA,OUDALAYE,"H2 WENDOU DIABE",15,24,98,107,205
MATAM,"RANEROU FERLO",VELINGARA,OUDALAYE,"GASSE SAFALBES",22,33,142,139,281
MATAM,"RANEROU FERLO",VELINGARA,OUDALAYE,GASSEL,6,10,38,33,71
MATAM,"RANEROU FERLO",VELINGARA,OUDALAYE,"H1 PETEL de GASSEL",8,10,34,35,69
MATAM,"RANEROU FERLO",VELINGARA,OUDALAYE,"GOUREL FADOUBES",11,22,107,110,217
MATAM,"RANEROU FERLO",VELINGARA,OUDALAYE,HODIOLDOU,16,35,168,164,332
MATAM,"RANEROU FERLO",VELINGARA,OUDALAYE,"H2 BOGAL (BOKI MBARODI)",2,5,18,11,29
MATAM,"RANEROU FERLO",VELINGARA,OUDALAYE,OUDALAYE,162,259,1430,1349,2779
MATAM,"RANEROU FERLO",VELINGARA,OUDALAYE,"H1 OURO MAMADOU TORODO",13,16,90,64,154
MATAM,"RANEROU FERLO",VELINGARA,OUDALAYE,"H6 KOLI",8,12,98,70,168
MATAM,"RANEROU FERLO",VELINGARA,OUDALAYE,"H7 OURO AMADOU ISMA",4,7,35,37,72
MATAM,"RANEROU FERLO",VELINGARA,OUDALAYE,"H8 OURO DOULO BA",2,3,13,12,25
MATAM,"RANEROU FERLO",VELINGARA,OUDALAYE,"H9 OURO KALIDOU HOULEYE",2,2,26,29,55
MATAM,"RANEROU FERLO",VELINGARA,OUDALAYE,"H10 HANT",1,1,6,5,11
MATAM,"RANEROU FERLO",VELINGARA,OUDALAYE,"H17 HAMDALLAH",8,13,73,60,133
MATAM,"RANEROU FERLO",VELINGARA,OUDALAYE,"H18 OURO MAMADOU YEREL BA",7,11,60,50,110
MATAM,"RANEROU FERLO",VELINGARA,OUDALAYE,"H19 WOURO MOUHADJI (BOGAL HETHIO)",3,8,40,31,71
MATAM,"RANEROU FERLO",VELINGARA,OUDALAYE,KACK,16,25,94,56,150
MATAM,"RANEROU FERLO",VELINGARA,OUDALAYE,"H1 GOUREL OUMAR SAMBA FARY",3,3,18,18,36
MATAM,"RANEROU FERLO",VELINGARA,OUDALAYE,"H2 BOULI DEPE",3,3,12,11,23
MATAM,"RANEROU FERLO",VELINGARA,OUDALAYE,"H3 BELI DOULO",13,15,72,88,160
MATAM,"RANEROU FERLO",VELINGARA,OUDALAYE,"KORE KABY",22,33,152,126,278
MATAM,"RANEROU FERLO",VELINGARA,OUDALAYE,"H1 WENDOU SALLA",13,25,114,108,222
MATAM,"RANEROU FERLO",VELINGARA,OUDALAYE,"H2 NDOULO DIALLO",15,27,127,144,271
MATAM,"RANEROU FERLO",VELINGARA,OUDALAYE,"H4 NALELE NDOGNOU",13,15,86,96,182
MATAM,"RANEROU FERLO",VELINGARA,OUDALAYE,"H8 WOURO SALIF DIESSOROU",2,3,15,10,25
MATAM,"RANEROU FERLO",VELINGARA,OUDALAYE,"H9 FETE DJINKE (WOURO HABIBOU)",2,3,12,6,18
MATAM,"RANEROU FERLO",VELINGARA,OUDALAYE,"KOUROU KARANE",40,89,485,386,871
MATAM,"RANEROU FERLO",VELINGARA,OUDALAYE,"H1 SILIWOL I",6,8,43,37,80
MATAM,"RANEROU FERLO",VELINGARA,OUDALAYE,"H2 SILIWOL II",8,18,73,60,133
MATAM,"RANEROU FERLO",VELINGARA,OUDALAYE,"H3 OURO MAMADOU MANSALY BA",3,9,23,39,62
MATAM,"RANEROU FERLO",VELINGARA,OUDALAYE,"H4 WOURO MOLY",5,14,82,72,154
MATAM,"RANEROU FERLO",VELINGARA,OUDALAYE,"H5 BOKILODJI",6,13,58,51,109
MATAM,"RANEROU FERLO",VELINGARA,OUDALAYE,"H6 WOURO MAMADOU DEMBA BOLY",2,3,17,14,31
MATAM,"RANEROU FERLO",VELINGARA,OUDALAYE,"H7 WOURO ABDOULAYE MOUSSA",2,5,12,14,26
MATAM,"RANEROU FERLO",VELINGARA,OUDALAYE,"H8 WOURO WENDOU KOBA",1,3,14,17,31
MATAM,"RANEROU FERLO",VELINGARA,OUDALAYE,"LOUGUE THIECOUDJI",26,57,244,218,462
MATAM,"RANEROU FERLO",VELINGARA,OUDALAYE,"H1 GOUREL MOUCTAR",11,21,93,78,171
MATAM,"RANEROU FERLO",VELINGARA,OUDALAYE,"H2 BINGUEL",7,11,65,45,110
MATAM,"RANEROU FERLO",VELINGARA,OUDALAYE,"H3 NALELE MAMADOU DIENI",3,11,60,61,121
MATAM,"RANEROU FERLO",VELINGARA,OUDALAYE,"H4 WOURO YERO KORKA",8,14,60,61,121
MATAM,"RANEROU FERLO",VELINGARA,OUDALAYE,"H5 GOUREL SAMBA DEMBA",11,21,94,90,184
MATAM,"RANEROU FERLO",VELINGARA,OUDALAYE,"H6 BELY POUNEDJI",1,5,14,20,34
MATAM,"RANEROU FERLO",VELINGARA,OUDALAYE,"LOUMBOUL SAMBA ABDOUL",60,90,417,467,884
MATAM,"RANEROU FERLO",VELINGARA,OUDALAYE,"H1 WENDOU THIATNGOL (WOURO BIRAME)",9,16,47,25,72
MATAM,"RANEROU FERLO",VELINGARA,OUDALAYE,"H2 HONTINIRGO",7,12,51,43,94
MATAM,"RANEROU FERLO",VELINGARA,OUDALAYE,"LOUMBY NIALBY",16,38,193,161,354
MATAM,"RANEROU FERLO",VELINGARA,OUDALAYE,"H SOUNATOU",11,19,106,85,191
MATAM,"RANEROU FERLO",VELINGARA,OUDALAYE,"H2 WOURO PATHE",3,7,46,29,75
MATAM,"RANEROU FERLO",VELINGARA,OUDALAYE,"H3 LOUMBATOU",3,6,20,24,44
MATAM,"RANEROU FERLO",VELINGARA,OUDALAYE,"H4 GOUREL MAMADOU SOW",17,29,139,145,284
MATAM,"RANEROU FERLO",VELINGARA,OUDALAYE,"H5 DAYIFOU NDEYBATOU",19,34,144,153,297
MATAM,"RANEROU FERLO",VELINGARA,OUDALAYE,"H6 MADINA SABAKH",13,14,78,67,145
MATAM,"RANEROU FERLO",VELINGARA,OUDALAYE,"MADINA FERLO",7,14,64,48,112
MATAM,"RANEROU FERLO",VELINGARA,OUDALAYE,MBAME,21,37,167,180,347
MATAM,"RANEROU FERLO",VELINGARA,OUDALAYE,"H1 MBAME THIAYDE",10,14,61,61,122
MATAM,"RANEROU FERLO",VELINGARA,OUDALAYE,"H2 BITELE",11,18,102,107,209
MATAM,"RANEROU FERLO",VELINGARA,OUDALAYE,"H3 GASSAKOLE(WOURO BATHIEL)",4,6,25,24,49
MATAM,"RANEROU FERLO",VELINGARA,OUDALAYE,"H4 OUSMANEL (DIOLY)",5,5,28,22,50
MATAM,"RANEROU FERLO",VELINGARA,OUDALAYE,"H5 DENDOUDI DOW",37,63,229,193,422
MATAM,"RANEROU FERLO",VELINGARA,OUDALAYE,"H6 SINTHIOU BAIDY",9,13,119,110,229
MATAM,"RANEROU FERLO",VELINGARA,OUDALAYE,"H7 BOKI NGATAM",12,28,122,90,212
MATAM,"RANEROU FERLO",VELINGARA,OUDALAYE,"H8 PETONE",13,31,130,124,254
MATAM,"RANEROU FERLO",VELINGARA,OUDALAYE,"H9 TOUBE MAMADOU MIGNEL",12,14,98,98,196
MATAM,"RANEROU FERLO",VELINGARA,OUDALAYE,"H10 GASSOBEL YAYA",3,10,65,63,128
MATAM,"RANEROU FERLO",VELINGARA,OUDALAYE,"H11 FETE BOUBOU (WOURO GUEDA)",3,3,17,13,30
MATAM,"RANEROU FERLO",VELINGARA,OUDALAYE,"H12 TOUBE SAMBA HODIO",6,19,81,85,166
MATAM,"RANEROU FERLO",VELINGARA,OUDALAYE,"H13 TOUBE DIAW",3,4,15,20,35
MATAM,"RANEROU FERLO",VELINGARA,OUDALAYE,"H14 OURO AMADOU DIADOROU",15,19,63,78,141
MATAM,"RANEROU FERLO",VELINGARA,OUDALAYE,"H15 BELI THIENGUI",22,40,175,175,350
MATAM,"RANEROU FERLO",VELINGARA,OUDALAYE,"H16 MBILONE",17,24,70,71,141
MATAM,"RANEROU FERLO",VELINGARA,OUDALAYE,"H17 GALLE TOURADO",4,7,45,34,79
MATAM,"RANEROU FERLO",VELINGARA,OUDALAYE,"H18 GASSOBEL AMADOU YARAL",8,8,39,39,78
MATAM,"RANEROU FERLO",VELINGARA,OUDALAYE,"H19 GASSOBEL SAMBA LELDO",12,26,103,94,197
MATAM,"RANEROU FERLO",VELINGARA,OUDALAYE,"H20 BOULY DIABY",11,21,70,66,136
MATAM,"RANEROU FERLO",VELINGARA,OUDALAYE,"H21 MBAM POURAL",10,13,55,58,113
MATAM,"RANEROU FERLO",VELINGARA,OUDALAYE,"H22 TOUBE OUSMANE DEMBA",1,1,6,13,19
MATAM,"RANEROU FERLO",VELINGARA,OUDALAYE,"H23 TOUBA OUROURBE (WOURO MAMADOU DAKA)",3,3,12,9,21
MATAM,"RANEROU FERLO",VELINGARA,OUDALAYE,"H24 TOUBE AMADOU OUMAREL",12,14,80,79,159
MATAM,"RANEROU FERLO",VELINGARA,OUDALAYE,"H25 TOUBE YERO DEWEL",5,7,36,31,67
MATAM,"RANEROU FERLO",VELINGARA,OUDALAYE,"H26 MADIANDOU",22,36,171,157,328
MATAM,"RANEROU FERLO",VELINGARA,OUDALAYE,"H27 TOUBE BELEL KOYLE",6,6,37,28,65
MATAM,"RANEROU FERLO",VELINGARA,OUDALAYE,"MBOUL BOKI",30,43,170,149,319
MATAM,"RANEROU FERLO",VELINGARA,OUDALAYE,"H1 MBOUL BADY",4,5,17,26,43
MATAM,"RANEROU FERLO",VELINGARA,OUDALAYE,"H2 WENDOU ALIOU",6,9,27,31,58
MATAM,"RANEROU FERLO",VELINGARA,OUDALAYE,"H3 WOURO BASSAROU",5,14,71,60,131
MATAM,"RANEROU FERLO",VELINGARA,OUDALAYE,"H4 WENDOU NAYI",7,9,33,39,72
MATAM,"RANEROU FERLO",VELINGARA,OUDALAYE,"H5 LOUMBOL YALALBE (WOURO MAMADOU ABDOURAHMANE LY)",2,2,14,21,35
MATAM,"RANEROU FERLO",VELINGARA,OUDALAYE,"H6 BELEL KOYLI",2,2,18,25,43
MATAM,"RANEROU FERLO",VELINGARA,OUDALAYE,"MBOUL GAOUDY",35,57,229,196,425
MATAM,"RANEROU FERLO",VELINGARA,OUDALAYE,"H1 BELWELKI HAÏRANKOBE",15,20,79,80,159
MATAM,"RANEROU FERLO",VELINGARA,OUDALAYE,"H2 BELWELKI MAMADOU HAROUNA",4,10,54,33,87
MATAM,"RANEROU FERLO",VELINGARA,OUDALAYE,"H3 KAWEL SOWONABE",6,7,28,29,57
MATAM,"RANEROU FERLO",VELINGARA,OUDALAYE,"H4 BELEL NELBY",4,4,20,26,46
MATAM,"RANEROU FERLO",VELINGARA,OUDALAYE,"H5 KAWEL (WOURO DEMBEL)",6,6,23,24,47
MATAM,"RANEROU FERLO",VELINGARA,OUDALAYE,"H6 WOURO NDOUROUNABE",10,10,50,42,92
MATAM,"RANEROU FERLO",VELINGARA,OUDALAYE,"MODY KELLOL",16,31,134,133,267
MATAM,"RANEROU FERLO",VELINGARA,OUDALAYE,"H1 DAROU RAHMANE",12,21,86,78,164
MATAM,"RANEROU FERLO",VELINGARA,OUDALAYE,"H2 GOUREL SAMBA THILLEL",7,13,67,72,139
MATAM,"RANEROU FERLO",VELINGARA,OUDALAYE,"NAKARA GENTOU BOKI",33,52,231,209,440
MATAM,"RANEROU FERLO",VELINGARA,OUDALAYE,"H3 GOUREL DEMBA LAO",2,3,6,10,16
MATAM,"RANEROU FERLO",VELINGARA,OUDALAYE,"NAOURE I (MOUNKI)",19,31,162,118,280
MATAM,"RANEROU FERLO",VELINGARA,OUDALAYE,"H1 GOUREL ALIOU MALAL DIALLO",3,5,15,15,30
MATAM,"RANEROU FERLO",VELINGARA,OUDALAYE,"H2 GOUREL THIELEL BA",3,6,29,23,52
MATAM,"RANEROU FERLO",VELINGARA,OUDALAYE,"NAWRE CENTRAL",28,37,122,113,235
MATAM,"RANEROU FERLO",VELINGARA,OUDALAYE,"H1 BELI SENO ARDO",16,23,115,80,195
MATAM,"RANEROU FERLO",VELINGARA,OUDALAYE,"H2 BOWDEL",5,7,28,40,68
MATAM,"RANEROU FERLO",VELINGARA,OUDALAYE,"H3 BELI SANGHRE",27,43,149,145,294
MATAM,"RANEROU FERLO",VELINGARA,OUDALAYE,"H4 BELI SENO BOBORAL",21,50,189,190,379
MATAM,"RANEROU FERLO",VELINGARA,OUDALAYE,NDAYARA,31,64,281,283,564
MATAM,"RANEROU FERLO",VELINGARA,OUDALAYE,"H1 BELEL NDENDY",15,23,105,96,201
MATAM,"RANEROU FERLO",VELINGARA,OUDALAYE,NDOULACKY,32,59,243,213,456
MATAM,"RANEROU FERLO",VELINGARA,OUDALAYE,"H1 ASRE GUEDA BOCAR SOW",6,8,78,77,155
MATAM,"RANEROU FERLO",VELINGARA,OUDALAYE,"H2 GOUREL GUEDA",21,29,105,104,209
MATAM,"RANEROU FERLO",VELINGARA,OUDALAYE,"NGALA NDAO",19,37,158,140,298
MATAM,"RANEROU FERLO",VELINGARA,OUDALAYE,"H1 BELI THIOYI",12,23,116,97,213
MATAM,"RANEROU FERLO",VELINGARA,OUDALAYE,"H2 WENDOU BOKI",21,58,225,188,413
MATAM,"RANEROU FERLO",VELINGARA,OUDALAYE,"H3 KODIOLELE",42,86,355,324,679
MATAM,"RANEROU FERLO",VELINGARA,OUDALAYE,"OURO ALY",4,15,83,91,174
MATAM,"RANEROU FERLO",VELINGARA,OUDALAYE,"H1 YAMBAR",3,4,14,15,29
MATAM,"RANEROU FERLO",VELINGARA,OUDALAYE,"H2 MADIANDOU (GOUREL HAMMA DA)",2,2,9,9,18
MATAM,"RANEROU FERLO",VELINGARA,OUDALAYE,"H3 WOURO DEMBA MARY",3,7,46,39,85
MATAM,"RANEROU FERLO",VELINGARA,OUDALAYE,"WOURO BOULY",21,59,129,101,230
MATAM,"RANEROU FERLO",VELINGARA,OUDALAYE,"H1 WOURO BODIEL",11,50,105,100,205
MATAM,"RANEROU FERLO",VELINGARA,OUDALAYE,"PATOUKI OCCIDENTALE (PATOUKI)",38,49,269,214,483
MATAM,"RANEROU FERLO",VELINGARA,OUDALAYE,"H1 KEUR SAICKOU DIALLO",16,34,173,144,317
MATAM,"RANEROU FERLO",VELINGARA,OUDALAYE,"H2 FETE SANGNOU",1,10,40,47,87
MATAM,"RANEROU FERLO",VELINGARA,OUDALAYE,"H3 GOUREL YORO NDOUDY SOW",17,31,183,138,321
MATAM,"RANEROU FERLO",VELINGARA,OUDALAYE,"H5 DENDOUDY ANCIEN",1,2,10,9,19
MATAM,"RANEROU FERLO",VELINGARA,OUDALAYE,"SAMBA DOGUEL",46,83,392,375,767
MATAM,"RANEROU FERLO",VELINGARA,OUDALAYE,"SINTHIOU NAOURE",21,36,173,141,314
MATAM,"RANEROU FERLO",VELINGARA,OUDALAYE,"H1 ALANA",9,27,122,74,196
MATAM,"RANEROU FERLO",VELINGARA,OUDALAYE,SODORE,13,22,104,99,203
MATAM,"RANEROU FERLO",VELINGARA,OUDALAYE,"H1 BELI THIOYI (SODOR)",6,13,54,55,109
MATAM,"RANEROU FERLO",VELINGARA,OUDALAYE,SORINGHO,17,25,135,106,241
MATAM,"RANEROU FERLO",VELINGARA,OUDALAYE,"H2 OURO DICOUROU",15,27,80,94,174
MATAM,"RANEROU FERLO",VELINGARA,OUDALAYE,"H3 CARRIÈRE GAWDY (WOUROU IDY DOULAL)",10,17,95,73,168
MATAM,"RANEROU FERLO",VELINGARA,OUDALAYE,"H4 FETO",19,27,134,122,256
MATAM,"RANEROU FERLO",VELINGARA,OUDALAYE,"H5 WOURO MORO",4,8,27,28,55
MATAM,"RANEROU FERLO",VELINGARA,OUDALAYE,TEKINGUEL,15,41,179,145,324
MATAM,"RANEROU FERLO",VELINGARA,OUDALAYE,"H1 GOUREL DORO",33,52,322,256,578
MATAM,"RANEROU FERLO",VELINGARA,OUDALAYE,"H2 OURO SICK BA",10,10,49,54,103
MATAM,"RANEROU FERLO",VELINGARA,OUDALAYE,"TOURE DIAOBES",41,66,257,256,513
MATAM,"RANEROU FERLO",VELINGARA,OUDALAYE,"H1 KODE DIARRA",13,39,183,154,337
MATAM,"RANEROU FERLO",VELINGARA,OUDALAYE,"WENDOU  GUESSA LOMBEL",3,4,26,22,48
MATAM,"RANEROU FERLO",VELINGARA,OUDALAYE,"H1 DIALENDENDI (GOUREL GOUYA DIALLO)",12,20,73,88,161
MATAM,"RANEROU FERLO",VELINGARA,OUDALAYE,"H2 BELEL MOURTOKI",9,24,111,71,182
MATAM,"RANEROU FERLO",VELINGARA,OUDALAYE,"H3 WENDOU WADABE",12,25,96,123,219
MATAM,"RANEROU FERLO",VELINGARA,OUDALAYE,"H4 GOUREL DIALLOUBE",15,24,94,89,183
MATAM,"RANEROU FERLO",VELINGARA,OUDALAYE,"WOYDOU ALI",15,31,135,98,233
MATAM,"RANEROU FERLO",VELINGARA,OUDALAYE,"H1 GASGAL",10,21,70,73,143
MATAM,"RANEROU FERLO",VELINGARA,OUDALAYE,"H2 MADINA OURO ALI",26,37,154,148,302
MATAM,"RANEROU FERLO",VELINGARA,OUDALAYE,"H3 BELI BOULO",19,23,140,105,245
MATAM,"RANEROU FERLO",VELINGARA,OUDALAYE,"H4 DOUBEL SENO",2,4,14,17,31
MATAM,"RANEROU FERLO",VELINGARA,OUDALAYE,"WOYDOU MAKHAM",27,68,194,172,366
MATAM,"RANEROU FERLO",VELINGARA,OUDALAYE,"H2 WOURO NGAGNE",4,5,21,20,41
MATAM,"RANEROU FERLO",VELINGARA,OUDALAYE,"WOYNDOU AMADOU",5,6,35,26,61
MATAM,"RANEROU FERLO",VELINGARA,OUDALAYE,"H1 BELEL LIEDJI",27,46,217,188,405
MATAM,"RANEROU FERLO",VELINGARA,OUDALAYE,"H3 YARAM THIOLY",7,8,27,27,54
MATAM,"RANEROU FERLO",VELINGARA,OUDALAYE,"H4 FOYNDOU",7,13,61,45,106
MATAM,"RANEROU FERLO",VELINGARA,OUDALAYE,"WOYNDOU BOUBOU",21,36,106,103,209
MATAM,"RANEROU FERLO",VELINGARA,OUDALAYE,"WOYNDOU NGARY",21,40,150,186,336
MATAM,"RANEROU FERLO",VELINGARA,OUDALAYE,"H1 NIAROUWAL",8,11,42,34,76
MATAM,"RANEROU FERLO",VELINGARA,OUDALAYE,YOUNOUFERE,98,129,558,575,1133
MATAM,"RANEROU FERLO",VELINGARA,OUDALAYE,"H1 WOUROU BOUBOU COUMBA SOW",18,29,120,132,252
MATAM,"RANEROU FERLO",VELINGARA,OUDALAYE,"H2 DAROU SALAM (WENDOU FOUÏNDOU)",4,8,42,46,88
MATAM,"RANEROU FERLO",VELINGARA,OUDALAYE,"H3 THIALTOL",8,12,46,56,102
MATAM,"RANEROU FERLO",VELINGARA,OUDALAYE,"H4 MBOULYEL",11,23,50,64,114
MATAM,"RANEROU FERLO",VELINGARA,OUDALAYE,"H5 DIALENDENDI (WOURO SEGA GUISSE)",7,13,71,44,115
MATAM,"RANEROU FERLO",VELINGARA,OUDALAYE,"H6 BOULY FARRY",11,19,59,61,120
MATAM,"RANEROU FERLO",VELINGARA,OUDALAYE,"H7 WENDOU DIAMI",3,4,21,21,42
MATAM,"RANEROU FERLO",VELINGARA,OUDALAYE,"H8 WENDOU NDOULA (WOURO NDOULA)",8,21,112,89,201
MATAM,"RANEROU FERLO",VELINGARA,OUDALAYE,"BELLY MBONE",11,12,50,57,107
MATAM,"RANEROU FERLO",VELINGARA,OUDALAYE,"DAROU NEMA II",25,67,152,139,291
MATAM,"RANEROU FERLO",VELINGARA,OUDALAYE,KATANE,22,28,100,109,209
MATAM,"RANEROU FERLO",VELINGARA,OUDALAYE,"H1 TOUBEL YALALBE",9,16,77,85,162
MATAM,"RANEROU FERLO",VELINGARA,OUDALAYE,"H2 HODIOLDOU",9,20,76,76,152
MATAM,"RANEROU FERLO",VELINGARA,OUDALAYE,"H3 BOULEL",9,22,69,65,134
MATAM,"RANEROU FERLO",VELINGARA,OUDALAYE,"LOUGUI GNIBI",22,22,87,87,174
MATAM,"RANEROU FERLO",VELINGARA,OUDALAYE,"H1 MBELONE",8,11,100,75,175
MATAM,"RANEROU FERLO",VELINGARA,OUDALAYE,"H2 THIAPATOWOL",9,9,32,48,80
MATAM,"RANEROU FERLO",VELINGARA,OUDALAYE,"MBOUL DJIOLOF",9,11,63,64,127
MATAM,"RANEROU FERLO",VELINGARA,OUDALAYE,"WENDOU DOULA (WOURO ALIOU DIALA)",13,37,92,80,172
MATAM,"RANEROU FERLO",VELINGARA,OUDALAYE,"WENDOU DOULA (WOURO KALIDOU GOUBEL)",8,19,65,73,138
MATAM,"RANEROU FERLO",VELINGARA,OUDALAYE,WOPPA,18,31,141,140,281
KAFFRINE,KAFFRINE,KAFFRINE,KAFFRINE,"DIAMAGUENE CENTRE",685,896,4209,4244,8453
KAFFRINE,KAFFRINE,KAFFRINE,KAFFRINE,"DIAMAGUENE NDIOBENE",548,676,3071,3059,6130
KAFFRINE,KAFFRINE,KAFFRINE,KAFFRINE,"DIAMAGUENE TP",913,1113,6104,5477,11581
KAFFRINE,KAFFRINE,KAFFRINE,KAFFRINE,"ESCALE EST",246,347,1402,1309,2711
KAFFRINE,KAFFRINE,KAFFRINE,KAFFRINE,"KAFFRINE NORD",478,568,2547,2419,4966
KAFFRINE,KAFFRINE,KAFFRINE,KAFFRINE,"KAFFRINE SUD",426,561,2597,2839,5436
KAFFRINE,KAFFRINE,KAFFRINE,KAFFRINE,MBAMBA,592,687,3277,3467,6744
KAFFRINE,KAFFRINE,KAFFRINE,KAFFRINE,PEYE,439,531,2386,2510,4896
KAFFRINE,KAFFRINE,KAFFRINE,KAFFRINE,"ESCALE OUEST/CITE MILLIONNAIRE",296,373,1255,1007,2262
KAFFRINE,KAFFRINE,KAFFRINE,KAFFRINE,"MEDINA BAYE",249,286,2257,1871,4128
KAFFRINE,KAFFRINE,GNIBY,BOULEL,"ALOUKY (TERRES NEUVES) ET ALOUKY SY",100,122,756,645,1401
KAFFRINE,KAFFRINE,GNIBY,BOULEL,"H2 NELBEL",12,13,81,95,176
KAFFRINE,KAFFRINE,GNIBY,BOULEL,"H3 BAYE NDIAYE",8,8,55,43,98
KAFFRINE,KAFFRINE,GNIBY,BOULEL,"H4 ALOUKY KAHI",30,38,198,191,389
KAFFRINE,KAFFRINE,GNIBY,BOULEL,"H5 DAROU KARIM",10,13,100,66,166
KAFFRINE,KAFFRINE,GNIBY,BOULEL,"H6 NELBEL SERERE",5,13,68,64,132
KAFFRINE,KAFFRINE,GNIBY,BOULEL,"H7 DAROU DIOP",1,2,29,12,41
KAFFRINE,KAFFRINE,GNIBY,BOULEL,"BOULEL GOUMACK",324,367,1861,1814,3675
KAFFRINE,KAFFRINE,GNIBY,BOULEL,"H1 NIETY GOUYE",28,30,258,269,527
KAFFRINE,KAFFRINE,GNIBY,BOULEL,"H2 MBETHIE PEULH",13,24,110,109,219
KAFFRINE,KAFFRINE,GNIBY,BOULEL,"H3 TAÏF THISSE",12,12,134,78,212
KAFFRINE,KAFFRINE,GNIBY,BOULEL,"BOULEL TERRES NEUVES",72,81,357,426,783
KAFFRINE,KAFFRINE,GNIBY,BOULEL,"H1 MBOUL SERERE (MBOUL DJIOULY FAYE)",17,18,158,131,289
KAFFRINE,KAFFRINE,GNIBY,BOULEL,"DAROU SALAM III",23,30,180,144,324
KAFFRINE,KAFFRINE,GNIBY,BOULEL,"DIAKHAO SALOUM",176,202,1036,1141,2177
KAFFRINE,KAFFRINE,GNIBY,BOULEL,"H1 KAKARE",12,19,136,127,263
KAFFRINE,KAFFRINE,GNIBY,BOULEL,"DIOUT NGEUL I",110,141,833,773,1606
KAFFRINE,KAFFRINE,GNIBY,BOULEL,"H1 KAYE NIALBE",9,10,63,66,129
KAFFRINE,KAFFRINE,GNIBY,BOULEL,"DIOUT NGUEL II",27,31,248,222,470
KAFFRINE,KAFFRINE,GNIBY,BOULEL,"FASS GOULAKOUM",49,62,309,269,578
KAFFRINE,KAFFRINE,GNIBY,BOULEL,GOULOKOUM,132,166,701,644,1345
KAFFRINE,KAFFRINE,GNIBY,BOULEL,"H1 DIABA (DIABO)",2,2,6,7,13
KAFFRINE,KAFFRINE,GNIBY,BOULEL,HORE,92,125,535,503,1038
KAFFRINE,KAFFRINE,GNIBY,BOULEL,KHENDE,164,194,1127,1127,2254
KAFFRINE,KAFFRINE,GNIBY,BOULEL,"H1 KEUR SAMBA",2,4,15,11,26
KAFFRINE,KAFFRINE,GNIBY,BOULEL,"KOUYANDE KANDJI",54,69,401,390,791
KAFFRINE,KAFFRINE,GNIBY,BOULEL,"H2 NDIABAYENE",6,6,19,25,44
KAFFRINE,KAFFRINE,GNIBY,BOULEL,"KOUYANDE NDIAYE",24,32,191,172,363
KAFFRINE,KAFFRINE,GNIBY,BOULEL,"H1 DIAYANE",11,25,104,85,189
KAFFRINE,KAFFRINE,GNIBY,BOULEL,"H2 MBATHIERE",19,40,149,149,298
KAFFRINE,KAFFRINE,GNIBY,BOULEL,"H3 KOUYANDE TEOUROU",6,16,72,51,123
KAFFRINE,KAFFRINE,GNIBY,BOULEL,"LANEL (LANENE)",77,104,553,448,1001
KAFFRINE,KAFFRINE,GNIBY,BOULEL,"H1 BOURLEYE LANEL",10,10,39,26,65
KAFFRINE,KAFFRINE,GNIBY,BOULEL,LAHI,44,49,289,289,578
KAFFRINE,KAFFRINE,GNIBY,BOULEL,"H1 MIDIO",7,11,50,60,110
KAFFRINE,KAFFRINE,GNIBY,BOULEL,"H2 FORET",5,7,51,48,99
KAFFRINE,KAFFRINE,GNIBY,BOULEL,"HI KEUR ELHADJI SAMBA SOW",5,6,36,34,70
KAFFRINE,KAFFRINE,GNIBY,BOULEL,"MBOUL PEULH",26,44,233,252,485
KAFFRINE,KAFFRINE,GNIBY,BOULEL,"H1 NGASSAMA SERERE",8,14,67,59,126
KAFFRINE,KAFFRINE,GNIBY,BOULEL,"MEDINA KEBE",43,65,398,382,780
KAFFRINE,KAFFRINE,GNIBY,BOULEL,"H1 GALOLY  PEULH",15,31,142,98,240
KAFFRINE,KAFFRINE,GNIBY,BOULEL,"MEDINE KANDIANE",26,31,147,148,295
KAFFRINE,KAFFRINE,GNIBY,BOULEL,"H1 PEULGA",12,19,74,76,150
KAFFRINE,KAFFRINE,GNIBY,BOULEL,"SEMA III",71,86,543,583,1126
KAFFRINE,KAFFRINE,GNIBY,BOULEL,"H1 TEOUROU",9,14,54,33,87
KAFFRINE,KAFFRINE,GNIBY,BOULEL,"TOUBA TAGGOUM (TAGGOUM )",24,29,143,133,276
KAFFRINE,KAFFRINE,GNIBY,BOULEL,"TAIF SALOUM (BLOC NORD)",65,71,325,288,613
KAFFRINE,KAFFRINE,GNIBY,BOULEL,TORODO,78,90,479,463,942
KAFFRINE,KAFFRINE,GNIBY,BOULEL,"H1 DIAMAGUENE",2,3,17,10,27
KAFFRINE,KAFFRINE,GNIBY,BOULEL,"H2 MEDINA TORODO",9,9,46,48,94
KAFFRINE,KAFFRINE,GNIBY,BOULEL,"TOUBA FALL WARKERE",33,39,202,165,367
KAFFRINE,KAFFRINE,GNIBY,BOULEL,"H1 NASSOUROULAH (DAARAYE SERIGNE MOUKHTAR SOW)",1,1,23,0,23
KAFFRINE,KAFFRINE,GNIBY,BOULEL,"TOUBA SALOUM",107,114,744,586,1330
KAFFRINE,KAFFRINE,GNIBY,BOULEL,"TOUBA TAWFEKH (SANTHIE SOULEYMANE)",28,32,150,130,280
KAFFRINE,KAFFRINE,GNIBY,BOULEL,WARKERE,31,43,198,183,381
KAFFRINE,KAFFRINE,GNIBY,BOULEL,"H1 KEUR GALLO BIGUE",7,14,64,59,123
KAFFRINE,KAFFRINE,GNIBY,BOULEL,"ALOUKY THIARENE",22,26,131,135,266
KAFFRINE,KAFFRINE,GNIBY,BOULEL,"BOULEL TERRES NEUVES (BOULEL NDOFFENE)",1,1,6,4,10
KAFFRINE,KAFFRINE,GNIBY,GNIBY,"BIT NGUEL",33,39,226,225,451
KAFFRINE,KAFFRINE,GNIBY,GNIBY,"H1 KEUR CHEIKH DIOUF",1,1,5,0,5
KAFFRINE,KAFFRINE,GNIBY,GNIBY,"H2 KEUR AMADOU BA",1,1,7,7,14
KAFFRINE,KAFFRINE,GNIBY,GNIBY,"BOCKY PUITS",19,27,145,127,272
KAFFRINE,KAFFRINE,GNIBY,GNIBY,"H1 KEUR GUELADIO DIALLO",1,1,6,6,12
KAFFRINE,KAFFRINE,GNIBY,GNIBY,"H2 KEUR SOUNGUEL BA",3,5,13,16,29
KAFFRINE,KAFFRINE,GNIBY,GNIBY,"H3 SENÈNE",8,8,69,64,133
KAFFRINE,KAFFRINE,GNIBY,GNIBY,"H4 NDIOUFENE",10,11,96,82,178
KAFFRINE,KAFFRINE,GNIBY,GNIBY,"BONDIE SAMBA",70,91,489,427,916
KAFFRINE,KAFFRINE,GNIBY,GNIBY,"H1 THIARENE",31,42,160,185,345
KAFFRINE,KAFFRINE,GNIBY,GNIBY,"H2 KEBE",16,20,95,90,185
KAFFRINE,KAFFRINE,GNIBY,GNIBY,"H3 SAMBÈNE",14,18,101,107,208
KAFFRINE,KAFFRINE,GNIBY,GNIBY,"H4 TENE BOUBESS",70,92,493,424,917
KAFFRINE,KAFFRINE,GNIBY,GNIBY,"H5 BAP",4,4,29,21,50
KAFFRINE,KAFFRINE,GNIBY,GNIBY,"H6 BEDE",2,2,6,13,19
KAFFRINE,KAFFRINE,GNIBY,GNIBY,"H7 KEUR SAMBA DIOP",6,9,36,34,70
KAFFRINE,KAFFRINE,GNIBY,GNIBY,"H8 KEUR MBAYE SIMBE",11,11,36,50,86
KAFFRINE,KAFFRINE,GNIBY,GNIBY,"BOYE NGAMBOU",3,7,34,38,72
KAFFRINE,KAFFRINE,GNIBY,GNIBY,"H1 BOUBANE",12,18,85,77,162
KAFFRINE,KAFFRINE,GNIBY,GNIBY,"DAROU SALAM (TERRES NEUVES)",38,41,169,177,346
KAFFRINE,KAFFRINE,GNIBY,GNIBY,"H1 BOYE",16,21,141,102,243
KAFFRINE,KAFFRINE,GNIBY,GNIBY,DIOUMADA,42,48,286,251,537
KAFFRINE,KAFFRINE,GNIBY,GNIBY,"H2 DAARA SERIGNE ABDOU AZIZ M’BACKE",2,2,111,11,122
KAFFRINE,KAFFRINE,GNIBY,GNIBY,GNIBY,399,462,2453,2618,5071
KAFFRINE,KAFFRINE,GNIBY,GNIBY,"H1 THIEYENE",2,2,19,18,37
KAFFRINE,KAFFRINE,GNIBY,GNIBY,"H2 NDONY",9,13,64,60,124
KAFFRINE,KAFFRINE,GNIBY,GNIBY,"GNIBY LAMBAYE",73,81,590,411,1001
KAFFRINE,KAFFRINE,GNIBY,GNIBY,"KEBE YARA ( KEUR SELLE )",21,26,163,132,295
KAFFRINE,KAFFRINE,GNIBY,GNIBY,"H1 KEBE PEULH",14,17,115,99,214
KAFFRINE,KAFFRINE,GNIBY,GNIBY,"H2 YARA PEULH BOUMACK",12,13,72,65,137
KAFFRINE,KAFFRINE,GNIBY,GNIBY,"LEONA GNIBY",16,19,101,104,205
KAFFRINE,KAFFRINE,GNIBY,GNIBY,"MBEGUE GOUME",21,46,167,149,316
KAFFRINE,KAFFRINE,GNIBY,GNIBY,"MBEGUE WENDOU",110,148,888,644,1532
KAFFRINE,KAFFRINE,GNIBY,GNIBY,"H2 MBISSINABE",12,18,84,70,154
KAFFRINE,KAFFRINE,GNIBY,GNIBY,"H4 KEUR DIAMANE",10,11,67,59,126
KAFFRINE,KAFFRINE,GNIBY,GNIBY,"H1 MBADACOUNE",7,9,32,32,64
KAFFRINE,KAFFRINE,GNIBY,GNIBY,"MEDINA GNIBY",5,5,35,27,62
KAFFRINE,KAFFRINE,GNIBY,GNIBY,"H1 LINGUEDIE",4,7,47,40,87
KAFFRINE,KAFFRINE,GNIBY,GNIBY,"PANAL MBAYARD ( LERAL)",51,81,545,572,1117
KAFFRINE,KAFFRINE,GNIBY,GNIBY,"H1 LIGNE",9,12,50,55,105
KAFFRINE,KAFFRINE,GNIBY,GNIBY,"RONGO THIL",6,7,62,60,122
KAFFRINE,KAFFRINE,GNIBY,GNIBY,"H1 BELELE GUELOCKY",8,10,61,56,117
KAFFRINE,KAFFRINE,GNIBY,GNIBY,SAO-FALO,7,8,81,72,153
KAFFRINE,KAFFRINE,GNIBY,GNIBY,"H1 BOSSEDIE",8,12,66,61,127
KAFFRINE,KAFFRINE,GNIBY,GNIBY,"TABA (KEUR EL HADJI ABASS SALL)",20,20,105,101,206
KAFFRINE,KAFFRINE,GNIBY,GNIBY,"H1  KEUR MODOU NDIAYE",1,2,23,14,37
KAFFRINE,KAFFRINE,GNIBY,GNIBY,"H2 KEUR DAOUDA BA",1,2,23,16,39
KAFFRINE,KAFFRINE,GNIBY,GNIBY,"H3 KEUR SALIOU POUYE",4,10,67,51,118
KAFFRINE,KAFFRINE,GNIBY,GNIBY,"H4 KEUR NDAME SARR",14,14,137,93,230
KAFFRINE,KAFFRINE,GNIBY,GNIBY,THIONE,87,98,621,615,1236
KAFFRINE,KAFFRINE,GNIBY,GNIBY,"H1 THIONE PEULH",4,7,41,28,69
KAFFRINE,KAFFRINE,GNIBY,GNIBY,"TOUBA LAMBAYE",6,12,69,67,136
KAFFRINE,KAFFRINE,GNIBY,GNIBY,"H1 KEUR DAOUDA SENE ( PATAR SINE )",18,24,165,151,316
KAFFRINE,KAFFRINE,GNIBY,GNIBY,"H2 NDIOUFENE",10,11,73,65,138
KAFFRINE,KAFFRINE,GNIBY,GNIBY,"WENDOU BOYE",36,63,307,283,590
KAFFRINE,KAFFRINE,GNIBY,GNIBY,"YARA PEULH",10,14,61,64,125
KAFFRINE,KAFFRINE,GNIBY,KAHI,"AFFE MOURIDE",86,115,625,615,1240
KAFFRINE,KAFFRINE,GNIBY,KAHI,"AFFE TIDIANE",28,31,174,150,324
KAFFRINE,KAFFRINE,GNIBY,KAHI,"H1 THIALENE",62,74,462,409,871
KAFFRINE,KAFFRINE,GNIBY,KAHI,"H2 EDE",16,20,120,100,220
KAFFRINE,KAFFRINE,GNIBY,KAHI,"H3 KEUR SACCO",3,3,7,18,25
KAFFRINE,KAFFRINE,GNIBY,KAHI,"H4 KEUR YORO DÈME",7,8,44,43,87
KAFFRINE,KAFFRINE,GNIBY,KAHI,"DAROU KAHI (KASSAS)",43,46,272,291,563
KAFFRINE,KAFFRINE,GNIBY,KAHI,"DAROU MINAM I",20,21,176,160,336
KAFFRINE,KAFFRINE,GNIBY,KAHI,DIAGLE,85,165,644,579,1223
KAFFRINE,KAFFRINE,GNIBY,KAHI,DIOGO,22,26,147,161,308
KAFFRINE,KAFFRINE,GNIBY,KAHI,"H1 DIOGO PEULH",8,11,54,41,95
KAFFRINE,KAFFRINE,GNIBY,KAHI,"H2 KEUR SARA",2,4,22,13,35
KAFFRINE,KAFFRINE,GNIBY,KAHI,"DJIDAH II",36,41,197,215,412
KAFFRINE,KAFFRINE,GNIBY,KAHI,"FASS NGODIBA (SANTHIE ALY FATIM)",39,45,268,279,547
KAFFRINE,KAFFRINE,GNIBY,KAHI,KAHI,141,159,738,737,1475
KAFFRINE,KAFFRINE,GNIBY,KAHI,"H1 PEULGA ( MBAMBEYE )",4,4,13,14,27
KAFFRINE,KAFFRINE,GNIBY,KAHI,"H2 PEULGA",1,4,22,10,32
KAFFRINE,KAFFRINE,GNIBY,KAHI,"KASSAS GOUMACK (KASSAS VELINGARA)",8,11,27,21,48
KAFFRINE,KAFFRINE,GNIBY,KAHI,"H1 BÊLE",5,5,11,14,25
KAFFRINE,KAFFRINE,GNIBY,KAHI,"H2 DJIPO",7,8,9,12,21
KAFFRINE,KAFFRINE,GNIBY,KAHI,"KASSAS LODOYEL",12,14,30,32,62
KAFFRINE,KAFFRINE,GNIBY,KAHI,"H1 YEITA",10,10,24,23,47
KAFFRINE,KAFFRINE,GNIBY,KAHI,"H2 BAPEDJI",7,12,59,46,105
KAFFRINE,KAFFRINE,GNIBY,KAHI,"H3 NDIARY",18,26,128,119,247
KAFFRINE,KAFFRINE,GNIBY,KAHI,"KASSAS WALY NDOUR",12,16,97,94,191
KAFFRINE,KAFFRINE,GNIBY,KAHI,"KEUR SANDAO",6,8,31,27,58
KAFFRINE,KAFFRINE,GNIBY,KAHI,"H2 DIAMWELY",6,8,50,36,86
KAFFRINE,KAFFRINE,GNIBY,KAHI,"LOUGUE BAMBARA",31,32,289,258,547
KAFFRINE,KAFFRINE,GNIBY,KAHI,"LOUGUE OUOLOF",48,60,383,296,679
KAFFRINE,KAFFRINE,GNIBY,KAHI,"MEDINA KAFFRINE (SANTHIE MOUSSA)",12,13,57,53,110
KAFFRINE,KAFFRINE,GNIBY,KAHI,"H1 PEULGA",1,3,27,21,48
KAFFRINE,KAFFRINE,GNIBY,KAHI,"MEDINA MOUNAWARA ( WENGUY )",11,12,97,65,162
KAFFRINE,KAFFRINE,GNIBY,KAHI,"MEDINA THISSE ( NUMERO II )",21,23,122,96,218
KAFFRINE,KAFFRINE,GNIBY,KAHI,NDJIGUI,152,172,1039,861,1900
KAFFRINE,KAFFRINE,GNIBY,KAHI,NDODJI,82,91,445,421,866
KAFFRINE,KAFFRINE,GNIBY,KAHI,"H1 PEULGA ET NDIORENE",33,47,252,235,487
KAFFRINE,KAFFRINE,GNIBY,KAHI,NGODIBA,359,411,2502,2406,4908
KAFFRINE,KAFFRINE,GNIBY,KAHI,"NIANGHENE BAMBARA (NIANGHENE ALTE )",13,14,62,43,105
KAFFRINE,KAFFRINE,GNIBY,KAHI,"NIANGHENE OUOLOF (NIANGHENE DJIBY)",63,72,414,436,850
KAFFRINE,KAFFRINE,GNIBY,KAHI,PETE,39,43,282,304,586
KAFFRINE,KAFFRINE,GNIBY,KAHI,"H1 PETE BAMBARA",8,11,71,75,146
KAFFRINE,KAFFRINE,GNIBY,KAHI,"SANGHOL OUOLOF",11,24,131,132,263
KAFFRINE,KAFFRINE,GNIBY,KAHI,"SANGHOL PEULH",18,37,187,201,388
KAFFRINE,KAFFRINE,GNIBY,KAHI,"H1 NDIALOUM",6,9,66,43,109
KAFFRINE,KAFFRINE,GNIBY,KAHI,"SIKILO (NDINDY BOUGOU)",68,71,368,324,692
KAFFRINE,KAFFRINE,GNIBY,KAHI,SOROCOGNE,163,193,1135,1077,2212
KAFFRINE,KAFFRINE,GNIBY,KAHI,"H1 SOROCOGNE SANTHIE ( KEUR MAMOUR SY)",16,19,145,194,339
KAFFRINE,KAFFRINE,GNIBY,KAHI,"TOUBA KEUR CHEIKH",20,22,121,96,217
KAFFRINE,KAFFRINE,GNIBY,KAHI,"TOUNE MOSQUEE",151,214,1075,1164,2239
KAFFRINE,KAFFRINE,GNIBY,KAHI,"H1 TOUNE COPE ( TOUNE SANTHIE)",79,93,543,581,1124
KAFFRINE,KAFFRINE,GNIBY,KAHI,"H2 NDOUGOUBENE",40,53,345,333,678
KAFFRINE,KAFFRINE,GNIBY,KAHI,"H3 KEUR BALLE",2,2,9,9,18
KAFFRINE,KAFFRINE,GNIBY,KAHI,NGAGNE,8,8,46,41,87
KAFFRINE,KAFFRINE,GNIBY,KAHI,"DIAMAGUENE I",39,43,290,216,506
KAFFRINE,KAFFRINE,GNIBY,KAHI,"TOUBA MADIYANA",7,7,15,6,21
KAFFRINE,KAFFRINE,KATAKEL,"DIOKOUL BELBOUCK",BACKO,57,67,422,520,942
KAFFRINE,KAFFRINE,KATAKEL,"DIOKOUL BELBOUCK","DAROU MANDAKH (DAROU NIANKA)",43,64,439,512,951
KAFFRINE,KAFFRINE,KATAKEL,"DIOKOUL BELBOUCK","DIOKOUL MBELBOUCK",409,464,2941,2998,5939
KAFFRINE,KAFFRINE,KATAKEL,"DIOKOUL BELBOUCK","DIOLY MANDAKH",195,219,1221,1293,2514
KAFFRINE,KAFFRINE,KATAKEL,"DIOKOUL BELBOUCK","DIOLY MBELBOUCK",67,82,494,511,1005
KAFFRINE,KAFFRINE,KATAKEL,"DIOKOUL BELBOUCK","HAFFE NDJIGANE",32,41,248,251,499
KAFFRINE,KAFFRINE,KATAKEL,"DIOKOUL BELBOUCK","H1 SANTHIE BAILA",13,20,106,133,239
KAFFRINE,KAFFRINE,KATAKEL,"DIOKOUL BELBOUCK","KANOUMA THIALTIGUE",24,32,214,212,426
KAFFRINE,KAFFRINE,KATAKEL,"DIOKOUL BELBOUCK",KATHIAL,35,47,284,329,613
KAFFRINE,KAFFRINE,KATAKEL,"DIOKOUL BELBOUCK","KEUR  BABOU II",25,30,224,183,407
KAFFRINE,KAFFRINE,KATAKEL,"DIOKOUL BELBOUCK","KEUR NDIAGA I",20,31,196,190,386
KAFFRINE,KAFFRINE,KATAKEL,"DIOKOUL BELBOUCK",KOUTHIA,38,51,93,91,184
KAFFRINE,KAFFRINE,KATAKEL,"DIOKOUL BELBOUCK","H1 THIECKENE",8,10,32,33,65
KAFFRINE,KAFFRINE,KATAKEL,"DIOKOUL BELBOUCK",MANDAKH,34,38,275,274,549
KAFFRINE,KAFFRINE,KATAKEL,"DIOKOUL BELBOUCK",MARA,94,119,863,852,1715
KAFFRINE,KAFFRINE,KATAKEL,"DIOKOUL BELBOUCK",MBOUL,33,42,291,314,605
KAFFRINE,KAFFRINE,KATAKEL,"DIOKOUL BELBOUCK","MEDINA DIOKOUL (SANTHIE DEMBA)",32,35,270,283,553
KAFFRINE,KAFFRINE,KATAKEL,"DIOKOUL BELBOUCK","MEDINA MBAYENE (KEUR KOGALA)",15,19,129,111,240
KAFFRINE,KAFFRINE,KATAKEL,"DIOKOUL BELBOUCK","MEDINA TEMEGNE",37,45,376,289,665
KAFFRINE,KAFFRINE,KATAKEL,"DIOKOUL BELBOUCK","MEDINA VELINGARA",2,4,31,12,43
KAFFRINE,KAFFRINE,KATAKEL,"DIOKOUL BELBOUCK","MEO NDIOBENE",133,145,1034,1136,2170
KAFFRINE,KAFFRINE,KATAKEL,"DIOKOUL BELBOUCK","MISSIRAH MANDAKH (MBATTA)",22,25,185,209,394
KAFFRINE,KAFFRINE,KATAKEL,"DIOKOUL BELBOUCK","MISSIRAH TOBENE (BAMBA KOUTHIA)",10,27,173,194,367
KAFFRINE,KAFFRINE,KATAKEL,"DIOKOUL BELBOUCK",NDIAWARA,16,26,222,220,442
KAFFRINE,KAFFRINE,KATAKEL,"DIOKOUL BELBOUCK","NGUER MANDAKH",189,225,1452,1618,3070
KAFFRINE,KAFFRINE,KATAKEL,"DIOKOUL BELBOUCK","SAME NGUEYENNE II",34,39,210,295,505
KAFFRINE,KAFFRINE,KATAKEL,"DIOKOUL BELBOUCK","TEMEGNE (PALLENE)",80,94,632,620,1252
KAFFRINE,KAFFRINE,KATAKEL,"DIOKOUL BELBOUCK","TEMEGNE NGUEYENE",14,15,121,113,234
KAFFRINE,KAFFRINE,KATAKEL,"DIOKOUL BELBOUCK","TEMEGNE THIECKENE",12,16,272,126,398
KAFFRINE,KAFFRINE,KATAKEL,"DIOKOUL BELBOUCK","THIONGA SANTHIE",31,35,211,259,470
KAFFRINE,KAFFRINE,KATAKEL,"DIOKOUL BELBOUCK","TOUNE MANDAKH",106,131,734,866,1600
KAFFRINE,KAFFRINE,KATAKEL,"DIOKOUL BELBOUCK",WEYNANE,38,58,217,221,438
KAFFRINE,KAFFRINE,KATAKEL,"DIOKOUL BELBOUCK","KEUR NDIAGA II",17,17,112,96,208
KAFFRINE,KAFFRINE,KATAKEL,"DIOKOUL BELBOUCK","KOUTHIA NDAWENE",56,65,384,448,832
KAFFRINE,KAFFRINE,KATAKEL,"DIOKOUL BELBOUCK","SAME GUEYENE I",92,121,920,959,1879
KAFFRINE,KAFFRINE,KATAKEL,"DIOKOUL BELBOUCK","SAME THIALENE",50,57,370,422,792
KAFFRINE,KAFFRINE,KATAKEL,KATHIOTTE,BALLY,37,40,267,225,492
KAFFRINE,KAFFRINE,KATAKEL,KATHIOTTE,BARONE,93,102,558,604,1162
KAFFRINE,KAFFRINE,KATAKEL,KATHIOTTE,BOFFY,45,51,256,255,511
KAFFRINE,KAFFRINE,KATAKEL,KATHIOTTE,"DAGAY GOUYE (SANTHIE OUSMANE DIAKHA)",62,79,396,446,842
KAFFRINE,KAFFRINE,KATAKEL,KATHIOTTE,DARA,34,37,223,222,445
KAFFRINE,KAFFRINE,KATAKEL,KATHIOTTE,FARATO,69,75,506,587,1093
KAFFRINE,KAFFRINE,KATAKEL,KATHIOTTE,"GAINTH GOUYE",64,78,529,473,1002
KAFFRINE,KAFFRINE,KATAKEL,KATHIOTTE,"H1 KEUR SETTE TABARA",18,19,117,100,217
KAFFRINE,KAFFRINE,KATAKEL,KATHIOTTE,"GAINTH PEULH II (PEULGA)",15,21,93,82,175
KAFFRINE,KAFFRINE,KATAKEL,KATHIOTTE,"GAINTH PEUL I",98,124,602,670,1272
KAFFRINE,KAFFRINE,KATAKEL,KATHIOTTE,KATAKEL,92,105,542,524,1066
KAFFRINE,KAFFRINE,KATAKEL,KATHIOTTE,KATHIOTE,311,381,1982,2093,4075
KAFFRINE,KAFFRINE,KATAKEL,KATHIOTTE,"KEUR BIRANE (KEUR BIRANE MATA)",73,89,448,494,942
KAFFRINE,KAFFRINE,KATAKEL,KATHIOTTE,"KEUR DEMBA",38,44,247,235,482
KAFFRINE,KAFFRINE,KATAKEL,KATHIOTTE,"KEUR LAHINE RAMATA",67,89,463,450,913
KAFFRINE,KAFFRINE,KATAKEL,KATHIOTTE,"KEUR MALICK NDIAYE",126,154,1030,1080,2110
KAFFRINE,KAFFRINE,KATAKEL,KATHIOTTE,LAGUE,7,10,44,55,99
KAFFRINE,KAFFRINE,KATAKEL,KATHIOTTE,"MAGANENE (SANGUE)",44,48,303,345,648
KAFFRINE,KAFFRINE,KATAKEL,KATHIOTTE,MBELBOUCK,58,78,527,623,1150
KAFFRINE,KAFFRINE,KATAKEL,KATHIOTTE,"H1 DAROU FALLA",1,2,10,6,16
KAFFRINE,KAFFRINE,KATAKEL,KATHIOTTE,"H2 DAROU SALAM ( KEUR ELHADJI MALICK THIALL)",3,3,46,20,66
KAFFRINE,KAFFRINE,KATAKEL,KATHIOTTE,"MBENE DIOUMA",112,146,845,835,1680
KAFFRINE,KAFFRINE,KATAKEL,KATHIOTTE,"MBÈNE MAMOUR",51,69,468,373,841
KAFFRINE,KAFFRINE,KATAKEL,KATHIOTTE,"H1 PEULGA",3,3,22,19,41
KAFFRINE,KAFFRINE,KATAKEL,KATHIOTTE,"MEDINA NDIAYENE",27,36,277,208,485
KAFFRINE,KAFFRINE,KATAKEL,KATHIOTTE,"H1 KEUR GATTA",11,11,57,58,115
KAFFRINE,KAFFRINE,KATAKEL,KATHIOTTE,"MEDINA NDIOUDIENE (BANKOTO)",14,15,73,83,156
KAFFRINE,KAFFRINE,KATAKEL,KATHIOTTE,"MEDINA TABA",44,50,344,311,655
KAFFRINE,KAFFRINE,KATAKEL,KATHIOTTE,"H1 TABA",18,19,144,123,267
KAFFRINE,KAFFRINE,KATAKEL,KATHIOTTE,"MEDINA THIESSE",20,26,158,170,328
KAFFRINE,KAFFRINE,KATAKEL,KATHIOTTE,"MEDINA SALAM 4 (MEDINA ELHADJI BABOU NDAO)",41,58,325,351,676
KAFFRINE,KAFFRINE,KATAKEL,KATHIOTTE,MOUYE,101,108,758,717,1475
KAFFRINE,KAFFRINE,KATAKEL,KATHIOTTE,NDEME,19,26,164,150,314
KAFFRINE,KAFFRINE,KATAKEL,KATHIOTTE,"NDIAYE COUNDA",74,95,373,467,840
KAFFRINE,KAFFRINE,KATAKEL,KATHIOTTE,NDIOUDIENE,140,180,961,976,1937
KAFFRINE,KAFFRINE,KATAKEL,KATHIOTTE,"NGATOU FARBA",68,80,326,427,753
KAFFRINE,KAFFRINE,KATAKEL,KATHIOTTE,"NGATOU MALICK",130,154,789,1009,1798
KAFFRINE,KAFFRINE,KATAKEL,KATHIOTTE,"PAKALA CHEIKH MATAR ( PAKALA BOU NDAW)",2,4,23,22,45
KAFFRINE,KAFFRINE,KATAKEL,KATHIOTTE,"SANTHIE GALNGONE",264,331,1899,1651,3550
KAFFRINE,KAFFRINE,KATAKEL,KATHIOTTE,"H1 NDIANE",12,15,76,81,157
KAFFRINE,KAFFRINE,KATAKEL,KATHIOTTE,"SANTHIE MANDAKH I",51,57,402,478,880
KAFFRINE,KAFFRINE,KATAKEL,KATHIOTTE,"H1 SANTHIE MANDAKH WOLOF",10,12,88,78,166
KAFFRINE,KAFFRINE,KATAKEL,KATHIOTTE,"SANTHIOU MANDAKH II",47,57,428,408,836
KAFFRINE,KAFFRINE,KATAKEL,KATHIOTTE,SOTHO,28,37,238,277,515
KAFFRINE,KAFFRINE,KATAKEL,KATHIOTTE,"H1 SOTHO SANTHIABA",21,24,113,135,248
KAFFRINE,KAFFRINE,KATAKEL,KATHIOTTE,"H2 SOTO PEULH",3,5,42,45,87
KAFFRINE,KAFFRINE,KATAKEL,KATHIOTTE,"H3 FASS SOTHO",5,5,16,27,43
KAFFRINE,KAFFRINE,KATAKEL,KATHIOTTE,"SOULKHOU LOHENE",17,22,96,115,211
KAFFRINE,KAFFRINE,KATAKEL,KATHIOTTE,"SOULKHOU THISSE",39,48,267,318,585
KAFFRINE,KAFFRINE,KATAKEL,KATHIOTTE,TAÏBA,102,124,682,590,1272
KAFFRINE,KAFFRINE,KATAKEL,KATHIOTTE,TAWA,49,52,260,240,500
KAFFRINE,KAFFRINE,KATAKEL,KATHIOTTE,THIAMENE,76,87,520,511,1031
KAFFRINE,KAFFRINE,KATAKEL,KATHIOTTE,"H1 THIARENE",7,9,54,53,107
KAFFRINE,KAFFRINE,KATAKEL,KATHIOTTE,"TOUBA MOURIDE I (SANTHIE MOTH SOKHNA)",83,96,475,634,1109
KAFFRINE,KAFFRINE,KATAKEL,KATHIOTTE,"TOUBA MOURIDE II (KELLE)",5,5,43,39,82
KAFFRINE,KAFFRINE,KATAKEL,KATHIOTTE,"TOUBA TABA (KEUR LAHINE  LOBE)",45,62,270,337,607
KAFFRINE,KAFFRINE,KATAKEL,KATHIOTTE,"H1 KEUR MALICK COUMBA",10,12,65,77,142
KAFFRINE,KAFFRINE,KATAKEL,KATHIOTTE,WALALANE,34,45,308,395,703
KAFFRINE,KAFFRINE,KATAKEL,KATHIOTTE,"WILANENE (WILANENE GOUYE)",30,37,191,190,381
KAFFRINE,KAFFRINE,KATAKEL,"MEDINATOUL SALAM 2","BAMBA MODOU",119,154,919,1077,1996
KAFFRINE,KAFFRINE,KATAKEL,"MEDINATOUL SALAM 2","BAMBA MOUSSA",10,11,77,75,152
KAFFRINE,KAFFRINE,KATAKEL,"MEDINATOUL SALAM 2","DAROU MADY DIALLO",25,45,327,302,629
KAFFRINE,KAFFRINE,KATAKEL,"MEDINATOUL SALAM 2","DAROU RAHMANE",32,38,388,293,681
KAFFRINE,KAFFRINE,KATAKEL,"MEDINATOUL SALAM 2","DAROU SALAM",17,28,163,165,328
KAFFRINE,KAFFRINE,KATAKEL,"MEDINATOUL SALAM 2","NDIAMA SENEGAL",15,23,170,154,324
KAFFRINE,KAFFRINE,KATAKEL,"MEDINATOUL SALAM 2","IDA MBAYENE",23,39,275,286,561
KAFFRINE,KAFFRINE,KATAKEL,"MEDINATOUL SALAM 2","KELIMANE GOUYE",15,29,221,214,435
KAFFRINE,KAFFRINE,KATAKEL,"MEDINATOUL SALAM 2","KEUR ALI FANNA",31,52,328,438,766
KAFFRINE,KAFFRINE,KATAKEL,"MEDINATOUL SALAM 2","KEUR BABOU",45,62,471,457,928
KAFFRINE,KAFFRINE,KATAKEL,"MEDINATOUL SALAM 2","KEUR GANDA CISSE",3,3,58,35,93
KAFFRINE,KAFFRINE,KATAKEL,"MEDINATOUL SALAM 2","KEUR SAFADY",43,53,263,314,577
KAFFRINE,KAFFRINE,KATAKEL,"MEDINATOUL SALAM 2","KEUR SAWELY",20,33,231,265,496
KAFFRINE,KAFFRINE,KATAKEL,"MEDINATOUL SALAM 2","MEDINA KEUR SERIGNE AWA",32,44,405,365,770
KAFFRINE,KAFFRINE,KATAKEL,"MEDINATOUL SALAM 2","KOLY PEULH",31,43,296,304,600
KAFFRINE,KAFFRINE,KATAKEL,"MEDINATOUL SALAM 2","MADINA BAMBA",10,11,87,102,189
KAFFRINE,KAFFRINE,KATAKEL,"MEDINATOUL SALAM 2","H2 SANTHIE EL HADJI MALICK",27,41,300,286,586
KAFFRINE,KAFFRINE,KATAKEL,"MEDINATOUL SALAM 2","MAKA GOUYE",93,137,987,930,1917
KAFFRINE,KAFFRINE,KATAKEL,"MEDINATOUL SALAM 2","MEDINATOU SALAM II",131,171,962,1179,2141
KAFFRINE,KAFFRINE,KATAKEL,"MEDINATOUL SALAM 2","H2 HAKHIKHATOULAHI MOUBINOU",1,1,1,0,1
KAFFRINE,KAFFRINE,KATAKEL,"MEDINATOUL SALAM 2","MEDINATOU SALAM III",89,89,620,477,1097
KAFFRINE,KAFFRINE,KATAKEL,"MEDINATOUL SALAM 2","MISSIRAH PATHE",14,18,174,148,322
KAFFRINE,KAFFRINE,KATAKEL,"MEDINATOUL SALAM 2","NDAKHAR MBAYENE",41,50,405,304,709
KAFFRINE,KAFFRINE,KATAKEL,"MEDINATOUL SALAM 2","H1 KEUR BAMBA",21,29,256,210,466
KAFFRINE,KAFFRINE,KATAKEL,"MEDINATOUL SALAM 2","NDAKHAR POSTE",32,47,278,293,571
KAFFRINE,KAFFRINE,KATAKEL,"MEDINATOUL SALAM 2",NDIENGUENE,47,70,404,432,836
KAFFRINE,KAFFRINE,KATAKEL,"MEDINATOUL SALAM 2","NGOUCK DIAMA",29,47,206,313,519
KAFFRINE,KAFFRINE,KATAKEL,"MEDINATOUL SALAM 2","NGOUCK KHOUBE",30,42,245,245,490
KAFFRINE,KAFFRINE,KATAKEL,"MEDINATOUL SALAM 2","PANTHIANG I",31,55,328,340,668
KAFFRINE,KAFFRINE,KATAKEL,"MEDINATOUL SALAM 2","H1 PANTHIANG FRONTIERE (FRANCAIS)",7,8,31,25,56
KAFFRINE,KAFFRINE,KATAKEL,"MEDINATOUL SALAM 2","PANTHIANG II",22,41,266,253,519
KAFFRINE,KAFFRINE,KATAKEL,"MEDINATOUL SALAM 2","PANTHIANG III",10,17,85,81,166
KAFFRINE,KAFFRINE,KATAKEL,"MEDINATOUL SALAM 2","PATHE THIANGANE",33,51,339,326,665
KAFFRINE,KAFFRINE,KATAKEL,"MEDINATOUL SALAM 2","PATHE TOUCOULEUR",40,57,536,461,997
KAFFRINE,KAFFRINE,KATAKEL,"MEDINATOUL SALAM 2","SANTHIE NGUETHIE",32,41,364,346,710
KAFFRINE,KAFFRINE,KATAKEL,"MEDINATOUL SALAM 2",TABADIALENE,5,12,73,82,155
KAFFRINE,KAFFRINE,KATAKEL,"MEDINATOUL SALAM 2","H1 TABADIELEME (KEUR FAFA)",9,12,74,67,141
KAFFRINE,KAFFRINE,KATAKEL,"MEDINATOUL SALAM 2",TAGUE,33,45,270,319,589
KAFFRINE,KAFFRINE,KATAKEL,"MEDINATOUL SALAM 2",TAMBA,53,76,449,514,963
KAFFRINE,KAFFRINE,KATAKEL,"MEDINATOUL SALAM 2","YARI GOUYE",10,21,179,185,364
KAFFRINE,KAFFRINE,KATAKEL,"MEDINATOUL SALAM 2",AÏNOUMADY,66,71,437,418,855
KAFFRINE,KAFFRINE,KATAKEL,"MEDINATOUL SALAM 2",DIACKSAO,78,91,597,556,1153
KAFFRINE,KAFFRINE,KATAKEL,"MEDINATOUL SALAM 2","NDIAYE COUNDA",28,42,220,227,447
KAFFRINE,KAFFRINE,KATAKEL,DIAMAGADIO,BAMBALI,65,73,511,511,1022
KAFFRINE,KAFFRINE,KATAKEL,DIAMAGADIO,"H1 TABA",22,29,221,208,429
KAFFRINE,KAFFRINE,KATAKEL,DIAMAGADIO,DANKOU,104,139,707,660,1367
KAFFRINE,KAFFRINE,KATAKEL,DIAMAGADIO,"DAROU MINAME (SANTHIE BAKA)",13,21,117,116,233
KAFFRINE,KAFFRINE,KATAKEL,DIAMAGADIO,DIAMAGADIO,290,361,1815,2139,3954
KAFFRINE,KAFFRINE,KATAKEL,DIAMAGADIO,"DIERY (TOUBA DIERY)",10,11,73,74,147
KAFFRINE,KAFFRINE,KATAKEL,DIAMAGADIO,"DIOLY MBABA",20,28,193,154,347
KAFFRINE,KAFFRINE,KATAKEL,DIAMAGADIO,"DIOLY KEUR MOR (DIOLY KEUR MADY)",25,35,209,296,505
KAFFRINE,KAFFRINE,KATAKEL,DIAMAGADIO,"DJIMBALLA SENEGAL (DIMBALA FRANÇAIS)",16,21,118,140,258
KAFFRINE,KAFFRINE,KATAKEL,DIAMAGADIO,"DJIMBALLA VENEROU",14,21,110,118,228
KAFFRINE,KAFFRINE,KATAKEL,DIAMAGADIO,HAMDALLAHI,53,58,318,384,702
KAFFRINE,KAFFRINE,KATAKEL,DIAMAGADIO,"KAYFARA I (FAFA TALIBE)",30,39,233,168,401
KAFFRINE,KAFFRINE,KATAKEL,DIAMAGADIO,"KAYFARA SANTHIE",62,74,435,490,925
KAFFRINE,KAFFRINE,KATAKEL,DIAMAGADIO,"H1 MOUNAWARA",4,4,20,7,27
KAFFRINE,KAFFRINE,KATAKEL,DIAMAGADIO,"KANOUMA MBOYENE",31,41,237,227,464
KAFFRINE,KAFFRINE,KATAKEL,DIAMAGADIO,"H1 TOUBA TAWFEKH",1,2,36,4,40
KAFFRINE,KAFFRINE,KATAKEL,DIAMAGADIO,"KEUR BATHIE",13,17,107,117,224
KAFFRINE,KAFFRINE,KATAKEL,DIAMAGADIO,"KEUR MALLE",56,69,499,444,943
KAFFRINE,KAFFRINE,KATAKEL,DIAMAGADIO,"KEUR NDIAGANE",93,114,750,671,1421
KAFFRINE,KAFFRINE,KATAKEL,DIAMAGADIO,"H1 DEUCK BOUMACK",7,11,65,76,141
KAFFRINE,KAFFRINE,KATAKEL,DIAMAGADIO,KHOUNAKH,18,18,108,82,190
KAFFRINE,KAFFRINE,KATAKEL,DIAMAGADIO,LOUBA,46,61,286,351,637
KAFFRINE,KAFFRINE,KATAKEL,DIAMAGADIO,"H2 THISSE",51,54,284,288,572
KAFFRINE,KAFFRINE,KATAKEL,DIAMAGADIO,"H3 KEUR ALY KEBA",28,28,178,162,340
KAFFRINE,KAFFRINE,KATAKEL,DIAMAGADIO,"MAKA ANDALLAH",36,42,236,247,483
KAFFRINE,KAFFRINE,KATAKEL,DIAMAGADIO,"MEDINA DIERY",47,60,307,349,656
KAFFRINE,KAFFRINE,KATAKEL,DIAMAGADIO,"MEDINATOUL SALAM I (SANTHIE AMATH MARAM)",36,48,291,419,710
KAFFRINE,KAFFRINE,KATAKEL,DIAMAGADIO,"MEO NDIAWENE",60,84,514,536,1050
KAFFRINE,KAFFRINE,KATAKEL,DIAMAGADIO,"NDAKHAR PEULH",63,74,503,511,1014
KAFFRINE,KAFFRINE,KATAKEL,DIAMAGADIO,NDANKHE,19,24,165,141,306
KAFFRINE,KAFFRINE,KATAKEL,DIAMAGADIO,"H1 SANTHIE",5,9,58,54,112
KAFFRINE,KAFFRINE,KATAKEL,DIAMAGADIO,"NDIAO BAMBALY",124,141,872,822,1694
KAFFRINE,KAFFRINE,KATAKEL,DIAMAGADIO,"NDIOCK (NDIOCK DIMB)",32,35,274,264,538
KAFFRINE,KAFFRINE,KATAKEL,DIAMAGADIO,"GOUYE MADY BOURRY",50,65,204,264,468
KAFFRINE,KAFFRINE,KATAKEL,DIAMAGADIO,"PASSY NDIALAKH",50,66,341,230,571
KAFFRINE,KAFFRINE,KATAKEL,DIAMAGADIO,"TOUBA MEDINA (MEDINA MAKA)",16,26,160,208,368
KAFFRINE,KAFFRINE,KATAKEL,DIAMAGADIO,"TOUBA NGUETTE (NGUETTENE)",14,15,89,125,214
KAFFRINE,KAFFRINE,KATAKEL,DIAMAGADIO,WINTINKOU,20,29,177,243,420
KAFFRINE,KAFFRINE,KATAKEL,DIAMAGADIO,"H1 WINTINKOU BOUMACK",15,21,153,146,299
KAFFRINE,KAFFRINE,KATAKEL,NGANDA,"DIOKOUL KAO",31,35,166,223,389
KAFFRINE,KAFFRINE,KATAKEL,NGANDA,"DIOKOUL KELIMANE",36,43,231,319,550
KAFFRINE,KAFFRINE,KATAKEL,NGANDA,KELIMANE,169,202,1428,1631,3059
KAFFRINE,KAFFRINE,KATAKEL,NGANDA,MINNA,190,246,1362,1599,2961
KAFFRINE,KAFFRINE,KATAKEL,NGANDA,"NGANDA CENTRE",360,478,2423,2760,5183
KAFFRINE,KAFFRINE,KATAKEL,NGANDA,"SANTHIE DIMB",116,144,1090,1137,2227
KAFFRINE,BIRKELANE,BIRKELANE,BIRKELANE,"GADGA ESCALE",162,295,947,1064,2011
KAFFRINE,BIRKELANE,BIRKELANE,BIRKELANE,SANTHIABA,214,234,1096,1114,2210
KAFFRINE,BIRKELANE,BIRKELANE,BIRKELANE,"TALLY BA",213,242,1224,1195,2419
KAFFRINE,BIRKELANE,BIRKELANE,BIRKELANE,THIERERE,186,223,991,1178,2169
KAFFRINE,BIRKELANE,BIRKELANE,BIRKELANE,"GUINAW RAYE",200,224,1012,1070,2082
KAFFRINE,BIRKELANE,"KEUR MBOUCKI","KEUR MBOUCKI","DARA NGUER ET NGUER MABADIANE",73,86,414,409,823
KAFFRINE,BIRKELANE,"KEUR MBOUCKI","KEUR MBOUCKI","H1 WASAKOL",10,16,111,120,231
KAFFRINE,BIRKELANE,"KEUR MBOUCKI","KEUR MBOUCKI","DIMBE GALE",11,13,104,80,184
KAFFRINE,BIRKELANE,"KEUR MBOUCKI","KEUR MBOUCKI","H1 DIMBE GALE PEULH",3,3,13,19,32
KAFFRINE,BIRKELANE,"KEUR MBOUCKI","KEUR MBOUCKI","H2 KEUR SAMBA BA",4,4,22,16,38
KAFFRINE,BIRKELANE,"KEUR MBOUCKI","KEUR MBOUCKI",GANKY,4,11,29,32,61
KAFFRINE,BIRKELANE,"KEUR MBOUCKI","KEUR MBOUCKI","KEUR EL HADJI MALICK",20,22,152,115,267
KAFFRINE,BIRKELANE,"KEUR MBOUCKI","KEUR MBOUCKI","KEUR MAGAYE",41,43,188,198,386
KAFFRINE,BIRKELANE,"KEUR MBOUCKI","KEUR MBOUCKI","KEUR MASSER",14,17,118,71,189
KAFFRINE,BIRKELANE,"KEUR MBOUCKI","KEUR MBOUCKI","KEUR MBOUCKI",95,106,558,559,1117
KAFFRINE,BIRKELANE,"KEUR MBOUCKI","KEUR MBOUCKI","H1 KEUR MBOUKI II",8,12,58,49,107
KAFFRINE,BIRKELANE,"KEUR MBOUCKI","KEUR MBOUCKI","H2 NDAME",4,5,20,14,34
KAFFRINE,BIRKELANE,"KEUR MBOUCKI","KEUR MBOUCKI","H3 DAGANA",2,2,10,13,23
KAFFRINE,BIRKELANE,"KEUR MBOUCKI","KEUR MBOUCKI","KEUR NOLORY",21,25,150,131,281
KAFFRINE,BIRKELANE,"KEUR MBOUCKI","KEUR MBOUCKI",MBODIENE,9,10,47,44,91
KAFFRINE,BIRKELANE,"KEUR MBOUCKI","KEUR MBOUCKI","H2 BAPEDJI",25,29,153,166,319
KAFFRINE,BIRKELANE,"KEUR MBOUCKI","KEUR MBOUCKI",NAVEL,31,33,206,210,416
KAFFRINE,BIRKELANE,"KEUR MBOUCKI","KEUR MBOUCKI","NDIAYENE WALY",139,188,934,1028,1962
KAFFRINE,BIRKELANE,"KEUR MBOUCKI","KEUR MBOUCKI","NETTY THIOCOGNE",20,22,99,98,197
KAFFRINE,BIRKELANE,"KEUR MBOUCKI","KEUR MBOUCKI",NGAMBOU,22,26,186,162,348
KAFFRINE,BIRKELANE,"KEUR MBOUCKI","KEUR MBOUCKI",NGONGANE,11,11,45,41,86
KAFFRINE,BIRKELANE,"KEUR MBOUCKI","KEUR MBOUCKI","SANTHIE NAVEL",87,96,526,502,1028
KAFFRINE,BIRKELANE,"KEUR MBOUCKI","KEUR MBOUCKI","H1 SARE SAMBA",7,12,73,71,144
KAFFRINE,BIRKELANE,"KEUR MBOUCKI","KEUR MBOUCKI","THIDY DIEYE",13,14,71,92,163
KAFFRINE,BIRKELANE,"KEUR MBOUCKI","KEUR MBOUCKI","THYCATT KEUR GALLO",11,13,89,65,154
KAFFRINE,BIRKELANE,"KEUR MBOUCKI","KEUR MBOUCKI","H1 BOULY",11,13,80,67,147
KAFFRINE,BIRKELANE,"KEUR MBOUCKI","KEUR MBOUCKI","THYCATT OUOLOF",86,97,623,717,1340
KAFFRINE,BIRKELANE,"KEUR MBOUCKI","KEUR MBOUCKI","TOUBA KHADAMA",60,66,412,285,697
KAFFRINE,BIRKELANE,"KEUR MBOUCKI","KEUR MBOUCKI","H1 GORIA",8,10,48,65,113
KAFFRINE,BIRKELANE,"KEUR MBOUCKI","KEUR MBOUCKI","YALLAL GATTA",10,10,66,56,122
KAFFRINE,BIRKELANE,"KEUR MBOUCKI","KEUR MBOUCKI","H1 GANKY PEULH",1,2,21,11,32
KAFFRINE,BIRKELANE,"KEUR MBOUCKI","KEUR MBOUCKI","YALLAL MAISSA",9,13,65,41,106
KAFFRINE,BIRKELANE,"KEUR MBOUCKI","KEUR MBOUCKI","H1 MBOULOUM KEUR DIALLO",18,23,129,128,257
KAFFRINE,BIRKELANE,"KEUR MBOUCKI","KEUR MBOUCKI","KEUR MANDIAYE",12,14,97,64,161
KAFFRINE,BIRKELANE,"KEUR MBOUCKI","KEUR MBOUCKI","KEUR MBOUCKI (NDIENE)",80,86,518,479,997
KAFFRINE,BIRKELANE,"KEUR MBOUCKI","KEUR MBOUCKI","KEUR MBOUCKI (THIEWE)",83,90,552,489,1041
KAFFRINE,BIRKELANE,"KEUR MBOUCKI","KEUR MBOUCKI",KOUNIASS,40,44,293,242,535
KAFFRINE,BIRKELANE,"KEUR MBOUCKI","TOUBA MBELLA",BAGANA,22,26,109,106,215
KAFFRINE,BIRKELANE,"KEUR MBOUCKI","TOUBA MBELLA","H2 NGATTY",4,4,40,42,82
KAFFRINE,BIRKELANE,"KEUR MBOUCKI","TOUBA MBELLA","BAILA NDOUR",61,68,325,359,684
KAFFRINE,BIRKELANE,"KEUR MBOUCKI","TOUBA MBELLA","H1 NDIAWENE",16,17,62,81,143
KAFFRINE,BIRKELANE,"KEUR MBOUCKI","TOUBA MBELLA",BIDIAM,79,90,521,498,1019
KAFFRINE,BIRKELANE,"KEUR MBOUCKI","TOUBA MBELLA","BOSSOLEL PEULH",22,23,157,134,291
KAFFRINE,BIRKELANE,"KEUR MBOUCKI","TOUBA MBELLA","H3 KEUR DEMBA",8,9,49,40,89
KAFFRINE,BIRKELANE,"KEUR MBOUCKI","TOUBA MBELLA",DADIELE,6,18,103,76,179
KAFFRINE,BIRKELANE,"KEUR MBOUCKI","TOUBA MBELLA","H1 GATTY YORO",4,4,24,26,50
KAFFRINE,BIRKELANE,"KEUR MBOUCKI","TOUBA MBELLA","DIACKE MARAME (MBOUBENE)",13,24,97,101,198
KAFFRINE,BIRKELANE,"KEUR MBOUCKI","TOUBA MBELLA","DIACKE SAMBA",25,30,147,92,239
KAFFRINE,BIRKELANE,"KEUR MBOUCKI","TOUBA MBELLA","DIASSOUM DIAMAGUENE",42,49,213,233,446
KAFFRINE,BIRKELANE,"KEUR MBOUCKI","TOUBA MBELLA","DIASSOUM WILLANENE",15,16,72,77,149
KAFFRINE,BIRKELANE,"KEUR MBOUCKI","TOUBA MBELLA","GAWANE DJIDAH",23,33,215,154,369
KAFFRINE,BIRKELANE,"KEUR MBOUCKI","TOUBA MBELLA","GORY MBANDE",24,26,118,105,223
KAFFRINE,BIRKELANE,"KEUR MBOUCKI","TOUBA MBELLA",KANKA,6,11,42,47,89
KAFFRINE,BIRKELANE,"KEUR MBOUCKI","TOUBA MBELLA","KEUR YORO DIOMBO",13,30,127,115,242
KAFFRINE,BIRKELANE,"KEUR MBOUCKI","TOUBA MBELLA",LEWE,9,9,49,57,106
KAFFRINE,BIRKELANE,"KEUR MBOUCKI","TOUBA MBELLA","MBELLA SALOUM",34,41,265,275,540
KAFFRINE,BIRKELANE,"KEUR MBOUCKI","TOUBA MBELLA","MBELLA PEULH (BOULI BANI)",10,14,75,84,159
KAFFRINE,BIRKELANE,"KEUR MBOUCKI","TOUBA MBELLA","H1 MBELLA PEULH",14,17,90,73,163
KAFFRINE,BIRKELANE,"KEUR MBOUCKI","TOUBA MBELLA","BOSSOLEL/ BOSSOLEL DIAWENE",96,105,497,537,1034
KAFFRINE,BIRKELANE,"KEUR MBOUCKI","TOUBA MBELLA","H2 MANGOUM",6,9,35,36,71
KAFFRINE,BIRKELANE,"KEUR MBOUCKI","TOUBA MBELLA","H1 BOSSOLEL OUOLOF",18,23,90,110,200
KAFFRINE,BIRKELANE,"KEUR MBOUCKI","TOUBA MBELLA","MEDINATOUL SALAM",27,31,174,187,361
KAFFRINE,BIRKELANE,"KEUR MBOUCKI","TOUBA MBELLA","NDIOUNDIA I",27,38,216,226,442
KAFFRINE,BIRKELANE,"KEUR MBOUCKI","TOUBA MBELLA","NETTY BIREYE",9,17,68,93,161
KAFFRINE,BIRKELANE,"KEUR MBOUCKI","TOUBA MBELLA","H2 NDIORENE",7,7,39,35,74
KAFFRINE,BIRKELANE,"KEUR MBOUCKI","TOUBA MBELLA","NETTY DAGA OUOLOF (NDAWENE)",17,18,74,101,175
KAFFRINE,BIRKELANE,"KEUR MBOUCKI","TOUBA MBELLA","NETTY DAGA PEULH",24,28,116,95,211
KAFFRINE,BIRKELANE,"KEUR MBOUCKI","TOUBA MBELLA","H1 KEUR MAMADOU SIRA",8,9,43,37,80
KAFFRINE,BIRKELANE,"KEUR MBOUCKI","TOUBA MBELLA","NETTY SASSY",9,17,75,74,149
KAFFRINE,BIRKELANE,"KEUR MBOUCKI","TOUBA MBELLA",NGALLICK,11,14,99,81,180
KAFFRINE,BIRKELANE,"KEUR MBOUCKI","TOUBA MBELLA","SARE NDIOUGARY",26,30,187,180,367
KAFFRINE,BIRKELANE,"KEUR MBOUCKI","TOUBA MBELLA","SOMB DIACK",23,29,209,187,396
KAFFRINE,BIRKELANE,"KEUR MBOUCKI","TOUBA MBELLA",THIARLCOGNE,5,6,42,39,81
KAFFRINE,BIRKELANE,"KEUR MBOUCKI","TOUBA MBELLA","H2 GATTY SALIF",2,2,13,6,19
KAFFRINE,BIRKELANE,"KEUR MBOUCKI","TOUBA MBELLA","TIVAOUANE LEWE",45,50,309,317,626
KAFFRINE,BIRKELANE,"KEUR MBOUCKI","TOUBA MBELLA","TOUBA MBELLA",129,172,841,726,1567
KAFFRINE,BIRKELANE,"KEUR MBOUCKI","TOUBA MBELLA",WEYNDE,85,95,536,422,958
KAFFRINE,BIRKELANE,"KEUR MBOUCKI","TOUBA MBELLA","YALAL DIAKE",18,41,168,133,301
KAFFRINE,BIRKELANE,"KEUR MBOUCKI","TOUBA MBELLA","H1 SARE DEMBA GNABO",4,9,30,19,49
KAFFRINE,BIRKELANE,"KEUR MBOUCKI","TOUBA MBELLA","DAROU SALAM SENE",1,2,76,17,93
KAFFRINE,BIRKELANE,"KEUR MBOUCKI","TOUBA MBELLA","GUENTHE LOBOYE (KEUR SAMBA)",7,8,43,44,87
KAFFRINE,BIRKELANE,"KEUR MBOUCKI","TOUBA MBELLA","HALTOU BAGANA",32,37,225,207,432
KAFFRINE,BIRKELANE,"KEUR MBOUCKI","TOUBA MBELLA","KAI YALAL DIAKE",10,20,78,77,155
KAFFRINE,BIRKELANE,"KEUR MBOUCKI","TOUBA MBELLA","KEUR BAME",8,12,51,54,105
KAFFRINE,BIRKELANE,"KEUR MBOUCKI","TOUBA MBELLA","MBATHIARE I",7,8,38,49,87
KAFFRINE,BIRKELANE,"KEUR MBOUCKI","TOUBA MBELLA","MBATHIARE II",9,14,66,66,132
KAFFRINE,BIRKELANE,"KEUR MBOUCKI","TOUBA MBELLA","NDOUNDIA II",13,15,74,72,146
KAFFRINE,BIRKELANE,"KEUR MBOUCKI",DIAMAL,"DAROU SALAM III",5,5,27,19,46
KAFFRINE,BIRKELANE,"KEUR MBOUCKI",DIAMAL,DIAMAL,182,241,1651,1476,3127
KAFFRINE,BIRKELANE,"KEUR MBOUCKI",DIAMAL,"H2 SANTHIABA",20,23,528,250,778
KAFFRINE,BIRKELANE,"KEUR MBOUCKI",DIAMAL,"H3 PEULH DIAMAL",4,9,72,46,118
KAFFRINE,BIRKELANE,"KEUR MBOUCKI",DIAMAL,"H4 KEUR DIAM",13,15,63,67,130
KAFFRINE,BIRKELANE,"KEUR MBOUCKI",DIAMAL,"H5 KEUR DIOUBOL",6,13,111,97,208
KAFFRINE,BIRKELANE,"KEUR MBOUCKI",DIAMAL,"FASS SY",6,8,44,45,89
KAFFRINE,BIRKELANE,"KEUR MBOUCKI",DIAMAL,GAMA,29,33,163,124,287
KAFFRINE,BIRKELANE,"KEUR MBOUCKI",DIAMAL,"H1 DAGAY NDENE",69,89,441,388,829
KAFFRINE,BIRKELANE,"KEUR MBOUCKI",DIAMAL,"GAINTH BOYE",32,38,228,210,438
KAFFRINE,BIRKELANE,"KEUR MBOUCKI",DIAMAL,"KEBE GOUYE",13,16,112,97,209
KAFFRINE,BIRKELANE,"KEUR MBOUCKI",DIAMAL,"H1 KEUR ABOU SOW",1,1,8,7,15
KAFFRINE,BIRKELANE,"KEUR MBOUCKI",DIAMAL,"KEBE KEUR LAHINE",41,48,342,362,704
KAFFRINE,BIRKELANE,"KEUR MBOUCKI",DIAMAL,"H1 THIALLANENE",12,14,67,60,127
KAFFRINE,BIRKELANE,"KEUR MBOUCKI",DIAMAL,"KEBE THIEYENE",18,20,125,130,255
KAFFRINE,BIRKELANE,"KEUR MBOUCKI",DIAMAL,"KELEL MOFEL",30,34,186,190,376
KAFFRINE,BIRKELANE,"KEUR MBOUCKI",DIAMAL,"H1 KEUR MAMADOU DABO",9,12,67,74,141
KAFFRINE,BIRKELANE,"KEUR MBOUCKI",DIAMAL,"KEUR IBRA NDOUR",3,3,17,15,32
KAFFRINE,BIRKELANE,"KEUR MBOUCKI",DIAMAL,"H1 KEUR YORO TANDA",6,8,55,50,105
KAFFRINE,BIRKELANE,"KEUR MBOUCKI",DIAMAL,"H2 KEUR DIOUMA",8,11,80,51,131
KAFFRINE,BIRKELANE,"KEUR MBOUCKI",DIAMAL,"H3 KEUR MBISSANE",4,5,28,26,54
KAFFRINE,BIRKELANE,"KEUR MBOUCKI",DIAMAL,"H4 FASS MAKHTAR",23,23,431,87,518
KAFFRINE,BIRKELANE,"KEUR MBOUCKI",DIAMAL,"KEUR IBRAHIMA MBAYE",38,50,306,223,529
KAFFRINE,BIRKELANE,"KEUR MBOUCKI",DIAMAL,"KEUR ISMAILA",82,114,798,854,1652
KAFFRINE,BIRKELANE,"KEUR MBOUCKI",DIAMAL,"H1 KEUR GORY",5,10,37,34,71
KAFFRINE,BIRKELANE,"KEUR MBOUCKI",DIAMAL,"KORKY BAMBARA",44,57,336,300,636
KAFFRINE,BIRKELANE,"KEUR MBOUCKI",DIAMAL,"LOUMBEL KORKY PEULH",3,3,16,19,35
KAFFRINE,BIRKELANE,"KEUR MBOUCKI",DIAMAL,"H1 PATAR LADJI",2,6,34,29,63
KAFFRINE,BIRKELANE,"KEUR MBOUCKI",DIAMAL,"H2 NDIAO",3,5,33,22,55
KAFFRINE,BIRKELANE,"KEUR MBOUCKI",DIAMAL,"KORKY SERÈRE",18,30,131,122,253
KAFFRINE,BIRKELANE,"KEUR MBOUCKI",DIAMAL,"H2 LOUMBEL",12,17,114,103,217
KAFFRINE,BIRKELANE,"KEUR MBOUCKI",DIAMAL,KOUMBOF,13,13,77,70,147
KAFFRINE,BIRKELANE,"KEUR MBOUCKI",DIAMAL,LOUGOL,27,29,117,103,220
KAFFRINE,BIRKELANE,"KEUR MBOUCKI",DIAMAL,"H1 NETTE LOUGOL",13,19,107,91,198
KAFFRINE,BIRKELANE,"KEUR MBOUCKI",DIAMAL,"MBANDE OUOLOF",10,13,59,59,118
KAFFRINE,BIRKELANE,"KEUR MBOUCKI",DIAMAL,"MBANDE PEULH",17,20,105,90,195
KAFFRINE,BIRKELANE,"KEUR MBOUCKI",DIAMAL,"MOUYE NDAGANE",8,9,50,30,80
KAFFRINE,BIRKELANE,"KEUR MBOUCKI",DIAMAL,NDANGANE,48,59,360,310,670
KAFFRINE,BIRKELANE,"KEUR MBOUCKI",DIAMAL,"H4 KEUR DIOUNDOU",4,6,22,23,45
KAFFRINE,BIRKELANE,"KEUR MBOUCKI",DIAMAL,"NGORDJILENE MOURID",41,61,341,362,703
KAFFRINE,BIRKELANE,"KEUR MBOUCKI",DIAMAL,GUISSAM,11,13,84,70,154
KAFFRINE,BIRKELANE,"KEUR MBOUCKI",DIAMAL,"H1 NGUISSAM PEULH",4,11,86,62,148
KAFFRINE,BIRKELANE,"KEUR MBOUCKI",DIAMAL,"NGORDJELENE WILLANENE",25,30,176,198,374
KAFFRINE,BIRKELANE,"KEUR MBOUCKI",DIAMAL,"DIAMAGUENE (KEUR SASSY)",35,39,192,166,358
KAFFRINE,BIRKELANE,"KEUR MBOUCKI",DIAMAL,"KORKY DIAMEGEUNE",6,12,73,65,138
KAFFRINE,BIRKELANE,MABO,MABO,BARKEDJI,17,17,112,119,231
KAFFRINE,BIRKELANE,MABO,MABO,"H1 MBAYENE",19,30,212,174,386
KAFFRINE,BIRKELANE,MABO,MABO,"DAGA BALLA",124,139,1029,881,1910
KAFFRINE,BIRKELANE,MABO,MABO,"H1 PEULGA",4,6,41,38,79
KAFFRINE,BIRKELANE,MABO,MABO,"DIAMA FARA",122,155,920,862,1782
KAFFRINE,BIRKELANE,MABO,MABO,"H1 CISSE",20,24,102,101,203
KAFFRINE,BIRKELANE,MABO,MABO,"NDIAO SOUKOUM",12,14,84,73,157
KAFFRINE,BIRKELANE,MABO,MABO,"H1 KEUR SAMBA DIAO",3,3,30,20,50
KAFFRINE,BIRKELANE,MABO,MABO,NDOYLI,46,76,471,443,914
KAFFRINE,BIRKELANE,MABO,MABO,"FASS DIA",18,23,132,132,264
KAFFRINE,BIRKELANE,MABO,MABO,"FASS GADE (KEUR IBRA TOURE)",26,30,218,171,389
KAFFRINE,BIRKELANE,MABO,MABO,"KEUR DEMBA BA",5,7,34,27,61
KAFFRINE,BIRKELANE,MABO,MABO,"KAPAYE DIABEL",10,15,91,77,168
KAFFRINE,BIRKELANE,MABO,MABO,"H1 SANTJIE DIAMAL",4,6,31,33,64
KAFFRINE,BIRKELANE,MABO,MABO,KASSAS,152,182,1159,1263,2422
KAFFRINE,BIRKELANE,MABO,MABO,"H1 KASSAS TOUCOULEUR",10,10,105,95,200
KAFFRINE,BIRKELANE,MABO,MABO,"KEUR EL HADJI BABOU SECK",52,72,502,503,1005
KAFFRINE,BIRKELANE,MABO,MABO,"KEUR DJIBY",51,63,268,217,485
KAFFRINE,BIRKELANE,MABO,MABO,"H1 BOCKY BANEL",9,11,65,42,107
KAFFRINE,BIRKELANE,MABO,MABO,"KEUR GATA PEULH",10,11,53,47,100
KAFFRINE,BIRKELANE,MABO,MABO,"H2 KEUR SABALANGAR",17,18,86,96,182
KAFFRINE,BIRKELANE,MABO,MABO,"H3 KEUR MOUSSA THIOUNE",11,15,79,83,162
KAFFRINE,BIRKELANE,MABO,MABO,"KEUR KATIM",15,21,142,135,277
KAFFRINE,BIRKELANE,MABO,MABO,"KEUR MADEMBA GUEYE I",24,27,378,218,596
KAFFRINE,BIRKELANE,MABO,MABO,"H1 MBAMBARA",7,7,92,66,158
KAFFRINE,BIRKELANE,MABO,MABO,"KEUR MADEMBA GUEYE II",23,28,216,247,463
KAFFRINE,BIRKELANE,MABO,MABO,"MAKA SACOUMBA",111,120,839,825,1664
KAFFRINE,BIRKELANE,MABO,MABO,"KEUR NDONGO",16,18,102,90,192
KAFFRINE,BIRKELANE,MABO,MABO,"KONY OUOLOF",5,13,71,70,141
KAFFRINE,BIRKELANE,MABO,MABO,"H1 KONY PEULH",13,14,107,83,190
KAFFRINE,BIRKELANE,MABO,MABO,"KOUMPEUL PEULH",11,18,92,36,128
KAFFRINE,BIRKELANE,MABO,MABO,"H1 KEUR YORO BA",4,4,18,16,34
KAFFRINE,BIRKELANE,MABO,MABO,"KOUMPEUL WOLOF",59,70,629,521,1150
KAFFRINE,BIRKELANE,MABO,MABO,"MABO I",102,156,978,913,1891
KAFFRINE,BIRKELANE,MABO,MABO,"MABO PEULH",13,18,83,91,174
KAFFRINE,BIRKELANE,MABO,MABO,"MEDINA DAROU SALAM",14,20,245,169,414
KAFFRINE,BIRKELANE,MABO,MABO,"MEDINA KEUR BABOU DIA",27,30,179,215,394
KAFFRINE,BIRKELANE,MABO,MABO,"MEDINA THIAKHO (PEULH GUI)",18,21,142,121,263
KAFFRINE,BIRKELANE,MABO,MABO,"H2 KEUR AMADOU",23,25,166,170,336
KAFFRINE,BIRKELANE,MABO,MABO,"MEDINA THISSE (SANTHIE DIAMAL)",56,72,415,504,919
KAFFRINE,BIRKELANE,MABO,MABO,"NDIORAL BIRANE DIOP",38,42,334,311,645
KAFFRINE,BIRKELANE,MABO,MABO,"H1 PASSY",11,12,91,90,181
KAFFRINE,BIRKELANE,MABO,MABO,"NDIORAL DIA MBAYE",45,47,309,234,543
KAFFRINE,BIRKELANE,MABO,MABO,"NDIORAL SAMBA GAYE",37,43,350,256,606
KAFFRINE,BIRKELANE,MABO,MABO,NEMA,20,28,121,110,231
KAFFRINE,BIRKELANE,MABO,MABO,WANAR,65,81,567,670,1237
KAFFRINE,BIRKELANE,MABO,MABO,"SANTHIE NDIAO",35,45,193,293,486
KAFFRINE,BIRKELANE,MABO,MABO,"H1 KEUR SAWALO",16,19,95,124,219
KAFFRINE,BIRKELANE,MABO,MABO,"SANNTHIE  THIAKHO",25,29,238,238,476
KAFFRINE,BIRKELANE,MABO,MABO,SIMBARA,69,78,372,377,749
KAFFRINE,BIRKELANE,MABO,MABO,"H1 KEUR GATTA",6,7,50,41,91
KAFFRINE,BIRKELANE,MABO,MABO,"H2 KEUR GALLO KA",4,9,45,41,86
KAFFRINE,BIRKELANE,MABO,MABO,"SINE MADAMEL",39,48,301,314,615
KAFFRINE,BIRKELANE,MABO,MABO,"H1 PEULGUA",2,3,17,15,32
KAFFRINE,BIRKELANE,MABO,MABO,"H2 SINE MADAMEL",19,29,190,204,394
KAFFRINE,BIRKELANE,MABO,MABO,"SINE MOURIDE",31,35,230,234,464
KAFFRINE,BIRKELANE,MABO,MABO,"DAROU SALAM WANAR",173,212,1412,1428,2840
KAFFRINE,BIRKELANE,MABO,MABO,"TALENE I",19,20,192,151,343
KAFFRINE,BIRKELANE,MABO,MABO,"TALLENE II",33,43,294,262,556
KAFFRINE,BIRKELANE,MABO,MABO,"TALENE III",13,18,198,135,333
KAFFRINE,BIRKELANE,MABO,MABO,"TAMBA DIAKHA",22,28,163,206,369
KAFFRINE,BIRKELANE,MABO,MABO,"H1 SAMBA TEDY",3,6,36,35,71
KAFFRINE,BIRKELANE,MABO,MABO,"THIAKHO SERY",35,40,316,312,628
KAFFRINE,BIRKELANE,MABO,MABO,"MABO II",62,79,535,548,1083
KAFFRINE,BIRKELANE,MABO,MABO,"MABO III",74,95,511,372,883
KAFFRINE,BIRKELANE,MABO,MABO,"MEDINA THIAKHO",44,49,366,324,690
KAFFRINE,BIRKELANE,MABO,MABO,"SANTHIE IBRA",53,78,450,508,958
KAFFRINE,BIRKELANE,MABO,NDIOGNICK,"ALY NGANE I",7,10,45,34,79
KAFFRINE,BIRKELANE,MABO,NDIOGNICK,"ALY NGANE II",6,7,21,23,44
KAFFRINE,BIRKELANE,MABO,NDIOGNICK,BAITITE,60,74,452,453,905
KAFFRINE,BIRKELANE,MABO,NDIOGNICK,"H1 BAITITE SANTHIABA",11,13,77,85,162
KAFFRINE,BIRKELANE,MABO,NDIOGNICK,BOUCHRA,72,94,521,621,1142
KAFFRINE,BIRKELANE,MABO,NDIOGNICK,BOUNAKH,8,12,48,53,101
KAFFRINE,BIRKELANE,MABO,NDIOGNICK,"DAGA BIRAME",86,97,588,667,1255
KAFFRINE,BIRKELANE,MABO,NDIOGNICK,"DAROU NANDJIGUI",102,119,850,898,1748
KAFFRINE,BIRKELANE,MABO,NDIOGNICK,"DAROU PAKALA",55,61,321,427,748
KAFFRINE,BIRKELANE,MABO,NDIOGNICK,"H1 LOUMENE PAKALA",12,16,67,63,130
KAFFRINE,BIRKELANE,MABO,NDIOGNICK,DIAMACOLONG,130,175,778,1007,1785
KAFFRINE,BIRKELANE,MABO,NDIOGNICK,"GODJI AMADOU MATAR",46,51,292,288,580
KAFFRINE,BIRKELANE,MABO,NDIOGNICK,"H1 KEUR SERIGNE",48,59,319,336,655
KAFFRINE,BIRKELANE,MABO,NDIOGNICK,"GODJI AMATH NDAO",39,47,230,269,499
KAFFRINE,BIRKELANE,MABO,NDIOGNICK,"H1 LAOBEGUI",5,5,18,22,40
KAFFRINE,BIRKELANE,MABO,NDIOGNICK,"GOBACK KEUR SAMBA",26,30,304,198,502
KAFFRINE,BIRKELANE,MABO,NDIOGNICK,"GOBACK SOUKOUM",10,14,65,66,131
KAFFRINE,BIRKELANE,MABO,NDIOGNICK,"H1 GOBACK SOUCKOUM",47,58,383,359,742
KAFFRINE,BIRKELANE,MABO,NDIOGNICK,"H2 GOBACK NDAWENE",17,20,109,77,186
KAFFRINE,BIRKELANE,MABO,NDIOGNICK,"H3 KEUR BOGO BA",10,15,91,74,165
KAFFRINE,BIRKELANE,MABO,NDIOGNICK,"HAMDALAYE OUOLOF",14,17,100,88,188
KAFFRINE,BIRKELANE,MABO,NDIOGNICK,"HAMDALAYE PEULH (KEUR GALLO)",10,11,60,46,106
KAFFRINE,BIRKELANE,MABO,NDIOGNICK,"H1 HAMDALAYE PEULGA",5,13,45,38,83
KAFFRINE,BIRKELANE,MABO,NDIOGNICK,"KATHIAWANE PEULH",21,37,304,284,588
KAFFRINE,BIRKELANE,MABO,NDIOGNICK,"H1 KEUR GATTA PEULH",6,12,71,66,137
KAFFRINE,BIRKELANE,MABO,NDIOGNICK,"H2 KEUR DIOMBO",8,11,86,75,161
KAFFRINE,BIRKELANE,MABO,NDIOGNICK,"H3 KEUR SAWELY PEULH",10,16,93,71,164
KAFFRINE,BIRKELANE,MABO,NDIOGNICK,"KATHIAWANE WOLOF",44,60,345,390,735
KAFFRINE,BIRKELANE,MABO,NDIOGNICK,"KEBE KEUR BABOU",41,58,260,183,443
KAFFRINE,BIRKELANE,MABO,NDIOGNICK,"KEUR BAKA NGOYE",23,27,184,147,331
KAFFRINE,BIRKELANE,MABO,NDIOGNICK,"KEUR BIRANE NGODE",2,2,11,13,24
KAFFRINE,BIRKELANE,MABO,NDIOGNICK,"KEUR EL HADJI MOR COUMBA",38,40,202,206,408
KAFFRINE,BIRKELANE,MABO,NDIOGNICK,"KEUR IBRA FALL",12,17,170,131,301
KAFFRINE,BIRKELANE,MABO,NDIOGNICK,"H1 PEULGA KEUR IBRA FALL",12,14,103,101,204
KAFFRINE,BIRKELANE,MABO,NDIOGNICK,"KEUR MODOU NDIAMATOU",36,46,302,309,611
KAFFRINE,BIRKELANE,MABO,NDIOGNICK,"H1 PEULGA GALLO BA",9,14,74,64,138
KAFFRINE,BIRKELANE,MABO,NDIOGNICK,"KEUR MODOU WILAME",50,61,387,353,740
KAFFRINE,BIRKELANE,MABO,NDIOGNICK,"KEUR NDERY",74,82,564,527,1091
KAFFRINE,BIRKELANE,MABO,NDIOGNICK,"KEUR PATHE DEME",45,56,309,275,584
KAFFRINE,BIRKELANE,MABO,NDIOGNICK,"H1 KEUR PATHE PEULGA",4,4,34,38,72
KAFFRINE,BIRKELANE,MABO,NDIOGNICK,"KEUR SADER",47,69,489,530,1019
KAFFRINE,BIRKELANE,MABO,NDIOGNICK,"KEUR SAWELY",111,151,1272,1205,2477
KAFFRINE,BIRKELANE,MABO,NDIOGNICK,"KEUR GOUMBO (KEUR SERIGNE GOUMBO)",68,73,377,418,795
KAFFRINE,BIRKELANE,MABO,NDIOGNICK,"H1 BAMBARA",8,9,60,57,117
KAFFRINE,BIRKELANE,MABO,NDIOGNICK,"KEUR SEYDOU BA",29,36,161,163,324
KAFFRINE,BIRKELANE,MABO,NDIOGNICK,"KEUR SIRIKY DIOP",32,35,257,263,520
KAFFRINE,BIRKELANE,MABO,NDIOGNICK,"KEUR THIERNO TALLA",52,66,374,393,767
KAFFRINE,BIRKELANE,MABO,NDIOGNICK,LANTA,8,9,46,25,71
KAFFRINE,BIRKELANE,MABO,NDIOGNICK,"H2 TEUGUEGUA",12,12,101,31,132
KAFFRINE,BIRKELANE,MABO,NDIOGNICK,LOUMENE,106,121,885,803,1688
KAFFRINE,BIRKELANE,MABO,NDIOGNICK,"H1 KEUR MADY",7,7,33,29,62
KAFFRINE,BIRKELANE,MABO,NDIOGNICK,"H2 KEUR BAKARY",20,22,123,119,242
KAFFRINE,BIRKELANE,MABO,NDIOGNICK,"H3 LOUMENE PEULGA",8,9,64,15,79
KAFFRINE,BIRKELANE,MABO,NDIOGNICK,MBOUKHOUME,27,37,198,175,373
KAFFRINE,BIRKELANE,MABO,NDIOGNICK,BOUPNAM,9,13,66,70,136
KAFFRINE,BIRKELANE,MABO,NDIOGNICK,"MEDINA NDIOGNICK",23,28,172,157,329
KAFFRINE,BIRKELANE,MABO,NDIOGNICK,MORIBOUGOU,33,37,272,235,507
KAFFRINE,BIRKELANE,MABO,NDIOGNICK,"H1 PEULGA (NDIMB)",7,10,57,39,96
KAFFRINE,BIRKELANE,MABO,NDIOGNICK,"MOUYE NDIAGNENE",29,38,314,333,647
KAFFRINE,BIRKELANE,MABO,NDIOGNICK,NANDJIGUI,34,40,260,322,582
KAFFRINE,BIRKELANE,MABO,NDIOGNICK,NDIABO,24,36,190,213,403
KAFFRINE,BIRKELANE,MABO,NDIOGNICK,"H1 NDIABO PEULH",7,7,39,38,77
KAFFRINE,BIRKELANE,MABO,NDIOGNICK,"NDIAGNENE BOBORY",16,19,94,131,225
KAFFRINE,BIRKELANE,MABO,NDIOGNICK,"NDIAYENE BAGANA",50,66,412,443,855
KAFFRINE,BIRKELANE,MABO,NDIOGNICK,"NDIMB KORKY",92,95,618,602,1220
KAFFRINE,BIRKELANE,MABO,NDIOGNICK,NDIOGNICK,64,86,426,511,937
KAFFRINE,BIRKELANE,MABO,NDIOGNICK,"NDIOGNICK PEULH",20,27,138,105,243
KAFFRINE,BIRKELANE,MABO,NDIOGNICK,NDRAME,58,81,345,464,809
KAFFRINE,BIRKELANE,MABO,NDIOGNICK,"H1 NDIORENE",2,4,21,23,44
KAFFRINE,BIRKELANE,MABO,NDIOGNICK,NGOUYE,196,254,1524,1693,3217
KAFFRINE,BIRKELANE,MABO,NDIOGNICK,NIANGHENE,44,54,313,317,630
KAFFRINE,BIRKELANE,MABO,NDIOGNICK,"SEGRE BAMBARA",43,49,373,335,708
KAFFRINE,BIRKELANE,MABO,NDIOGNICK,"SEGRE SECCO",150,213,1388,1386,2774
KAFFRINE,BIRKELANE,MABO,NDIOGNICK,"H1 KEUR DIOUMA BA",14,21,145,123,268
KAFFRINE,BIRKELANE,MABO,NDIOGNICK,"H2 KEUR GALLO DIAO",15,22,82,81,163
KAFFRINE,BIRKELANE,MABO,NDIOGNICK,TAIF,43,49,283,408,691
KAFFRINE,BIRKELANE,MABO,NDIOGNICK,"HI DIAMAGUENE",3,7,56,31,87
KAFFRINE,BIRKELANE,MABO,NDIOGNICK,THIANTE,48,72,458,395,853
KAFFRINE,BIRKELANE,MABO,NDIOGNICK,"TOUBA NIANE",27,29,160,149,309
KAFFRINE,BIRKELANE,MABO,NDIOGNICK,"KEUR DEMBA",3,15,60,40,100
KAFFRINE,BIRKELANE,MABO,NDIOGNICK,"TOUBA PAKALA",10,15,72,93,165
KAFFRINE,BIRKELANE,MABO,MBEULEUP,"DAROU SALAM",18,27,155,149,304
KAFFRINE,BIRKELANE,MABO,MBEULEUP,"DIATTA FAKHA",70,88,363,403,766
KAFFRINE,BIRKELANE,MABO,MBEULEUP,"HAMDALAYE MBEULEUP ( HAMDALAYE L0NKANE)",25,35,149,178,327
KAFFRINE,BIRKELANE,MABO,MBEULEUP,"LONKANE MBEULEUP (LONKANE MATH)",55,69,411,535,946
KAFFRINE,BIRKELANE,MABO,MBEULEUP,MBEULEUP,116,134,711,676,1387
KAFFRINE,BIRKELANE,MABO,MBEULEUP,"NDIAGNENE ( NDIAGNENE DIOUMA)",97,107,660,638,1298
KAFFRINE,BIRKELANE,MABO,MBEULEUP,"NDIAYENE MBEULEUP (NDIAYENE ALLA)",7,10,56,35,91
KAFFRINE,BIRKELANE,MABO,MBEULEUP,"NDIOBENE DIAGLE",60,73,283,356,639
KAFFRINE,BIRKELANE,MABO,MBEULEUP,"NDIOBENE GOUYE (ALLA GAWRY)",22,24,140,158,298
KAFFRINE,BIRKELANE,MABO,MBEULEUP,"NDIOBENE TAIBA",56,82,480,521,1001
KAFFRINE,BIRKELANE,MABO,MBEULEUP,ROUKHANE,5,7,50,51,101
KAFFRINE,BIRKELANE,MABO,MBEULEUP,"TALLA ( TALLA GNIOUROKHE )",11,12,45,75,120
KAFFRINE,BIRKELANE,MABO,MBEULEUP,"THIEKENE MBEULEUP",14,21,100,106,206
KAFFRINE,BIRKELANE,MABO,"SEGRE GATTA","DAARA MBAYENE",3,5,29,21,50
KAFFRINE,BIRKELANE,MABO,"SEGRE GATTA","KEUR MALLA (DOUTA KEUR MALLA)",34,43,251,243,494
KAFFRINE,BIRKELANE,MABO,"SEGRE GATTA","KEUR ALY KHADY",36,39,280,277,557
KAFFRINE,BIRKELANE,MABO,"SEGRE GATTA","KEUR ALY MARAME",39,41,288,258,546
KAFFRINE,BIRKELANE,MABO,"SEGRE GATTA","H1 BOSSEDJI",5,9,40,45,85
KAFFRINE,BIRKELANE,MABO,"SEGRE GATTA","H2 KEUR YOUGA BA",9,9,59,62,121
KAFFRINE,BIRKELANE,MABO,"SEGRE GATTA","KEUR MATAR COUMBA",13,15,90,119,209
KAFFRINE,BIRKELANE,MABO,"SEGRE GATTA","H1 KEUR IBRA DIABOU",11,16,90,96,186
KAFFRINE,BIRKELANE,MABO,"SEGRE GATTA","KEUR NGATTA DRAME",61,67,454,465,919
KAFFRINE,BIRKELANE,MABO,"SEGRE GATTA","H1 KEUR ELHADJ MOR SATOU ( KEUR MASSYLLA)",6,8,43,49,92
KAFFRINE,BIRKELANE,MABO,"SEGRE GATTA","KEUR SETTE AWA",38,43,294,338,632
KAFFRINE,BIRKELANE,MABO,"SEGRE GATTA","KOKY(KEUR BABOU KHOREDIA)",30,32,175,236,411
KAFFRINE,BIRKELANE,MABO,"SEGRE GATTA","MAKA DRAME",41,47,249,323,572
KAFFRINE,BIRKELANE,MABO,"SEGRE GATTA","MEDINA KEUR IBRAHIMA CISSE",9,10,61,83,144
KAFFRINE,BIRKELANE,MABO,"SEGRE GATTA","NDIMBERE BAMBARA",73,76,370,392,762
KAFFRINE,BIRKELANE,MABO,"SEGRE GATTA","H1 KEUR SAMBA KA",2,2,10,10,20
KAFFRINE,BIRKELANE,MABO,"SEGRE GATTA","H2 KEUR TOUMANY DOUMBOUYA",1,1,14,7,21
KAFFRINE,BIRKELANE,MABO,"SEGRE GATTA","NIASSENE SEGRE",3,3,19,18,37
KAFFRINE,BIRKELANE,MABO,"SEGRE GATTA","H1 PEULGA ( NIASSENE SAMBA SIRA)",3,3,29,37,66
KAFFRINE,BIRKELANE,MABO,"SEGRE GATTA","H2 KEUR PATHE DIAO",2,3,21,19,40
KAFFRINE,BIRKELANE,MABO,"SEGRE GATTA","SEGRE GATTA",120,147,596,638,1234
KAFFRINE,BIRKELANE,MABO,"SEGRE GATTA","H1 SEGRE PEULH ( KEUR MAMADOU FATOU)",8,10,60,49,109
KAFFRINE,KOUNGHEUL,KOUNGHEUL,KOUNGHEUL,CAMPEMENT,99,114,585,477,1062
KAFFRINE,KOUNGHEUL,KOUNGHEUL,KOUNGHEUL,"BAMBA MODOU COURA",322,376,1498,1634,3132
KAFFRINE,KOUNGHEUL,KOUNGHEUL,KOUNGHEUL,"DIAMAGUENE I",670,868,3091,3622,6713
KAFFRINE,KOUNGHEUL,KOUNGHEUL,KOUNGHEUL,ESCALE,182,236,762,808,1570
KAFFRINE,KOUNGHEUL,KOUNGHEUL,KOUNGHEUL,"KOUNGHEUL SANTHIE",799,996,4160,4314,8474
KAFFRINE,KOUNGHEUL,KOUNGHEUL,KOUNGHEUL,"KOUNGHEUL VILLE II",186,191,908,918,1826
KAFFRINE,KOUNGHEUL,KOUNGHEUL,KOUNGHEUL,MALI,391,487,2214,2421,4635
KAFFRINE,KOUNGHEUL,KOUNGHEUL,KOUNGHEUL,"TOUBA KOUNGHEUL",61,72,366,370,736
KAFFRINE,KOUNGHEUL,KOUNGHEUL,KOUNGHEUL,"KOUNGHEUL VILLE I",238,311,1390,1611,3001
KAFFRINE,KOUNGHEUL,"IDA MOURIDE","SALY ESCALE","BAGDAD II TOBENE",3,8,28,39,67
KAFFRINE,KOUNGHEUL,"IDA MOURIDE","SALY ESCALE","DIAM DIAM KOUCOTO",16,24,162,157,319
KAFFRINE,KOUNGHEUL,"IDA MOURIDE","SALY ESCALE","DIAM DIAM SALY",21,34,158,157,315
KAFFRINE,KOUNGHEUL,"IDA MOURIDE","SALY ESCALE","FASS KATY",49,67,307,361,668
KAFFRINE,KOUNGHEUL,"IDA MOURIDE","SALY ESCALE","FASS KEUR MOMAR",25,31,205,185,390
KAFFRINE,KOUNGHEUL,"IDA MOURIDE","SALY ESCALE","FASS NIANGHENE",14,24,162,147,309
KAFFRINE,KOUNGHEUL,"IDA MOURIDE","SALY ESCALE","GAINTH SIMBING",20,21,126,141,267
KAFFRINE,KOUNGHEUL,"IDA MOURIDE","SALY ESCALE",HILIASSA,17,31,194,177,371
KAFFRINE,KOUNGHEUL,"IDA MOURIDE","SALY ESCALE","H1 NDIALAL SAMBA",1,4,10,5,15
KAFFRINE,KOUNGHEUL,"IDA MOURIDE","SALY ESCALE","KEUR ALY LOBE (DAROU)",40,70,308,334,642
KAFFRINE,KOUNGHEUL,"IDA MOURIDE","SALY ESCALE","KEUR BARA",43,52,411,454,865
KAFFRINE,KOUNGHEUL,"IDA MOURIDE","SALY ESCALE","H1 KEUR GANNA",20,22,212,226,438
KAFFRINE,KOUNGHEUL,"IDA MOURIDE","SALY ESCALE","KEUR DIAM CODE",16,27,205,180,385
KAFFRINE,KOUNGHEUL,"IDA MOURIDE","SALY ESCALE","KEUR LAMINE",33,44,375,318,693
KAFFRINE,KOUNGHEUL,"IDA MOURIDE","SALY ESCALE","KEUR MANDOUMBE",156,218,1396,1573,2969
KAFFRINE,KOUNGHEUL,"IDA MOURIDE","SALY ESCALE","KEUR SAGAR NDIAYE",13,18,84,102,186
KAFFRINE,KOUNGHEUL,"IDA MOURIDE","SALY ESCALE","KEUR SAMBA NDIAMBANE",84,114,600,686,1286
KAFFRINE,KOUNGHEUL,"IDA MOURIDE","SALY ESCALE","KEUR SAMBA NDIAYE",16,29,166,130,296
KAFFRINE,KOUNGHEUL,"IDA MOURIDE","SALY ESCALE","KEUR YERY",22,55,339,277,616
KAFFRINE,KOUNGHEUL,"IDA MOURIDE","SALY ESCALE",KHOSNANE,97,114,562,617,1179
KAFFRINE,KOUNGHEUL,"IDA MOURIDE","SALY ESCALE","KOUCOTO (BOUSTANE)",30,37,277,285,562
KAFFRINE,KOUNGHEUL,"IDA MOURIDE","SALY ESCALE","KOUCOTO SETTE GUEYE",7,10,50,54,104
KAFFRINE,KOUNGHEUL,"IDA MOURIDE","SALY ESCALE","H1 KOUKOTO NGARA",12,26,161,106,267
KAFFRINE,KOUNGHEUL,"IDA MOURIDE","SALY ESCALE","KOUCOTO SIMONG",29,31,221,260,481
KAFFRINE,KOUNGHEUL,"IDA MOURIDE","SALY ESCALE","KOUMBIDIA PEULH",21,30,217,163,380
KAFFRINE,KOUNGHEUL,"IDA MOURIDE","SALY ESCALE","H1 KOUMBIDIA BOUMACK",14,19,110,118,228
KAFFRINE,KOUNGHEUL,"IDA MOURIDE","SALY ESCALE","KOUMBIDIA SOCE",58,69,355,389,744
KAFFRINE,KOUNGHEUL,"IDA MOURIDE","SALY ESCALE","KOUMBIDIA YAMONG",21,37,194,194,388
KAFFRINE,KOUNGHEUL,"IDA MOURIDE","SALY ESCALE","KOUTHIA NDAWENE",11,16,90,121,211
KAFFRINE,KOUNGHEUL,"IDA MOURIDE","SALY ESCALE","MAKA GOUYE PEULH",10,23,111,133,244
KAFFRINE,KOUNGHEUL,"IDA MOURIDE","SALY ESCALE",MAKHAMA,16,23,157,155,312
KAFFRINE,KOUNGHEUL,"IDA MOURIDE","SALY ESCALE","MBAYENE MOMATH",5,6,28,31,59
KAFFRINE,KOUNGHEUL,"IDA MOURIDE","SALY ESCALE","MBOURE SALY",7,12,69,66,135
KAFFRINE,KOUNGHEUL,"IDA MOURIDE","SALY ESCALE","MEDINA MBADIANENE",19,21,150,146,296
KAFFRINE,KOUNGHEUL,"IDA MOURIDE","SALY ESCALE","MEDINA NDIENGHENE",10,13,55,55,110
KAFFRINE,KOUNGHEUL,"IDA MOURIDE","SALY ESCALE","MEDINA SALY",14,25,148,136,284
KAFFRINE,KOUNGHEUL,"IDA MOURIDE","SALY ESCALE","MEDINA SIWOL",20,28,111,175,286
KAFFRINE,KOUNGHEUL,"IDA MOURIDE","SALY ESCALE","MINAL KEUR IBRA DIENG",20,36,210,179,389
KAFFRINE,KOUNGHEUL,"IDA MOURIDE","SALY ESCALE","MISSIRAH THIECKENE",9,17,111,107,218
KAFFRINE,KOUNGHEUL,"IDA MOURIDE","SALY ESCALE",MOUSDALIFA,17,27,163,155,318
KAFFRINE,KOUNGHEUL,"IDA MOURIDE","SALY ESCALE","H1 MEDINA THIEKENE",3,4,44,24,68
KAFFRINE,KOUNGHEUL,"IDA MOURIDE","SALY ESCALE","NDANGHA PEULH",22,40,202,145,347
KAFFRINE,KOUNGHEUL,"IDA MOURIDE","SALY ESCALE","KOO SOCE",61,79,542,474,1016
KAFFRINE,KOUNGHEUL,"IDA MOURIDE","SALY ESCALE","H1 MAKA TOBENE",15,17,102,97,199
KAFFRINE,KOUNGHEUL,"IDA MOURIDE","SALY ESCALE","NDIAPTO OUOLOF",21,28,161,142,303
KAFFRINE,KOUNGHEUL,"IDA MOURIDE","SALY ESCALE","NDIAPTO PEULH",21,33,238,203,441
KAFFRINE,KOUNGHEUL,"IDA MOURIDE","SALY ESCALE","NDIAPTO SALY",24,42,229,190,419
KAFFRINE,KOUNGHEUL,"IDA MOURIDE","SALY ESCALE","NDIAPTO SARA",10,12,58,48,106
KAFFRINE,KOUNGHEUL,"IDA MOURIDE","SALY ESCALE","NDIAYE COUNDA II",17,27,137,119,256
KAFFRINE,KOUNGHEUL,"IDA MOURIDE","SALY ESCALE","NDIENGUENE KEUR SOULEYE",14,29,182,205,387
KAFFRINE,KOUNGHEUL,"IDA MOURIDE","SALY ESCALE","H1 SANTHIE PAKALA",11,20,127,194,321
KAFFRINE,KOUNGHEUL,"IDA MOURIDE","SALY ESCALE","NDJIBA KOUCOTO",17,20,147,152,299
KAFFRINE,KOUNGHEUL,"IDA MOURIDE","SALY ESCALE","NGOUYE MBANDE",21,28,170,162,332
KAFFRINE,KOUNGHEUL,"IDA MOURIDE","SALY ESCALE","NIORO THIALENE",42,50,305,226,531
KAFFRINE,KOUNGHEUL,"IDA MOURIDE","SALY ESCALE","PAKALA (PAKABOURE)",111,159,1018,1089,2107
KAFFRINE,KOUNGHEUL,"IDA MOURIDE","SALY ESCALE","SALY ESCALE",27,44,191,238,429
KAFFRINE,KOUNGHEUL,"IDA MOURIDE","SALY ESCALE","SALY TORO",18,33,240,198,438
KAFFRINE,KOUNGHEUL,"IDA MOURIDE","SALY ESCALE","H1 THIMBENE",2,2,34,48,82
KAFFRINE,KOUNGHEUL,"IDA MOURIDE","SALY ESCALE","SAM NDIENGHENE",14,23,163,128,291
KAFFRINE,KOUNGHEUL,"IDA MOURIDE","SALY ESCALE","MAKA GOUYE",46,55,216,289,505
KAFFRINE,KOUNGHEUL,"IDA MOURIDE","SALY ESCALE","SANTHIE SALY",24,28,162,139,301
KAFFRINE,KOUNGHEUL,"IDA MOURIDE","SALY ESCALE","SARE BIRAM BAMBEY",10,19,91,82,173
KAFFRINE,KOUNGHEUL,"IDA MOURIDE","SALY ESCALE","H1 DABEL SALY",6,9,40,34,74
KAFFRINE,KOUNGHEUL,"IDA MOURIDE","SALY ESCALE","SINE MATAR",28,41,261,257,518
KAFFRINE,KOUNGHEUL,"IDA MOURIDE","SALY ESCALE","SINE NGUEYENE",21,39,159,194,353
KAFFRINE,KOUNGHEUL,"IDA MOURIDE","SALY ESCALE","TAGUE KATY",7,13,44,49,93
KAFFRINE,KOUNGHEUL,"IDA MOURIDE","SALY ESCALE","TAIBA NDIAGNENE",22,24,116,124,240
KAFFRINE,KOUNGHEUL,"IDA MOURIDE","SALY ESCALE","TAIBA NGUEBANENE",11,18,112,111,223
KAFFRINE,KOUNGHEUL,"IDA MOURIDE","SALY ESCALE","THIONGUE OUOLOF",17,32,211,214,425
KAFFRINE,KOUNGHEUL,"IDA MOURIDE","SALY ESCALE","THIONGUE PEULH",30,42,282,229,511
KAFFRINE,KOUNGHEUL,"IDA MOURIDE","SALY ESCALE","TOUBA MBAYENE",13,35,200,252,452
KAFFRINE,KOUNGHEUL,"IDA MOURIDE","SALY ESCALE","WILLANENE I",39,48,300,297,597
KAFFRINE,KOUNGHEUL,"IDA MOURIDE","SALY ESCALE","H1 WILLANENE PEULH",15,15,111,103,214
KAFFRINE,KOUNGHEUL,"IDA MOURIDE","SALY ESCALE","WOYE BOURE NDOMENE",20,47,268,250,518
KAFFRINE,KOUNGHEUL,"IDA MOURIDE","SALY ESCALE","WOYE BOURE SITASSABA",11,28,135,148,283
KAFFRINE,KOUNGHEUL,"IDA MOURIDE","SALY ESCALE",YAMONG,45,49,241,282,523
KAFFRINE,KOUNGHEUL,"IDA MOURIDE","SALY ESCALE","BAMBA FASS",4,4,28,25,53
KAFFRINE,KOUNGHEUL,"IDA MOURIDE","SALY ESCALE","KOUWO PEULH",9,11,42,56,98
KAFFRINE,KOUNGHEUL,"IDA MOURIDE","SALY ESCALE","MAKA GOUYE TOUCOULEUR",14,16,75,67,142
KAFFRINE,KOUNGHEUL,"IDA MOURIDE","SALY ESCALE","MEDINA EL OUSMANE (SANTHIE GOUSSE)",14,19,103,88,191
KAFFRINE,KOUNGHEUL,"IDA MOURIDE","SALY ESCALE","MEDINA KATY (KEUR MADIOP)",4,6,50,46,96
KAFFRINE,KOUNGHEUL,"IDA MOURIDE","SALY ESCALE","MEDINATOUL SALAM",7,7,63,59,122
KAFFRINE,KOUNGHEUL,"IDA MOURIDE","SALY ESCALE","NDIALAL NDIAPTO",4,11,58,47,105
KAFFRINE,KOUNGHEUL,"IDA MOURIDE","SALY ESCALE","SAME PATHE WILLANE",26,37,356,282,638
KAFFRINE,KOUNGHEUL,"IDA MOURIDE","SALY ESCALE",TONUS,3,3,10,12,22
KAFFRINE,KOUNGHEUL,"IDA MOURIDE","FASS THIEKENE","AHLOULAHI (KEUR KOUTHIA)",2,8,76,64,140
KAFFRINE,KOUNGHEUL,"IDA MOURIDE","FASS THIEKENE","DAROU FANA",67,73,400,410,810
KAFFRINE,KOUNGHEUL,"IDA MOURIDE","FASS THIEKENE","DAROU MBAYENE",68,83,431,543,974
KAFFRINE,KOUNGHEUL,"IDA MOURIDE","FASS THIEKENE","DOUBEL GUEDE",30,42,235,336,571
KAFFRINE,KOUNGHEUL,"IDA MOURIDE","FASS THIEKENE","FASS THIEKENE",153,183,1296,1294,2590
KAFFRINE,KOUNGHEUL,"IDA MOURIDE","FASS THIEKENE","KEUR ABDOULAYE FANTA",47,51,311,297,608
KAFFRINE,KOUNGHEUL,"IDA MOURIDE","FASS THIEKENE","H1 SARE DEMBA SADIO",9,10,66,70,136
KAFFRINE,KOUNGHEUL,"IDA MOURIDE","FASS THIEKENE","KEUR IBRA MBAYE",43,55,333,436,769
KAFFRINE,KOUNGHEUL,"IDA MOURIDE","FASS THIEKENE","KEUR MOUSSA NDIAYE",14,14,58,64,122
KAFFRINE,KOUNGHEUL,"IDA MOURIDE","FASS THIEKENE","KEUR OMAR BOUNE",56,60,284,389,673
KAFFRINE,KOUNGHEUL,"IDA MOURIDE","FASS THIEKENE","KEUR SERIGNE DIABEL",86,91,519,559,1078
KAFFRINE,KOUNGHEUL,"IDA MOURIDE","FASS THIEKENE","KOUNGHEUL SOCE",76,88,497,512,1009
KAFFRINE,KOUNGHEUL,"IDA MOURIDE","FASS THIEKENE","KOUNO BABOU NGUETT",35,45,276,368,644
KAFFRINE,KOUNGHEUL,"IDA MOURIDE","FASS THIEKENE","MAKA KATAL",22,30,172,203,375
KAFFRINE,KOUNGHEUL,"IDA MOURIDE","FASS THIEKENE",MBADIANENE,25,32,164,158,322
KAFFRINE,KOUNGHEUL,"IDA MOURIDE","FASS THIEKENE","MBOWENE SARANIAMA",15,24,112,100,212
KAFFRINE,KOUNGHEUL,"IDA MOURIDE","FASS THIEKENE","MEDINA FASS I",28,41,305,297,602
KAFFRINE,KOUNGHEUL,"IDA MOURIDE","FASS THIEKENE","MBAYENE ELIMANE",18,24,129,166,295
KAFFRINE,KOUNGHEUL,"IDA MOURIDE","FASS THIEKENE","MEDINA PANTHIANG",23,47,277,210,487
KAFFRINE,KOUNGHEUL,"IDA MOURIDE","FASS THIEKENE","MEDINA TAHIROU",105,124,925,970,1895
KAFFRINE,KOUNGHEUL,"IDA MOURIDE","FASS THIEKENE",MINAME,121,133,906,1097,2003
KAFFRINE,KOUNGHEUL,"IDA MOURIDE","FASS THIEKENE","MISSIRAH KOUTHIAME",66,76,339,464,803
KAFFRINE,KOUNGHEUL,"IDA MOURIDE","FASS THIEKENE","NDAWENE SARANIAMA",28,38,178,187,365
KAFFRINE,KOUNGHEUL,"IDA MOURIDE","FASS THIEKENE","NDIAYE COUNDA I",27,36,238,238,476
KAFFRINE,KOUNGHEUL,"IDA MOURIDE","FASS THIEKENE","PIROME MANDAKH",112,126,694,697,1391
KAFFRINE,KOUNGHEUL,"IDA MOURIDE","FASS THIEKENE","SAM DIEBEL",80,92,572,619,1191
KAFFRINE,KOUNGHEUL,"IDA MOURIDE","FASS THIEKENE","SAM THIALENE",21,27,176,245,421
KAFFRINE,KOUNGHEUL,"IDA MOURIDE","FASS THIEKENE","SANTHIE PATHE",30,44,327,206,533
KAFFRINE,KOUNGHEUL,"IDA MOURIDE","FASS THIEKENE","H1 BADIRI",8,16,112,127,239
KAFFRINE,KOUNGHEUL,"IDA MOURIDE","FASS THIEKENE","BAGDAD II(SANTHIE SETT)",20,30,190,227,417
KAFFRINE,KOUNGHEUL,"IDA MOURIDE","FASS THIEKENE","TOUBA FANA",19,25,176,146,322
KAFFRINE,KOUNGHEUL,"IDA MOURIDE","FASS THIEKENE","TOBENE MALICK",38,58,391,473,864
KAFFRINE,KOUNGHEUL,"IDA MOURIDE","FASS THIEKENE","MEDINA MBARAKYS",5,6,51,35,86
KAFFRINE,KOUNGHEUL,"IDA MOURIDE","FASS THIEKENE","MEDINA NDIOBENE",5,6,38,24,62
KAFFRINE,KOUNGHEUL,"IDA MOURIDE","FASS THIEKENE","SANTHIE YEDDOU",3,5,29,33,62
KAFFRINE,KOUNGHEUL,"IDA MOURIDE","IDA MOURIDE",ASRAF,5,6,34,27,61
KAFFRINE,KOUNGHEUL,"IDA MOURIDE","IDA MOURIDE","DAROU BAMBARA",14,22,172,125,297
KAFFRINE,KOUNGHEUL,"IDA MOURIDE","IDA MOURIDE","DAROU OUOLOF",86,94,623,644,1267
KAFFRINE,KOUNGHEUL,"IDA MOURIDE","IDA MOURIDE","DAROU THIEGUENE",31,42,217,231,448
KAFFRINE,KOUNGHEUL,"IDA MOURIDE","IDA MOURIDE","DIAMAGUENE NDAME",42,48,309,261,570
KAFFRINE,KOUNGHEUL,"IDA MOURIDE","IDA MOURIDE",DIAMEWELY,18,64,282,237,519
KAFFRINE,KOUNGHEUL,"IDA MOURIDE","IDA MOURIDE","DIMAR DJIGO",4,5,27,26,53
KAFFRINE,KOUNGHEUL,"IDA MOURIDE","IDA MOURIDE","DIOKOUL WADENE",86,90,423,422,845
KAFFRINE,KOUNGHEUL,"IDA MOURIDE","IDA MOURIDE","DOUBA LAMPOUR",116,149,908,789,1697
KAFFRINE,KOUNGHEUL,"IDA MOURIDE","IDA MOURIDE","FASS DIEBEL",28,38,226,219,445
KAFFRINE,KOUNGHEUL,"IDA MOURIDE","IDA MOURIDE","FASS KOUNGHEUL",8,9,56,67,123
KAFFRINE,KOUNGHEUL,"IDA MOURIDE","IDA MOURIDE","HAMDALLAYE THIAMENE",13,23,146,141,287
KAFFRINE,KOUNGHEUL,"IDA MOURIDE","IDA MOURIDE","H1 KEUR GUEDEL",13,26,133,178,311
KAFFRINE,KOUNGHEUL,"IDA MOURIDE","IDA MOURIDE","HAMDALLAYE THIARENE",4,5,48,41,89
KAFFRINE,KOUNGHEUL,"IDA MOURIDE","IDA MOURIDE","ARAFAT MBAYENE",36,48,254,271,525
KAFFRINE,KOUNGHEUL,"IDA MOURIDE","IDA MOURIDE","IDA GADIAGA",60,114,630,581,1211
KAFFRINE,KOUNGHEUL,"IDA MOURIDE","IDA MOURIDE","IDA KEUR ABDOU",20,22,138,142,280
KAFFRINE,KOUNGHEUL,"IDA MOURIDE","IDA MOURIDE","H1 IDA ALTOU",22,25,136,121,257
KAFFRINE,KOUNGHEUL,"IDA MOURIDE","IDA MOURIDE","IDA MOURIDE",175,203,1529,1588,3117
KAFFRINE,KOUNGHEUL,"IDA MOURIDE","IDA MOURIDE","IDA NDAWENE",19,33,155,166,321
KAFFRINE,KOUNGHEUL,"IDA MOURIDE","IDA MOURIDE",KASSASSA,26,37,317,341,658
KAFFRINE,KOUNGHEUL,"IDA MOURIDE","IDA MOURIDE","KEUR NGAYE",92,142,1096,1198,2294
KAFFRINE,KOUNGHEUL,"IDA MOURIDE","IDA MOURIDE",KHOURDANE,72,90,1207,649,1856
KAFFRINE,KOUNGHEUL,"IDA MOURIDE","IDA MOURIDE",KOULAGNA,9,16,58,81,139
KAFFRINE,KOUNGHEUL,"IDA MOURIDE","IDA MOURIDE","MEDINA FASS KEUR ELI",10,15,78,75,153
KAFFRINE,KOUNGHEUL,"IDA MOURIDE","IDA MOURIDE","MEDINA MBAYENE WOLOF",12,20,182,129,311
KAFFRINE,KOUNGHEUL,"IDA MOURIDE","IDA MOURIDE","MEDINA MBAYENE PEULH",13,17,77,73,150
KAFFRINE,KOUNGHEUL,"IDA MOURIDE","IDA MOURIDE","H1 MEDINA ALWAR",13,17,70,75,145
KAFFRINE,KOUNGHEUL,"IDA MOURIDE","IDA MOURIDE","MISSIRAH KEUR OMAR SARR",21,32,237,215,452
KAFFRINE,KOUNGHEUL,"IDA MOURIDE","IDA MOURIDE","MSSIRAH FAYENE",35,41,190,206,396
KAFFRINE,KOUNGHEUL,"IDA MOURIDE","IDA MOURIDE",NDIARMEO,10,16,102,120,222
KAFFRINE,KOUNGHEUL,"IDA MOURIDE","IDA MOURIDE","NDIENGUENE FAFA",15,17,112,141,253
KAFFRINE,KOUNGHEUL,"IDA MOURIDE","IDA MOURIDE",NDIOUM,28,44,265,251,516
KAFFRINE,KOUNGHEUL,"IDA MOURIDE","IDA MOURIDE","NDIOUNTOU NGUEYENE",26,35,191,211,402
KAFFRINE,KOUNGHEUL,"IDA MOURIDE","IDA MOURIDE","H1 NDIOUNTOU NGUEYENE PEULH",6,6,30,31,61
KAFFRINE,KOUNGHEUL,"IDA MOURIDE","IDA MOURIDE",NDOUNE,168,199,1377,1371,2748
KAFFRINE,KOUNGHEUL,"IDA MOURIDE","IDA MOURIDE","H1 SANTHIE NDOUNE",6,11,85,86,171
KAFFRINE,KOUNGHEUL,"IDA MOURIDE","IDA MOURIDE","NGOUYE SIWAKH",18,32,186,187,373
KAFFRINE,KOUNGHEUL,"IDA MOURIDE","IDA MOURIDE","H1 KEUR NGOR DEME",13,20,85,91,176
KAFFRINE,KOUNGHEUL,"IDA MOURIDE","IDA MOURIDE","H2 KEUR THIAYA",3,8,36,30,66
KAFFRINE,KOUNGHEUL,"IDA MOURIDE","IDA MOURIDE",PAL,4,9,39,29,68
KAFFRINE,KOUNGHEUL,"IDA MOURIDE","IDA MOURIDE","PIRE NANGO",41,102,523,420,943
KAFFRINE,KOUNGHEUL,"IDA MOURIDE","IDA MOURIDE","H1 KEUR NGADIARY",14,23,131,105,236
KAFFRINE,KOUNGHEUL,"IDA MOURIDE","IDA MOURIDE","PIRE NDAWENE",32,35,282,242,524
KAFFRINE,KOUNGHEUL,"IDA MOURIDE","IDA MOURIDE","PIRE PAMPY",8,17,139,106,245
KAFFRINE,KOUNGHEUL,"IDA MOURIDE","IDA MOURIDE","H1 SALAMATA",6,9,57,45,102
KAFFRINE,KOUNGHEUL,"IDA MOURIDE","IDA MOURIDE","H2 WOKA KA",5,11,54,62,116
KAFFRINE,KOUNGHEUL,"IDA MOURIDE","IDA MOURIDE","H3 BOYE KA",2,6,42,41,83
KAFFRINE,KOUNGHEUL,"IDA MOURIDE","IDA MOURIDE","PIRE TOBENE",18,32,186,161,347
KAFFRINE,KOUNGHEUL,"IDA MOURIDE","IDA MOURIDE","PIRE YORO DIOUMEL",10,22,80,112,192
KAFFRINE,KOUNGHEUL,"IDA MOURIDE","IDA MOURIDE","SAME NDIAYENE",21,43,223,194,417
KAFFRINE,KOUNGHEUL,"IDA MOURIDE","IDA MOURIDE","SANTHIE TABA",12,20,145,153,298
KAFFRINE,KOUNGHEUL,"IDA MOURIDE","IDA MOURIDE","SARE SADIO",41,90,443,428,871
KAFFRINE,KOUNGHEUL,"IDA MOURIDE","IDA MOURIDE",SIBINOKHO,40,50,305,356,661
KAFFRINE,KOUNGHEUL,"IDA MOURIDE","IDA MOURIDE",TABA,30,36,229,152,381
KAFFRINE,KOUNGHEUL,"IDA MOURIDE","IDA MOURIDE",THIAKHO,35,46,316,365,681
KAFFRINE,KOUNGHEUL,"IDA MOURIDE","IDA MOURIDE","TOUBA GOUYE",33,36,196,150,346
KAFFRINE,KOUNGHEUL,"IDA MOURIDE","IDA MOURIDE","FASS BAMBA",34,37,302,209,511
KAFFRINE,KOUNGHEUL,"IDA MOURIDE","IDA MOURIDE","FASS BARENA",6,8,54,37,91
KAFFRINE,KOUNGHEUL,"IDA MOURIDE","IDA MOURIDE","MEDINA SOW",4,4,33,18,51
KAFFRINE,KOUNGHEUL,"IDA MOURIDE","IDA MOURIDE",THIALENE,10,10,62,44,106
KAFFRINE,KOUNGHEUL,"LOUR ESCALE","LOUR ESCALE","ABY SAM KHONE",17,22,106,107,213
KAFFRINE,KOUNGHEUL,"LOUR ESCALE","LOUR ESCALE","AFFE LOUR",9,9,110,60,170
KAFFRINE,KOUNGHEUL,"LOUR ESCALE","LOUR ESCALE",AINOUMADY,5,6,82,43,125
KAFFRINE,KOUNGHEUL,"LOUR ESCALE","LOUR ESCALE","BELELE BABOU",123,188,753,799,1552
KAFFRINE,KOUNGHEUL,"LOUR ESCALE","LOUR ESCALE","BELEL PEULH",47,88,387,335,722
KAFFRINE,KOUNGHEUL,"LOUR ESCALE","LOUR ESCALE","COURA ALDIOUMA (SARE GATTA)",23,44,224,204,428
KAFFRINE,KOUNGHEUL,"LOUR ESCALE","LOUR ESCALE","COURA FOUTAYEL I",7,9,59,54,113
KAFFRINE,KOUNGHEUL,"LOUR ESCALE","LOUR ESCALE","COURA FOUTAYEL II",23,30,236,196,432
KAFFRINE,KOUNGHEUL,"LOUR ESCALE","LOUR ESCALE","COURA KHAYE BOURANG",4,5,28,29,57
KAFFRINE,KOUNGHEUL,"LOUR ESCALE","LOUR ESCALE","COURA MOURIDE",143,154,968,918,1886
KAFFRINE,KOUNGHEUL,"LOUR ESCALE","LOUR ESCALE","H1 PEULGA de COURA MOURIDE",10,14,72,75,147
KAFFRINE,KOUNGHEUL,"LOUR ESCALE","LOUR ESCALE","DAROU SALAM COLY",6,13,55,56,111
KAFFRINE,KOUNGHEUL,"LOUR ESCALE","LOUR ESCALE","COURA YORO THIDY",28,61,287,267,554
KAFFRINE,KOUNGHEUL,"LOUR ESCALE","LOUR ESCALE","DAROU DAME LEYE",15,18,106,105,211
KAFFRINE,KOUNGHEUL,"LOUR ESCALE","LOUR ESCALE","DAROU SALAM NGUEYENE (SANTHIE RAME)",45,64,392,332,724
KAFFRINE,KOUNGHEUL,"LOUR ESCALE","LOUR ESCALE","H1 FASS THIAMENE",7,14,102,82,184
KAFFRINE,KOUNGHEUL,"LOUR ESCALE","LOUR ESCALE","DINGUIRAYE SALEMATA",16,27,99,81,180
KAFFRINE,KOUNGHEUL,"LOUR ESCALE","LOUR ESCALE","FASS NIABARDOU",20,30,180,154,334
KAFFRINE,KOUNGHEUL,"LOUR ESCALE","LOUR ESCALE","H1 NDIOPE",18,27,166,123,289
KAFFRINE,KOUNGHEUL,"LOUR ESCALE","LOUR ESCALE","H2 SARE MAMADOU",5,12,32,43,75
KAFFRINE,KOUNGHEUL,"LOUR ESCALE","LOUR ESCALE","HAMDALLAYE NDANGHA",12,22,105,90,195
KAFFRINE,KOUNGHEUL,"LOUR ESCALE","LOUR ESCALE","H1 MEDINA NIAGHA",2,3,15,8,23
KAFFRINE,KOUNGHEUL,"LOUR ESCALE","LOUR ESCALE","HAMDALLAYE LOMENE",30,36,205,166,371
KAFFRINE,KOUNGHEUL,"LOUR ESCALE","LOUR ESCALE","H1 TAWFEKH",1,1,104,16,120
KAFFRINE,KOUNGHEUL,"LOUR ESCALE","LOUR ESCALE","HAMDALLAYE PEULH",9,18,98,78,176
KAFFRINE,KOUNGHEUL,"LOUR ESCALE","LOUR ESCALE","LOUR ESCALE",374,438,2663,2618,5281
KAFFRINE,KOUNGHEUL,"LOUR ESCALE","LOUR ESCALE","H1 MEDINA LOUR",17,34,124,124,248
KAFFRINE,KOUNGHEUL,"LOUR ESCALE","LOUR ESCALE","M’BACKE SALOUM",10,10,57,50,107
KAFFRINE,KOUNGHEUL,"LOUR ESCALE","LOUR ESCALE","MEDINA GOUNASS",21,45,210,184,394
KAFFRINE,KOUNGHEUL,"LOUR ESCALE","LOUR ESCALE","MEDINA THIAMENE",15,22,151,137,288
KAFFRINE,KOUNGHEUL,"LOUR ESCALE","LOUR ESCALE","MEDINA TOBENE I",78,79,424,449,873
KAFFRINE,KOUNGHEUL,"LOUR ESCALE","LOUR ESCALE","H1 PEULGA de MEDINA TOBENE I",15,20,107,97,204
KAFFRINE,KOUNGHEUL,"LOUR ESCALE","LOUR ESCALE","CAURA NDIARY NDIAFFA",8,13,60,63,123
KAFFRINE,KOUNGHEUL,"LOUR ESCALE","LOUR ESCALE","NDIAYENE LOUR",80,108,535,576,1111
KAFFRINE,KOUNGHEUL,"LOUR ESCALE","LOUR ESCALE","H1 SARE BIRAME",21,38,182,174,356
KAFFRINE,KOUNGHEUL,"LOUR ESCALE","LOUR ESCALE","H2  SARE LALY",10,18,97,90,187
KAFFRINE,KOUNGHEUL,"LOUR ESCALE","LOUR ESCALE","COURA NDIOCRAME",16,37,157,119,276
KAFFRINE,KOUNGHEUL,"LOUR ESCALE","LOUR ESCALE","NGOUYE DIARAF CAMPEMENT",48,99,493,375,868
KAFFRINE,KOUNGHEUL,"LOUR ESCALE","LOUR ESCALE","NGOUYE DIARAF MOURIDE",116,152,668,797,1465
KAFFRINE,KOUNGHEUL,"LOUR ESCALE","LOUR ESCALE","H1 RAHMATOULAYE",11,19,91,67,158
KAFFRINE,KOUNGHEUL,"LOUR ESCALE","LOUR ESCALE","NIABARDOU PEULH",22,35,202,157,359
KAFFRINE,KOUNGHEUL,"LOUR ESCALE","LOUR ESCALE","NIABARDOU SAMBENE",10,11,53,50,103
KAFFRINE,KOUNGHEUL,"LOUR ESCALE","LOUR ESCALE","NIOLE OUOLOF",24,31,164,158,322
KAFFRINE,KOUNGHEUL,"LOUR ESCALE","LOUR ESCALE","NIOLE PEULH",27,45,203,164,367
KAFFRINE,KOUNGHEUL,"LOUR ESCALE","LOUR ESCALE","NIORO KEBA",8,8,44,41,85
KAFFRINE,KOUNGHEUL,"LOUR ESCALE","LOUR ESCALE",PAKALA,22,48,253,224,477
KAFFRINE,KOUNGHEUL,"LOUR ESCALE","LOUR ESCALE","H1 MAKA MALEDE",8,8,37,27,64
KAFFRINE,KOUNGHEUL,"LOUR ESCALE","LOUR ESCALE","H2 FOUMI HARA",1,3,10,12,22
KAFFRINE,KOUNGHEUL,"LOUR ESCALE","LOUR ESCALE","PATOULANE OUOLOF",6,8,39,37,76
KAFFRINE,KOUNGHEUL,"LOUR ESCALE","LOUR ESCALE","PATOULANE PEULH",13,26,122,86,208
KAFFRINE,KOUNGHEUL,"LOUR ESCALE","LOUR ESCALE","SAME NIANGHA",15,26,126,77,203
KAFFRINE,KOUNGHEUL,"LOUR ESCALE","LOUR ESCALE","SINTHIANE MBETETE 1",11,21,87,71,158
KAFFRINE,KOUNGHEUL,"LOUR ESCALE","LOUR ESCALE","SOBEL DIAM DIAM",57,78,488,483,971
KAFFRINE,KOUNGHEUL,"LOUR ESCALE","LOUR ESCALE","SOBEL HAMDALLAYE",30,64,302,225,527
KAFFRINE,KOUNGHEUL,"LOUR ESCALE","LOUR ESCALE","SOBEL NGAGNANE",9,20,72,72,144
KAFFRINE,KOUNGHEUL,"LOUR ESCALE","LOUR ESCALE","H1 KEUR ABLAYE BA",3,9,31,37,68
KAFFRINE,KOUNGHEUL,"LOUR ESCALE","LOUR ESCALE","SOBEL NIOLE",30,46,211,192,403
KAFFRINE,KOUNGHEUL,"LOUR ESCALE","LOUR ESCALE","SOBEL THIEGUENE",6,6,36,40,76
KAFFRINE,KOUNGHEUL,"LOUR ESCALE","LOUR ESCALE","TOUBA ALY MBENDA",176,189,1037,1070,2107
KAFFRINE,KOUNGHEUL,"LOUR ESCALE","LOUR ESCALE","TOUBA GALLO",34,49,287,270,557
KAFFRINE,KOUNGHEUL,"LOUR ESCALE","LOUR ESCALE","H1 KEUR MODA",14,24,112,114,226
KAFFRINE,KOUNGHEUL,"LOUR ESCALE","LOUR ESCALE","TOUBA TAW FEKH",23,25,132,133,265
KAFFRINE,KOUNGHEUL,"LOUR ESCALE","LOUR ESCALE","H1 KEUR CHEIKH SAGNE",3,4,26,14,40
KAFFRINE,KOUNGHEUL,"LOUR ESCALE","LOUR ESCALE","TOUBA THIARENE",59,66,400,342,742
KAFFRINE,KOUNGHEUL,"LOUR ESCALE","LOUR ESCALE","H1 DEUKOU BOU NDAW",7,8,53,64,117
KAFFRINE,KOUNGHEUL,"LOUR ESCALE","LOUR ESCALE","H2 SARE MADY",4,7,45,42,87
KAFFRINE,KOUNGHEUL,"LOUR ESCALE","LOUR ESCALE","H3 SARE MAKAM",4,5,28,14,42
KAFFRINE,KOUNGHEUL,"LOUR ESCALE","LOUR ESCALE","H4 KEUR DIOUBERE",10,16,82,64,146
KAFFRINE,KOUNGHEUL,"LOUR ESCALE","LOUR ESCALE","H6 KEUR DEMBA WALOM",4,8,43,37,80
KAFFRINE,KOUNGHEUL,"LOUR ESCALE","LOUR ESCALE","H8 DIAM DIAM DIMAREL",1,1,11,15,26
KAFFRINE,KOUNGHEUL,"LOUR ESCALE","LOUR ESCALE","WILLANENE II",14,18,94,101,195
KAFFRINE,KOUNGHEUL,"LOUR ESCALE","LOUR ESCALE","H1 PEULGHA",7,9,42,51,93
KAFFRINE,KOUNGHEUL,"LOUR ESCALE","LOUR ESCALE","YETTY KHAYES",71,101,533,501,1034
KAFFRINE,KOUNGHEUL,"LOUR ESCALE","LOUR ESCALE","H1 SANTHIE MAMOUTH KA",6,8,34,33,67
KAFFRINE,KOUNGHEUL,"LOUR ESCALE","LOUR ESCALE","H2 SARE BOULA",16,28,134,113,247
KAFFRINE,KOUNGHEUL,"LOUR ESCALE","LOUR ESCALE","H3 KEUR SARR COUMBA KA",6,10,39,41,80
KAFFRINE,KOUNGHEUL,"LOUR ESCALE","LOUR ESCALE","ABISSANKHONE SERERE",8,8,45,38,83
KAFFRINE,KOUNGHEUL,"LOUR ESCALE","LOUR ESCALE",BAGDAD,4,5,26,22,48
KAFFRINE,KOUNGHEUL,"LOUR ESCALE","LOUR ESCALE","COURA THIOBERY",29,77,363,295,658
KAFFRINE,KOUNGHEUL,"LOUR ESCALE","LOUR ESCALE","DIAMAGUENE NDANGHA",6,14,58,58,116
KAFFRINE,KOUNGHEUL,"LOUR ESCALE","LOUR ESCALE","KEUR EL HADJ SAMBA NIANGA",17,25,132,166,298
KAFFRINE,KOUNGHEUL,"LOUR ESCALE","LOUR ESCALE","MEDINA FASS",19,33,199,153,352
KAFFRINE,KOUNGHEUL,"LOUR ESCALE","LOUR ESCALE","MEDINA NDIOCRANE",3,6,26,24,50
KAFFRINE,KOUNGHEUL,"LOUR ESCALE","LOUR ESCALE","SARE ABDOUL",7,12,53,45,98
KAFFRINE,KOUNGHEUL,"LOUR ESCALE","LOUR ESCALE","SARE BOUBOU",15,28,128,118,246
KAFFRINE,KOUNGHEUL,"LOUR ESCALE","LOUR ESCALE","SARE DADI",14,27,124,109,233
KAFFRINE,KOUNGHEUL,"LOUR ESCALE","LOUR ESCALE","SARE EL HADJI SADIO BA",4,7,36,34,70
KAFFRINE,KOUNGHEUL,"LOUR ESCALE","LOUR ESCALE","SARE EL HADJI SARA BA",7,10,82,61,143
KAFFRINE,KOUNGHEUL,"LOUR ESCALE","LOUR ESCALE","SARE PATHE",7,15,50,59,109
KAFFRINE,KOUNGHEUL,"LOUR ESCALE","LOUR ESCALE","SINTHIANE MBETETE 2",2,5,16,10,26
KAFFRINE,KOUNGHEUL,"LOUR ESCALE","LOUR ESCALE","TAÏF THIEGUENE",16,25,117,143,260
KAFFRINE,KOUNGHEUL,"LOUR ESCALE","RIBOT ESCALE",ARAFAT,11,26,159,120,279
KAFFRINE,KOUNGHEUL,"LOUR ESCALE","RIBOT ESCALE",BOKIDIOR,38,43,169,161,330
KAFFRINE,KOUNGHEUL,"LOUR ESCALE","RIBOT ESCALE","BOKIDIOR PEULH",47,59,354,308,662
KAFFRINE,KOUNGHEUL,"LOUR ESCALE","RIBOT ESCALE","DAMADJI DIAM DIAM",40,57,220,227,447
KAFFRINE,KOUNGHEUL,"LOUR ESCALE","RIBOT ESCALE","DAMADJI SALY",27,49,228,215,443
KAFFRINE,KOUNGHEUL,"LOUR ESCALE","RIBOT ESCALE","DAROU KARIME",24,35,228,212,440
KAFFRINE,KOUNGHEUL,"LOUR ESCALE","RIBOT ESCALE","H1 PEULGA de DAROU KARIME",6,11,69,66,135
KAFFRINE,KOUNGHEUL,"LOUR ESCALE","RIBOT ESCALE","DAROU KHOUDOSS",31,40,360,256,616
KAFFRINE,KOUNGHEUL,"LOUR ESCALE","RIBOT ESCALE","H1 PEULGA de DAROU KHOUDOSS",7,17,100,96,196
KAFFRINE,KOUNGHEUL,"LOUR ESCALE","RIBOT ESCALE","DAROU KOUNG KOUNG",38,49,233,237,470
KAFFRINE,KOUNGHEUL,"LOUR ESCALE","RIBOT ESCALE","H3 KOUNG KOUNG FORAGE",14,30,145,124,269
KAFFRINE,KOUNGHEUL,"LOUR ESCALE","RIBOT ESCALE","H4 KOUNG KOUNG DIASSARNABE",11,11,73,74,147
KAFFRINE,KOUNGHEUL,"LOUR ESCALE","RIBOT ESCALE","DAROU MOUSTY",13,13,107,73,180
KAFFRINE,KOUNGHEUL,"LOUR ESCALE","RIBOT ESCALE","DAROU NAHIM",8,12,83,57,140
KAFFRINE,KOUNGHEUL,"LOUR ESCALE","RIBOT ESCALE","DAROU SALAM DIERY (KEUR MAHADAM)",12,14,94,96,190
KAFFRINE,KOUNGHEUL,"LOUR ESCALE","RIBOT ESCALE","H1 PEULGA de DAROU SALAM DIERY (KEUR MAHADAM)",9,18,81,82,163
KAFFRINE,KOUNGHEUL,"LOUR ESCALE","RIBOT ESCALE",DIAMAGUENE,27,46,222,200,422
KAFFRINE,KOUNGHEUL,"LOUR ESCALE","RIBOT ESCALE","DIAWARY GAKOU",12,17,93,76,169
KAFFRINE,KOUNGHEUL,"LOUR ESCALE","RIBOT ESCALE","H1 BOUBACAR DIAO",7,9,61,40,101
KAFFRINE,KOUNGHEUL,"LOUR ESCALE","RIBOT ESCALE","DIOURBEL SALOUM KEUR NDONGO",15,20,99,83,182
KAFFRINE,KOUNGHEUL,"LOUR ESCALE","RIBOT ESCALE","H1 PEULGA de DIOURBEL SALOUM KEUR NDONGO",3,4,24,24,48
KAFFRINE,KOUNGHEUL,"LOUR ESCALE","RIBOT ESCALE","H2 KEUR MBISSANE",6,7,40,35,75
KAFFRINE,KOUNGHEUL,"LOUR ESCALE","RIBOT ESCALE","FASS MBAYENE",12,13,57,49,106
KAFFRINE,KOUNGHEUL,"LOUR ESCALE","RIBOT ESCALE","HAFIA THIANENE",28,44,243,230,473
KAFFRINE,KOUNGHEUL,"LOUR ESCALE","RIBOT ESCALE","H1 TOUBA DIAWARTOU",6,6,56,23,79
KAFFRINE,KOUNGHEUL,"LOUR ESCALE","RIBOT ESCALE","HAMDALLAYE (KEUR MAHADAM)",37,70,325,318,643
KAFFRINE,KOUNGHEUL,"LOUR ESCALE","RIBOT ESCALE","KOUNG KOUNG",5,13,132,53,185
KAFFRINE,KOUNGHEUL,"LOUR ESCALE","RIBOT ESCALE","KOUNG KOUNG PEULH",7,17,91,82,173
KAFFRINE,KOUNGHEUL,"LOUR ESCALE","RIBOT ESCALE","LOUMBY PEULH",24,65,324,292,616
KAFFRINE,KOUNGHEUL,"LOUR ESCALE","RIBOT ESCALE","MAODO MOURIDE",10,12,55,49,104
KAFFRINE,KOUNGHEUL,"LOUR ESCALE","RIBOT ESCALE","H1 LOUMBY KOYLE",24,32,153,127,280
KAFFRINE,KOUNGHEUL,"LOUR ESCALE","RIBOT ESCALE","H2 THIERERE",1,2,18,20,38
KAFFRINE,KOUNGHEUL,"LOUR ESCALE","RIBOT ESCALE","H3 KEUR SAER SENE",2,4,31,34,65
KAFFRINE,KOUNGHEUL,"LOUR ESCALE","RIBOT ESCALE","MAODO PEULH",33,71,329,316,645
KAFFRINE,KOUNGHEUL,"LOUR ESCALE","RIBOT ESCALE","MEDINA KAHENE",16,35,122,93,215
KAFFRINE,KOUNGHEUL,"LOUR ESCALE","RIBOT ESCALE","MEDINA MOUNAWARA",58,72,549,373,922
KAFFRINE,KOUNGHEUL,"LOUR ESCALE","RIBOT ESCALE","H1 PEULGA de MEDINA MOUNAWARA",17,27,111,118,229
KAFFRINE,KOUNGHEUL,"LOUR ESCALE","RIBOT ESCALE",NDINDY,6,13,63,66,129
KAFFRINE,KOUNGHEUL,"LOUR ESCALE","RIBOT ESCALE","NDOGANDOU DIAM DIAM",3,8,24,31,55
KAFFRINE,KOUNGHEUL,"LOUR ESCALE","RIBOT ESCALE","NEMA DIAM DIAM",19,20,87,49,136
KAFFRINE,KOUNGHEUL,"LOUR ESCALE","RIBOT ESCALE","PETEL NDIODORY",8,14,83,77,160
KAFFRINE,KOUNGHEUL,"LOUR ESCALE","RIBOT ESCALE","PETELE KEUR AMADY",21,55,260,214,474
KAFFRINE,KOUNGHEUL,"LOUR ESCALE","RIBOT ESCALE","H1 SARE MOUSSA",7,15,76,64,140
KAFFRINE,KOUNGHEUL,"LOUR ESCALE","RIBOT ESCALE","POUBAR KEUR SEYDOU",7,9,30,26,56
KAFFRINE,KOUNGHEUL,"LOUR ESCALE","RIBOT ESCALE","RIBOT BAPP WOLOF",4,9,53,32,85
KAFFRINE,KOUNGHEUL,"LOUR ESCALE","RIBOT ESCALE","RIBOT BAPP PEULH",6,9,90,56,146
KAFFRINE,KOUNGHEUL,"LOUR ESCALE","RIBOT ESCALE","H1 KEUR SARA PENDA BA",3,5,13,9,22
KAFFRINE,KOUNGHEUL,"LOUR ESCALE","RIBOT ESCALE","H5 KEUR ABDOU BA",1,2,10,5,15
KAFFRINE,KOUNGHEUL,"LOUR ESCALE","RIBOT ESCALE","H6 KEUR CHEIKH DIONE",3,3,21,22,43
KAFFRINE,KOUNGHEUL,"LOUR ESCALE","RIBOT ESCALE","H7 KEUR OUSMANE",1,3,10,5,15
KAFFRINE,KOUNGHEUL,"LOUR ESCALE","RIBOT ESCALE","RIBOT ESCALE",120,136,638,614,1252
KAFFRINE,KOUNGHEUL,"LOUR ESCALE","RIBOT ESCALE","RIBOT KODIOLY",40,48,268,251,519
KAFFRINE,KOUNGHEUL,"LOUR ESCALE","RIBOT ESCALE","H1 KEUR NIANY",18,24,135,113,248
KAFFRINE,KOUNGHEUL,"LOUR ESCALE","RIBOT ESCALE","H2 KEUR MANKOU",7,19,128,112,240
KAFFRINE,KOUNGHEUL,"LOUR ESCALE","RIBOT ESCALE","RIBOT PEULH",26,32,204,147,351
KAFFRINE,KOUNGHEUL,"LOUR ESCALE","RIBOT ESCALE","RIBOT SALY",28,38,184,142,326
KAFFRINE,KOUNGHEUL,"LOUR ESCALE","RIBOT ESCALE","TAIF THIECKENE",146,176,1118,1021,2139
KAFFRINE,KOUNGHEUL,"LOUR ESCALE","RIBOT ESCALE","H1 PEULGA de TAIF THIECKENE",20,26,128,87,215
KAFFRINE,KOUNGHEUL,"LOUR ESCALE","RIBOT ESCALE","TAWFEKH SALOUM",55,55,310,245,555
KAFFRINE,KOUNGHEUL,"LOUR ESCALE","RIBOT ESCALE","H3 KEUR FARANG",6,8,41,30,71
KAFFRINE,KOUNGHEUL,"LOUR ESCALE","RIBOT ESCALE","THIAKHATE MOURIDE",54,74,562,416,978
KAFFRINE,KOUNGHEUL,"LOUR ESCALE","RIBOT ESCALE","THIAKHATE PEULH",17,33,188,187,375
KAFFRINE,KOUNGHEUL,"LOUR ESCALE","RIBOT ESCALE","TOUBA HAFFIA (SERIGNE CHEIKH)",25,28,164,149,313
KAFFRINE,KOUNGHEUL,"LOUR ESCALE","RIBOT ESCALE","TOUBA BOGO",23,39,207,209,416
KAFFRINE,KOUNGHEUL,"LOUR ESCALE","RIBOT ESCALE","TOUBA DAROU SALAM",1,1,1,0,1
KAFFRINE,KOUNGHEUL,"LOUR ESCALE","RIBOT ESCALE","TOUBA DIANATOUL FIRDAWSI",8,8,44,32,76
KAFFRINE,KOUNGHEUL,"LOUR ESCALE","RIBOT ESCALE","TOUBA DIWANE",5,5,14,9,23
KAFFRINE,KOUNGHEUL,"LOUR ESCALE","RIBOT ESCALE","TOUBA KOYA",11,14,39,34,73
KAFFRINE,KOUNGHEUL,"LOUR ESCALE","RIBOT ESCALE","TOUBA LOUMBY",15,18,76,62,138
KAFFRINE,KOUNGHEUL,"LOUR ESCALE","RIBOT ESCALE","TOUBA THIECKENE",61,78,506,360,866
KAFFRINE,KOUNGHEUL,"LOUR ESCALE","RIBOT ESCALE","H4 SARE BOYEDO",29,62,255,231,486
KAFFRINE,KOUNGHEUL,"LOUR ESCALE","RIBOT ESCALE","LOUGUE YAMA",22,62,307,270,577
KAFFRINE,KOUNGHEUL,"LOUR ESCALE","RIBOT ESCALE","MEDINA KHOGUE",11,22,104,95,199
KAFFRINE,KOUNGHEUL,"LOUR ESCALE","RIBOT ESCALE","PATAR TAWFEKH",17,24,107,113,220
KAFFRINE,KOUNGHEUL,"MISSIRAH WADENE","NGAINTHE PATHE",BOUDIOURGUEL,61,67,339,424,763
KAFFRINE,KOUNGHEUL,"MISSIRAH WADENE","NGAINTHE PATHE","H1 PEULGA de BOUDIOURGUEL",6,17,86,80,166
KAFFRINE,KOUNGHEUL,"MISSIRAH WADENE","NGAINTHE PATHE","H2 KEUR NIADA",5,6,29,34,63
KAFFRINE,KOUNGHEUL,"MISSIRAH WADENE","NGAINTHE PATHE","BOULEL DEMBA BA ( BOULEL SIBY)",32,59,250,186,436
KAFFRINE,KOUNGHEUL,"MISSIRAH WADENE","NGAINTHE PATHE","H1 MBELOGNE THINGOLE",3,3,11,16,27
KAFFRINE,KOUNGHEUL,"MISSIRAH WADENE","NGAINTHE PATHE","BOULEL DIAM DIAM",11,18,88,94,182
KAFFRINE,KOUNGHEUL,"MISSIRAH WADENE","NGAINTHE PATHE","H1 NDEBA FAYE",16,23,149,144,293
KAFFRINE,KOUNGHEUL,"MISSIRAH WADENE","NGAINTHE PATHE","H2 BOUSTANE BA",1,1,19,11,30
KAFFRINE,KOUNGHEUL,"MISSIRAH WADENE","NGAINTHE PATHE","BOUSRAH NDAWENE (PERABE NGABA)",20,35,211,224,435
KAFFRINE,KOUNGHEUL,"MISSIRAH WADENE","NGAINTHE PATHE","DAROU NDEUSSINE (CHEIKH LO)",15,15,69,63,132
KAFFRINE,KOUNGHEUL,"MISSIRAH WADENE","NGAINTHE PATHE","H1 KEUR SAMBA SANOU BA",1,2,14,17,31
KAFFRINE,KOUNGHEUL,"MISSIRAH WADENE","NGAINTHE PATHE","H2 KEUR SAMBA THIEWNGUEL BA",4,5,12,9,21
KAFFRINE,KOUNGHEUL,"MISSIRAH WADENE","NGAINTHE PATHE","H3 KEUR OMAR SOW",2,2,6,7,13
KAFFRINE,KOUNGHEUL,"MISSIRAH WADENE","NGAINTHE PATHE","H4 KEUR BOUDY KA",2,5,13,12,25
KAFFRINE,KOUNGHEUL,"MISSIRAH WADENE","NGAINTHE PATHE","H5 KEUR DOGA",6,7,29,25,54
KAFFRINE,KOUNGHEUL,"MISSIRAH WADENE","NGAINTHE PATHE","H6 KEUR MODA KA",2,2,11,5,16
KAFFRINE,KOUNGHEUL,"MISSIRAH WADENE","NGAINTHE PATHE","H7 KEUR BOYDO BA",2,2,11,7,18
KAFFRINE,KOUNGHEUL,"MISSIRAH WADENE","NGAINTHE PATHE","H8 KEUR OUSMANE SOW",4,4,15,12,27
KAFFRINE,KOUNGHEUL,"MISSIRAH WADENE","NGAINTHE PATHE","DAROU KHADIM (KEUR MAME MOR)",6,8,40,24,64
KAFFRINE,KOUNGHEUL,"MISSIRAH WADENE","NGAINTHE PATHE","H2 TOUBA NDENDEYE",13,17,90,78,168
KAFFRINE,KOUNGHEUL,"MISSIRAH WADENE","NGAINTHE PATHE","H3 DARAYE KAW",1,1,8,0,8
KAFFRINE,KOUNGHEUL,"MISSIRAH WADENE","NGAINTHE PATHE","H4 MOR FALL (HABANE GUEYE)",1,1,7,0,7
KAFFRINE,KOUNGHEUL,"MISSIRAH WADENE","NGAINTHE PATHE","DAROU MOUSSEU",16,24,94,89,183
KAFFRINE,KOUNGHEUL,"MISSIRAH WADENE","NGAINTHE PATHE","H1 PEULGA de DAROU MOUSSEU",13,23,113,115,228
KAFFRINE,KOUNGHEUL,"MISSIRAH WADENE","NGAINTHE PATHE","H2 NDIAREME",5,9,50,35,85
KAFFRINE,KOUNGHEUL,"MISSIRAH WADENE","NGAINTHE PATHE","DAROU MOUSTY NDAWENE",12,14,69,77,146
KAFFRINE,KOUNGHEUL,"MISSIRAH WADENE","NGAINTHE PATHE","H1 KEUR DAME NDAO",5,5,22,24,46
KAFFRINE,KOUNGHEUL,"MISSIRAH WADENE","NGAINTHE PATHE","H2 KEUR SAMBA GOURDA BA",17,33,165,117,282
KAFFRINE,KOUNGHEUL,"MISSIRAH WADENE","NGAINTHE PATHE","H3 KEUR SAMBA SOUNKAROU KA",6,10,57,50,107
KAFFRINE,KOUNGHEUL,"MISSIRAH WADENE","NGAINTHE PATHE","H4 KEUR PATHE KA",1,1,6,7,13
KAFFRINE,KOUNGHEUL,"MISSIRAH WADENE","NGAINTHE PATHE","DAROU THIOYENE",13,15,79,63,142
KAFFRINE,KOUNGHEUL,"MISSIRAH WADENE","NGAINTHE PATHE","H1 PEULGA de DAROU THIOYENE",2,3,12,9,21
KAFFRINE,KOUNGHEUL,"MISSIRAH WADENE","NGAINTHE PATHE","H2 THIERERGA",6,7,56,51,107
KAFFRINE,KOUNGHEUL,"MISSIRAH WADENE","NGAINTHE PATHE",DIATMEL,18,41,189,183,372
KAFFRINE,KOUNGHEUL,"MISSIRAH WADENE","NGAINTHE PATHE","DIOULMAK (DIAM DIAM)",31,49,176,179,355
KAFFRINE,KOUNGHEUL,"MISSIRAH WADENE","NGAINTHE PATHE","H1 KEUR AMATH BA",5,7,43,33,76
KAFFRINE,KOUNGHEUL,"MISSIRAH WADENE","NGAINTHE PATHE","FASS THIOYENE (YAGUINE)",22,24,119,115,234
KAFFRINE,KOUNGHEUL,"MISSIRAH WADENE","NGAINTHE PATHE","H1 YAGUINE PEULH",7,12,43,41,84
KAFFRINE,KOUNGHEUL,"MISSIRAH WADENE","NGAINTHE PATHE","GAINTHE PATHE",214,243,1387,1520,2907
KAFFRINE,KOUNGHEUL,"MISSIRAH WADENE","NGAINTHE PATHE","H1 KEUR DIAKAYE BA",3,8,39,29,68
KAFFRINE,KOUNGHEUL,"MISSIRAH WADENE","NGAINTHE PATHE","GAZEL NODY",4,7,44,23,67
KAFFRINE,KOUNGHEUL,"MISSIRAH WADENE","NGAINTHE PATHE",KANDIANE,5,9,50,57,107
KAFFRINE,KOUNGHEUL,"MISSIRAH WADENE","NGAINTHE PATHE","H1 KEUR KIBEL BA",6,13,71,68,139
KAFFRINE,KOUNGHEUL,"MISSIRAH WADENE","NGAINTHE PATHE","KEUR NDEME",22,42,183,176,359
KAFFRINE,KOUNGHEUL,"MISSIRAH WADENE","NGAINTHE PATHE","KEUR SALIOU",10,18,66,85,151
KAFFRINE,KOUNGHEUL,"MISSIRAH WADENE","NGAINTHE PATHE","KHAYE BOUBOU",32,33,194,180,374
KAFFRINE,KOUNGHEUL,"MISSIRAH WADENE","NGAINTHE PATHE",LOUMBOL,27,33,160,145,305
KAFFRINE,KOUNGHEUL,"MISSIRAH WADENE","NGAINTHE PATHE","H1 KEUR YORO BOUYA",4,6,28,26,54
KAFFRINE,KOUNGHEUL,"MISSIRAH WADENE","NGAINTHE PATHE","H2 SANTHIANE",3,4,23,14,37
KAFFRINE,KOUNGHEUL,"MISSIRAH WADENE","NGAINTHE PATHE","H3 WENDOU ALPHA",8,13,76,75,151
KAFFRINE,KOUNGHEUL,"MISSIRAH WADENE","NGAINTHE PATHE","H4 BÊLE",9,10,84,58,142
KAFFRINE,KOUNGHEUL,"MISSIRAH WADENE","NGAINTHE PATHE","H5 COUFA MALICK KEUR MODY",7,15,60,50,110
KAFFRINE,KOUNGHEUL,"MISSIRAH WADENE","NGAINTHE PATHE",MBETTETE,19,23,118,112,230
KAFFRINE,KOUNGHEUL,"MISSIRAH WADENE","NGAINTHE PATHE","H1 COUFA MALICK",14,25,102,109,211
KAFFRINE,KOUNGHEUL,"MISSIRAH WADENE","NGAINTHE PATHE","MEDINA FASS (KEUR SAMBA NDAO)",17,23,151,141,292
KAFFRINE,KOUNGHEUL,"MISSIRAH WADENE","NGAINTHE PATHE","H1 TAWFEKH SERERGA",2,2,8,7,15
KAFFRINE,KOUNGHEUL,"MISSIRAH WADENE","NGAINTHE PATHE","MEDINA NDIAYENE (KEUR EL HADJI BAKAR)",47,49,222,257,479
KAFFRINE,KOUNGHEUL,"MISSIRAH WADENE","NGAINTHE PATHE","MEDINA SALAM",7,13,108,77,185
KAFFRINE,KOUNGHEUL,"MISSIRAH WADENE","NGAINTHE PATHE","H1 THIERERGA ( KEUR BAYE DIOP)",5,6,36,35,71
KAFFRINE,KOUNGHEUL,"MISSIRAH WADENE","NGAINTHE PATHE","H2 THIERERGA (KEUR DAME FAYE)",13,19,120,120,240
KAFFRINE,KOUNGHEUL,"MISSIRAH WADENE","NGAINTHE PATHE","MEDINA SAMBENE",35,39,203,229,432
KAFFRINE,KOUNGHEUL,"MISSIRAH WADENE","NGAINTHE PATHE","H1 FASS ( THIAMBENE)",27,31,151,172,323
KAFFRINE,KOUNGHEUL,"MISSIRAH WADENE","NGAINTHE PATHE","H2 KEUR BAÏDY SOW",8,12,70,78,148
KAFFRINE,KOUNGHEUL,"MISSIRAH WADENE","NGAINTHE PATHE","H3 NAYOME SOW",11,13,72,71,143
KAFFRINE,KOUNGHEUL,"MISSIRAH WADENE","NGAINTHE PATHE","H4 KEUR ALASSANE BA",2,3,11,13,24
KAFFRINE,KOUNGHEUL,"MISSIRAH WADENE","NGAINTHE PATHE","H5 DAROU SALAM  DIAM DIAM",16,25,168,149,317
KAFFRINE,KOUNGHEUL,"MISSIRAH WADENE","NGAINTHE PATHE","H6 KEUR ELHADJ SOW",3,8,47,40,87
KAFFRINE,KOUNGHEUL,"MISSIRAH WADENE","NGAINTHE PATHE","MISSIRAH THIOYENE",16,19,153,120,273
KAFFRINE,KOUNGHEUL,"MISSIRAH WADENE","NGAINTHE PATHE","DANTHIADJI PEULH",11,17,101,55,156
KAFFRINE,KOUNGHEUL,"MISSIRAH WADENE","NGAINTHE PATHE",NDIALKHOSS,26,36,195,208,403
KAFFRINE,KOUNGHEUL,"MISSIRAH WADENE","NGAINTHE PATHE","DIAWARY SIDACK (DIAOREL)",21,30,179,119,298
KAFFRINE,KOUNGHEUL,"MISSIRAH WADENE","NGAINTHE PATHE","H1 DAARAY SERIGNE CHEIKH BINTOU",2,2,20,4,24
KAFFRINE,KOUNGHEUL,"MISSIRAH WADENE","NGAINTHE PATHE","H2 FORÊT NDAYRY",8,11,45,44,89
KAFFRINE,KOUNGHEUL,"MISSIRAH WADENE","NGAINTHE PATHE",NDIOGOP,12,14,67,69,136
KAFFRINE,KOUNGHEUL,"MISSIRAH WADENE","NGAINTHE PATHE","NGOUYE DIERY ( NDIAMBA)",127,151,895,782,1677
KAFFRINE,KOUNGHEUL,"MISSIRAH WADENE","NGAINTHE PATHE","H1 TOUBA KEUR NIANG",1,1,12,3,15
KAFFRINE,KOUNGHEUL,"MISSIRAH WADENE","NGAINTHE PATHE","H2 TOUBA BASSAME ( DARAYE SERIGNE MOURTALLA )",3,3,31,3,34
KAFFRINE,KOUNGHEUL,"MISSIRAH WADENE","NGAINTHE PATHE","H3 TOUBA  NIANGUENE",1,1,4,1,5
KAFFRINE,KOUNGHEUL,"MISSIRAH WADENE","NGAINTHE PATHE","SABE SABRE",12,19,73,76,149
KAFFRINE,KOUNGHEUL,"MISSIRAH WADENE","NGAINTHE PATHE","SIDACK DEMBA KODE",21,41,182,167,349
KAFFRINE,KOUNGHEUL,"MISSIRAH WADENE","NGAINTHE PATHE","H1 NIOUNGHEYROU",26,46,186,187,373
KAFFRINE,KOUNGHEUL,"MISSIRAH WADENE","NGAINTHE PATHE","H2 KALELA",18,30,131,116,247
KAFFRINE,KOUNGHEUL,"MISSIRAH WADENE","NGAINTHE PATHE","H3 SIDACK DIAM DIAM",10,23,110,91,201
KAFFRINE,KOUNGHEUL,"MISSIRAH WADENE","NGAINTHE PATHE",TAGUE,4,4,26,20,46
KAFFRINE,KOUNGHEUL,"MISSIRAH WADENE","NGAINTHE PATHE","H1 TAGUE PEULH",5,12,79,43,122
KAFFRINE,KOUNGHEUL,"MISSIRAH WADENE","NGAINTHE PATHE","H2 TIVAOUANE SALOUM",5,8,48,62,110
KAFFRINE,KOUNGHEUL,"MISSIRAH WADENE","NGAINTHE PATHE",THIEPPE,31,37,235,224,459
KAFFRINE,KOUNGHEUL,"MISSIRAH WADENE","NGAINTHE PATHE","H1 KEUR DAOUDA BA( THIEPPA KOUMBIDIA)",27,54,245,237,482
KAFFRINE,KOUNGHEUL,"MISSIRAH WADENE","NGAINTHE PATHE","H2 DIAM DIAM KEUR LALY",7,12,60,61,121
KAFFRINE,KOUNGHEUL,"MISSIRAH WADENE","NGAINTHE PATHE","THIOBE NDIOUFENE",21,31,150,175,325
KAFFRINE,KOUNGHEUL,"MISSIRAH WADENE","NGAINTHE PATHE","H1 LOYENE",8,9,81,67,148
KAFFRINE,KOUNGHEUL,"MISSIRAH WADENE","NGAINTHE PATHE","H2 DIAM DIAM",3,9,59,34,93
KAFFRINE,KOUNGHEUL,"MISSIRAH WADENE","NGAINTHE PATHE","H3 COLY",5,6,41,33,74
KAFFRINE,KOUNGHEUL,"MISSIRAH WADENE","NGAINTHE PATHE","H4 NDIAO  THIOBE",6,13,48,37,85
KAFFRINE,KOUNGHEUL,"MISSIRAH WADENE","NGAINTHE PATHE","H5 THIOBE NDANGA",3,6,47,43,90
KAFFRINE,KOUNGHEUL,"MISSIRAH WADENE","NGAINTHE PATHE",THIOYENE,23,29,160,178,338
KAFFRINE,KOUNGHEUL,"MISSIRAH WADENE","NGAINTHE PATHE","H1 THIOYENE PEULGA",9,26,123,146,269
KAFFRINE,KOUNGHEUL,"MISSIRAH WADENE","NGAINTHE PATHE","TOUBA ALIEU",94,111,783,605,1388
KAFFRINE,KOUNGHEUL,"MISSIRAH WADENE","NGAINTHE PATHE","H1 DAROU SALAM",34,42,223,205,428
KAFFRINE,KOUNGHEUL,"MISSIRAH WADENE","NGAINTHE PATHE","H2 NASROU",6,6,64,44,108
KAFFRINE,KOUNGHEUL,"MISSIRAH WADENE","NGAINTHE PATHE","H3 TOUBA SAM",5,5,29,20,49
KAFFRINE,KOUNGHEUL,"MISSIRAH WADENE","NGAINTHE PATHE","H4 DAARA SERIGNE ISMAILA DIOUF ( DANTHIALY SERERE)",9,11,53,56,109
KAFFRINE,KOUNGHEUL,"MISSIRAH WADENE","NGAINTHE PATHE","H5 NDIAMBOUR",6,7,44,37,81
KAFFRINE,KOUNGHEUL,"MISSIRAH WADENE","NGAINTHE PATHE","H6 TAISSIROU",12,15,93,87,180
KAFFRINE,KOUNGHEUL,"MISSIRAH WADENE","NGAINTHE PATHE","H7 RABIKH",6,6,29,31,60
KAFFRINE,KOUNGHEUL,"MISSIRAH WADENE","NGAINTHE PATHE","H8 DAARAY CHEIKH IBRA FALL",1,1,11,0,11
KAFFRINE,KOUNGHEUL,"MISSIRAH WADENE","NGAINTHE PATHE","TOUBA DIOULMACK (NIANGUENE)",23,30,168,150,318
KAFFRINE,KOUNGHEUL,"MISSIRAH WADENE","NGAINTHE PATHE","TOUBA KANDIANE ( NDIAGANENE )",12,12,60,41,101
KAFFRINE,KOUNGHEUL,"MISSIRAH WADENE","NGAINTHE PATHE","TOUBA MBOWENE",28,33,228,286,514
KAFFRINE,KOUNGHEUL,"MISSIRAH WADENE","NGAINTHE PATHE","TOUBA NGUEYENE( KEUR DOF)",12,16,79,81,160
KAFFRINE,KOUNGHEUL,"MISSIRAH WADENE","NGAINTHE PATHE","H1 PEULGA de TOUBA NGUEYENE( KEUR DOF)",2,4,11,16,27
KAFFRINE,KOUNGHEUL,"MISSIRAH WADENE","NGAINTHE PATHE","H2 BÊLE BONDJIE",6,9,34,30,64
KAFFRINE,KOUNGHEUL,"MISSIRAH WADENE","NGAINTHE PATHE","H3 MBELOGNE KADJI",3,3,15,16,31
KAFFRINE,KOUNGHEUL,"MISSIRAH WADENE","NGAINTHE PATHE",YASSI,27,39,211,208,419
KAFFRINE,KOUNGHEUL,"MISSIRAH WADENE","NGAINTHE PATHE","H1 KEUR PATHE DEME",16,25,132,118,250
KAFFRINE,KOUNGHEUL,"MISSIRAH WADENE","NGAINTHE PATHE","H3 KEUR OMAR DIAO",7,18,95,91,186
KAFFRINE,KOUNGHEUL,"MISSIRAH WADENE","NGAINTHE PATHE","H2 KEUR MODOU NIANG",4,4,28,25,53
KAFFRINE,KOUNGHEUL,"MISSIRAH WADENE","NGAINTHE PATHE","H4 TOUBA TAWFEKH",1,1,14,10,24
KAFFRINE,KOUNGHEUL,"MISSIRAH WADENE","NGAINTHE PATHE","H5 BADARA",1,1,66,33,99
KAFFRINE,KOUNGHEUL,"MISSIRAH WADENE","NGAINTHE PATHE","TAGUE NGUEYENE ( SANTHIE NDIMB)",19,23,104,112,216
KAFFRINE,KOUNGHEUL,"MISSIRAH WADENE","NGAINTHE PATHE","TOUBA MEW",6,7,36,38,74
KAFFRINE,KOUNGHEUL,"MISSIRAH WADENE","MAKA YOP","DAROU KAFATTE",68,89,491,544,1035
KAFFRINE,KOUNGHEUL,"MISSIRAH WADENE","MAKA YOP","H1 PEULGA de DAROU KAFATTE",7,17,129,99,228
KAFFRINE,KOUNGHEUL,"MISSIRAH WADENE","MAKA YOP","DAROU MINAM (NDAWENE)",22,26,166,134,300
KAFFRINE,KOUNGHEUL,"MISSIRAH WADENE","MAKA YOP","DAROU SALAM (KEUR KABE)",35,47,297,337,634
KAFFRINE,KOUNGHEUL,"MISSIRAH WADENE","MAKA YOP","H1 DIAM DIAM ( SARE BODEDIE)",14,27,159,137,296
KAFFRINE,KOUNGHEUL,"MISSIRAH WADENE","MAKA YOP","DAROU THIAMENE",43,49,373,355,728
KAFFRINE,KOUNGHEUL,"MISSIRAH WADENE","MAKA YOP","FASS NGACKENE (KEUR SAMBA YELI)",19,31,198,135,333
KAFFRINE,KOUNGHEUL,"MISSIRAH WADENE","MAKA YOP","FASS THIARENE (KEUR IBOU SARR)",19,23,113,82,195
KAFFRINE,KOUNGHEUL,"MISSIRAH WADENE","MAKA YOP","H1 MOUNAWARA II (SANTHIE IBRAHIMA SARR)",7,10,45,16,61
KAFFRINE,KOUNGHEUL,"MISSIRAH WADENE","MAKA YOP",HANENE,62,71,440,440,880
KAFFRINE,KOUNGHEUL,"MISSIRAH WADENE","MAKA YOP",KAFFATE,44,69,395,375,770
KAFFRINE,KOUNGHEUL,"MISSIRAH WADENE","MAKA YOP","H1 MANDIOCK BA",7,14,82,72,154
KAFFRINE,KOUNGHEUL,"MISSIRAH WADENE","MAKA YOP","H2 NDIAO KAFFATE",7,9,15,20,35
KAFFRINE,KOUNGHEUL,"MISSIRAH WADENE","MAKA YOP","KHAIRAWANE NDAWENE",15,30,181,146,327
KAFFRINE,KOUNGHEUL,"MISSIRAH WADENE","MAKA YOP","MAKA YOPP",109,119,613,623,1236
KAFFRINE,KOUNGHEUL,"MISSIRAH WADENE","MAKA YOP","H1 DAARAY SERIGNE FALLOU FALL",1,1,19,0,19
KAFFRINE,KOUNGHEUL,"MISSIRAH WADENE","MAKA YOP","H2 FASS THIONGANE",28,31,201,182,383
KAFFRINE,KOUNGHEUL,"MISSIRAH WADENE","MAKA YOP",MBELOGNE,23,29,188,184,372
KAFFRINE,KOUNGHEUL,"MISSIRAH WADENE","MAKA YOP","H1 MBELOGNE SARA",4,5,29,36,65
KAFFRINE,KOUNGHEUL,"MISSIRAH WADENE","MAKA YOP","MEDINA DEGOUYE (SANTHIE ADA)",149,166,939,988,1927
KAFFRINE,KOUNGHEUL,"MISSIRAH WADENE","MAKA YOP","MEDINA MOMATH( SANTHIE MOTH BA)",28,44,417,268,685
KAFFRINE,KOUNGHEUL,"MISSIRAH WADENE","MAKA YOP","H1 PEULGA de MEDINA MOMATH( SANTHIE MOTH BA)",7,16,82,64,146
KAFFRINE,KOUNGHEUL,"MISSIRAH WADENE","MAKA YOP","H2 MEDINA FAAS ( KEUR MOUSTAPHA BA)",1,1,2,10,12
KAFFRINE,KOUNGHEUL,"MISSIRAH WADENE","MAKA YOP","MEDINA THIALLENE (SANTHIE BABA SEYE)",8,8,30,35,65
KAFFRINE,KOUNGHEUL,"MISSIRAH WADENE","MAKA YOP","MEDINA TOBENE II",57,65,396,298,694
KAFFRINE,KOUNGHEUL,"MISSIRAH WADENE","MAKA YOP","H1 MEDINA THIECKENE",13,14,68,53,121
KAFFRINE,KOUNGHEUL,"MISSIRAH WADENE","MAKA YOP","MEDINA  MOUNAWARA I ( NDAWENE)",6,10,43,50,93
KAFFRINE,KOUNGHEUL,"MISSIRAH WADENE","MAKA YOP",NDAKHAR,18,25,126,166,292
KAFFRINE,KOUNGHEUL,"MISSIRAH WADENE","MAKA YOP","H1 MAKHAMA",3,3,24,10,34
KAFFRINE,KOUNGHEUL,"MISSIRAH WADENE","MAKA YOP",NGAYENE,26,37,241,201,442
KAFFRINE,KOUNGHEUL,"MISSIRAH WADENE","MAKA YOP","H2 KEUR SARRA CODE",2,3,25,16,41
KAFFRINE,KOUNGHEUL,"MISSIRAH WADENE","MAKA YOP","NGUERANE FASS (SANTHIOU NGUERANE)",142,193,1183,1246,2429
KAFFRINE,KOUNGHEUL,"MISSIRAH WADENE","MAKA YOP","H1 KEUR MAGOR KA",2,3,14,13,27
KAFFRINE,KOUNGHEUL,"MISSIRAH WADENE","MAKA YOP","NGUERANE GOUMACK",81,100,570,574,1144
KAFFRINE,KOUNGHEUL,"MISSIRAH WADENE","MAKA YOP","H1 DIACKSAO",1,1,25,0,25
KAFFRINE,KOUNGHEUL,"MISSIRAH WADENE","MAKA YOP","PAPE LOUGUE",5,7,34,35,69
KAFFRINE,KOUNGHEUL,"MISSIRAH WADENE","MAKA YOP","H1 PAPE LOUGUE",12,17,87,91,178
KAFFRINE,KOUNGHEUL,"MISSIRAH WADENE","MAKA YOP","H2 KEUR BARA KA",1,1,6,6,12
KAFFRINE,KOUNGHEUL,"MISSIRAH WADENE","MAKA YOP","PAPE SA BOP (KEUR THIALLY)",15,20,87,93,180
KAFFRINE,KOUNGHEUL,"MISSIRAH WADENE","MAKA YOP","SAM SAM (SANTHIOU SAMBODOU)",4,12,34,29,63
KAFFRINE,KOUNGHEUL,"MISSIRAH WADENE","MAKA YOP","H1 NDANGA ( SANTHIOU YERO BOUYA )",7,7,35,16,51
KAFFRINE,KOUNGHEUL,"MISSIRAH WADENE","MAKA YOP","SANTHIE KAFFATE (SANTHIOU MANIANG)",62,76,501,540,1041
KAFFRINE,KOUNGHEUL,"MISSIRAH WADENE","MAKA YOP","TAIBA NDIOUFENE",31,49,271,305,576
KAFFRINE,KOUNGHEUL,"MISSIRAH WADENE","MAKA YOP","H1 KEUR BABA",9,22,121,116,237
KAFFRINE,KOUNGHEUL,"MISSIRAH WADENE","MAKA YOP",TANEME,34,48,345,245,590
KAFFRINE,KOUNGHEUL,"MISSIRAH WADENE","MAKA YOP","NGUERANE FASS PEULH",14,18,92,111,203
KAFFRINE,KOUNGHEUL,"MISSIRAH WADENE","MISSIRAH WADENE","AÏNOUMANE ( AÏNOUMANE TAMBEDOU )",94,118,721,792,1513
KAFFRINE,KOUNGHEUL,"MISSIRAH WADENE","MISSIRAH WADENE","AINOUMANE DRAME",23,29,167,196,363
KAFFRINE,KOUNGHEUL,"MISSIRAH WADENE","MISSIRAH WADENE","H1 KEUR BOYE  BA",1,2,7,5,12
KAFFRINE,KOUNGHEUL,"MISSIRAH WADENE","MISSIRAH WADENE","H2 KEUR HILLO DIAO",1,1,11,10,21
KAFFRINE,KOUNGHEUL,"MISSIRAH WADENE","MISSIRAH WADENE",ARAFAT,158,211,1296,1266,2562
KAFFRINE,KOUNGHEUL,"MISSIRAH WADENE","MISSIRAH WADENE","H1 BANDIOUL BANTE",89,106,563,478,1041
KAFFRINE,KOUNGHEUL,"MISSIRAH WADENE","MISSIRAH WADENE","BAYTI MOUKHADAS",4,4,34,27,61
KAFFRINE,KOUNGHEUL,"MISSIRAH WADENE","MISSIRAH WADENE","H1 KEUR MBAYE KA",1,3,23,18,41
KAFFRINE,KOUNGHEUL,"MISSIRAH WADENE","MISSIRAH WADENE","NDAGNE TALLY  (KEUR GALLO)",12,12,115,110,225
KAFFRINE,KOUNGHEUL,"MISSIRAH WADENE","MISSIRAH WADENE","H1 KEUR IBRA SOW",6,6,27,26,53
KAFFRINE,KOUNGHEUL,"MISSIRAH WADENE","MISSIRAH WADENE","DIAM DIAM (SARE KODE DIALLO)",9,16,93,73,166
KAFFRINE,KOUNGHEUL,"MISSIRAH WADENE","MISSIRAH WADENE",DIMISKHA,282,337,2924,2441,5365
KAFFRINE,KOUNGHEUL,"MISSIRAH WADENE","MISSIRAH WADENE","FASS MBAYENE II",23,35,216,208,424
KAFFRINE,KOUNGHEUL,"MISSIRAH WADENE","MISSIRAH WADENE","FASS NDIAYENE",22,26,137,102,239
KAFFRINE,KOUNGHEUL,"MISSIRAH WADENE","MISSIRAH WADENE","KAHENE NDIOUMA ( KEUR DIOUMA)",7,10,44,43,87
KAFFRINE,KOUNGHEUL,"MISSIRAH WADENE","MISSIRAH WADENE","KEUR BABOU DIOUF",14,18,81,71,152
KAFFRINE,KOUNGHEUL,"MISSIRAH WADENE","MISSIRAH WADENE","KEUR MALICK MARAME",38,49,258,349,607
KAFFRINE,KOUNGHEUL,"MISSIRAH WADENE","MISSIRAH WADENE","KOLY OMAR DAGA",20,37,302,259,561
KAFFRINE,KOUNGHEUL,"MISSIRAH WADENE","MISSIRAH WADENE","MAME DIARRA",15,19,109,152,261
KAFFRINE,KOUNGHEUL,"MISSIRAH WADENE","MISSIRAH WADENE","MBAYE MBAYE",53,62,203,129,332
KAFFRINE,KOUNGHEUL,"MISSIRAH WADENE","MISSIRAH WADENE","MEDINA COLY (COLY WOLOF)",65,81,581,570,1151
KAFFRINE,KOUNGHEUL,"MISSIRAH WADENE","MISSIRAH WADENE","MEDINA FALL ( GNOUROUKH )",20,23,122,110,232
KAFFRINE,KOUNGHEUL,"MISSIRAH WADENE","MISSIRAH WADENE","MEDINA LAHINE (KEUR LAHINE MARA)",35,54,273,255,528
KAFFRINE,KOUNGHEUL,"MISSIRAH WADENE","MISSIRAH WADENE","MEDINA NDAWENE (NDIRANE)",26,31,170,162,332
KAFFRINE,KOUNGHEUL,"MISSIRAH WADENE","MISSIRAH WADENE","MEDINA NDEMENE (SANTHIOU ABLAYE)",16,20,121,131,252
KAFFRINE,KOUNGHEUL,"MISSIRAH WADENE","MISSIRAH WADENE","MEDINA NDIOBENE ( NIARY LAME)",59,62,399,359,758
KAFFRINE,KOUNGHEUL,"MISSIRAH WADENE","MISSIRAH WADENE","MEDINA NDRAME (SANTHIOU MOR AMINTA)",24,40,264,246,510
KAFFRINE,KOUNGHEUL,"MISSIRAH WADENE","MISSIRAH WADENE","MEO DIOBENE (MEO TRAVAUX)",40,65,268,293,561
KAFFRINE,KOUNGHEUL,"MISSIRAH WADENE","MISSIRAH WADENE","H1 SANTHIE DJIBRIL ( MEDINA THIAMENE)",4,4,59,31,90
KAFFRINE,KOUNGHEUL,"MISSIRAH WADENE","MISSIRAH WADENE","MINAL NDRAME ( MINAL YARI GOUYE)",9,17,73,88,161
KAFFRINE,KOUNGHEUL,"MISSIRAH WADENE","MISSIRAH WADENE","MISSIRAH WADENE",483,546,2656,2515,5171
KAFFRINE,KOUNGHEUL,"MISSIRAH WADENE","MISSIRAH WADENE","H1 MINAL LAOUBE",11,16,66,54,120
KAFFRINE,KOUNGHEUL,"MISSIRAH WADENE","MISSIRAH WADENE","MEDINA NDAWENE (SALLA DIAW)",21,24,129,163,292
KAFFRINE,KOUNGHEUL,"MISSIRAH WADENE","MISSIRAH WADENE","NDIAYENE SADIAKHOU",23,26,113,111,224
KAFFRINE,KOUNGHEUL,"MISSIRAH WADENE","MISSIRAH WADENE","NDIOBENE SEANE",10,12,70,69,139
KAFFRINE,KOUNGHEUL,"MISSIRAH WADENE","MISSIRAH WADENE","NDRAME SALY",21,29,140,187,327
KAFFRINE,KOUNGHEUL,"MISSIRAH WADENE","MISSIRAH WADENE","PORT NDRAME",33,34,213,199,412
KAFFRINE,KOUNGHEUL,"MISSIRAH WADENE","MISSIRAH WADENE","H1 KEUR BABOU DRAME",2,2,13,16,29
KAFFRINE,KOUNGHEUL,"MISSIRAH WADENE","MISSIRAH WADENE","H2 SARRE MALEDA",12,16,103,60,163
KAFFRINE,KOUNGHEUL,"MISSIRAH WADENE","MISSIRAH WADENE","PORT THIALENE",34,44,277,249,526
KAFFRINE,KOUNGHEUL,"MISSIRAH WADENE","MISSIRAH WADENE","H1 DIMISKHA THIALENE ( SANTHIE OMAR DIARRA)",13,13,109,88,197
KAFFRINE,KOUNGHEUL,"MISSIRAH WADENE","MISSIRAH WADENE","TAÏBA THIALENE",52,73,665,569,1234
KAFFRINE,KOUNGHEUL,"MISSIRAH WADENE","MISSIRAH WADENE","TAIBA WILANENE",16,19,95,90,185
KAFFRINE,KOUNGHEUL,"MISSIRAH WADENE","MISSIRAH WADENE","H1 PEULGA",4,4,37,28,65
KAFFRINE,KOUNGHEUL,"MISSIRAH WADENE","MISSIRAH WADENE",THISSE,13,17,69,83,152
KAFFRINE,KOUNGHEUL,"MISSIRAH WADENE","MISSIRAH WADENE","TOUBA MOURIDE ( TAWA)",11,15,104,91,195
KAFFRINE,KOUNGHEUL,"MISSIRAH WADENE","MISSIRAH WADENE","TOUBA WENHAIRE",12,17,91,106,197
KAFFRINE,KOUNGHEUL,"MISSIRAH WADENE","MISSIRAH WADENE","VELINGARA DEMBA SOW",12,21,113,91,204
KAFFRINE,KOUNGHEUL,"MISSIRAH WADENE","MISSIRAH WADENE",YAMANE,22,29,146,154,300
KAFFRINE,KOUNGHEUL,"MISSIRAH WADENE","MISSIRAH WADENE","FASS THIEKENE ( SANTHIE ELHADJI AÏDARA SECK)",1,1,3,4,7
KAFFRINE,KOUNGHEUL,"MISSIRAH WADENE","MISSIRAH WADENE","KEUR NDARY DIE ( SANTHIE NDARY TALL)",15,15,90,37,127
KAFFRINE,KOUNGHEUL,"MISSIRAH WADENE","MISSIRAH WADENE",MAKHAMA,20,22,275,150,425
KAFFRINE,KOUNGHEUL,"MISSIRAH WADENE","MISSIRAH WADENE","MEDINA FASS",28,31,71,84,155
KAFFRINE,KOUNGHEUL,"MISSIRAH WADENE","MISSIRAH WADENE","MEDINA MOUNAWARA",17,23,173,114,287
KAFFRINE,KOUNGHEUL,"MISSIRAH WADENE","MISSIRAH WADENE","MEDINA WADENE ( WADENE)",7,7,20,13,33
KAFFRINE,"MALEM HODDAR","MALEM HODDAR","MALEM HODDAR",ESCALE,125,151,815,847,1662
KAFFRINE,"MALEM HODDAR","MALEM HODDAR","MALEM HODDAR","GUINAW RAIL",176,215,1001,972,1973
KAFFRINE,"MALEM HODDAR","MALEM HODDAR","MALEM HODDAR",IMINDINE,34,48,288,408,696
KAFFRINE,"MALEM HODDAR","MALEM HODDAR","MALEM HODDAR",MBADIANENE,150,170,856,919,1775
KAFFRINE,"MALEM HODDAR","MALEM HODDAR","MALEM HODDAR",TAIBA,109,119,905,955,1860
KAFFRINE,"MALEM HODDAR","MALEM HODDAR","MALEM HODDAR","TAWA KEUR EL HADJI",175,187,1390,1342,2732
KAFFRINE,"MALEM HODDAR","MALEM HODDAR","MALEM HODDAR","TAWA MOSQUEE",86,103,792,698,1490
KAFFRINE,"MALEM HODDAR","DAROU MINAM 2","DAROU MINAM","BOGNEDIE (SAM FATIM)",14,19,87,84,171
KAFFRINE,"MALEM HODDAR","DAROU MINAM 2","DAROU MINAM","DAROU DIENE (DARA MAME MOR DIOP)",28,37,214,173,387
KAFFRINE,"MALEM HODDAR","DAROU MINAM 2","DAROU MINAM","DAROU DIOP (DAROU GUEYE)",30,34,271,235,506
KAFFRINE,"MALEM HODDAR","DAROU MINAM 2","DAROU MINAM","DAROU MINAM II",106,119,671,690,1361
KAFFRINE,"MALEM HODDAR","DAROU MINAM 2","DAROU MINAM","H1 DAROU HODIOLDE",22,33,271,248,519
KAFFRINE,"MALEM HODDAR","DAROU MINAM 2","DAROU MINAM","H2 DAROU SALAM",36,37,205,172,377
KAFFRINE,"MALEM HODDAR","DAROU MINAM 2","DAROU MINAM","H4 SIADA",8,13,60,43,103
KAFFRINE,"MALEM HODDAR","DAROU MINAM 2","DAROU MINAM","H5 MINATOU AKHLA",2,2,35,12,47
KAFFRINE,"MALEM HODDAR","DAROU MINAM 2","DAROU MINAM","H6 KEUR MBAYE NGOM",6,6,42,33,75
KAFFRINE,"MALEM HODDAR","DAROU MINAM 2","DAROU MINAM",DEPE,33,58,426,397,823
KAFFRINE,"MALEM HODDAR","DAROU MINAM 2","DAROU MINAM","DIAGA KEUR SERIGNE NIANG",86,107,640,592,1232
KAFFRINE,"MALEM HODDAR","DAROU MINAM 2","DAROU MINAM","H3 TENNALT",3,4,40,40,80
KAFFRINE,"MALEM HODDAR","DAROU MINAM 2","DAROU MINAM","FASS SENENE",11,18,108,108,216
KAFFRINE,"MALEM HODDAR","DAROU MINAM 2","DAROU MINAM","KEUR IBRA DIACK (NDIAGUENE)",10,19,153,100,253
KAFFRINE,"MALEM HODDAR","DAROU MINAM 2","DAROU MINAM","KHAIRA II (KHAIRA DIAGA)",129,148,861,881,1742
KAFFRINE,"MALEM HODDAR","DAROU MINAM 2","DAROU MINAM","H1 NDIGALEME",7,8,46,31,77
KAFFRINE,"MALEM HODDAR","DAROU MINAM 2","DAROU MINAM","KHELCOM DIAGA (KEUR DAYE KA)",29,35,243,236,479
KAFFRINE,"MALEM HODDAR","DAROU MINAM 2","DAROU MINAM",LOUGUENE,24,26,202,136,338
KAFFRINE,"MALEM HODDAR","DAROU MINAM 2","DAROU MINAM","LOUGUENE DAARA",6,6,38,0,38
KAFFRINE,"MALEM HODDAR","DAROU MINAM 2","DAROU MINAM","MBABANE GOUYARD",23,29,134,117,251
KAFFRINE,"MALEM HODDAR","DAROU MINAM 2","DAROU MINAM","H1 THIERERGA",35,57,349,290,639
KAFFRINE,"MALEM HODDAR","DAROU MINAM 2","DAROU MINAM","MBABANE MOURIDE",103,118,929,679,1608
KAFFRINE,"MALEM HODDAR","DAROU MINAM 2","DAROU MINAM","H1 DAROU KARIM",7,7,41,54,95
KAFFRINE,"MALEM HODDAR","DAROU MINAM 2","DAROU MINAM","MEDINA DIAMAGUENE (WILLANENE)",8,10,65,58,123
KAFFRINE,"MALEM HODDAR","DAROU MINAM 2","DAROU MINAM","MEDINA FALL",70,72,485,347,832
KAFFRINE,"MALEM HODDAR","DAROU MINAM 2","DAROU MINAM","H1 DAROU DIENG (NGUEMBE)",6,6,77,29,106
KAFFRINE,"MALEM HODDAR","DAROU MINAM 2","DAROU MINAM","H3 KEUR CHEIKH GUEYE",6,7,62,43,105
KAFFRINE,"MALEM HODDAR","DAROU MINAM 2","DAROU MINAM","H4 DARADIA (PALLENE)",5,5,66,0,66
KAFFRINE,"MALEM HODDAR","DAROU MINAM 2","DAROU MINAM","H5 NDIOUFENE (MEDINA SERERE)",14,21,157,140,297
KAFFRINE,"MALEM HODDAR","DAROU MINAM 2","DAROU MINAM","H6 DAROU FALL (WENDOU)",58,91,614,526,1140
KAFFRINE,"MALEM HODDAR","DAROU MINAM 2","DAROU MINAM","H7 KEUR THIONE NDIAYE",1,1,2,0,2
KAFFRINE,"MALEM HODDAR","DAROU MINAM 2","DAROU MINAM","MEDINA MBAYENE",31,34,203,155,358
KAFFRINE,"MALEM HODDAR","DAROU MINAM 2","DAROU MINAM","MISSIRAH HODIOLDE",45,54,636,308,944
KAFFRINE,"MALEM HODDAR","DAROU MINAM 2","DAROU MINAM","NDIARY NDIOFFA (KEUR GOUMALO)",22,32,153,165,318
KAFFRINE,"MALEM HODDAR","DAROU MINAM 2","DAROU MINAM","NDIOB (FEGUE)",12,23,116,105,221
KAFFRINE,"MALEM HODDAR","DAROU MINAM 2","DAROU MINAM",NIARGUEL,23,30,153,137,290
KAFFRINE,"MALEM HODDAR","DAROU MINAM 2","DAROU MINAM","H1 MBAYENE",7,7,71,49,120
KAFFRINE,"MALEM HODDAR","DAROU MINAM 2","DAROU MINAM","H2 MODJI",6,9,76,51,127
KAFFRINE,"MALEM HODDAR","DAROU MINAM 2","DAROU MINAM","OUADIOUR HABATH (KHOULE)",15,26,162,151,313
KAFFRINE,"MALEM HODDAR","DAROU MINAM 2","DAROU MINAM","H1 KEUR NDIAPE NDIAYE",10,14,116,83,199
KAFFRINE,"MALEM HODDAR","DAROU MINAM 2","DAROU MINAM",PAYLAR,16,34,131,130,261
KAFFRINE,"MALEM HODDAR","DAROU MINAM 2","DAROU MINAM",TCHIECKE,13,20,116,82,198
KAFFRINE,"MALEM HODDAR","DAROU MINAM 2","DAROU MINAM","THIABOULY (NGADIALOGNE)",18,26,118,111,229
KAFFRINE,"MALEM HODDAR","DAROU MINAM 2","DAROU MINAM","TOUBA HABATH (KEUR FALOU SYLLA)",5,6,44,34,78
KAFFRINE,"MALEM HODDAR","DAROU MINAM 2","DAROU MINAM","TOUBA MINAM",7,10,86,49,135
KAFFRINE,"MALEM HODDAR","DAROU MINAM 2","DAROU MINAM","TOUBA NDIENE",32,43,251,221,472
KAFFRINE,"MALEM HODDAR","DAROU MINAM 2","DAROU MINAM","TOUBA NDIENGUENE",13,14,85,59,144
KAFFRINE,"MALEM HODDAR","DAROU MINAM 2","DAROU MINAM","TOUBA NDIOUM (KEUR SERIGNE DAME)",12,16,73,70,143
KAFFRINE,"MALEM HODDAR","DAROU MINAM 2","DAROU MINAM",ARTOUCKY,9,9,59,60,119
KAFFRINE,"MALEM HODDAR","DAROU MINAM 2","DAROU MINAM","DAROU GUEYE",21,21,110,93,203
KAFFRINE,"MALEM HODDAR","DAROU MINAM 2","DAROU MINAM","H1 THIOLLE",2,4,13,12,25
KAFFRINE,"MALEM HODDAR","DAROU MINAM 2","DAROU MINAM",DIAMAGUENE,27,27,184,176,360
KAFFRINE,"MALEM HODDAR","DAROU MINAM 2","DAROU MINAM","KHELCOM FORAGE",93,292,611,610,1221
KAFFRINE,"MALEM HODDAR","DAROU MINAM 2","DAROU MINAM","NGOURWE KHELCOM",33,92,406,329,735
KAFFRINE,"MALEM HODDAR","DAROU MINAM 2","NDIOUM NGAINTH","AFFE LEWE",6,9,32,26,58
KAFFRINE,"MALEM HODDAR","DAROU MINAM 2","NDIOUM NGAINTH","H1 PEULGA(AFFE LEWE)",9,13,70,61,131
KAFFRINE,"MALEM HODDAR","DAROU MINAM 2","NDIOUM NGAINTH","AINOUMANE THIAMENE",13,13,82,59,141
KAFFRINE,"MALEM HODDAR","DAROU MINAM 2","NDIOUM NGAINTH","BELEL DJIGA (BELEL NDENDOGOU)",40,86,331,277,608
KAFFRINE,"MALEM HODDAR","DAROU MINAM 2","NDIOUM NGAINTH",BOGUEL,27,32,148,150,298
KAFFRINE,"MALEM HODDAR","DAROU MINAM 2","NDIOUM NGAINTH","H1 KEUR MBASSA DIOUF",7,11,44,43,87
KAFFRINE,"MALEM HODDAR","DAROU MINAM 2","NDIOUM NGAINTH","H2 DAROU SALAM LOUMBY",6,6,33,23,56
KAFFRINE,"MALEM HODDAR","DAROU MINAM 2","NDIOUM NGAINTH","DAROU MBANE",41,46,275,294,569
KAFFRINE,"MALEM HODDAR","DAROU MINAM 2","NDIOUM NGAINTH","H1 PEULGA(DAROU MBANE)",8,25,143,131,274
KAFFRINE,"MALEM HODDAR","DAROU MINAM 2","NDIOUM NGAINTH","DAROU NDIOUM (DAROU THIECKENE)",19,28,156,142,298
KAFFRINE,"MALEM HODDAR","DAROU MINAM 2","NDIOUM NGAINTH","DAROU NIANG",9,17,117,105,222
KAFFRINE,"MALEM HODDAR","DAROU MINAM 2","NDIOUM NGAINTH","GOUYARD (GOYARD SALL)",15,18,86,87,173
KAFFRINE,"MALEM HODDAR","DAROU MINAM 2","NDIOUM NGAINTH","H1 PEULGA(GOUYARD)",10,11,54,47,101
KAFFRINE,"MALEM HODDAR","DAROU MINAM 2","NDIOUM NGAINTH","H2 DARA DJILY M’BACKE",1,1,7,2,9
KAFFRINE,"MALEM HODDAR","DAROU MINAM 2","NDIOUM NGAINTH",GUIDOYEL,4,8,44,37,81
KAFFRINE,"MALEM HODDAR","DAROU MINAM 2","NDIOUM NGAINTH","KHOUROU LOUMBY",75,82,407,394,801
KAFFRINE,"MALEM HODDAR","DAROU MINAM 2","NDIOUM NGAINTH",LEWE,61,81,412,441,853
KAFFRINE,"MALEM HODDAR","DAROU MINAM 2","NDIOUM NGAINTH",MBANE,46,57,341,346,687
KAFFRINE,"MALEM HODDAR","DAROU MINAM 2","NDIOUM NGAINTH","MEDINA BOYGUEL",20,29,190,171,361
KAFFRINE,"MALEM HODDAR","DAROU MINAM 2","NDIOUM NGAINTH","MEDINA NDIAYENE (SANTHIOU SAMBA NDIAYE)",33,39,198,168,366
KAFFRINE,"MALEM HODDAR","DAROU MINAM 2","NDIOUM NGAINTH","H1 TOUBA LANEL",15,16,99,49,148
KAFFRINE,"MALEM HODDAR","DAROU MINAM 2","NDIOUM NGAINTH","MEDINA NDIOUM",25,29,145,125,270
KAFFRINE,"MALEM HODDAR","DAROU MINAM 2","NDIOUM NGAINTH","MEDINA TAWA (MBEYENE)",31,38,162,149,311
KAFFRINE,"MALEM HODDAR","DAROU MINAM 2","NDIOUM NGAINTH","NDIOUM NGAINTH I",142,163,1122,994,2116
KAFFRINE,"MALEM HODDAR","DAROU MINAM 2","NDIOUM NGAINTH","H1 MBAMBARA",6,8,38,33,71
KAFFRINE,"MALEM HODDAR","DAROU MINAM 2","NDIOUM NGAINTH","TABAKALY (SANTHIOU ELH  MA FAYE)",13,20,125,106,231
KAFFRINE,"MALEM HODDAR","DAROU MINAM 2","NDIOUM NGAINTH","TAIF NDIOUM",35,45,260,219,479
KAFFRINE,"MALEM HODDAR","DAROU MINAM 2","NDIOUM NGAINTH","THIOYE NDIOUM",31,41,285,251,536
KAFFRINE,"MALEM HODDAR","DAROU MINAM 2","NDIOUM NGAINTH","H1 PEULGA (KEUR ABDOU SOW)",9,10,54,49,103
KAFFRINE,"MALEM HODDAR","DAROU MINAM 2","NDIOUM NGAINTH","TOUBA DIABEL FALL",8,12,50,46,96
KAFFRINE,"MALEM HODDAR","DAROU MINAM 2","NDIOUM NGAINTH","TOUBA DIOUF",16,18,89,112,201
KAFFRINE,"MALEM HODDAR","DAROU MINAM 2","NDIOUM NGAINTH","TOUBA FALL",17,21,153,110,263
KAFFRINE,"MALEM HODDAR","DAROU MINAM 2","NDIOUM NGAINTH","TOUBA NDIOUM (KEUR IBRA DIOP)",9,12,67,64,131
KAFFRINE,"MALEM HODDAR","DAROU MINAM 2","NDIOUM NGAINTH","NDIOUM NGAINTH II",156,163,792,691,1483
KAFFRINE,"MALEM HODDAR","DAROU MINAM 2",KHELCOM,KHELCOM,17,9,1811,23,1834
KAFFRINE,"MALEM HODDAR","DAROU MINAM 2","NDIOBENE SAMBA LAMO","DAROU SALAM PAFFA",13,16,83,53,136
KAFFRINE,"MALEM HODDAR","DAROU MINAM 2","NDIOBENE SAMBA LAMO","H1 SANTHIOU SAMBA DIOP",4,8,34,29,63
KAFFRINE,"MALEM HODDAR","DAROU MINAM 2","NDIOBENE SAMBA LAMO","DIOUFFENE WALY",9,12,71,41,112
KAFFRINE,"MALEM HODDAR","DAROU MINAM 2","NDIOBENE SAMBA LAMO","KAHENE DIAM DIAM (KEUR EL HADJI DIAMA)",10,19,81,74,155
KAFFRINE,"MALEM HODDAR","DAROU MINAM 2","NDIOBENE SAMBA LAMO","KEUR ABASS (SANTHIOU ABASS)",23,27,159,119,278
KAFFRINE,"MALEM HODDAR","DAROU MINAM 2","NDIOBENE SAMBA LAMO",KHOUNAH,40,57,375,281,656
KAFFRINE,"MALEM HODDAR","DAROU MINAM 2","NDIOBENE SAMBA LAMO","KHOUROU GALLO",18,25,130,121,251
KAFFRINE,"MALEM HODDAR","DAROU MINAM 2","NDIOBENE SAMBA LAMO","KHOUROU NDIOBENE",35,43,231,199,430
KAFFRINE,"MALEM HODDAR","DAROU MINAM 2","NDIOBENE SAMBA LAMO","H1 PEULGA (KEUR MBAYO)",3,6,19,8,27
KAFFRINE,"MALEM HODDAR","DAROU MINAM 2","NDIOBENE SAMBA LAMO","KHOUROU NDIOBENE PEULH",4,8,30,35,65
KAFFRINE,"MALEM HODDAR","DAROU MINAM 2","NDIOBENE SAMBA LAMO","LINGUERE PAFFA",14,17,131,96,227
KAFFRINE,"MALEM HODDAR","DAROU MINAM 2","NDIOBENE SAMBA LAMO","LOUANGA (LOUANGO PAFFA)",37,40,222,182,404
KAFFRINE,"MALEM HODDAR","DAROU MINAM 2","NDIOBENE SAMBA LAMO","H1 TAWFEKH (KEUR ABDOU LOUM)",4,5,31,30,61
KAFFRINE,"MALEM HODDAR","DAROU MINAM 2","NDIOBENE SAMBA LAMO","MEDINA NDIOBENE (DIANGA DIGA)",16,21,91,77,168
KAFFRINE,"MALEM HODDAR","DAROU MINAM 2","NDIOBENE SAMBA LAMO","NDEMENE PAFFA",8,20,87,86,173
KAFFRINE,"MALEM HODDAR","DAROU MINAM 2","NDIOBENE SAMBA LAMO","NDIAO PAFFA",18,23,89,75,164
KAFFRINE,"MALEM HODDAR","DAROU MINAM 2","NDIOBENE SAMBA LAMO","NDIOBENE SAMBA LAMA",168,186,850,800,1650
KAFFRINE,"MALEM HODDAR","DAROU MINAM 2","NDIOBENE SAMBA LAMO","H1 PEULGA",12,17,125,50,175
KAFFRINE,"MALEM HODDAR","DAROU MINAM 2","NDIOBENE SAMBA LAMO","H2 MEDINATOU SALAM",3,3,19,7,26
KAFFRINE,"MALEM HODDAR","DAROU MINAM 2","NDIOBENE SAMBA LAMO","NDIOUM SAMBA NDAW",23,31,153,146,299
KAFFRINE,"MALEM HODDAR","DAROU MINAM 2","NDIOBENE SAMBA LAMO","H1 PEULGA (KEUR ABASS)",1,1,8,4,12
KAFFRINE,"MALEM HODDAR","DAROU MINAM 2","NDIOBENE SAMBA LAMO","SANOU PAFFA",5,7,66,60,126
KAFFRINE,"MALEM HODDAR","DAROU MINAM 2","NDIOBENE SAMBA LAMO","SANTHIOU DIAM DIAM",5,10,62,55,117
KAFFRINE,"MALEM HODDAR","DAROU MINAM 2","NDIOBENE SAMBA LAMO",SELLY,66,71,529,322,851
KAFFRINE,"MALEM HODDAR","DAROU MINAM 2","NDIOBENE SAMBA LAMO","THINDY BOYE DEME",14,21,126,103,229
KAFFRINE,"MALEM HODDAR","DAROU MINAM 2","NDIOBENE SAMBA LAMO","THINDY DIALIGUE",6,12,50,62,112
KAFFRINE,"MALEM HODDAR","DAROU MINAM 2","NDIOBENE SAMBA LAMO","TIVAOUANE NDIOBENE (SANTHIOU CISSE)",8,8,56,39,95
KAFFRINE,"MALEM HODDAR","DAROU MINAM 2","NDIOBENE SAMBA LAMO","H1 KEUR YANKHOBA",2,2,22,1,23
KAFFRINE,"MALEM HODDAR","DAROU MINAM 2","NDIOBENE SAMBA LAMO",PAFFA,91,130,791,705,1496
KAFFRINE,"MALEM HODDAR",SAGNA,"DIANKE SOUF","ALOUKY NDOUCOUMANE",42,44,272,236,508
KAFFRINE,"MALEM HODDAR",SAGNA,"DIANKE SOUF",BANGHADJI,30,34,187,176,363
KAFFRINE,"MALEM HODDAR",SAGNA,"DIANKE SOUF",BODE,43,58,391,379,770
KAFFRINE,"MALEM HODDAR",SAGNA,"DIANKE SOUF","BOULEYDA (SANTHIE SADY)",57,66,426,361,787
KAFFRINE,"MALEM HODDAR",SAGNA,"DIANKE SOUF","DAROU NAHIM",11,12,53,35,88
KAFFRINE,"MALEM HODDAR",SAGNA,"DIANKE SOUF","H1 TAWFEKH (DAROU NAHIME)",3,6,31,22,53
KAFFRINE,"MALEM HODDAR",SAGNA,"DIANKE SOUF","H2 TOUBA DAARA",3,6,37,47,84
KAFFRINE,"MALEM HODDAR",SAGNA,"DIANKE SOUF","DAROU SALAM DELBY",16,19,194,114,308
KAFFRINE,"MALEM HODDAR",SAGNA,"DIANKE SOUF",DELBY,81,83,539,480,1019
KAFFRINE,"MALEM HODDAR",SAGNA,"DIANKE SOUF","H1 PEULGA de DELBY",10,20,104,88,192
KAFFRINE,"MALEM HODDAR",SAGNA,"DIANKE SOUF","H2 PEULGA",4,8,29,26,55
KAFFRINE,"MALEM HODDAR",SAGNA,"DIANKE SOUF","DIAKSAO SALOUM",47,51,285,269,554
KAFFRINE,"MALEM HODDAR",SAGNA,"DIANKE SOUF","DIANKE KAO",46,52,354,231,585
KAFFRINE,"MALEM HODDAR",SAGNA,"DIANKE SOUF","DIANKE SOUF",99,102,533,570,1103
KAFFRINE,"MALEM HODDAR",SAGNA,"DIANKE SOUF","H1 KEUR SADIO BA",7,13,59,55,114
KAFFRINE,"MALEM HODDAR",SAGNA,"DIANKE SOUF","H2 KEUR AMADOU KA",3,3,15,9,24
KAFFRINE,"MALEM HODDAR",SAGNA,"DIANKE SOUF","H3 KEUR ALIOU KA",2,4,17,25,42
KAFFRINE,"MALEM HODDAR",SAGNA,"DIANKE SOUF","H4 KEUR ALIOU WALAM KA",3,5,27,21,48
KAFFRINE,"MALEM HODDAR",SAGNA,"DIANKE SOUF","FASS LEWE",5,9,35,37,72
KAFFRINE,"MALEM HODDAR",SAGNA,"DIANKE SOUF",GADIAGA,94,102,467,405,872
KAFFRINE,"MALEM HODDAR",SAGNA,"DIANKE SOUF",GOUBY,60,72,408,230,638
KAFFRINE,"MALEM HODDAR",SAGNA,"DIANKE SOUF","GUEOUL SALOUM",13,14,113,80,193
KAFFRINE,"MALEM HODDAR",SAGNA,"DIANKE SOUF","HAMDALAYE DELBY",33,55,314,305,619
KAFFRINE,"MALEM HODDAR",SAGNA,"DIANKE SOUF",MBABANENE,63,73,536,461,997
KAFFRINE,"MALEM HODDAR",SAGNA,"DIANKE SOUF","MEDINA DIANKE",106,164,1283,1296,2579
KAFFRINE,"MALEM HODDAR",SAGNA,"DIANKE SOUF","MEDINA MBOWENE (KEUR IBRA)",30,36,251,258,509
KAFFRINE,"MALEM HODDAR",SAGNA,"DIANKE SOUF","H2 TOUBA GORIA",5,6,35,36,71
KAFFRINE,"MALEM HODDAR",SAGNA,"DIANKE SOUF","MEDINA SAFFA",20,20,137,101,238
KAFFRINE,"MALEM HODDAR",SAGNA,"DIANKE SOUF","MEDINA SY",206,312,1227,1275,2502
KAFFRINE,"MALEM HODDAR",SAGNA,"DIANKE SOUF",NAWARENE,50,65,463,480,943
KAFFRINE,"MALEM HODDAR",SAGNA,"DIANKE SOUF","H1 BAGDAD",9,13,72,66,138
KAFFRINE,"MALEM HODDAR",SAGNA,"DIANKE SOUF","NDIOTE NDIOLOFENE",16,20,96,78,174
KAFFRINE,"MALEM HODDAR",SAGNA,"DIANKE SOUF","NDIOTE BIRAM",24,33,153,134,287
KAFFRINE,"MALEM HODDAR",SAGNA,"DIANKE SOUF","NDIOTE MOR COUMBA",23,38,259,272,531
KAFFRINE,"MALEM HODDAR",SAGNA,"DIANKE SOUF","NDIOTE SEANE",59,63,374,352,726
KAFFRINE,"MALEM HODDAR",SAGNA,"DIANKE SOUF",NGABA,215,260,1482,1605,3087
KAFFRINE,"MALEM HODDAR",SAGNA,"DIANKE SOUF","TIP SALOUM",102,117,665,645,1310
KAFFRINE,"MALEM HODDAR",SAGNA,"DIANKE SOUF","TIVAOUANE DELBY",28,43,217,204,421
KAFFRINE,"MALEM HODDAR",SAGNA,"DIANKE SOUF","TOUBA SALOUM DELBY",13,18,107,90,197
KAFFRINE,"MALEM HODDAR",SAGNA,"DIANKE SOUF",WANDE,92,106,584,547,1131
KAFFRINE,"MALEM HODDAR",SAGNA,"DIANKE SOUF","H1 PEULGA de WANDE",13,18,106,107,213
KAFFRINE,"MALEM HODDAR",SAGNA,"DIANKE SOUF",DIGANTE,4,4,29,19,48
KAFFRINE,"MALEM HODDAR",SAGNA,"DIANKE SOUF","M’BACKE SALOUM",9,9,79,85,164
KAFFRINE,"MALEM HODDAR",SAGNA,SAGNA,"AINOUMANE I",92,114,918,867,1785
KAFFRINE,"MALEM HODDAR",SAGNA,SAGNA,"AINOUMANE II",19,20,144,96,240
KAFFRINE,"MALEM HODDAR",SAGNA,SAGNA,"MEDINA KAYENE",37,39,249,275,524
KAFFRINE,"MALEM HODDAR",SAGNA,SAGNA,"BOULEL NDOUCOUMANE",61,75,381,339,720
KAFFRINE,"MALEM HODDAR",SAGNA,SAGNA,"DAROU SALAM I",25,31,267,254,521
KAFFRINE,"MALEM HODDAR",SAGNA,SAGNA,"DAROU SALAM II",18,22,163,175,338
KAFFRINE,"MALEM HODDAR",SAGNA,SAGNA,DIABY,84,105,998,835,1833
KAFFRINE,"MALEM HODDAR",SAGNA,SAGNA,"DIAM DIAM",205,233,1460,1784,3244
KAFFRINE,"MALEM HODDAR",SAGNA,SAGNA,"DIOKOUL MBAHENE",7,10,40,59,99
KAFFRINE,"MALEM HODDAR",SAGNA,SAGNA,DJIDDAH,28,35,236,230,466
KAFFRINE,"MALEM HODDAR",SAGNA,SAGNA,"FASS MAME BABA",101,113,777,873,1650
KAFFRINE,"MALEM HODDAR",SAGNA,SAGNA,"FASS NIAKHENE",28,35,196,224,420
KAFFRINE,"MALEM HODDAR",SAGNA,SAGNA,GALLO,12,16,113,126,239
KAFFRINE,"MALEM HODDAR",SAGNA,SAGNA,GOUDIE,45,53,254,252,506
KAFFRINE,"MALEM HODDAR",SAGNA,SAGNA,"HAMDALLAYE I",41,49,259,266,525
KAFFRINE,"MALEM HODDAR",SAGNA,SAGNA,"HAMDALLAYE II",32,39,369,319,688
KAFFRINE,"MALEM HODDAR",SAGNA,SAGNA,HODDAR,175,197,1256,1146,2402
KAFFRINE,"MALEM HODDAR",SAGNA,SAGNA,"KEUR YORO MBAROU",64,71,425,420,845
KAFFRINE,"MALEM HODDAR",SAGNA,SAGNA,LAGUE,117,125,808,767,1575
KAFFRINE,"MALEM HODDAR",SAGNA,SAGNA,"MAKA BELAL",122,138,988,1058,2046
KAFFRINE,"MALEM HODDAR",SAGNA,SAGNA,"MALEM KATY",11,15,86,104,190
KAFFRINE,"MALEM HODDAR",SAGNA,SAGNA,"MALEME SERIGNE",89,113,770,741,1511
KAFFRINE,"MALEM HODDAR",SAGNA,SAGNA,MBANKOUMA,64,74,404,507,911
KAFFRINE,"MALEM HODDAR",SAGNA,SAGNA,"H1 SEANE",10,11,66,76,142
KAFFRINE,"MALEM HODDAR",SAGNA,SAGNA,MBAROUCOUNDA,169,192,1208,1410,2618
KAFFRINE,"MALEM HODDAR",SAGNA,SAGNA,MBENTENKY,70,90,445,531,976
KAFFRINE,"MALEM HODDAR",SAGNA,SAGNA,"MEDINA EL HADJI MALICK",19,21,143,128,271
KAFFRINE,"MALEM HODDAR",SAGNA,SAGNA,"MEDINA FASS",60,63,518,513,1031
KAFFRINE,"MALEM HODDAR",SAGNA,SAGNA,BELAL,29,32,248,228,476
KAFFRINE,"MALEM HODDAR",SAGNA,SAGNA,"MEDINA GOWE",43,58,428,409,837
KAFFRINE,"MALEM HODDAR",SAGNA,SAGNA,"MEDINA NGAYENE",20,30,191,199,390
KAFFRINE,"MALEM HODDAR",SAGNA,SAGNA,"MEDINA NGUEYENE",24,50,287,324,611
KAFFRINE,"MALEM HODDAR",SAGNA,SAGNA,"MEDINA NIAHEME",98,126,729,667,1396
KAFFRINE,"MALEM HODDAR",SAGNA,SAGNA,"MISSIRAH FASS",5,5,28,29,57
KAFFRINE,"MALEM HODDAR",SAGNA,SAGNA,"MISSIRAH HODDAR",23,38,238,242,480
KAFFRINE,"MALEM HODDAR",SAGNA,SAGNA,"MISSIRAH NDRAME",20,22,162,208,370
KAFFRINE,"MALEM HODDAR",SAGNA,SAGNA,"MOUYE PAFFA",15,33,202,160,362
KAFFRINE,"MALEM HODDAR",SAGNA,SAGNA,NGUETHIE,103,142,1189,1158,2347
KAFFRINE,"MALEM HODDAR",SAGNA,SAGNA,NIAHENE,432,503,3094,3349,6443
KAFFRINE,"MALEM HODDAR",SAGNA,SAGNA,"PASSY MBELBOUCK",42,49,317,312,629
KAFFRINE,"MALEM HODDAR",SAGNA,SAGNA,SAGNA,138,166,922,766,1688
KAFFRINE,"MALEM HODDAR",SAGNA,SAGNA,"H1 PEULGA(SAGNA)",4,5,23,16,39
KAFFRINE,"MALEM HODDAR",SAGNA,SAGNA,"H2 NASROULAYE",1,4,30,17,47
KAFFRINE,"MALEM HODDAR",SAGNA,SAGNA,"SANTHIE MBELBOUCK",87,118,859,911,1770
KAFFRINE,"MALEM HODDAR",SAGNA,SAGNA,SEANE,82,95,634,543,1177
KAFFRINE,"MALEM HODDAR",SAGNA,SAGNA,SIWOL,85,96,630,589,1219
KAFFRINE,"MALEM HODDAR",SAGNA,SAGNA,"TAIBA MBADIANENE",38,46,296,440,736
KAFFRINE,"MALEM HODDAR",SAGNA,SAGNA,TEKHE,34,37,242,173,415
KAFFRINE,"MALEM HODDAR",SAGNA,SAGNA,"MALEME THIALENE",77,99,588,658,1246
KAFFRINE,"MALEM HODDAR",SAGNA,SAGNA,"H1 KIPP",32,35,206,214,420
KAFFRINE,"MALEM HODDAR",SAGNA,SAGNA,"H2 KEUR MALAHINE LO",6,7,42,51,93
KAFFRINE,"MALEM HODDAR",SAGNA,SAGNA,THIANTANG,12,12,103,87,190
KAFFRINE,"MALEM HODDAR",SAGNA,SAGNA,"TOBENE LAGUE",32,37,191,198,389
KAFFRINE,"MALEM HODDAR",SAGNA,SAGNA,"TOUBA NGUEYENE",39,58,333,341,674
KAFFRINE,"MALEM HODDAR",SAGNA,SAGNA,"BANT BOU TEUDD(TOUBA MALEM)",1,2,79,7,86
KAFFRINE,"MALEM HODDAR",SAGNA,SAGNA,"KHAIRA 3(SANTHIE ABDOUL)",5,6,33,35,68
KAFFRINE,"MALEM HODDAR",SAGNA,SAGNA,"KHAIRA NDRAME",7,10,106,77,183
KAFFRINE,"MALEM HODDAR",SAGNA,SAGNA,THIONGUE,1,4,14,17,31
KAFFRINE,"MALEM HODDAR",SAGNA,SAGNA,"TIVAOUANE PASSY",1,1,6,5,11
KAFFRINE,"MALEM HODDAR",SAGNA,SAGNA,"TOUBA MEDINATOUL MOUNAWARA",16,16,150,29,179
KEDOUGOU,KEDOUGOU,KEDOUGOU,KEDOUGOU,DALABA,293,480,1970,1895,3865
KEDOUGOU,KEDOUGOU,KEDOUGOU,KEDOUGOU,DANDEMAYO,492,713,3375,2747,6122
KEDOUGOU,KEDOUGOU,KEDOUGOU,KEDOUGOU,"DINGUESSOU (PASTEUR BUTLER)",1033,1440,5898,4862,10760
KEDOUGOU,KEDOUGOU,KEDOUGOU,KEDOUGOU,FADIGA,224,248,979,865,1844
KEDOUGOU,KEDOUGOU,KEDOUGOU,KEDOUGOU,"NDIORMI (GADA DINGUESSOU)",1465,1803,6067,5547,11614
KEDOUGOU,KEDOUGOU,KEDOUGOU,KEDOUGOU,"GOMBA (TRIPANO)",1911,2245,7652,6856,14508
KEDOUGOU,KEDOUGOU,KEDOUGOU,KEDOUGOU,"KEGNETO PEULH",155,161,700,584,1284
KEDOUGOU,KEDOUGOU,KEDOUGOU,KEDOUGOU,"MEDINA KEGNETO",30,33,365,258,623
KEDOUGOU,KEDOUGOU,KEDOUGOU,KEDOUGOU,MOSQUEE,396,587,2714,2617,5331
KEDOUGOU,KEDOUGOU,KEDOUGOU,KEDOUGOU,TOGORO,251,406,1671,1609,3280
KEDOUGOU,KEDOUGOU,BANDAFASSI,BANDAFASSI,"BADEMBAN (IWOL)",13,20,166,191,357
KEDOUGOU,KEDOUGOU,BANDAFASSI,BANDAFASSI,"H1 GUINGARA",13,16,95,70,165
KEDOUGOU,KEDOUGOU,BANDAFASSI,BANDAFASSI,BAITILAYE,33,61,415,403,818
KEDOUGOU,KEDOUGOU,BANDAFASSI,BANDAFASSI,"BANDAFASSI PEULH",82,365,479,452,931
KEDOUGOU,KEDOUGOU,BANDAFASSI,BANDAFASSI,"H1 TAKOUROU",16,20,81,64,145
KEDOUGOU,KEDOUGOU,BANDAFASSI,BANDAFASSI,"H2 SANTAKHO",42,46,180,183,363
KEDOUGOU,KEDOUGOU,BANDAFASSI,BANDAFASSI,"H3 SILING",2,2,9,8,17
KEDOUGOU,KEDOUGOU,BANDAFASSI,BANDAFASSI,"BANDAFASSI TANDA",18,19,82,96,178
KEDOUGOU,KEDOUGOU,BANDAFASSI,BANDAFASSI,"H1 INDAR",22,26,96,80,176
KEDOUGOU,KEDOUGOU,BANDAFASSI,BANDAFASSI,"H2 SILLY BASSARI",8,8,18,26,44
KEDOUGOU,KEDOUGOU,BANDAFASSI,BANDAFASSI,"H3 SILLY PEULH",19,20,96,58,154
KEDOUGOU,KEDOUGOU,BANDAFASSI,BANDAFASSI,"H4 MERESSI",13,14,44,39,83
KEDOUGOU,KEDOUGOU,BANDAFASSI,BANDAFASSI,BOUNDOUCONDI,43,45,226,185,411
KEDOUGOU,KEDOUGOU,BANDAFASSI,BANDAFASSI,"H1 NATHIA",33,43,155,166,321
KEDOUGOU,KEDOUGOU,BANDAFASSI,BANDAFASSI,"DAR SALAM 1",20,21,107,85,192
KEDOUGOU,KEDOUGOU,BANDAFASSI,BANDAFASSI,"DIENDJI DIAKHA",40,41,289,181,470
KEDOUGOU,KEDOUGOU,BANDAFASSI,BANDAFASSI,"H2 NIANGHE BASSARI",7,7,22,12,34
KEDOUGOU,KEDOUGOU,BANDAFASSI,BANDAFASSI,HABIBOU,34,39,106,110,216
KEDOUGOU,KEDOUGOU,BANDAFASSI,BANDAFASSI,IBEL,110,136,557,614,1171
KEDOUGOU,KEDOUGOU,BANDAFASSI,BANDAFASSI,"H1 CARRIERE",3,4,23,17,40
KEDOUGOU,KEDOUGOU,BANDAFASSI,BANDAFASSI,"H2 DAMBOUKOYE",11,12,79,79,158
KEDOUGOU,KEDOUGOU,BANDAFASSI,BANDAFASSI,ITATO,27,29,108,106,214
KEDOUGOU,KEDOUGOU,BANDAFASSI,BANDAFASSI,"H1 MAREWA",7,7,20,14,34
KEDOUGOU,KEDOUGOU,BANDAFASSI,BANDAFASSI,"H2 THIANKOU MALAL",44,50,185,165,350
KEDOUGOU,KEDOUGOU,BANDAFASSI,BANDAFASSI,LAMINIA,92,111,842,614,1456
KEDOUGOU,KEDOUGOU,BANDAFASSI,BANDAFASSI,"LANDE BAITYL",32,43,223,204,427
KEDOUGOU,KEDOUGOU,BANDAFASSI,BANDAFASSI,"LANDIENI PEULH",23,30,154,142,296
KEDOUGOU,KEDOUGOU,BANDAFASSI,BANDAFASSI,"LANDIENY TANDA",14,15,116,101,217
KEDOUGOU,KEDOUGOU,BANDAFASSI,BANDAFASSI,NIANGHE,27,30,127,126,253
KEDOUGOU,KEDOUGOU,BANDAFASSI,BANDAFASSI,"H6 SINTHIOU SITELLY",1,1,3,0,3
KEDOUGOU,KEDOUGOU,BANDAFASSI,BANDAFASSI,PATASSY,22,24,167,120,287
KEDOUGOU,KEDOUGOU,BANDAFASSI,BANDAFASSI,"H2 CARREFOUR NDIAYE PRAYA",1,1,3,8,11
KEDOUGOU,KEDOUGOU,BANDAFASSI,BANDAFASSI,SAMECOUTA,111,131,1053,912,1965
KEDOUGOU,KEDOUGOU,BANDAFASSI,BANDAFASSI,"H1 DOUTADING",3,3,20,23,43
KEDOUGOU,KEDOUGOU,BANDAFASSI,BANDAFASSI,"SINTHIOU ROUDJI",47,48,183,154,337
KEDOUGOU,KEDOUGOU,BANDAFASSI,BANDAFASSI,"SYLLACOUNDA DIAKHA",62,71,590,549,1139
KEDOUGOU,KEDOUGOU,BANDAFASSI,BANDAFASSI,"H1 TAIFA",12,16,122,66,188
KEDOUGOU,KEDOUGOU,BANDAFASSI,BANDAFASSI,"SYLLACOUNDA PEULH",14,15,65,59,124
KEDOUGOU,KEDOUGOU,BANDAFASSI,BANDAFASSI,THIABEDJI,85,124,558,577,1135
KEDOUGOU,KEDOUGOU,BANDAFASSI,BANDAFASSI,THIOKETHIAN,40,51,289,273,562
KEDOUGOU,KEDOUGOU,BANDAFASSI,BANDAFASSI,BITELAIRE,4,4,12,4,16
KEDOUGOU,KEDOUGOU,BANDAFASSI,BANDAFASSI,"DAR SALAM 2",29,29,164,127,291
KEDOUGOU,KEDOUGOU,BANDAFASSI,BANDAFASSI,"MADINA VIRAGE TAIBATOU",7,8,27,21,48
KEDOUGOU,KEDOUGOU,BANDAFASSI,TOMBORONCOTO,BADON,12,16,141,154,295
KEDOUGOU,KEDOUGOU,BANDAFASSI,TOMBORONCOTO,BAFOUNDOU,1,1,1,1,2
KEDOUGOU,KEDOUGOU,BANDAFASSI,TOMBORONCOTO,"H2 BANCAKOKHOCO",5,6,65,47,112
KEDOUGOU,KEDOUGOU,BANDAFASSI,TOMBORONCOTO,"H3 TEMASSOU",15,15,43,39,82
KEDOUGOU,KEDOUGOU,BANDAFASSI,TOMBORONCOTO,BAGNOMBA,21,23,192,190,382
KEDOUGOU,KEDOUGOU,BANDAFASSI,TOMBORONCOTO,"H3 KOLON",3,6,48,39,87
KEDOUGOU,KEDOUGOU,BANDAFASSI,TOMBORONCOTO,BANTAKOCOUTA,634,955,3105,1700,4805
KEDOUGOU,KEDOUGOU,BANDAFASSI,TOMBORONCOTO,"H1 BANTAKOKHOTO",2,3,13,7,20
KEDOUGOU,KEDOUGOU,BANDAFASSI,TOMBORONCOTO,"BANTATA MANDINGUE",2,3,14,11,25
KEDOUGOU,KEDOUGOU,BANDAFASSI,TOMBORONCOTO,"H1 FOLONKOTO",5,5,56,47,103
KEDOUGOU,KEDOUGOU,BANDAFASSI,TOMBORONCOTO,"BANTATA TANDA",12,24,167,169,336
KEDOUGOU,KEDOUGOU,BANDAFASSI,TOMBORONCOTO,BATRANKE,4,6,82,76,158
KEDOUGOU,KEDOUGOU,BANDAFASSI,TOMBORONCOTO,BRANDOUFARY,8,9,108,108,216
KEDOUGOU,KEDOUGOU,BANDAFASSI,TOMBORONCOTO,"H1 LAME",10,11,132,119,251
KEDOUGOU,KEDOUGOU,BANDAFASSI,TOMBORONCOTO,"H2 KOUTOUFINKOTO",5,5,56,53,109
KEDOUGOU,KEDOUGOU,BANDAFASSI,TOMBORONCOTO,"DAR SALAM DALABA",9,9,38,28,66
KEDOUGOU,KEDOUGOU,BANDAFASSI,TOMBORONCOTO,"KABATE GUINDA",18,21,177,190,367
KEDOUGOU,KEDOUGOU,BANDAFASSI,TOMBORONCOTO,KANOUMERING,83,102,497,405,902
KEDOUGOU,KEDOUGOU,BANDAFASSI,TOMBORONCOTO,"H1 KOULOUNTOU",6,6,25,24,49
KEDOUGOU,KEDOUGOU,BANDAFASSI,TOMBORONCOTO,MAKO,225,279,1618,1365,2983
KEDOUGOU,KEDOUGOU,BANDAFASSI,TOMBORONCOTO,"MANIANKANTY (KEREKONKO)",11,12,80,65,145
KEDOUGOU,KEDOUGOU,BANDAFASSI,TOMBORONCOTO,"H1 DALAKOYE",14,19,143,108,251
KEDOUGOU,KEDOUGOU,BANDAFASSI,TOMBORONCOTO,"H2 BAMBOYA",4,4,26,10,36
KEDOUGOU,KEDOUGOU,BANDAFASSI,TOMBORONCOTO,MAROUGOUDING,15,34,101,97,198
KEDOUGOU,KEDOUGOU,BANDAFASSI,TOMBORONCOTO,"MAROUGOUKOTO (BADIAN 1)",16,27,152,111,263
KEDOUGOU,KEDOUGOU,BANDAFASSI,TOMBORONCOTO,"H1 FOUKHOTO (BADIAN 2)",55,65,368,337,705
KEDOUGOU,KEDOUGOU,BANDAFASSI,TOMBORONCOTO,"NEGUEBAKHO MIRABOUGOU",39,41,134,168,302
KEDOUGOU,KEDOUGOU,BANDAFASSI,TOMBORONCOTO,"NGARY (ONGAR)",31,69,194,168,362
KEDOUGOU,KEDOUGOU,BANDAFASSI,TOMBORONCOTO,NIEMENIKE,7,14,58,51,109
KEDOUGOU,KEDOUGOU,BANDAFASSI,TOMBORONCOTO,"H2 SENOTHIE",10,10,46,57,103
KEDOUGOU,KEDOUGOU,BANDAFASSI,TOMBORONCOTO,"H3 SINTHIOU ROUDJI",5,5,19,15,34
KEDOUGOU,KEDOUGOU,BANDAFASSI,TOMBORONCOTO,"SEGUEKO BASSARI",17,20,100,129,229
KEDOUGOU,KEDOUGOU,BANDAFASSI,TOMBORONCOTO,"H1 SINDAKHA",5,5,19,15,34
KEDOUGOU,KEDOUGOU,BANDAFASSI,TOMBORONCOTO,"H2 NIARICONDON",3,3,11,12,23
KEDOUGOU,KEDOUGOU,BANDAFASSI,TOMBORONCOTO,"H3 SAINT ETIENNE",9,13,60,45,105
KEDOUGOU,KEDOUGOU,BANDAFASSI,TOMBORONCOTO,"SEGUEKO PEULH",29,33,165,156,321
KEDOUGOU,KEDOUGOU,BANDAFASSI,TOMBORONCOTO,SIBIKILING,20,25,199,161,360
KEDOUGOU,KEDOUGOU,BANDAFASSI,TOMBORONCOTO,TAMBANOUMOUYA,33,34,412,347,759
KEDOUGOU,KEDOUGOU,BANDAFASSI,TOMBORONCOTO,"H1 LINGUEKOTO",22,22,137,99,236
KEDOUGOU,KEDOUGOU,BANDAFASSI,TOMBORONCOTO,TIKANKALY,7,10,92,95,187
KEDOUGOU,KEDOUGOU,BANDAFASSI,TOMBORONCOTO,"TENKOTO TANDA ET MANDINGUE",29,82,243,176,419
KEDOUGOU,KEDOUGOU,BANDAFASSI,TOMBORONCOTO,"H1 BARAFOUTE",7,19,80,59,139
KEDOUGOU,KEDOUGOU,BANDAFASSI,TOMBORONCOTO,"H2 DIENDJI BASSARI (OUBADJI)",8,21,42,35,77
KEDOUGOU,KEDOUGOU,BANDAFASSI,TOMBORONCOTO,"H3 FANKOLY",2,3,9,5,14
KEDOUGOU,KEDOUGOU,BANDAFASSI,TOMBORONCOTO,"H4 THIOBO",10,14,55,45,100
KEDOUGOU,KEDOUGOU,BANDAFASSI,TOMBORONCOTO,TOMBORONKOTO,93,108,631,512,1143
KEDOUGOU,KEDOUGOU,BANDAFASSI,TOMBORONCOTO,"H1 KOUMOUSSABOTO",2,3,14,11,25
KEDOUGOU,KEDOUGOU,BANDAFASSI,TOMBORONCOTO,"H2 SEKHOTO",15,15,90,109,199
KEDOUGOU,KEDOUGOU,BANDAFASSI,TOMBORONCOTO,"TOUBA DIAKHA",12,14,55,46,101
KEDOUGOU,KEDOUGOU,BANDAFASSI,TOMBORONCOTO,SINPAPOU,9,10,24,7,31
KEDOUGOU,KEDOUGOU,BANDAFASSI,DINDEFELO,"AFIA 1 (THIABE CARE)",53,61,204,222,426
KEDOUGOU,KEDOUGOU,BANDAFASSI,DINDEFELO,"H3 TEPERE DIANTOUNG",45,53,193,191,384
KEDOUGOU,KEDOUGOU,BANDAFASSI,DINDEFELO,"H4 NEWDOU (BOUCHRA)",24,27,65,59,124
KEDOUGOU,KEDOUGOU,BANDAFASSI,DINDEFELO,"AFIA 2",26,28,90,109,199
KEDOUGOU,KEDOUGOU,BANDAFASSI,DINDEFELO,"BOUSSOURA (MAMADOU BOUNDOU)",24,28,127,135,262
KEDOUGOU,KEDOUGOU,BANDAFASSI,DINDEFELO,DANDE,43,49,158,169,327
KEDOUGOU,KEDOUGOU,BANDAFASSI,DINDEFELO,DINDEFELLO,175,203,908,905,1813
KEDOUGOU,KEDOUGOU,BANDAFASSI,DINDEFELO,"DIOGOMA NANDOUMARI",48,51,200,183,383
KEDOUGOU,KEDOUGOU,BANDAFASSI,DINDEFELO,"H1 MBOULAYE",7,8,35,29,64
KEDOUGOU,KEDOUGOU,BANDAFASSI,DINDEFELO,"PELEL KENDESSA",125,153,639,621,1260
KEDOUGOU,KEDOUGOU,BANDAFASSI,DINDEFELO,"SAGARIDJI BADIARI",18,18,61,64,125
KEDOUGOU,KEDOUGOU,BANDAFASSI,DINDEFELO,"H1 BOUNDOU DOUDOUKE",7,7,26,36,62
KEDOUGOU,KEDOUGOU,BANDAFASSI,DINDEFELO,THIANGUE,80,92,375,393,768
KEDOUGOU,KEDOUGOU,BANDAFASSI,DINDEFELO,"YAMOUSSA SEGOU",119,139,576,546,1122
KEDOUGOU,KEDOUGOU,BANDAFASSI,DINDEFELO,"H1 BADALLAH",6,6,48,51,99
KEDOUGOU,KEDOUGOU,BANDAFASSI,DINDEFELO,"H2 YAMOUSSA DIAKHA",8,10,90,82,172
KEDOUGOU,KEDOUGOU,BANDAFASSI,NINEFECHA,"AFIA 1 (AFIA MAGASIN)",27,34,179,159,338
KEDOUGOU,KEDOUGOU,BANDAFASSI,NINEFECHA,"AFIA 2 (AFIA PONT)",19,25,223,186,409
KEDOUGOU,KEDOUGOU,BANDAFASSI,NINEFECHA,ANGOUSSAKA,12,19,70,78,148
KEDOUGOU,KEDOUGOU,BANDAFASSI,NINEFECHA,"H1 KEINDA",9,10,47,51,98
KEDOUGOU,KEDOUGOU,BANDAFASSI,NINEFECHA,"H2 INERE",1,1,10,5,15
KEDOUGOU,KEDOUGOU,BANDAFASSI,NINEFECHA,ASSONI,49,61,298,291,589
KEDOUGOU,KEDOUGOU,BANDAFASSI,NINEFECHA,"H1 SAMAL",81,84,290,290,580
KEDOUGOU,KEDOUGOU,BANDAFASSI,NINEFECHA,BARABOYE,30,36,306,255,561
KEDOUGOU,KEDOUGOU,BANDAFASSI,NINEFECHA,BAYA,26,32,154,151,305
KEDOUGOU,KEDOUGOU,BANDAFASSI,NINEFECHA,"H1 SINTHIOU ROUDJI",13,15,71,61,132
KEDOUGOU,KEDOUGOU,BANDAFASSI,NINEFECHA,DINDIFELLO,5,7,37,39,76
KEDOUGOU,KEDOUGOU,BANDAFASSI,NINEFECHA,"H1 DAP DAPASS",6,6,31,30,61
KEDOUGOU,KEDOUGOU,BANDAFASSI,NINEFECHA,"DONGOL NIALBY",30,37,114,160,274
KEDOUGOU,KEDOUGOU,BANDAFASSI,NINEFECHA,"H1 BAYE",4,4,10,12,22
KEDOUGOU,KEDOUGOU,BANDAFASSI,NINEFECHA,"H2 KADIAMOU",5,5,14,16,30
KEDOUGOU,KEDOUGOU,BANDAFASSI,NINEFECHA,"ETHIESSE HAUT",10,10,65,65,130
KEDOUGOU,KEDOUGOU,BANDAFASSI,NINEFECHA,"H1 ETHIESSE BAS",4,4,38,23,61
KEDOUGOU,KEDOUGOU,BANDAFASSI,NINEFECHA,"HAMADY HERY",56,60,268,311,579
KEDOUGOU,KEDOUGOU,BANDAFASSI,NINEFECHA,"HAMDALLAYE (THIOKOYE)",48,58,207,231,438
KEDOUGOU,KEDOUGOU,BANDAFASSI,NINEFECHA,KESSEMA,8,10,29,43,72
KEDOUGOU,KEDOUGOU,BANDAFASSI,NINEFECHA,"KOUROU NGOTO",18,19,122,113,235
KEDOUGOU,KEDOUGOU,BANDAFASSI,NINEFECHA,SOUCOUTA,11,15,104,101,205
KEDOUGOU,KEDOUGOU,BANDAFASSI,NINEFECHA,MAMAKONO,10,13,58,65,123
KEDOUGOU,KEDOUGOU,BANDAFASSI,NINEFECHA,"H1 ALY NGUETH",4,11,42,28,70
KEDOUGOU,KEDOUGOU,BANDAFASSI,NINEFECHA,MATAKOSSI,48,54,140,225,365
KEDOUGOU,KEDOUGOU,BANDAFASSI,NINEFECHA,NAMEL,30,31,138,151,289
KEDOUGOU,KEDOUGOU,BANDAFASSI,NINEFECHA,NINEFECHA,42,47,275,224,499
KEDOUGOU,KEDOUGOU,BANDAFASSI,NINEFECHA,MANDATHIES,16,19,140,133,273
KEDOUGOU,KEDOUGOU,BANDAFASSI,NINEFECHA,THIARMALEL,26,39,210,146,356
KEDOUGOU,KEDOUGOU,BANDAFASSI,NINEFECHA,WOUNTOUGOURE,23,26,118,124,242
KEDOUGOU,KEDOUGOU,BANDAFASSI,NINEFECHA,WOUROUDJE,35,39,215,177,392
KEDOUGOU,KEDOUGOU,BANDAFASSI,NINEFECHA,ABISSAMROUNA,1,4,80,34,114
KEDOUGOU,KEDOUGOU,BANDAFASSI,NINEFECHA,"NDANE NDAYE",12,13,70,63,133
KEDOUGOU,KEDOUGOU,BANDAFASSI,NINEFECHA,NDEBOU,31,40,217,238,455
KEDOUGOU,KEDOUGOU,BANDAFASSI,NINEFECHA,NIAPOUAR,4,4,22,24,46
KEDOUGOU,KEDOUGOU,FONGOLIMBI,DIMBOLI,"AFIA DANDEMAYO",305,337,1213,1154,2367
KEDOUGOU,KEDOUGOU,FONGOLIMBI,DIMBOLI,"H2 BOUSSOURA",6,7,49,37,86
KEDOUGOU,KEDOUGOU,FONGOLIMBI,DIMBOLI,"H3 DIAGUIRI BASSARI",8,8,40,36,76
KEDOUGOU,KEDOUGOU,FONGOLIMBI,DIMBOLI,"H4 DIAGUIRI PONT",63,65,289,240,529
KEDOUGOU,KEDOUGOU,FONGOLIMBI,DIMBOLI,"H6 SAMBA NDIAYE",29,34,102,105,207
KEDOUGOU,KEDOUGOU,FONGOLIMBI,DIMBOLI,"H7 SINTHIOU MALEM",12,13,49,33,82
KEDOUGOU,KEDOUGOU,FONGOLIMBI,DIMBOLI,"H8 THIANGOL YAYA",12,12,46,35,81
KEDOUGOU,KEDOUGOU,FONGOLIMBI,DIMBOLI,BAMBAYA,13,19,51,71,122
KEDOUGOU,KEDOUGOU,FONGOLIMBI,DIMBOLI,"H1 BAMBAYA LABOUR",12,13,41,43,84
KEDOUGOU,KEDOUGOU,FONGOLIMBI,DIMBOLI,BAMBOYA,17,21,77,71,148
KEDOUGOU,KEDOUGOU,FONGOLIMBI,DIMBOLI,"BARA (ROUNDE BARA)",47,52,169,173,342
KEDOUGOU,KEDOUGOU,FONGOLIMBI,DIMBOLI,"H1 BARA",14,19,49,45,94
KEDOUGOU,KEDOUGOU,FONGOLIMBI,DIMBOLI,BOWAL,32,37,126,135,261
KEDOUGOU,KEDOUGOU,FONGOLIMBI,DIMBOLI,DIALAYA,23,27,70,68,138
KEDOUGOU,KEDOUGOU,FONGOLIMBI,DIMBOLI,"H1 DIALAYA 2",18,21,70,78,148
KEDOUGOU,KEDOUGOU,FONGOLIMBI,DIMBOLI,"H2 NIAMANA",5,6,15,17,32
KEDOUGOU,KEDOUGOU,FONGOLIMBI,DIMBOLI,"H3 SINTHIOU MAMOUDOU",9,12,34,35,69
KEDOUGOU,KEDOUGOU,FONGOLIMBI,DIMBOLI,"DIANHERY (YOROYA)",42,46,203,166,369
KEDOUGOU,KEDOUGOU,FONGOLIMBI,DIMBOLI,DIMBOLI,71,76,265,289,554
KEDOUGOU,KEDOUGOU,FONGOLIMBI,DIMBOLI,"H1 LEFALODJI",2,2,10,5,15
KEDOUGOU,KEDOUGOU,FONGOLIMBI,DIMBOLI,KAFORY,109,204,435,470,905
KEDOUGOU,KEDOUGOU,FONGOLIMBI,DIMBOLI,"H1 BAKHO",5,5,25,24,49
KEDOUGOU,KEDOUGOU,FONGOLIMBI,DIMBOLI,LINDIANE,12,14,54,54,108
KEDOUGOU,KEDOUGOU,FONGOLIMBI,DIMBOLI,MALEME,13,15,63,66,129
KEDOUGOU,KEDOUGOU,FONGOLIMBI,DIMBOLI,"H1 BASSAKHO",4,4,10,8,18
KEDOUGOU,KEDOUGOU,FONGOLIMBI,DIMBOLI,MALINDA,32,40,176,184,360
KEDOUGOU,KEDOUGOU,FONGOLIMBI,DIMBOLI,"H3 KAFORY DIALONKE",9,15,76,78,154
KEDOUGOU,KEDOUGOU,FONGOLIMBI,DIMBOLI,MANIAFE,22,22,89,80,169
KEDOUGOU,KEDOUGOU,FONGOLIMBI,DIMBOLI,"H1 LINGUEKHOTO",1,1,3,4,7
KEDOUGOU,KEDOUGOU,FONGOLIMBI,DIMBOLI,MEDINATOU,29,32,118,132,250
KEDOUGOU,KEDOUGOU,FONGOLIMBI,DIMBOLI,TOGUE,24,29,83,90,173
KEDOUGOU,KEDOUGOU,FONGOLIMBI,DIMBOLI,VELINGARA,42,48,132,142,274
KEDOUGOU,KEDOUGOU,FONGOLIMBI,DIMBOLI,"H2 DAROU SALAM",4,4,15,21,36
KEDOUGOU,KEDOUGOU,FONGOLIMBI,DIMBOLI,WOULABA,24,32,146,158,304
KEDOUGOU,KEDOUGOU,FONGOLIMBI,DIMBOLI,"AFIA 2",20,22,122,114,236
KEDOUGOU,KEDOUGOU,FONGOLIMBI,DIMBOLI,TAMACOUMALA,5,10,21,26,47
KEDOUGOU,KEDOUGOU,FONGOLIMBI,FONGOLIMBI,FONGOLIMBI,127,168,783,682,1465
KEDOUGOU,KEDOUGOU,FONGOLIMBI,FONGOLIMBI,"H1 NIANGUI BOLY",13,17,39,46,85
KEDOUGOU,KEDOUGOU,FONGOLIMBI,FONGOLIMBI,"H2 LOMBEL",22,23,64,77,141
KEDOUGOU,KEDOUGOU,FONGOLIMBI,FONGOLIMBI,KOBOYE,49,51,182,162,344
KEDOUGOU,KEDOUGOU,FONGOLIMBI,FONGOLIMBI,KOUNSY,38,42,139,167,306
KEDOUGOU,KEDOUGOU,FONGOLIMBI,FONGOLIMBI,LESFALO,69,72,162,184,346
KEDOUGOU,KEDOUGOU,FONGOLIMBI,FONGOLIMBI,MADIHOU,38,40,119,143,262
KEDOUGOU,KEDOUGOU,FONGOLIMBI,FONGOLIMBI,"H1 THIEOUNE",17,17,34,53,87
KEDOUGOU,KEDOUGOU,FONGOLIMBI,FONGOLIMBI,"H2 ROUNDE",20,21,72,63,135
KEDOUGOU,KEDOUGOU,FONGOLIMBI,FONGOLIMBI,"H3 HAKOUDE THIANDY",3,3,9,7,16
KEDOUGOU,KEDOUGOU,FONGOLIMBI,FONGOLIMBI,MAROUGOU,29,51,251,231,482
KEDOUGOU,KEDOUGOU,FONGOLIMBI,FONGOLIMBI,NIANGALANKOME,46,60,171,158,329
KEDOUGOU,KEDOUGOU,FONGOLIMBI,FONGOLIMBI,"H1 HORE FELO FODEYABE",21,30,78,102,180
KEDOUGOU,KEDOUGOU,FONGOLIMBI,FONGOLIMBI,SAMBANGALOU,21,21,87,78,165
KEDOUGOU,KEDOUGOU,FONGOLIMBI,FONGOLIMBI,SECRETA,22,22,109,104,213
KEDOUGOU,KEDOUGOU,FONGOLIMBI,FONGOLIMBI,SODIORE,4,14,33,21,54
KEDOUGOU,KEDOUGOU,FONGOLIMBI,FONGOLIMBI,TEMBERY,4,6,21,29,50
KEDOUGOU,KEDOUGOU,FONGOLIMBI,FONGOLIMBI,TOUMANIA,48,49,242,221,463
KEDOUGOU,KEDOUGOU,FONGOLIMBI,FONGOLIMBI,"WALLAN KINGUI",31,35,98,92,190
KEDOUGOU,KEDOUGOU,FONGOLIMBI,FONGOLIMBI,"WALLAN SINTHIOUROU",23,25,69,72,141
KEDOUGOU,KEDOUGOU,FONGOLIMBI,FONGOLIMBI,WASSAYA,12,13,23,30,53
KEDOUGOU,SALEMATA,SALEMATA,SALEMATA,COULOUBA,228,301,955,967,1922
KEDOUGOU,SALEMATA,SALEMATA,SALEMATA,EGATH,27,61,147,128,275
KEDOUGOU,SALEMATA,SALEMATA,SALEMATA,GANDJIRI,62,71,298,241,539
KEDOUGOU,SALEMATA,SALEMATA,SALEMATA,GAYGUI,23,42,103,107,210
KEDOUGOU,SALEMATA,SALEMATA,SALEMATA,MOSQUEE,87,123,396,385,781
KEDOUGOU,SALEMATA,SALEMATA,SALEMATA,"NANGAR PEULH-NANGAR BASSARI",85,92,337,336,673
KEDOUGOU,SALEMATA,SALEMATA,SALEMATA,"SINTHIOU ROUDJI",43,72,166,151,317
KEDOUGOU,SALEMATA,SALEMATA,SALEMATA,"LAWOL KEDOUGOU (YIMBERING)",142,181,551,490,1041
KEDOUGOU,SALEMATA,SALEMATA,SALEMATA,"GADA GANDJIRI",61,64,272,250,522
KEDOUGOU,SALEMATA,SALEMATA,SALEMATA,"NANGAR PANDEMI",48,59,220,212,432
KEDOUGOU,SALEMATA,DAKATELY,DAKATELY,BATIMBA,18,20,86,80,166
KEDOUGOU,SALEMATA,DAKATELY,DAKATELY,"H1 SAMOUKA",17,22,90,80,170
KEDOUGOU,SALEMATA,DAKATELY,DAKATELY,"H2 LOUGUENIAN",13,15,54,64,118
KEDOUGOU,SALEMATA,DAKATELY,DAKATELY,DAKATELY,89,132,549,558,1107
KEDOUGOU,SALEMATA,DAKATELY,DAKATELY,"H1 OUTHIOUMBEL",41,47,161,203,364
KEDOUGOU,SALEMATA,DAKATELY,DAKATELY,"H2 DIARA",32,37,153,144,297
KEDOUGOU,SALEMATA,DAKATELY,DAKATELY,DIOUGOL,43,48,181,167,348
KEDOUGOU,SALEMATA,DAKATELY,DAKATELY,"H1 SINTHIROU",7,8,17,24,41
KEDOUGOU,SALEMATA,DAKATELY,DAKATELY,GOUMBAMBERE,24,33,125,115,240
KEDOUGOU,SALEMATA,DAKATELY,DAKATELY,"GOUNOUNG (KOUKOUDIE)",22,25,106,91,197
KEDOUGOU,SALEMATA,DAKATELY,DAKATELY,"GOURE NETERE",12,14,49,43,92
KEDOUGOU,SALEMATA,DAKATELY,DAKATELY,KADIORE,11,12,63,49,112
KEDOUGOU,SALEMATA,DAKATELY,DAKATELY,"H1 HOREKALOU",3,3,11,11,22
KEDOUGOU,SALEMATA,DAKATELY,DAKATELY,KOUMAFELE,23,30,135,159,294
KEDOUGOU,SALEMATA,DAKATELY,DAKATELY,"H1 SALEYAMBA",11,14,44,48,92
KEDOUGOU,SALEMATA,DAKATELY,DAKATELY,"NEPPENE DIAKHA",18,34,118,113,231
KEDOUGOU,SALEMATA,DAKATELY,DAKATELY,"H1 SYLLACOUNDA",19,30,98,88,186
KEDOUGOU,SALEMATA,DAKATELY,DAKATELY,"H2 SINTHIOU ROUDJI",7,7,34,27,61
KEDOUGOU,SALEMATA,DAKATELY,DAKATELY,"NEPPENE PEULH",16,17,99,73,172
KEDOUGOU,SALEMATA,DAKATELY,DAKATELY,"YERO NGUEDO",37,46,248,209,457
KEDOUGOU,SALEMATA,DAKATELY,KEVOYE,AYKOUM,33,35,132,115,247
KEDOUGOU,SALEMATA,DAKATELY,KEVOYE,KEREVANE,33,45,224,236,460
KEDOUGOU,SALEMATA,DAKATELY,KEVOYE,"H1 MISSIRAH COUTA (MISSIRAH SYLLACOUNDA)",26,30,186,155,341
KEDOUGOU,SALEMATA,DAKATELY,KEVOYE,KEVOYE,27,43,230,193,423
KEDOUGOU,SALEMATA,DAKATELY,KEVOYE,"H1 KORIKHO",4,8,32,38,70
KEDOUGOU,SALEMATA,DAKATELY,KEVOYE,"H2 GADAPETE",16,26,99,97,196
KEDOUGOU,SALEMATA,DAKATELY,KEVOYE,"H3 BASSARI",9,9,30,33,63
KEDOUGOU,SALEMATA,DAKATELY,KEVOYE,"H4 BAKANIKE",4,11,31,29,60
KEDOUGOU,SALEMATA,DAKATELY,KEVOYE,"H5 LILAKOUME",19,34,109,97,206
KEDOUGOU,SALEMATA,DAKATELY,KEVOYE,"H6 HOYE KOUME",40,56,188,179,367
KEDOUGOU,SALEMATA,DAKATELY,KEVOYE,NAGNAN,19,24,62,87,149
KEDOUGOU,SALEMATA,DAKATELY,KEVOYE,"NINGOU BASSARI",9,12,38,39,77
KEDOUGOU,SALEMATA,DAKATELY,KEVOYE,"NOUBOU (NINGOU PEULH)",91,102,272,311,583
KEDOUGOU,SALEMATA,DAKATELY,KEVOYE,"THANKOUM MBOURA",43,45,185,168,353
KEDOUGOU,SALEMATA,DAKATELY,KEVOYE,"H1 BOUDOU BOUDOU",2,3,11,8,19
KEDOUGOU,SALEMATA,DAKATELY,KEVOYE,"H2 MAREVA",2,2,11,10,21
KEDOUGOU,SALEMATA,DAKATELY,KEVOYE,THIANKOUNOUME,33,41,146,138,284
KEDOUGOU,SALEMATA,DAKATELY,KEVOYE,"H1 LOUMBIDOUBE",30,49,203,181,384
KEDOUGOU,SALEMATA,DAKATELY,KEVOYE,"H2 YIRNINI",3,3,14,15,29
KEDOUGOU,SALEMATA,DAKATELY,KEVOYE,"H3 GADANOUME",24,30,88,78,166
KEDOUGOU,SALEMATA,DAKATELY,KEVOYE,THIANKOYE,32,72,243,260,503
KEDOUGOU,SALEMATA,DAKATELY,KEVOYE,"H1 LORI",18,20,80,66,146
KEDOUGOU,SALEMATA,DAKATELY,KEVOYE,"H2 SAMBA NGAR",39,43,190,179,369
KEDOUGOU,SALEMATA,DAKATELY,KEVOYE,"H3 LALIMOULI",3,5,20,23,43
KEDOUGOU,SALEMATA,"DAR SALAM","DAR SALAM","BAKAOUKA (MISSIRAH)",81,85,246,281,527
KEDOUGOU,SALEMATA,"DAR SALAM","DAR SALAM","H1 POUNTAN PEULH",7,10,27,33,60
KEDOUGOU,SALEMATA,"DAR SALAM","DAR SALAM",BANFAROTO,38,45,157,145,302
KEDOUGOU,SALEMATA,"DAR SALAM","DAR SALAM",BILEL,3,5,7,16,23
KEDOUGOU,SALEMATA,"DAR SALAM","DAR SALAM","DAR SALAM",34,53,329,285,614
KEDOUGOU,SALEMATA,"DAR SALAM","DAR SALAM","DIARA PONT",58,59,159,189,348
KEDOUGOU,SALEMATA,"DAR SALAM","DAR SALAM",DJIRINE,5,5,13,13,26
KEDOUGOU,SALEMATA,"DAR SALAM","DAR SALAM",EDINE,11,13,41,48,89
KEDOUGOU,SALEMATA,"DAR SALAM","DAR SALAM","H2 SOUMBA",1,1,7,4,11
KEDOUGOU,SALEMATA,"DAR SALAM","DAR SALAM",EGANGA,33,35,131,129,260
KEDOUGOU,SALEMATA,"DAR SALAM","DAR SALAM","EPINGUE BASSARI",28,38,128,139,267
KEDOUGOU,SALEMATA,"DAR SALAM","DAR SALAM",HINEYA,13,19,64,75,139
KEDOUGOU,SALEMATA,"DAR SALAM","DAR SALAM",INGATHITIQUE,17,18,69,49,118
KEDOUGOU,SALEMATA,"DAR SALAM","DAR SALAM",KEKERESSI,18,20,65,68,133
KEDOUGOU,SALEMATA,"DAR SALAM","DAR SALAM","H1 HOLLANDE",19,19,63,66,129
KEDOUGOU,SALEMATA,"DAR SALAM","DAR SALAM","H2 BISSAO HOLLANDE",6,6,29,29,58
KEDOUGOU,SALEMATA,"DAR SALAM","DAR SALAM","H3 HOLLANDE",1,1,2,6,8
KEDOUGOU,SALEMATA,"DAR SALAM","DAR SALAM","H5 KARERE",7,8,15,16,31
KEDOUGOU,SALEMATA,"DAR SALAM","DAR SALAM",LINGUEKOTO,9,9,29,32,61
KEDOUGOU,SALEMATA,"DAR SALAM","DAR SALAM","H1 DIARA DOUCOURE",4,5,13,13,26
KEDOUGOU,SALEMATA,"DAR SALAM","DAR SALAM","H2 DIARA NANGAR",10,11,38,27,65
KEDOUGOU,SALEMATA,"DAR SALAM","DAR SALAM","H3 DIARA GANDJIRI",2,2,5,6,11
KEDOUGOU,SALEMATA,"DAR SALAM","DAR SALAM","MEDINA DIAMWELY",2,2,5,7,12
KEDOUGOU,SALEMATA,"DAR SALAM","DAR SALAM","H1 DIARA",16,17,46,49,95
KEDOUGOU,SALEMATA,"DAR SALAM","DAR SALAM","H2 SEDEMBOU",19,20,48,47,95
KEDOUGOU,SALEMATA,"DAR SALAM","DAR SALAM","H3 KONDORONG",6,8,28,22,50
KEDOUGOU,SALEMATA,"DAR SALAM","DAR SALAM","H4 PARAYAMBA",4,4,18,22,40
KEDOUGOU,SALEMATA,"DAR SALAM","DAR SALAM",SAMOU,9,11,42,41,83
KEDOUGOU,SALEMATA,"DAR SALAM","DAR SALAM","SINTHIOU BOMBOLY",28,31,80,87,167
KEDOUGOU,SALEMATA,"DAR SALAM","DAR SALAM","H1 SINTHIOUROU BOMBOLY",6,7,16,21,37
KEDOUGOU,SALEMATA,"DAR SALAM","DAR SALAM","THIANGUETO (LEBAR)",19,58,144,136,280
KEDOUGOU,SALEMATA,"DAR SALAM",ETHIOLO,EBARACK,40,46,170,162,332
KEDOUGOU,SALEMATA,"DAR SALAM",ETHIOLO,"H1 SIDY DIALLO",7,8,33,41,74
KEDOUGOU,SALEMATA,"DAR SALAM",ETHIOLO,"H2 PABELINE",8,9,32,28,60
KEDOUGOU,SALEMATA,"DAR SALAM",ETHIOLO,"H4 ANGOROR",9,12,34,39,73
KEDOUGOU,SALEMATA,"DAR SALAM",ETHIOLO,EDANE,24,27,73,75,148
KEDOUGOU,SALEMATA,"DAR SALAM",ETHIOLO,"H1 POUNTAN BASSARI",25,26,70,76,146
KEDOUGOU,SALEMATA,"DAR SALAM",ETHIOLO,EGNISSARA,27,28,108,107,215
KEDOUGOU,SALEMATA,"DAR SALAM",ETHIOLO,"H2 POUBRI",2,2,7,8,15
KEDOUGOU,SALEMATA,"DAR SALAM",ETHIOLO,"H3 GRIBANA",4,4,25,19,44
KEDOUGOU,SALEMATA,"DAR SALAM",ETHIOLO,EKESSE,18,20,63,61,124
KEDOUGOU,SALEMATA,"DAR SALAM",ETHIOLO,"EPINGUE PEULH",13,14,45,44,89
KEDOUGOU,SALEMATA,"DAR SALAM",ETHIOLO,ETHIOLO,85,93,330,345,675
KEDOUGOU,SALEMATA,"DAR SALAM",ETHIOLO,"H1 OPEB",21,23,84,85,169
KEDOUGOU,SALEMATA,"DAR SALAM",ETHIOLO,"H2 AKOLL",4,6,15,19,34
KEDOUGOU,SALEMATA,"DAR SALAM",ETHIOLO,GOUMON,9,10,28,30,58
KEDOUGOU,SALEMATA,"DAR SALAM",ETHIOLO,"H1 GOUMON",13,14,32,40,72
KEDOUGOU,SALEMATA,"DAR SALAM",ETHIOLO,KOTE,20,23,68,74,142
KEDOUGOU,SALEMATA,"DAR SALAM",ETHIOLO,"MBONG BASSARI",33,39,149,114,263
KEDOUGOU,SALEMATA,"DAR SALAM",ETHIOLO,"MBONG PEULH",71,77,225,249,474
KEDOUGOU,SALEMATA,"DAR SALAM",ETHIOLO,"MEDINA ARSAS",19,22,105,92,197
KEDOUGOU,SALEMATA,"DAR SALAM",ETHIOLO,"MEDINA BOWE",4,5,23,20,43
KEDOUGOU,SALEMATA,"DAR SALAM",ETHIOLO,"H1 KALATHI FOUTA",2,2,19,12,31
KEDOUGOU,SALEMATA,"DAR SALAM",ETHIOLO,NGOPPOU,15,15,47,57,104
KEDOUGOU,SALEMATA,"DAR SALAM",ETHIOLO,ANDEBY,21,22,96,89,185
KEDOUGOU,SALEMATA,"DAR SALAM",ETHIOLO,DATHIEMY,23,30,99,105,204
KEDOUGOU,SALEMATA,"DAR SALAM",ETHIOLO,HAMDALLAYE,18,22,86,86,172
KEDOUGOU,SALEMATA,"DAR SALAM",ETHIOLO,ATOUMAR,13,14,80,87,167
KEDOUGOU,SALEMATA,"DAR SALAM",OUBADJI,"BACK BACK",16,32,63,75,138
KEDOUGOU,SALEMATA,"DAR SALAM",OUBADJI,"H1 LAGNE BAKARY (BACK BACK BASSARI)",11,20,53,57,110
KEDOUGOU,SALEMATA,"DAR SALAM",OUBADJI,"H2 BACK BACK KONIAGUI",8,9,27,28,55
KEDOUGOU,SALEMATA,"DAR SALAM",OUBADJI,BOUTHILY,9,10,34,39,73
KEDOUGOU,SALEMATA,"DAR SALAM",OUBADJI,EDALE,20,24,65,77,142
KEDOUGOU,SALEMATA,"DAR SALAM",OUBADJI,"H2 AMOUNE",8,8,23,27,50
KEDOUGOU,SALEMATA,"DAR SALAM",OUBADJI,"H3 GRIYAMANE",5,5,12,11,23
KEDOUGOU,SALEMATA,"DAR SALAM",OUBADJI,"H4 SAKAR",10,12,36,30,66
KEDOUGOU,SALEMATA,"DAR SALAM",OUBADJI,"ETHINANGOR (BOUDJINE)",20,28,70,77,147
KEDOUGOU,SALEMATA,"DAR SALAM",OUBADJI,"H1 GUEURBAGUINE",18,21,79,81,160
KEDOUGOU,SALEMATA,"DAR SALAM",OUBADJI,"H2 ETHINANGOR",23,24,69,81,150
KEDOUGOU,SALEMATA,"DAR SALAM",OUBADJI,GRIDIAMBANE,16,19,62,64,126
KEDOUGOU,SALEMATA,"DAR SALAM",OUBADJI,GRIGNINDINE,16,18,64,47,111
KEDOUGOU,SALEMATA,"DAR SALAM",OUBADJI,"MEDINA BOINY (OUBADJI)",43,47,155,139,294
KEDOUGOU,SALEMATA,"DAR SALAM",OUBADJI,"MISSIRAH DALABA",12,12,41,48,89
KEDOUGOU,SALEMATA,"DAR SALAM",OUBADJI,MITHIOU,20,25,85,100,185
KEDOUGOU,SALEMATA,"DAR SALAM",OUBADJI,OUNDOUFERE,32,35,103,94,197
KEDOUGOU,SALEMATA,"DAR SALAM",OUBADJI,GRIBOTAON,3,3,8,8,16
KEDOUGOU,SALEMATA,"DAR SALAM",OUBADJI,BAMONG,9,9,23,24,47
KEDOUGOU,SALEMATA,"DAR SALAM",OUBADJI,DOUHELINE,18,19,64,77,141
KEDOUGOU,SALEMATA,"DAR SALAM",OUBADJI,GOINA,10,13,30,37,67
KEDOUGOU,SALEMATA,"DAR SALAM",OUBADJI,"SAKAR BASSARI",10,11,35,34,69
KEDOUGOU,SALEMATA,"DAR SALAM",OUBADJI,WINDIOU,9,9,30,27,57
KEDOUGOU,SARAYA,SARAYA,SARAYA,FOUNSAMBA,105,170,670,475,1145
KEDOUGOU,SARAYA,SARAYA,SARAYA,LIBERTE,80,112,449,393,842
KEDOUGOU,SARAYA,SARAYA,SARAYA,MOSQUEE,42,63,520,466,986
KEDOUGOU,SARAYA,SARAYA,SARAYA,SEKHOFARA,138,284,765,647,1412
KEDOUGOU,SARAYA,BEMBOU,"MEDINA BAFFE",DINDIARY,16,27,104,118,222
KEDOUGOU,SARAYA,BEMBOU,"MEDINA BAFFE",GUEMEDJI,169,206,1018,942,1960
KEDOUGOU,SARAYA,BEMBOU,"MEDINA BAFFE","H1 FADIANDIAN",4,7,30,25,55
KEDOUGOU,SARAYA,BEMBOU,"MEDINA BAFFE","H2 FALEMA (FADOUGOU NIAFA)",96,108,183,127,310
KEDOUGOU,SARAYA,BEMBOU,"MEDINA BAFFE","H3 KHOUMBANSOUKHOUNG",11,11,21,33,54
KEDOUGOU,SARAYA,BEMBOU,"MEDINA BAFFE","H4 KOULIMINDE",30,37,125,143,268
KEDOUGOU,SARAYA,BEMBOU,"MEDINA BAFFE","H5 NIENIEYA",2,2,9,6,15
KEDOUGOU,SARAYA,BEMBOU,"MEDINA BAFFE",KHOULEYA,9,18,37,48,85
KEDOUGOU,SARAYA,BEMBOU,"MEDINA BAFFE","MEDINA BAFFE",57,108,446,422,868
KEDOUGOU,SARAYA,BEMBOU,"MEDINA BAFFE","H1 BABOUYA (TEMBERE)",9,18,64,69,133
KEDOUGOU,SARAYA,BEMBOU,"MEDINA BAFFE","H2 HEREMAKONO",1,1,8,10,18
KEDOUGOU,SARAYA,BEMBOU,"MEDINA BAFFE","MISSIRAH DANTILA",28,65,563,492,1055
KEDOUGOU,SARAYA,BEMBOU,"MEDINA BAFFE",MOULOUNGA,18,27,104,95,199
KEDOUGOU,SARAYA,BEMBOU,"MEDINA BAFFE","H1 BOUMBOUKHOUTOU",10,11,39,36,75
KEDOUGOU,SARAYA,BEMBOU,"MEDINA BAFFE",NOUMOUFOUKHA,65,71,342,258,600
KEDOUGOU,SARAYA,BEMBOU,"MEDINA BAFFE","H1 SONKHOYA",16,21,131,97,228
KEDOUGOU,SARAYA,BEMBOU,"MEDINA BAFFE","H2 BOFETO",22,30,135,135,270
KEDOUGOU,SARAYA,BEMBOU,"MEDINA BAFFE","H10 BOTO 1",6,7,26,22,48
KEDOUGOU,SARAYA,BEMBOU,"MEDINA BAFFE","H11 BAGATA",2,4,15,11,26
KEDOUGOU,SARAYA,BEMBOU,"MEDINA BAFFE","SAKHOUYA (SONKHEYA)",15,21,114,134,248
KEDOUGOU,SARAYA,BEMBOU,"MEDINA BAFFE","H2 KHABANTING 2",1,1,5,5,10
KEDOUGOU,SARAYA,BEMBOU,"MEDINA BAFFE","SAMECOUTA (SAMECOUTA DANTILA)",26,58,250,312,562
KEDOUGOU,SARAYA,BEMBOU,"MEDINA BAFFE",SAROUDIA,48,72,372,368,740
KEDOUGOU,SARAYA,BEMBOU,"MEDINA BAFFE","H1 FATAKO",1,1,6,4,10
KEDOUGOU,SARAYA,BEMBOU,"MEDINA BAFFE","H2 FARATO",4,4,27,17,44
KEDOUGOU,SARAYA,BEMBOU,"MEDINA BAFFE",SEKHOTO,34,50,209,164,373
KEDOUGOU,SARAYA,BEMBOU,"MEDINA BAFFE",TAMEGUEDIA,21,38,137,166,303
KEDOUGOU,SARAYA,BEMBOU,"MEDINA BAFFE","H1 WAKILARE",7,8,24,40,64
KEDOUGOU,SARAYA,BEMBOU,"MEDINA BAFFE","H2 KONKOGNOUMA",6,8,55,48,103
KEDOUGOU,SARAYA,BEMBOU,"MEDINA BAFFE","H3 BALANDOUGOU",1,1,2,6,8
KEDOUGOU,SARAYA,BEMBOU,"MEDINA BAFFE","H4 NIENIEYA",14,20,94,101,195
KEDOUGOU,SARAYA,BEMBOU,"MEDINA BAFFE",TOUBAKOUTA,15,25,211,107,318
KEDOUGOU,SARAYA,BEMBOU,"MEDINA BAFFE",WAMBA,25,43,264,300,564
KEDOUGOU,SARAYA,BEMBOU,"MEDINA BAFFE","H2 BAGUE",7,10,71,62,133
KEDOUGOU,SARAYA,BEMBOU,"MEDINA BAFFE","BOTO 2",3,3,20,21,41
KEDOUGOU,SARAYA,BEMBOU,"MEDINA BAFFE","DIAKHA MACKY",70,82,258,280,538
KEDOUGOU,SARAYA,BEMBOU,BEMBOU,BADIOULA,41,68,314,225,539
KEDOUGOU,SARAYA,BEMBOU,BEMBOU,BALORY,13,15,117,105,222
KEDOUGOU,SARAYA,BEMBOU,BEMBOU,BAMBADJI,29,50,449,382,831
KEDOUGOU,SARAYA,BEMBOU,BEMBOU,"H3 OUSMANEYA",1,1,10,13,23
KEDOUGOU,SARAYA,BEMBOU,BEMBOU,"H4 FOUKHOLA",11,17,122,84,206
KEDOUGOU,SARAYA,BEMBOU,BEMBOU,BARABIRY,29,30,338,219,557
KEDOUGOU,SARAYA,BEMBOU,BEMBOU,BAYTILAYE,17,19,110,91,201
KEDOUGOU,SARAYA,BEMBOU,BEMBOU,BEMBOU,113,119,686,679,1365
KEDOUGOU,SARAYA,BEMBOU,BEMBOU,BOUNSANKHOBA,30,30,183,157,340
KEDOUGOU,SARAYA,BEMBOU,BEMBOU,DALAFING,39,62,235,216,451
KEDOUGOU,SARAYA,BEMBOU,BEMBOU,"DIAKHA MADINA",48,58,331,363,694
KEDOUGOU,SARAYA,BEMBOU,BEMBOU,DIAKHABA,51,63,488,493,981
KEDOUGOU,SARAYA,BEMBOU,BEMBOU,"H1 SEGUEKHO",91,119,270,139,409
KEDOUGOU,SARAYA,BEMBOU,BEMBOU,DIOULAFOUNDOU,42,46,251,219,470
KEDOUGOU,SARAYA,BEMBOU,BEMBOU,FARABA,29,34,226,211,437
KEDOUGOU,SARAYA,BEMBOU,BEMBOU,"FODE BINEA",14,19,128,98,226
KEDOUGOU,SARAYA,BEMBOU,BEMBOU,KOLYA,148,158,709,394,1103
KEDOUGOU,SARAYA,BEMBOU,BEMBOU,KONDOKHOU,105,108,676,675,1351
KEDOUGOU,SARAYA,BEMBOU,BEMBOU,"KOUMBOUTOUROU (TABANDING)",8,8,91,71,162
KEDOUGOU,SARAYA,BEMBOU,BEMBOU,"MADINA DANTILA",2,2,5,10,15
KEDOUGOU,SARAYA,BEMBOU,BEMBOU,"MOUSSALA MAHINAMINE",188,228,885,650,1535
KEDOUGOU,SARAYA,BEMBOU,BEMBOU,"H1 SANSAMBA",94,154,518,415,933
KEDOUGOU,SARAYA,BEMBOU,BEMBOU,"H4 MADINA",22,23,102,95,197
KEDOUGOU,SARAYA,BEMBOU,BEMBOU,"H5 GAMBA GAMBA",66,66,398,242,640
KEDOUGOU,SARAYA,BEMBOU,BEMBOU,"H6 DIALADAKHOTO",88,91,327,223,550
KEDOUGOU,SARAYA,BEMBOU,BEMBOU,NAFADJI,70,91,602,502,1104
KEDOUGOU,SARAYA,BEMBOU,BEMBOU,"SABOUSSIRE (PONDALLA)",37,38,254,313,567
KEDOUGOU,SARAYA,BEMBOU,BEMBOU,"SAKHADOFI (MASSAMASSA)",46,51,205,118,323
KEDOUGOU,SARAYA,BEMBOU,BEMBOU,SAMEKHOTO,9,12,96,85,181
KEDOUGOU,SARAYA,BEMBOU,BEMBOU,SANELA,45,56,372,343,715
KEDOUGOU,SARAYA,BEMBOU,BEMBOU,SANSELA,15,19,158,95,253
KEDOUGOU,SARAYA,BEMBOU,BEMBOU,"H1 DOUHIBA",22,24,124,103,227
KEDOUGOU,SARAYA,BEMBOU,BEMBOU,"H2 BANDIASSE",14,17,131,62,193
KEDOUGOU,SARAYA,BEMBOU,BEMBOU,"H5 GODIBANTANG",4,7,33,36,69
KEDOUGOU,SARAYA,BEMBOU,BEMBOU,"H6 SITADINA",194,252,885,358,1243
KEDOUGOU,SARAYA,BEMBOU,BEMBOU,"H7 MALICK YA",2,2,18,18,36
KEDOUGOU,SARAYA,BEMBOU,BEMBOU,SATADOUGOU,65,68,260,252,512
KEDOUGOU,SARAYA,BEMBOU,BEMBOU,SOMAYA,50,50,376,295,671
KEDOUGOU,SARAYA,BEMBOU,BEMBOU,BANTANKHO,168,196,944,318,1262
KEDOUGOU,SARAYA,BEMBOU,BEMBOU,GAREBOUREA,65,77,652,448,1100
KEDOUGOU,SARAYA,BEMBOU,BEMBOU,"H1 BOBOTY",14,15,124,132,256
KEDOUGOU,SARAYA,BEMBOU,BEMBOU,KHARAKHAINA,639,776,2018,1235,3253
KEDOUGOU,SARAYA,BEMBOU,BEMBOU,LINGUEYA,9,14,100,61,161
KEDOUGOU,SARAYA,BEMBOU,BEMBOU,"H1 KOUROUDIAKHOUMA",8,11,56,49,105
KEDOUGOU,SARAYA,BEMBOU,BEMBOU,MANDANKHOTO,11,12,88,63,151
KEDOUGOU,SARAYA,SABODALA,KHOSSANTO,BEROLA,13,13,92,77,169
KEDOUGOU,SARAYA,SABODALA,KHOSSANTO,DIAKHALING,146,161,780,653,1433
KEDOUGOU,SARAYA,SABODALA,KHOSSANTO,"H1 MEDINA BEROLA",12,13,108,137,245
KEDOUGOU,SARAYA,SABODALA,KHOSSANTO,DIEGOUNG,30,33,258,205,463
KEDOUGOU,SARAYA,SABODALA,KHOSSANTO,KHOSSANTO,513,688,3902,2297,6199
KEDOUGOU,SARAYA,SABODALA,KHOSSANTO,"H1 LEFAKHO",30,33,286,256,542
KEDOUGOU,SARAYA,SABODALA,KHOSSANTO,"H2 KOBOKHOTO",19,22,169,172,341
KEDOUGOU,SARAYA,SABODALA,KHOSSANTO,"H3 KEGNE KEGNEBADING",27,48,159,147,306
KEDOUGOU,SARAYA,SABODALA,KHOSSANTO,MANDANKHOLI,20,21,153,117,270
KEDOUGOU,SARAYA,SABODALA,KHOSSANTO,"H1 LAFIA",66,88,338,210,548
KEDOUGOU,SARAYA,SABODALA,KHOSSANTO,"H2 KONKOTO",3,5,33,28,61
KEDOUGOU,SARAYA,SABODALA,KHOSSANTO,NIAMAYA,11,12,139,125,264
KEDOUGOU,SARAYA,SABODALA,KHOSSANTO,TOUROKHOTO,19,35,177,158,335
KEDOUGOU,SARAYA,SABODALA,"MISSIRAH SIRIMANA",BALAKONKO,37,48,305,241,546
KEDOUGOU,SARAYA,SABODALA,"MISSIRAH SIRIMANA",BOKHODI,199,199,796,416,1212
KEDOUGOU,SARAYA,SABODALA,"MISSIRAH SIRIMANA",BOUNTOUNG,72,83,510,318,828
KEDOUGOU,SARAYA,SABODALA,"MISSIRAH SIRIMANA",DALOTO,155,180,1034,819,1853
KEDOUGOU,SARAYA,SABODALA,"MISSIRAH SIRIMANA","DAMBALA KEGNOTO",36,38,372,280,652
KEDOUGOU,SARAYA,SABODALA,"MISSIRAH SIRIMANA","DAMBALA SEKHOTO",33,34,293,276,569
KEDOUGOU,SARAYA,SABODALA,"MISSIRAH SIRIMANA",DAWOROLA,15,17,195,176,371
KEDOUGOU,SARAYA,SABODALA,"MISSIRAH SIRIMANA",FARANDING,26,33,210,202,412
KEDOUGOU,SARAYA,SABODALA,"MISSIRAH SIRIMANA",ILIMALO,17,21,177,200,377
KEDOUGOU,SARAYA,SABODALA,"MISSIRAH SIRIMANA",LINGUEKHOTO,9,13,183,159,342
KEDOUGOU,SARAYA,SABODALA,"MISSIRAH SIRIMANA","MADINA SIRIMANA",90,115,583,571,1154
KEDOUGOU,SARAYA,SABODALA,"MISSIRAH SIRIMANA","MISSIRAH SIRIMANA",88,93,551,517,1068
KEDOUGOU,SARAYA,SABODALA,"MISSIRAH SIRIMANA","H1 DALABA",3,3,38,24,62
KEDOUGOU,SARAYA,SABODALA,"MISSIRAH SIRIMANA",MOURAN,159,172,969,542,1511
KEDOUGOU,SARAYA,SABODALA,"MISSIRAH SIRIMANA","H1 BAGUE",7,7,56,90,146
KEDOUGOU,SARAYA,SABODALA,"MISSIRAH SIRIMANA",MOUSSALA,25,28,210,207,417
KEDOUGOU,SARAYA,SABODALA,"MISSIRAH SIRIMANA",SAIENSOUTOU,201,255,1198,938,2136
KEDOUGOU,SARAYA,SABODALA,"MISSIRAH SIRIMANA",SAMBRANBOUGOU,358,399,1410,864,2274
KEDOUGOU,SARAYA,SABODALA,"MISSIRAH SIRIMANA",TOUMBINFARA,4,12,44,44,88
KEDOUGOU,SARAYA,SABODALA,"MISSIRAH SIRIMANA",WANSANGARA,82,88,615,648,1263
KEDOUGOU,SARAYA,SABODALA,"MISSIRAH SIRIMANA",WORTOKHATI,23,44,183,141,324
KEDOUGOU,SARAYA,SABODALA,"MISSIRAH SIRIMANA",DOUTA,441,510,1133,856,1989
KEDOUGOU,SARAYA,SABODALA,"MISSIRAH SIRIMANA","KHASSAGUIRI (BONDALA)",240,248,1357,764,2121
KEDOUGOU,SARAYA,SABODALA,SABODALA,BAMBARAYA,61,67,443,403,846
KEDOUGOU,SARAYA,SABODALA,SABODALA,"H1 BAMBARAYADING",221,262,658,410,1068
KEDOUGOU,SARAYA,SABODALA,SABODALA,BRANSAN,65,112,735,588,1323
KEDOUGOU,SARAYA,SABODALA,SABODALA,DIALAKOTOBA,22,22,237,267,504
KEDOUGOU,SARAYA,SABODALA,SABODALA,"H1 SOUNTOUKOLONG",16,17,350,281,631
KEDOUGOU,SARAYA,SABODALA,SABODALA,DINDIFA,19,39,321,277,598
KEDOUGOU,SARAYA,SABODALA,SABODALA,FALOUMBOU,52,76,495,392,887
KEDOUGOU,SARAYA,SABODALA,SABODALA,MAKHANA,38,49,430,435,865
KEDOUGOU,SARAYA,SABODALA,SABODALA,MAMAKHONO,175,212,1629,1242,2871
KEDOUGOU,SARAYA,SABODALA,SABODALA,"MEDINA BRANSAN",47,74,388,372,760
KEDOUGOU,SARAYA,SABODALA,SABODALA,SABODALA,270,386,1479,1242,2721
KEDOUGOU,SARAYA,SABODALA,SABODALA,"H1 MADINA SABODALA",83,87,417,437,854
KEDOUGOU,SARAYA,SABODALA,SABODALA,"H4 MADINA SABODALA RECASEMENT",1,1,6,0,6
KEDOUGOU,SARAYA,SABODALA,SABODALA,TENKOTO,714,917,2478,1530,4008
KEDOUGOU,SARAYA,SABODALA,SABODALA,"H1 THIANGUEL BASSADJI",20,27,44,30,74
SEDHIOU,SEDHIOU,SEDHIOU,SEDHIOU,JULESCOUNDA,71,108,673,634,1307
SEDHIOU,SEDHIOU,SEDHIOU,SEDHIOU,KABEUMB,227,333,1358,1414,2772
SEDHIOU,SEDHIOU,SEDHIOU,SEDHIOU,MANSACOUNDA,190,330,1638,1550,3188
SEDHIOU,SEDHIOU,SEDHIOU,SEDHIOU,"MONTAGNE ROUGE",314,366,2183,1638,3821
SEDHIOU,SEDHIOU,SEDHIOU,SEDHIOU,MORICOUNDA,459,548,2463,2354,4817
SEDHIOU,SEDHIOU,SEDHIOU,SEDHIOU,"SANTASSOU I",257,381,1602,1683,3285
SEDHIOU,SEDHIOU,SEDHIOU,SEDHIOU,"SANTASSOU II",469,702,2271,2233,4504
SEDHIOU,SEDHIOU,SEDHIOU,SEDHIOU,DEMBAYA,208,256,1336,1391,2727
SEDHIOU,SEDHIOU,SEDHIOU,SEDHIOU,GOUDIABYA,235,252,975,913,1888
SEDHIOU,SEDHIOU,SEDHIOU,SEDHIOU,"SANTASSOU III",303,398,1584,1618,3202
SEDHIOU,SEDHIOU,MARSASSOUM,MARSASSOUM,BELALY,147,175,843,892,1735
SEDHIOU,SEDHIOU,MARSASSOUM,MARSASSOUM,ESCALE,59,76,388,409,797
SEDHIOU,SEDHIOU,MARSASSOUM,MARSASSOUM,"GRAND DAKAR",95,101,574,551,1125
SEDHIOU,SEDHIOU,MARSASSOUM,MARSASSOUM,KANKABA,134,148,924,963,1887
SEDHIOU,SEDHIOU,MARSASSOUM,MARSASSOUM,MANGUIR,13,20,145,136,281
SEDHIOU,SEDHIOU,MARSASSOUM,MARSASSOUM,SOURWACOUNDA,130,159,827,872,1699
SEDHIOU,SEDHIOU,MARSASSOUM,MARSASSOUM,TAIBA,17,20,535,241,776
SEDHIOU,SEDHIOU,MARSASSOUM,MARSASSOUM,TORONCOCOUNDA,106,126,768,747,1515
SEDHIOU,SEDHIOU,DIENDE,DIENDE,AYNOUSSALAM,22,23,122,131,253
SEDHIOU,SEDHIOU,DIENDE,DIENDE,"BADIANDIAN DIOLA",47,59,348,377,725
SEDHIOU,SEDHIOU,DIENDE,DIENDE,"BADIANDIAN MANCAGNE",22,23,166,107,273
SEDHIOU,SEDHIOU,DIENDE,DIENDE,"H1 BADIANDIAN SOUCOTOTO",8,8,43,38,81
SEDHIOU,SEDHIOU,DIENDE,DIENDE,"BAKOUM MANCAGNE",9,9,35,46,81
SEDHIOU,SEDHIOU,DIENDE,DIENDE,"BAKOUM MANDINGUE",63,66,447,450,897
SEDHIOU,SEDHIOU,DIENDE,DIENDE,"BISSARI (DIOUNKOYA)",42,51,288,330,618
SEDHIOU,SEDHIOU,DIENDE,DIENDE,"H1 SINTHIANG IBRAHIMA",4,4,10,16,26
SEDHIOU,SEDHIOU,DIENDE,DIENDE,"H2 TAMBACOURA",10,11,61,47,108
SEDHIOU,SEDHIOU,DIENDE,DIENDE,"H3 SINTHIANG YORO SANE",3,3,5,11,16
SEDHIOU,SEDHIOU,DIENDE,DIENDE,"H4 BISSARI (DIOUNKOUYA)",3,3,7,0,7
SEDHIOU,SEDHIOU,DIENDE,DIENDE,"BOUSSOURA ELHADJI KARAMBA",13,15,243,218,461
SEDHIOU,SEDHIOU,DIENDE,DIENDE,"DIATOUMA MANDINGUE",39,69,434,442,876
SEDHIOU,SEDHIOU,DIENDE,DIENDE,"DIATOUMA REFUGIE",9,9,56,42,98
SEDHIOU,SEDHIOU,DIENDE,DIENDE,DIENDE,154,188,1045,1150,2195
SEDHIOU,SEDHIOU,DIENDE,DIENDE,"H2 SINTHIANG KORKA",1,3,10,8,18
SEDHIOU,SEDHIOU,DIENDE,DIENDE,"DJIDATOU EL HADJ KHALIFA",7,18,242,99,341
SEDHIOU,SEDHIOU,DIENDE,DIENDE,IDA,26,30,286,274,560
SEDHIOU,SEDHIOU,DIENDE,DIENDE,"BLOC STATION",68,73,362,277,639
SEDHIOU,SEDHIOU,DIENDE,DIENDE,"H2 SIDOUYA (NGALPANTE)",5,7,44,40,84
SEDHIOU,SEDHIOU,DIENDE,DIENDE,"H3 DIENDE 2",5,5,26,16,42
SEDHIOU,SEDHIOU,DIENDE,DIENDE,"KOUNAYAN DIOLA",9,9,54,53,107
SEDHIOU,SEDHIOU,DIENDE,DIENDE,"KOUNAYAN MANCAGNE",35,43,186,232,418
SEDHIOU,SEDHIOU,DIENDE,DIENDE,"H1 KOUNAYAN MANCAGNE",9,11,44,32,76
SEDHIOU,SEDHIOU,DIENDE,DIENDE,"KOUNAYAN MANDING",32,71,313,338,651
SEDHIOU,SEDHIOU,DIENDE,DIENDE,"MADINA FINDIFETO",34,49,375,426,801
SEDHIOU,SEDHIOU,DIENDE,DIENDE,"MADINA UC I",8,8,45,57,102
SEDHIOU,SEDHIOU,DIENDE,DIENDE,SALIKEGNE,37,43,250,274,524
SEDHIOU,SEDHIOU,DIENDE,DIENDE,"SALIKEGNE SOUCOUTOTO",25,34,398,373,771
SEDHIOU,SEDHIOU,DIENDE,DIENDE,SEFA,31,36,160,162,322
SEDHIOU,SEDHIOU,DIENDE,DIENDE,SITABA,56,65,719,619,1338
SEDHIOU,SEDHIOU,DIENDE,DIENDE,TOURECOUNDA,52,71,621,656,1277
SEDHIOU,SEDHIOU,DIENDE,DIENDE,"UC 1 BLOC VILLAGE",151,179,747,686,1433
SEDHIOU,SEDHIOU,DIENDE,DIENDE,"H1 CHANTIER ECOLE BLOC",22,24,126,127,253
SEDHIOU,SEDHIOU,DIENDE,DIENDE,"KOUNAYAN SOUCOUTOTO (MADINA SALAM)",12,13,89,108,197
SEDHIOU,SEDHIOU,DIENDE,DIENDE,"TIVAOUANE PEULH",3,4,18,16,34
SEDHIOU,SEDHIOU,DIENDE,SAKAR,BABADY,34,67,421,436,857
SEDHIOU,SEDHIOU,DIENDE,SAKAR,"H1 TAMBATO",4,4,36,32,68
SEDHIOU,SEDHIOU,DIENDE,SAKAR,"H2 VELINGARA",1,1,4,7,11
SEDHIOU,SEDHIOU,DIENDE,SAKAR,BADOUGHA,34,63,388,518,906
SEDHIOU,SEDHIOU,DIENDE,SAKAR,BANY,47,58,429,435,864
SEDHIOU,SEDHIOU,DIENDE,SAKAR,BODIANCOUNDA,9,10,95,79,174
SEDHIOU,SEDHIOU,DIENDE,SAKAR,"H1 BOUGNADOU MANJACQUE",2,3,32,30,62
SEDHIOU,SEDHIOU,DIENDE,SAKAR,BOUGNADOU,53,102,727,724,1451
SEDHIOU,SEDHIOU,DIENDE,SAKAR,"H1 BOUGNADOU SOUCOUTO",7,9,72,78,150
SEDHIOU,SEDHIOU,DIENDE,SAKAR,"DAROU MINAM II",29,36,246,257,503
SEDHIOU,SEDHIOU,DIENDE,SAKAR,"DAROU MINAM NGANDA",5,6,38,36,74
SEDHIOU,SEDHIOU,DIENDE,SAKAR,"DAROU RAHMANE",12,15,60,68,128
SEDHIOU,SEDHIOU,DIENDE,SAKAR,"DAROU SAHETTE",14,20,115,103,218
SEDHIOU,SEDHIOU,DIENDE,SAKAR,"DAROU SALAM",18,20,155,144,299
SEDHIOU,SEDHIOU,DIENDE,SAKAR,"DASSILAME PAKAO",103,159,1003,1037,2040
SEDHIOU,SEDHIOU,DIENDE,SAKAR,DJIGUIMAR,7,9,31,30,61
SEDHIOU,SEDHIOU,DIENDE,SAKAR,"H1 KEREWANE PEULH",4,4,20,14,34
SEDHIOU,SEDHIOU,DIENDE,SAKAR,FARABATO,10,17,107,103,210
SEDHIOU,SEDHIOU,DIENDE,SAKAR,"MEDINA KHAIROUANE",10,14,80,65,145
SEDHIOU,SEDHIOU,DIENDE,SAKAR,"MEDINA NDIAYENE",5,6,32,38,70
SEDHIOU,SEDHIOU,DIENDE,SAKAR,"MEDINA SALAM KEBE",15,19,117,124,241
SEDHIOU,SEDHIOU,DIENDE,SAKAR,"H1 KOUNKALE",3,3,29,17,46
SEDHIOU,SEDHIOU,DIENDE,SAKAR,"MEDINATOUL MOUNAWARA",3,3,55,11,66
SEDHIOU,SEDHIOU,DIENDE,SAKAR,NASSOUROULAHI,16,18,90,77,167
SEDHIOU,SEDHIOU,DIENDE,SAKAR,SAKAR,78,92,498,571,1069
SEDHIOU,SEDHIOU,DIENDE,SAKAR,"SINTHIANG FODE",5,9,57,61,118
SEDHIOU,SEDHIOU,DIENDE,SAKAR,"SINTHIANG MAOUNDE",3,4,32,38,70
SEDHIOU,SEDHIOU,DIENDE,SAKAR,"TAIBA MADINA",20,23,187,173,360
SEDHIOU,SEDHIOU,DIENDE,SAKAR,"TAIBA NDIOUFENE",16,16,116,95,211
SEDHIOU,SEDHIOU,DIENDE,SAKAR,"H1 SINTHIANG KALILOU",1,2,23,17,40
SEDHIOU,SEDHIOU,DIENDE,SAKAR,"THIOYENE KAWSARA",43,45,363,243,606
SEDHIOU,SEDHIOU,DIENDE,SAKAR,"TOUBA TALLENE (TOUBA FALL)",13,17,120,96,216
SEDHIOU,SEDHIOU,DIENDE,"DIANNAH BA","BANTAN COUROTO",10,11,88,78,166
SEDHIOU,SEDHIOU,DIENDE,"DIANNAH BA","DIANNAH BA",223,305,1522,1612,3134
SEDHIOU,SEDHIOU,DIENDE,"DIANNAH BA",DIEMECOUNDA,2,2,22,19,41
SEDHIOU,SEDHIOU,DIENDE,"DIANNAH BA",DIOPCOUNDA,17,24,214,223,437
SEDHIOU,SEDHIOU,DIENDE,"DIANNAH BA","DJIGNAOULING MANJACQUE",2,4,21,19,40
SEDHIOU,SEDHIOU,DIENDE,"DIANNAH BA","DJIGNAOULING PEULH",3,5,22,30,52
SEDHIOU,SEDHIOU,DIENDE,"DIANNAH BA",KAMACOUNDA,10,16,123,93,216
SEDHIOU,SEDHIOU,DIENDE,"DIANNAH BA",KARSIA,59,82,642,632,1274
SEDHIOU,SEDHIOU,DIENDE,"DIANNAH BA","H1 SARE BOUYA",24,29,165,177,342
SEDHIOU,SEDHIOU,DIENDE,"DIANNAH BA",KOUDJINI,10,12,73,82,155
SEDHIOU,SEDHIOU,DIENDE,"DIANNAH BA","SAMETOULOU MANJAQUE",3,5,18,16,34
SEDHIOU,SEDHIOU,DIENDE,"DIANNAH BA","SAMETOULOU PEULH",12,21,135,148,283
SEDHIOU,SEDHIOU,DIENDE,"DIANNAH BA","SARE DANSA",35,58,270,355,625
SEDHIOU,SEDHIOU,DIENDE,"DIANNAH BA","SARE DJIMBI",29,44,204,210,414
SEDHIOU,SEDHIOU,DIENDE,"DIANNAH BA","H1 SINTHIANG ALADJI",1,2,13,15,28
SEDHIOU,SEDHIOU,DIENDE,"DIANNAH BA","SARE SARABOUYA",7,14,115,86,201
SEDHIOU,SEDHIOU,DIENDE,"DIANNAH BA","SARE TOUMANI MANJAQUE",14,22,160,126,286
SEDHIOU,SEDHIOU,DIENDE,"DIANNAH BA","SARE TOUMANI PEULH",3,4,32,24,56
SEDHIOU,SEDHIOU,DIENDE,"DIANNAH BA","SARE YORO SOW",11,15,128,99,227
SEDHIOU,SEDHIOU,DIENDE,"DIANNAH BA","SINTHIANG MAMADOU KONTE",11,18,137,142,279
SEDHIOU,SEDHIOU,DIENDE,"DIANNAH BA","SINTHIANG BONDA",2,4,21,26,47
SEDHIOU,SEDHIOU,DIENDE,"DIANNAH BA","TALTO PAKAO",20,20,125,141,266
SEDHIOU,SEDHIOU,DIENDE,"DIANNAH BA","TOUBACOUTA MANDING",18,33,196,179,375
SEDHIOU,SEDHIOU,DIENDE,"DIANNAH BA","TOUBACOUTA WOLOF",4,8,59,54,113
SEDHIOU,SEDHIOU,DIENDE,"DIANNAH BA","VELINGARA PAKAO",5,7,56,39,95
SEDHIOU,SEDHIOU,DIENDE,"DIANNAH BA","H1 SARE BILALY",5,6,33,26,59
SEDHIOU,SEDHIOU,DIENDE,KOUSSY,ALABATOU,30,31,170,152,322
SEDHIOU,SEDHIOU,DIENDE,KOUSSY,BABIRA,12,16,101,160,261
SEDHIOU,SEDHIOU,DIENDE,KOUSSY,BARI,11,23,244,260,504
SEDHIOU,SEDHIOU,DIENDE,KOUSSY,"H1 NEMA SALOUM",1,1,1,0,1
SEDHIOU,SEDHIOU,DIENDE,KOUSSY,BASSAF,48,67,358,370,728
SEDHIOU,SEDHIOU,DIENDE,KOUSSY,"H1 KOTOBA",5,8,24,29,53
SEDHIOU,SEDHIOU,DIENDE,KOUSSY,"H2 YAMBROUSSYA",1,1,7,9,16
SEDHIOU,SEDHIOU,DIENDE,KOUSSY,"H3 KEREVANE BOUDHIE",2,2,11,9,20
SEDHIOU,SEDHIOU,DIENDE,KOUSSY,"BOUSSOURA UC I",15,15,77,85,162
SEDHIOU,SEDHIOU,DIENDE,KOUSSY,"DASSILANE BOUDHIE",10,29,169,125,294
SEDHIOU,SEDHIOU,DIENDE,KOUSSY,"DASSILANE UC II",21,21,197,113,310
SEDHIOU,SEDHIOU,DIENDE,KOUSSY,"DIATOUMA SOUCOUTOTO",11,11,67,68,135
SEDHIOU,SEDHIOU,DIENDE,KOUSSY,DJIDIMA,26,38,132,138,270
SEDHIOU,SEDHIOU,DIENDE,KOUSSY,HAMDANY,30,44,174,209,383
SEDHIOU,SEDHIOU,DIENDE,KOUSSY,"H1 DAROU HOUDA",9,9,50,47,97
SEDHIOU,SEDHIOU,DIENDE,KOUSSY,"KARANTABA UC I et UC II",11,14,81,69,150
SEDHIOU,SEDHIOU,DIENDE,KOUSSY,"KEUR HABIB (CARREFOUR NDIAYE)",86,98,836,505,1341
SEDHIOU,SEDHIOU,DIENDE,KOUSSY,"KOUSSY I",229,266,1252,1179,2431
SEDHIOU,SEDHIOU,DIENDE,KOUSSY,"KOUSSY II",22,25,130,105,235
SEDHIOU,SEDHIOU,DIENDE,KOUSSY,KOUYNALA,4,4,48,26,74
SEDHIOU,SEDHIOU,DIENDE,KOUSSY,"H1 MENDYCOUNDA",8,8,67,83,150
SEDHIOU,SEDHIOU,DIENDE,KOUSSY,"H2 FOUTACOUNDA",5,5,32,27,59
SEDHIOU,SEDHIOU,DIENDE,KOUSSY,"MISSIRAH UC I",19,21,147,143,290
SEDHIOU,SEDHIOU,DIENDE,KOUSSY,"NEMA UC III",30,33,168,163,331
SEDHIOU,SEDHIOU,DIENDE,KOUSSY,"NIMAYA UC I",50,57,332,319,651
SEDHIOU,SEDHIOU,DIENDE,KOUSSY,NIMZAT,81,81,488,497,985
SEDHIOU,SEDHIOU,DIENDE,KOUSSY,SANKOUYA,23,24,136,103,239
SEDHIOU,SEDHIOU,DIENDE,KOUSSY,SAYANG,9,12,40,44,84
SEDHIOU,SEDHIOU,DIENDE,KOUSSY,"SOUCOUTOTO (SEFA SOUCOUTOTO)",63,63,348,340,688
SEDHIOU,SEDHIOU,DIENDE,KOUSSY,"TAKOUM  PEULH",29,32,109,93,202
SEDHIOU,SEDHIOU,DIENDE,KOUSSY,"H1 TAKOUM MANJACQUE",5,5,44,50,94
SEDHIOU,SEDHIOU,DIENDE,KOUSSY,"H2 FASS TAKOUM",3,3,12,9,21
SEDHIOU,SEDHIOU,DIENDE,KOUSSY,"TALTO BOUDHIE",7,10,70,68,138
SEDHIOU,SEDHIOU,DIENDE,KOUSSY,"H1 TALTO BOURAMA NDIAYE",9,9,37,35,72
SEDHIOU,SEDHIOU,DIENDE,KOUSSY,"H2 TALTO BERINDITE",3,4,10,15,25
SEDHIOU,SEDHIOU,DIENDE,KOUSSY,"KOUSSY III",22,22,59,56,115
SEDHIOU,SEDHIOU,DIENDE,KOUSSY,"H1 KAWSARA",1,1,7,2,9
SEDHIOU,SEDHIOU,DIENDE,KOUSSY,"MEDINA FASS",33,34,245,231,476
SEDHIOU,SEDHIOU,DIENDE,KOUSSY,"MEDINA HABIB SAMAKOUNE",23,24,213,130,343
SEDHIOU,SEDHIOU,DIENDE,OUDOUCAR,BABINAR,9,19,114,122,236
SEDHIOU,SEDHIOU,DIENDE,OUDOUCAR,DATALY,4,8,25,36,61
SEDHIOU,SEDHIOU,DIENDE,OUDOUCAR,DONGHEL,5,9,44,44,88
SEDHIOU,SEDHIOU,DIENDE,OUDOUCAR,"H1 SINTHIANG YOBA",1,1,6,7,13
SEDHIOU,SEDHIOU,DIENDE,OUDOUCAR,MANCONOMBA,142,234,1965,2030,3995
SEDHIOU,SEDHIOU,DIENDE,OUDOUCAR,"H2 SINTHIANG SADIO",1,2,9,16,25
SEDHIOU,SEDHIOU,DIENDE,OUDOUCAR,"MARANDANI I",26,37,306,216,522
SEDHIOU,SEDHIOU,DIENDE,OUDOUCAR,"MARANDANI II",101,242,1138,1153,2291
SEDHIOU,SEDHIOU,DIENDE,OUDOUCAR,OUDOUCAR,60,136,854,888,1742
SEDHIOU,SEDHIOU,DIENDE,OUDOUCAR,"SARE MENDY",4,6,25,21,46
SEDHIOU,SEDHIOU,DIENDE,OUDOUCAR,"SARE PENDA",5,10,64,82,146
SEDHIOU,SEDHIOU,DIENDE,OUDOUCAR,"SARE SEKOU (SINTHIANG SEKOU)",3,5,33,23,56
SEDHIOU,SEDHIOU,DIENDE,OUDOUCAR,SERIMBA,4,8,48,44,92
SEDHIOU,SEDHIOU,DIENDE,OUDOUCAR,"SINTHIANG ALARBA",9,11,78,61,139
SEDHIOU,SEDHIOU,DIENDE,OUDOUCAR,"SINTHIANG SOULOU (SINTHIANG BAKARY)",5,7,39,44,83
SEDHIOU,SEDHIOU,DIENDE,OUDOUCAR,"SINTHIANG TENING",3,6,38,31,69
SEDHIOU,SEDHIOU,DIENDE,OUDOUCAR,"H1 SINTHIANG CAMARA",2,3,14,19,33
SEDHIOU,SEDHIOU,DIENDE,OUDOUCAR,"H2 SINTHIANG OUSEYNOU BALDE",1,2,6,10,16
SEDHIOU,SEDHIOU,DIENDE,OUDOUCAR,"SOUMBOUNDOU PAKAO",81,122,1092,1027,2119
SEDHIOU,SEDHIOU,DIENDE,OUDOUCAR,"H1 MEDINATHOU HANDA",1,1,4,10,14
SEDHIOU,SEDHIOU,DIENDE,OUDOUCAR,"TEMENTO MANJACQUE",5,7,27,33,60
SEDHIOU,SEDHIOU,DIENDE,OUDOUCAR,"TOUBA WILANE",12,15,54,72,126
SEDHIOU,SEDHIOU,DIENDE,"SAMA KANTA PEULH","BOUSSI MBALLO",23,31,154,134,288
SEDHIOU,SEDHIOU,DIENDE,"SAMA KANTA PEULH","MEDINA SARA MBALLO",3,5,35,12,47
SEDHIOU,SEDHIOU,DIENDE,"SAMA KANTA PEULH","SABARI MADIA",5,5,37,33,70
SEDHIOU,SEDHIOU,DIENDE,"SAMA KANTA PEULH","H1 SABARI DIANGO",3,3,17,15,32
SEDHIOU,SEDHIOU,DIENDE,"SAMA KANTA PEULH","H2 SABARI NIMA",6,12,39,40,79
SEDHIOU,SEDHIOU,DIENDE,"SAMA KANTA PEULH","H3 SABARI SADA",1,2,14,11,25
SEDHIOU,SEDHIOU,DIENDE,"SAMA KANTA PEULH","SAME FOULAYEL MANJAQUE",6,11,79,68,147
SEDHIOU,SEDHIOU,DIENDE,"SAMA KANTA PEULH","SAME FOULAYEL PEULH",20,24,165,143,308
SEDHIOU,SEDHIOU,DIENDE,"SAMA KANTA PEULH","SAME KANTA MANJAQUE",4,5,39,34,73
SEDHIOU,SEDHIOU,DIENDE,"SAMA KANTA PEULH","SAME KANTE PEULH",41,65,281,334,615
SEDHIOU,SEDHIOU,DIENDE,"SAMA KANTA PEULH","SARE ABBA",12,25,136,107,243
SEDHIOU,SEDHIOU,DIENDE,"SAMA KANTA PEULH","H1 SINTHIANG THIERNO",11,15,103,104,207
SEDHIOU,SEDHIOU,DIENDE,"SAMA KANTA PEULH","H2 VELINGARA DEMBA",2,2,15,8,23
SEDHIOU,SEDHIOU,DIENDE,"SAMA KANTA PEULH","SARE ALMAMY",15,21,131,132,263
SEDHIOU,SEDHIOU,DIENDE,"SAMA KANTA PEULH","SARE BEYAN",5,6,33,24,57
SEDHIOU,SEDHIOU,DIENDE,"SAMA KANTA PEULH","H1 SINTHIANG CHERIFOU",2,2,11,13,24
SEDHIOU,SEDHIOU,DIENDE,"SAMA KANTA PEULH","SARE DEMBAYEL",5,7,33,28,61
SEDHIOU,SEDHIOU,DIENDE,"SAMA KANTA PEULH","SARE FARING MANJAQUE",6,7,50,49,99
SEDHIOU,SEDHIOU,DIENDE,"SAMA KANTA PEULH","SARE FARING PEULH",13,21,143,121,264
SEDHIOU,SEDHIOU,DIENDE,"SAMA KANTA PEULH","SARE KEITA",4,5,29,26,55
SEDHIOU,SEDHIOU,DIENDE,"SAMA KANTA PEULH","SARE MAMOUDOU",5,7,63,31,94
SEDHIOU,SEDHIOU,DIENDE,"SAMA KANTA PEULH","H1 SARE COLI",3,5,36,21,57
SEDHIOU,SEDHIOU,DIENDE,"SAMA KANTA PEULH","H2 SARE FODE",3,5,19,21,40
SEDHIOU,SEDHIOU,DIENDE,"SAMA KANTA PEULH","SARE NIMA",5,6,25,19,44
SEDHIOU,SEDHIOU,DIENDE,"SAMA KANTA PEULH","SARE PATHE DIAO",16,17,95,92,187
SEDHIOU,SEDHIOU,DIENDE,"SAMA KANTA PEULH","SARE SAMETTA",9,16,80,53,133
SEDHIOU,SEDHIOU,DIENDE,"SAMA KANTA PEULH","H2 SINTHIANG SAMBA OUMOU",2,3,19,10,29
SEDHIOU,SEDHIOU,DIENDE,"SAMA KANTA PEULH","SARE SOUNA MANJAQUE",10,14,84,115,199
SEDHIOU,SEDHIOU,DIENDE,"SAMA KANTA PEULH","SARE SOUNA PEULH",9,14,67,82,149
SEDHIOU,SEDHIOU,DIENDE,"SAMA KANTA PEULH","SARE YORO DIAO",22,31,161,172,333
SEDHIOU,SEDHIOU,DIENDE,"SAMA KANTA PEULH","SINTHIANG NAGUE",7,11,61,51,112
SEDHIOU,SEDHIOU,DIENDE,"DIANNAH MALARY",DOUMASSOU,140,169,734,721,1455
SEDHIOU,SEDHIOU,DIENDE,"DIANNAH MALARY",KEROUANE,43,55,389,392,781
SEDHIOU,SEDHIOU,DIENDE,"DIANNAH MALARY",SANTASSOU,92,109,522,514,1036
SEDHIOU,SEDHIOU,DJIBABOUYA,"BEMET BIDJINI","BEMET BAGHAGHA",12,16,114,101,215
SEDHIOU,SEDHIOU,DJIBABOUYA,"BEMET BIDJINI","BEMET BIDJINI",94,110,1013,885,1898
SEDHIOU,SEDHIOU,DJIBABOUYA,"BEMET BIDJINI","BEMET DIATTACOUNDA",32,37,297,307,604
SEDHIOU,SEDHIOU,DJIBABOUYA,"BEMET BIDJINI","BEMET DJIMANDE",21,24,148,124,272
SEDHIOU,SEDHIOU,DJIBABOUYA,"BEMET BIDJINI","BEMET WOULY",65,72,581,458,1039
SEDHIOU,SEDHIOU,DJIBABOUYA,"BEMET BIDJINI","DIAFAR DOUMA",83,115,856,650,1506
SEDHIOU,SEDHIOU,DJIBABOUYA,"BEMET BIDJINI","H1 MANJACQUE",2,2,13,16,29
SEDHIOU,SEDHIOU,DJIBABOUYA,"BEMET BIDJINI","DIAFAR SANTO",53,77,711,649,1360
SEDHIOU,SEDHIOU,DJIBABOUYA,"BEMET BIDJINI","H1 DOBACIACOUNDA",1,1,11,11,22
SEDHIOU,SEDHIOU,DJIBABOUYA,"BEMET BIDJINI","H2 NDIAMBOURCOUNDA",3,3,27,28,55
SEDHIOU,SEDHIOU,DJIBABOUYA,"BEMET BIDJINI","H3 NDIAYACOUNDA & MENDYCOUNDA",3,4,31,27,58
SEDHIOU,SEDHIOU,DJIBABOUYA,"BEMET BIDJINI","H4 DIAFAR SANTO",6,6,27,26,53
SEDHIOU,SEDHIOU,DJIBABOUYA,"BEMET BIDJINI","DIAO BA",40,57,441,358,799
SEDHIOU,SEDHIOU,DJIBABOUYA,"BEMET BIDJINI","DIAO INSACOUNDA",13,20,143,105,248
SEDHIOU,SEDHIOU,DJIBABOUYA,"BEMET BIDJINI","DIAO SIMACOUNDA",99,115,731,793,1524
SEDHIOU,SEDHIOU,DJIBABOUYA,"BEMET BIDJINI","DIAO SOUCOUTOTO",34,49,273,302,575
SEDHIOU,SEDHIOU,DJIBABOUYA,"BEMET BIDJINI","FRANCOUNDA BAINOUCK",12,17,136,130,266
SEDHIOU,SEDHIOU,DJIBABOUYA,"BEMET BIDJINI","H1 FRANCOUNDA BODIANCOUNDA",20,24,136,142,278
SEDHIOU,SEDHIOU,DJIBABOUYA,"BEMET BIDJINI","FRANCOUNDA DIOLA",39,42,320,355,675
SEDHIOU,SEDHIOU,DJIBABOUYA,"BEMET BIDJINI","FRANCOUNDA SARAKHOLE",50,62,454,448,902
SEDHIOU,SEDHIOU,DJIBABOUYA,"BEMET BIDJINI",NIASSYCOUNDA,7,7,26,26,52
SEDHIOU,SEDHIOU,DJIBABOUYA,"BEMET BIDJINI","SIBICOUROTO I (DJITTE)",29,34,208,161,369
SEDHIOU,SEDHIOU,DJIBABOUYA,"BEMET BIDJINI","H1 HLM",7,7,36,26,62
SEDHIOU,SEDHIOU,DJIBABOUYA,"BEMET BIDJINI","SIBICOUROTO II (CHERIFCOUNDA)",56,62,526,429,955
SEDHIOU,SEDHIOU,DJIBABOUYA,"SAN SAMBA",AMPOUTOUNG,9,9,60,56,116
SEDHIOU,SEDHIOU,DJIBABOUYA,"SAN SAMBA","H1 AMPOUNTOUNG MANJACQUE",2,3,21,13,34
SEDHIOU,SEDHIOU,DJIBABOUYA,"SAN SAMBA",BANTANGNIMA,34,38,207,223,430
SEDHIOU,SEDHIOU,DJIBABOUYA,"SAN SAMBA",BROGHONE,11,11,71,64,135
SEDHIOU,SEDHIOU,DJIBABOUYA,"SAN SAMBA","H1 COLYCOUNDA",22,32,218,196,414
SEDHIOU,SEDHIOU,DJIBABOUYA,"SAN SAMBA",DANDONE,33,41,248,273,521
SEDHIOU,SEDHIOU,DJIBABOUYA,"SAN SAMBA","DAROU DIALALY",12,13,133,115,248
SEDHIOU,SEDHIOU,DJIBABOUYA,"SAN SAMBA","DIAFILON DIOLA",35,47,279,237,516
SEDHIOU,SEDHIOU,DJIBABOUYA,"SAN SAMBA","H1 BOURSOUTOU",7,8,49,45,94
SEDHIOU,SEDHIOU,DJIBABOUYA,"SAN SAMBA","DIAFILON SONKOCOUNDA",57,79,736,801,1537
SEDHIOU,SEDHIOU,DJIBABOUYA,"SAN SAMBA","DIATTANDING COUNDA",38,48,338,345,683
SEDHIOU,SEDHIOU,DJIBABOUYA,"SAN SAMBA",DIOGNERE,67,108,807,762,1569
SEDHIOU,SEDHIOU,DJIBABOUYA,"SAN SAMBA","H1 DIOGNERE TAMBACOUNDA",15,19,137,125,262
SEDHIOU,SEDHIOU,DJIBABOUYA,"SAN SAMBA",KAMBOUNDA,59,70,410,480,890
SEDHIOU,SEDHIOU,DJIBABOUYA,"SAN SAMBA","H1 KAMBOUNDA DIOLA",11,14,103,94,197
SEDHIOU,SEDHIOU,DJIBABOUYA,"SAN SAMBA","H2 KAMBOUNDA MANJACQUE",14,14,80,68,148
SEDHIOU,SEDHIOU,DJIBABOUYA,"SAN SAMBA","H3 BISSARI",3,3,21,24,45
SEDHIOU,SEDHIOU,DJIBABOUYA,"SAN SAMBA",KAMOYA,29,48,253,228,481
SEDHIOU,SEDHIOU,DJIBABOUYA,"SAN SAMBA","H1 KANDODIA",2,3,13,9,22
SEDHIOU,SEDHIOU,DJIBABOUYA,"SAN SAMBA","H2 BOLONG BALLO",2,2,12,13,25
SEDHIOU,SEDHIOU,DJIBABOUYA,"SAN SAMBA","H3 WASSADOU",14,16,109,70,179
SEDHIOU,SEDHIOU,DJIBABOUYA,"SAN SAMBA","H4 BADJICOUNDA",31,39,217,220,437
SEDHIOU,SEDHIOU,DJIBABOUYA,"SAN SAMBA","H5 FECAPS (FROMAGERIE)",1,1,12,10,22
SEDHIOU,SEDHIOU,DJIBABOUYA,"SAN SAMBA","H6 NEMA",2,2,11,14,25
SEDHIOU,SEDHIOU,DJIBABOUYA,"SAN SAMBA","KARANTABA (KARANTABACOUTA)",16,21,185,114,299
SEDHIOU,SEDHIOU,DJIBABOUYA,"SAN SAMBA","KIKIYAKO I",3,5,24,27,51
SEDHIOU,SEDHIOU,DJIBABOUYA,"SAN SAMBA","H1 KIKIYAKO II",14,16,102,65,167
SEDHIOU,SEDHIOU,DJIBABOUYA,"SAN SAMBA",KOOLING,31,36,283,259,542
SEDHIOU,SEDHIOU,DJIBABOUYA,"SAN SAMBA","NEMA DIAOUR",22,31,217,253,470
SEDHIOU,SEDHIOU,DJIBABOUYA,"SAN SAMBA",NIADIENE,22,27,160,150,310
SEDHIOU,SEDHIOU,DJIBABOUYA,"SAN SAMBA","NIASSENE DIOLA",94,105,596,589,1185
SEDHIOU,SEDHIOU,DJIBABOUYA,"SAN SAMBA","NIASSENE MANDINGUE",49,61,488,403,891
SEDHIOU,SEDHIOU,DJIBABOUYA,"SAN SAMBA","H1 KABEUMB",9,13,59,59,118
SEDHIOU,SEDHIOU,DJIBABOUYA,"SAN SAMBA","H2 KAMBILAMBA",17,18,133,114,247
SEDHIOU,SEDHIOU,DJIBABOUYA,"SAN SAMBA","H4 DIALICOUNDA",3,5,54,30,84
SEDHIOU,SEDHIOU,DJIBABOUYA,"SAN SAMBA","SAMACOUNG I",26,44,398,367,765
SEDHIOU,SEDHIOU,DJIBABOUYA,"SAN SAMBA","SAMAKOUNG II (BATINCOUNDA)",12,20,122,122,244
SEDHIOU,SEDHIOU,DJIBABOUYA,"SAN SAMBA",SANSAMBA,119,142,888,850,1738
SEDHIOU,SEDHIOU,DJIBABOUYA,"SAN SAMBA","H1 SANSAMBA MANJAQUE",5,6,40,35,75
SEDHIOU,SEDHIOU,DJIBABOUYA,"SAN SAMBA","H2 SANSAMBA MANJACQUE",5,5,32,24,56
SEDHIOU,SEDHIOU,DJIBABOUYA,"SAN SAMBA",TABALY,14,24,148,166,314
SEDHIOU,SEDHIOU,DJIBABOUYA,"SAN SAMBA","TAMBANA (DIASSING TAMBANA)",37,48,349,352,701
SEDHIOU,SEDHIOU,DJIBABOUYA,"SAN SAMBA","YACINE MANDINA (DIASSING MANDINA)",62,68,427,381,808
SEDHIOU,SEDHIOU,DJIBABOUYA,DJIBABOUYA,DJIBABOUYA,184,231,2040,1880,3920
SEDHIOU,SEDHIOU,DJIBABOUYA,DJIBABOUYA,"H1 SELOTO",4,5,33,36,69
SEDHIOU,SEDHIOU,DJIBABOUYA,DJIBABOUYA,"KOUNOUNDING DIOYE",15,20,77,79,156
SEDHIOU,SEDHIOU,DJIBABOUYA,DJIBABOUYA,MARAKISSA,76,89,620,445,1065
SEDHIOU,SEDHIOU,DJIBABOUYA,DJIBABOUYA,"H1 TAMBACOUNDA",14,16,228,121,349
SEDHIOU,SEDHIOU,DJIBABOUYA,DJIBABOUYA,"MARSASSOUM SANTO",63,76,546,578,1124
SEDHIOU,SEDHIOU,DJIBABOUYA,DJIBABOUYA,"H1 BOUGNERY",17,18,86,76,162
SEDHIOU,SEDHIOU,DJIREDJI,BAMBALY,BADIARY,42,59,561,395,956
SEDHIOU,SEDHIOU,DJIREDJI,BAMBALY,BADJIMOR,5,7,27,22,49
SEDHIOU,SEDHIOU,DJIREDJI,BAMBALY,BAGADADJI,15,17,131,142,273
SEDHIOU,SEDHIOU,DJIREDJI,BAMBALY,BAMACOUNDA,32,43,285,270,555
SEDHIOU,SEDHIOU,DJIREDJI,BAMBALY,"H1 DAROU HOUDA",11,11,58,49,107
SEDHIOU,SEDHIOU,DJIREDJI,BAMBALY,"H2  SOBEYACOUNDA",1,2,219,20,239
SEDHIOU,SEDHIOU,DJIREDJI,BAMBALY,BAMBALY,141,195,1312,1297,2609
SEDHIOU,SEDHIOU,DJIREDJI,BAMBALY,"BOUDHIE SAMINE",66,121,694,663,1357
SEDHIOU,SEDHIOU,DJIREDJI,BAMBALY,"H1 YANKACOUNDA",12,35,126,116,242
SEDHIOU,SEDHIOU,DJIREDJI,BAMBALY,"H2 BOUGOUBO",10,59,182,162,344
SEDHIOU,SEDHIOU,DJIREDJI,BAMBALY,"BOUDHIE SONAKO",4,7,38,32,70
SEDHIOU,SEDHIOU,DJIREDJI,BAMBALY,"BOUDHIEMAR MANDINGUE",56,62,384,363,747
SEDHIOU,SEDHIOU,DJIREDJI,BAMBALY,"BOUDHIEMAR PEULH",17,20,94,122,216
SEDHIOU,SEDHIOU,DJIREDJI,BAMBALY,"BOUNKILING DIOLA",11,13,78,60,138
SEDHIOU,SEDHIOU,DJIREDJI,BAMBALY,BOUNO,65,81,960,891,1851
SEDHIOU,SEDHIOU,DJIREDJI,BAMBALY,"BOUNO MANJACQUE",2,8,77,84,161
SEDHIOU,SEDHIOU,DJIREDJI,BAMBALY,DIAMBANCOUNDA,20,23,242,183,425
SEDHIOU,SEDHIOU,DJIREDJI,BAMBALY,FRANCOUNDA,44,92,713,564,1277
SEDHIOU,SEDHIOU,DJIREDJI,BAMBALY,KANIKO,2,10,90,106,196
SEDHIOU,SEDHIOU,DJIREDJI,BAMBALY,KAPOL,11,12,75,47,122
SEDHIOU,SEDHIOU,DJIREDJI,BAMBALY,"KARANTABA NANI",49,66,728,644,1372
SEDHIOU,SEDHIOU,DJIREDJI,BAMBALY,"KARANTABA NANI MANJAQUE",2,7,88,86,174
SEDHIOU,SEDHIOU,DJIREDJI,BAMBALY,KAWARANCOUNDA,4,5,59,50,109
SEDHIOU,SEDHIOU,DJIREDJI,BAMBALY,KODJI,15,19,140,124,264
SEDHIOU,SEDHIOU,DJIREDJI,BAMBALY,KOUNTOUBOU,18,21,134,118,252
SEDHIOU,SEDHIOU,DJIREDJI,BAMBALY,"MADINA BOURAMA MANE",11,14,89,90,179
SEDHIOU,SEDHIOU,DJIREDJI,BAMBALY,MALIFARA,18,25,169,107,276
SEDHIOU,SEDHIOU,DJIREDJI,BAMBALY,MARONCOUNDA,27,37,316,366,682
SEDHIOU,SEDHIOU,DJIREDJI,BAMBALY,"MARONCOUNDA MANCAGNE",5,5,22,21,43
SEDHIOU,SEDHIOU,DJIREDJI,BAMBALY,"MISSIRAH KARANTABA NANI",29,49,321,261,582
SEDHIOU,SEDHIOU,DJIREDJI,BAMBALY,NGUINDIR,73,112,728,665,1393
SEDHIOU,SEDHIOU,DJIREDJI,BAMBALY,"H1 FOGNODING",10,11,68,43,111
SEDHIOU,SEDHIOU,DJIREDJI,BAMBALY,SORANCE,29,48,278,212,490
SEDHIOU,SEDHIOU,DJIREDJI,BAMBALY,"H1 DIAMBANCOUNDA",11,13,108,77,185
SEDHIOU,SEDHIOU,DJIREDJI,BAMBALY,"H2 SINKOUNDING",4,4,24,24,48
SEDHIOU,SEDHIOU,DJIREDJI,BAMBALY,"H3 NEMA TABA",14,15,89,98,187
SEDHIOU,SEDHIOU,DJIREDJI,BAMBALY,TAMBANADING,12,14,79,81,160
SEDHIOU,SEDHIOU,DJIREDJI,BAMBALY,TAMBANABA,42,50,401,431,832
SEDHIOU,SEDHIOU,DJIREDJI,BAMBALY,"TENDABA KINDAKAM",44,76,523,528,1051
SEDHIOU,SEDHIOU,DJIREDJI,BAMBALY,TERENOU,9,13,56,44,100
SEDHIOU,SEDHIOU,DJIREDJI,DJIREDJI,"BADJICOUNDA BAYNOUCK",18,27,184,177,361
SEDHIOU,SEDHIOU,DJIREDJI,DJIREDJI,"BADJICOUNDA MANJACQUE",15,17,62,85,147
SEDHIOU,SEDHIOU,DJIREDJI,DJIREDJI,BALMADOU,29,42,302,269,571
SEDHIOU,SEDHIOU,DJIREDJI,DJIREDJI,"H1 BALMADOU FAROBACO",11,11,58,72,130
SEDHIOU,SEDHIOU,DJIREDJI,DJIREDJI,"H2 DIOUSSECOUNDA",2,2,27,23,50
SEDHIOU,SEDHIOU,DJIREDJI,DJIREDJI,BERETO,11,16,102,103,205
SEDHIOU,SEDHIOU,DJIREDJI,DJIREDJI,"BONA MANJACQUE",36,36,204,233,437
SEDHIOU,SEDHIOU,DJIREDJI,DJIREDJI,"BOUMOUDA SOUCOTO",54,97,747,619,1366
SEDHIOU,SEDHIOU,DJIREDJI,DJIREDJI,"H1 KANKHINDAN",5,5,37,46,83
SEDHIOU,SEDHIOU,DJIREDJI,DJIREDJI,"BOUMOUDA SOUCOUTOTO",32,54,320,277,597
SEDHIOU,SEDHIOU,DJIREDJI,DJIREDJI,"H1 KONCOTO",3,3,25,16,41
SEDHIOU,SEDHIOU,DJIREDJI,DJIREDJI,DAKABANTANG,80,118,640,664,1304
SEDHIOU,SEDHIOU,DJIREDJI,DJIREDJI,DIAGNONDING,21,31,310,344,654
SEDHIOU,SEDHIOU,DJIREDJI,DJIREDJI,"DJIREDJI (DJIREDJI SOUCOUTO)",152,208,1271,1154,2425
SEDHIOU,SEDHIOU,DJIREDJI,DJIREDJI,"H1 FATIHA",6,6,47,42,89
SEDHIOU,SEDHIOU,DJIREDJI,DJIREDJI,"DJIREDJI SOUCOUTOTO",32,34,238,225,463
SEDHIOU,SEDHIOU,DJIREDJI,DJIREDJI,"HAMDALAYE (KAKENE)",5,6,37,25,62
SEDHIOU,SEDHIOU,DJIREDJI,DJIREDJI,"KARANTABA LINKETO",30,71,443,440,883
SEDHIOU,SEDHIOU,DJIREDJI,DJIREDJI,"H1 KARANTABA MANJACQUE",7,8,36,44,80
SEDHIOU,SEDHIOU,DJIREDJI,DJIREDJI,KINTHINKOUROU,44,67,296,314,610
SEDHIOU,SEDHIOU,DJIREDJI,DJIREDJI,"KOCOUMBA DIOLA",26,29,179,140,319
SEDHIOU,SEDHIOU,DJIREDJI,DJIREDJI,"MADINA AIDARA (BADOLY)",22,25,126,127,253
SEDHIOU,SEDHIOU,DJIREDJI,DJIREDJI,"MADINA EL HADJI SOUANE",45,54,1486,553,2039
SEDHIOU,SEDHIOU,DJIREDJI,DJIREDJI,"MADINA LINKETO",36,51,539,442,981
SEDHIOU,SEDHIOU,DJIREDJI,DJIREDJI,"H1 BONA LINKETO",3,4,38,44,82
SEDHIOU,SEDHIOU,DJIREDJI,DJIREDJI,MANECOUNDA,23,45,264,234,498
SEDHIOU,SEDHIOU,DJIREDJI,DJIREDJI,"MISSIRAH LINKETO",11,12,103,112,215
SEDHIOU,SEDHIOU,DJIREDJI,DJIREDJI,SAME,25,27,190,158,348
SEDHIOU,SEDHIOU,DJIREDJI,DJIREDJI,SANKANDJI,5,6,38,40,78
SEDHIOU,SEDHIOU,DJIREDJI,DJIREDJI,SANTANKOUROTO,14,15,56,67,123
SEDHIOU,SEDHIOU,DJIREDJI,DJIREDJI,SINDINA,69,109,926,853,1779
SEDHIOU,SEDHIOU,DJIREDJI,DJIREDJI,"KOCOUMB DABOYA",15,16,103,103,206
SEDHIOU,SEDHIOU,DJIREDJI,DJIREDJI,"SINGHERE BAYNOUCK",28,34,264,257,521
SEDHIOU,SEDHIOU,DJIREDJI,DJIREDJI,"SINGHERE MANDING",49,65,614,524,1138
SEDHIOU,SEDHIOU,DJIREDJI,DJIREDJI,"TAIFA LINKETO",11,14,78,81,159
SEDHIOU,SEDHIOU,DJIREDJI,DJIREDJI,"H1 TAIFA MANJACQUE",2,2,14,17,31
SEDHIOU,SEDHIOU,DJIREDJI,DJIREDJI,"TEMENTO (DJIREDJI SOUCOUTO MANJAQUE)",15,21,127,165,292
SEDHIOU,SEDHIOU,DJIREDJI,DJIREDJI,"THINGTINGKOME DIOLA",68,84,656,669,1325
SEDHIOU,SEDHIOU,DJIREDJI,DJIREDJI,"THINGTINGKOME MANJAQUE",18,19,82,110,192
SEDHIOU,SEDHIOU,DJIREDJI,DJIREDJI,"TOUBA MANDINGUE",56,86,677,614,1291
SEDHIOU,SEDHIOU,DJIREDJI,DJIREDJI,"TOUBA MANJAQUE",13,13,87,94,181
SEDHIOU,SEDHIOU,DJIREDJI,DJIREDJI,WOYOTO,16,22,159,178,337
SEDHIOU,BOUNKILING,BOUNKILING,BOUNKILING,BOULOUF,117,163,610,605,1215
SEDHIOU,BOUNKILING,BOUNKILING,BOUNKILING,"GRAND DAKAR",188,236,1093,1155,2248
SEDHIOU,BOUNKILING,BOUNKILING,BOUNKILING,KEGNETO,85,110,764,787,1551
SEDHIOU,BOUNKILING,BOUNKILING,BOUNKILING,KOUADI,16,24,120,147,267
SEDHIOU,BOUNKILING,BOUNKILING,BOUNKILING,MANSACOUNDA,88,105,671,537,1208
SEDHIOU,BOUNKILING,BOUNKILING,BOUNKILING,SOLLYCOUNDA,88,158,710,708,1418
SEDHIOU,BOUNKILING,BOUNKILING,BOUNKILING,SOUBACONO,95,127,1058,1004,2062
SEDHIOU,BOUNKILING,BOGHAL,BOGHAL,"BADINDING DOULO",24,33,184,188,372
SEDHIOU,BOUNKILING,BOGHAL,BOGHAL,BANEBA,34,44,288,332,620
SEDHIOU,BOUNKILING,BOGHAL,BOGHAL,"BOGHAL (FOLOLO ISMAILA)",143,157,778,713,1491
SEDHIOU,BOUNKILING,BOGHAL,BOGHAL,BOUFARAGHOR,35,47,258,281,539
SEDHIOU,BOUNKILING,BOGHAL,BOGHAL,"BOUGNA SAMBA DIALLO",7,10,62,63,125
SEDHIOU,BOUNKILING,BOGHAL,BOGHAL,"BOUGNA SEYDOU",7,8,38,49,87
SEDHIOU,BOUNKILING,BOGHAL,BOGHAL,BOUNDIANTO,26,31,186,179,365
SEDHIOU,BOUNKILING,BOGHAL,BOGHAL,COLYCOUNDA,12,12,62,71,133
SEDHIOU,BOUNKILING,BOGHAL,BOGHAL,"DAR SALAM FODE DIALLO",13,17,90,90,180
SEDHIOU,BOUNKILING,BOGHAL,BOGHAL,"DAROU BAIDAR",67,71,387,380,767
SEDHIOU,BOUNKILING,BOGHAL,BOGHAL,"DAROU SALAM",8,9,100,60,160
SEDHIOU,BOUNKILING,BOGHAL,BOGHAL,"DIAMWELLI SAMBA BA",27,47,209,208,417
SEDHIOU,BOUNKILING,BOGHAL,BOGHAL,DJINANI,9,10,67,59,126
SEDHIOU,BOUNKILING,BOGHAL,BOGHAL,"FOLOLO BIRANE",24,25,133,130,263
SEDHIOU,BOUNKILING,BOGHAL,BOGHAL,FOROYA,11,11,76,45,121
SEDHIOU,BOUNKILING,BOGHAL,BOGHAL,IRASSOLY,55,79,544,556,1100
SEDHIOU,BOUNKILING,BOGHAL,BOGHAL,KOUTOUNTA,56,58,256,277,533
SEDHIOU,BOUNKILING,BOGHAL,BOGHAL,"MADINA GUELEL",16,18,111,108,219
SEDHIOU,BOUNKILING,BOGHAL,BOGHAL,"MADINA MODY LOUM",47,64,408,325,733
SEDHIOU,BOUNKILING,BOGHAL,BOGHAL,"MADINA TAIBATOU",41,51,409,361,770
SEDHIOU,BOUNKILING,BOGHAL,BOGHAL,"H1 BANDIAGARA",7,13,63,61,124
SEDHIOU,BOUNKILING,BOGHAL,BOGHAL,"MEDINA ABDOULAH",10,10,56,60,116
SEDHIOU,BOUNKILING,BOGHAL,BOGHAL,"MEDINA ALPHA",4,8,61,48,109
SEDHIOU,BOUNKILING,BOGHAL,BOGHAL,NDIOLOFENE,69,98,557,598,1155
SEDHIOU,BOUNKILING,BOGHAL,BOGHAL,"H1 DAROU SALAM",36,43,219,186,405
SEDHIOU,BOUNKILING,BOGHAL,BOGHAL,NIAFOUGNE,26,33,206,187,393
SEDHIOU,BOUNKILING,BOGHAL,BOGHAL,RIATH,63,73,560,529,1089
SEDHIOU,BOUNKILING,BOGHAL,BOGHAL,"SARE ALKALY",126,163,705,635,1340
SEDHIOU,BOUNKILING,BOGHAL,BOGHAL,"SARE BABOU",16,20,117,123,240
SEDHIOU,BOUNKILING,BOGHAL,BOGHAL,"SARE DEMBA NDIADOU",41,43,235,252,487
SEDHIOU,BOUNKILING,BOGHAL,BOGHAL,"SARE MODY KA (BOUSSANKILING)",17,20,132,133,265
SEDHIOU,BOUNKILING,BOGHAL,BOGHAL,"SARE NDIAGA",31,39,292,299,591
SEDHIOU,BOUNKILING,BOGHAL,BOGHAL,"SARE SEYDI DIALLO",21,25,170,156,326
SEDHIOU,BOUNKILING,BOGHAL,BOGHAL,"SARE SIDI",42,49,286,205,491
SEDHIOU,BOUNKILING,BOGHAL,BOGHAL,"H1 MEDINA NDIOBENE",5,6,27,34,61
SEDHIOU,BOUNKILING,BOGHAL,BOGHAL,"SENO SENEGAL (SENOBA)",74,95,525,662,1187
SEDHIOU,BOUNKILING,BOGHAL,BOGHAL,"HI SARE DEMBA GOUMBAYA (SALL COUNDA)",15,16,73,81,154
SEDHIOU,BOUNKILING,BOGHAL,BOGHAL,"SINTHIOU BISMILAH",1,1,10,5,15
SEDHIOU,BOUNKILING,BOGHAL,BOGHAL,"SINTHIOU MBAYE SARR",61,96,321,296,617
SEDHIOU,BOUNKILING,BOGHAL,BOGHAL,"THIEWEL HABIB COLY",8,9,54,65,119
SEDHIOU,BOUNKILING,BOGHAL,BOGHAL,VELINGARA,11,11,77,67,144
SEDHIOU,BOUNKILING,BOGHAL,BOGHAL,"VELINGARA SAMBA DIAO",4,6,20,34,54
SEDHIOU,BOUNKILING,BOGHAL,BOGHAL,YARADIOULA,13,14,103,94,197
SEDHIOU,BOUNKILING,BOGHAL,BOGHAL,"HAMDALAYE (SARE ELIMANE)",32,38,277,307,584
SEDHIOU,BOUNKILING,BOGHAL,BOGHAL,"MEDINA BABA",13,15,90,87,177
SEDHIOU,BOUNKILING,BOGHAL,TANKON,BADIANDOU,26,44,263,241,504
SEDHIOU,BOUNKILING,BOGHAL,TANKON,BAMBADALA,109,171,1245,1120,2365
SEDHIOU,BOUNKILING,BOGHAL,TANKON,BARTO,16,20,109,138,247
SEDHIOU,BOUNKILING,BOGHAL,TANKON,"H1 SARE THIERNO",9,12,55,67,122
SEDHIOU,BOUNKILING,BOGHAL,TANKON,BERDALA,18,29,150,124,274
SEDHIOU,BOUNKILING,BOGHAL,TANKON,"BOUSSANKILING LAMINE DIALLO",18,32,151,142,293
SEDHIOU,BOUNKILING,BOGHAL,TANKON,"BOUSSANKILING THIABA DIOP",10,13,76,77,153
SEDHIOU,BOUNKILING,BOGHAL,TANKON,"DAROU KHOUDOSS",16,20,151,133,284
SEDHIOU,BOUNKILING,BOGHAL,TANKON,"DAROU SALAM MADY MBAYE",100,130,958,962,1920
SEDHIOU,BOUNKILING,BOGHAL,TANKON,DIAGANTE,46,66,468,403,871
SEDHIOU,BOUNKILING,BOGHAL,TANKON,DIAHIDINA,40,51,414,204,618
SEDHIOU,BOUNKILING,BOGHAL,TANKON,"H1 MEDINA SAMBA BA",7,7,26,25,51
SEDHIOU,BOUNKILING,BOGHAL,TANKON,DONGHORO,47,61,318,375,693
SEDHIOU,BOUNKILING,BOGHAL,TANKON,"SARE BABOU DIOP",25,28,184,153,337
SEDHIOU,BOUNKILING,BOGHAL,TANKON,"GORIA SAMBA NDAO",45,55,259,274,533
SEDHIOU,BOUNKILING,BOGHAL,TANKON,GOUMBAMBA,9,12,94,87,181
SEDHIOU,BOUNKILING,BOGHAL,TANKON,"GOUTOU DEMBA BA",19,26,262,147,409
SEDHIOU,BOUNKILING,BOGHAL,TANKON,"GOUTOU DEMBA DIOP",30,33,184,185,369
SEDHIOU,BOUNKILING,BOGHAL,TANKON,"GOUTOU SAMBA DIALLO",18,20,157,141,298
SEDHIOU,BOUNKILING,BOGHAL,TANKON,"HAMDALAYE BARRY",15,17,136,149,285
SEDHIOU,BOUNKILING,BOGHAL,TANKON,"KOEL MOUNKOUTALLA",43,77,576,518,1094
SEDHIOU,BOUNKILING,BOGHAL,TANKON,"H1 SENO BOBORE",8,12,78,71,149
SEDHIOU,BOUNKILING,BOGHAL,TANKON,KOUNKOUSSOU,20,23,243,167,410
SEDHIOU,BOUNKILING,BOGHAL,TANKON,"LYCOUNDA (SARE YAYA)",14,21,125,112,237
SEDHIOU,BOUNKILING,BOGHAL,TANKON,"SARE BIRANE",12,13,91,83,174
SEDHIOU,BOUNKILING,BOGHAL,TANKON,"MEDINA FASS",34,46,368,341,709
SEDHIOU,BOUNKILING,BOGHAL,TANKON,"MEDINA FASS GUEDJI",34,49,397,308,705
SEDHIOU,BOUNKILING,BOGHAL,TANKON,"MEDINA HANECOUNDA",15,23,157,127,284
SEDHIOU,BOUNKILING,BOGHAL,TANKON,"MEDINA KEBA",8,10,49,41,90
SEDHIOU,BOUNKILING,BOGHAL,TANKON,"MEDINA KOEL",11,11,81,57,138
SEDHIOU,BOUNKILING,BOGHAL,TANKON,"MEDINA MOUSTAPHA",19,25,202,218,420
SEDHIOU,BOUNKILING,BOGHAL,TANKON,"MEDINA SALAM",36,39,284,272,556
SEDHIOU,BOUNKILING,BOGHAL,TANKON,"MEDINA SIMBARA",28,34,278,258,536
SEDHIOU,BOUNKILING,BOGHAL,TANKON,"MEDINA WILAYA",44,54,288,297,585
SEDHIOU,BOUNKILING,BOGHAL,TANKON,"H1 SINTHIOU SOULEYE",27,29,220,183,403
SEDHIOU,BOUNKILING,BOGHAL,TANKON,"SACITA FARYMBOURE",79,111,739,601,1340
SEDHIOU,BOUNKILING,BOGHAL,TANKON,SAMOURA,28,32,199,187,386
SEDHIOU,BOUNKILING,BOGHAL,TANKON,FARAGNIMA,20,21,144,145,289
SEDHIOU,BOUNKILING,BOGHAL,TANKON,"SARE GUELEL BA",53,67,718,674,1392
SEDHIOU,BOUNKILING,BOGHAL,TANKON,"SARE HAMA SAMBA I",53,71,343,318,661
SEDHIOU,BOUNKILING,BOGHAL,TANKON,"SARE HAMA SAMBA II",77,107,815,761,1576
SEDHIOU,BOUNKILING,BOGHAL,TANKON,"SARE HAMETH DIALLO",48,80,389,322,711
SEDHIOU,BOUNKILING,BOGHAL,TANKON,"SARE MAMADY DIALLO",43,77,434,400,834
SEDHIOU,BOUNKILING,BOGHAL,TANKON,"H1 SARE CAPITAINE",19,19,111,96,207
SEDHIOU,BOUNKILING,BOGHAL,TANKON,"SARE NGAGNE (SINTHIOU NGAGNE)",3,6,33,32,65
SEDHIOU,BOUNKILING,BOGHAL,TANKON,"SARE PATHE SAGNA",56,73,511,549,1060
SEDHIOU,BOUNKILING,BOGHAL,TANKON,"SARE SADIANG",24,29,199,198,397
SEDHIOU,BOUNKILING,BOGHAL,TANKON,"SARE SAMBA OUNTTARE",23,25,336,163,499
SEDHIOU,BOUNKILING,BOGHAL,TANKON,"SATEME KAWSARA",20,20,139,116,255
SEDHIOU,BOUNKILING,BOGHAL,TANKON,"SINTHIOU ALASSANE",7,11,45,60,105
SEDHIOU,BOUNKILING,BOGHAL,TANKON,"SINTHIOU TANKOU",21,34,239,271,510
SEDHIOU,BOUNKILING,BOGHAL,TANKON,"TAIBA TOURE",37,41,236,230,466
SEDHIOU,BOUNKILING,BOGHAL,TANKON,TANKON,173,263,1825,1707,3532
SEDHIOU,BOUNKILING,BOGHAL,TANKON,"MEDINA TAWFEKH",18,22,106,114,220
SEDHIOU,BOUNKILING,BOGHAL,TANKON,"H1 MEDINA SAGNA",16,19,137,112,249
SEDHIOU,BOUNKILING,BOGHAL,TANKON,"H2  DAROU AFFIA",5,5,44,24,68
SEDHIOU,BOUNKILING,BOGHAL,TANKON,"THIEWEL BIRANE DIALLO",31,39,263,230,493
SEDHIOU,BOUNKILING,BOGHAL,TANKON,"TOUBA NGOUGOUREME",13,14,83,64,147
SEDHIOU,BOUNKILING,BOGHAL,TANKON,"TOUBA SASMAG",25,27,148,128,276
SEDHIOU,BOUNKILING,BOGHAL,TANKON,"H1 SATEME CASAMANCE",45,50,391,321,712
SEDHIOU,BOUNKILING,BOGHAL,TANKON,"TOUBA SATEME",2,4,22,18,40
SEDHIOU,BOUNKILING,BOGHAL,TANKON,"TOUBA SAWAYE",22,31,230,228,458
SEDHIOU,BOUNKILING,BOGHAL,TANKON,"TOUBA SERERE",8,11,61,43,104
SEDHIOU,BOUNKILING,BOGHAL,DJINANY,BADIOCOUNDA,15,38,112,135,247
SEDHIOU,BOUNKILING,BOGHAL,DJINANY,"BADOUMBA AHMET BARRY",17,32,267,156,423
SEDHIOU,BOUNKILING,BOGHAL,DJINANY,"BADOUMBA DIOUKA",15,25,255,218,473
SEDHIOU,BOUNKILING,BOGHAL,DJINANY,"BADOUMBA MAMADOU",15,27,134,104,238
SEDHIOU,BOUNKILING,BOGHAL,DJINANY,DIAKHANDI,19,22,98,91,189
SEDHIOU,BOUNKILING,BOGHAL,DJINANY,"DIAOUNAR GORGUI",6,9,58,37,95
SEDHIOU,BOUNKILING,BOGHAL,DJINANY,"DIAOUNAR SADIO",5,13,41,30,71
SEDHIOU,BOUNKILING,BOGHAL,DJINANY,DJINANY,48,54,326,247,573
SEDHIOU,BOUNKILING,BOGHAL,DJINANY,"GASSIKON MANDINGUE",22,34,240,240,480
SEDHIOU,BOUNKILING,BOGHAL,DJINANY,"GASSIKON PEULH",4,4,31,37,68
SEDHIOU,BOUNKILING,BOGHAL,DJINANY,KAMBALEBA,18,30,132,131,263
SEDHIOU,BOUNKILING,BOGHAL,DJINANY,"H1 KANTINKO",4,15,62,44,106
SEDHIOU,BOUNKILING,BOGHAL,DJINANY,KEREVANE,16,26,89,92,181
SEDHIOU,BOUNKILING,BOGHAL,DJINANY,MANSABANG,36,62,336,319,655
SEDHIOU,BOUNKILING,BOGHAL,DJINANY,SANDIAL,10,14,68,49,117
SEDHIOU,BOUNKILING,BOGHAL,DJINANY,"SARE DEMBA",5,9,48,40,88
SEDHIOU,BOUNKILING,BOGHAL,DJINANY,"SARE DIAYE",8,15,80,66,146
SEDHIOU,BOUNKILING,BOGHAL,DJINANY,"SARE DOULO",7,25,85,80,165
SEDHIOU,BOUNKILING,BOGHAL,DJINANY,"SARE YORO MBALLO",8,9,71,54,125
SEDHIOU,BOUNKILING,BOGHAL,DJINANY,"SINTHIOU ISMAILA",2,2,7,2,9
SEDHIOU,BOUNKILING,BOGHAL,DJINANY,TIVAOUANE,9,14,48,48,96
SEDHIOU,BOUNKILING,BOGHAL,NDIAMALATHIEL,BOUDOUCK,113,113,602,670,1272
SEDHIOU,BOUNKILING,BOGHAL,NDIAMALATHIEL,"H1 SARE DEMBA NIANIOKHO",11,12,35,35,70
SEDHIOU,BOUNKILING,BOGHAL,NDIAMALATHIEL,"BOUDOUCK (BALANTA COUNDA)",9,9,46,41,87
SEDHIOU,BOUNKILING,BOGHAL,NDIAMALATHIEL,"BOUDOUCK(GRAND BOUDOUCK)",161,168,735,771,1506
SEDHIOU,BOUNKILING,BOGHAL,NDIAMALATHIEL,"BOUDOUCK ARAFAT",70,72,343,362,705
SEDHIOU,BOUNKILING,BOGHAL,NDIAMALATHIEL,"BOUDOUCK BADJILO",80,80,453,425,878
SEDHIOU,BOUNKILING,BOGHAL,NDIAMALATHIEL,"BOUDOUCK  BANEBA",56,58,276,286,562
SEDHIOU,BOUNKILING,BOGHAL,NDIAMALATHIEL,"BOUDOUCK GUENTE",47,50,254,222,476
SEDHIOU,BOUNKILING,BOGHAL,NDIAMALATHIEL,"BOUDOUCK POYA",22,24,117,97,214
SEDHIOU,BOUNKILING,BOGHAL,NDIAMALATHIEL,"BOUDOUCK SARE FODE",87,96,469,476,945
SEDHIOU,BOUNKILING,BOGHAL,NDIAMALATHIEL,"DATOR ALPHA MAMADI",94,116,555,630,1185
SEDHIOU,BOUNKILING,BOGHAL,NDIAMALATHIEL,"DIARRABOUGOU (SARE TOURKA)",1,2,8,6,14
SEDHIOU,BOUNKILING,BOGHAL,NDIAMALATHIEL,"DIATOR COUTA (SARE SENY)",26,32,134,132,266
SEDHIOU,BOUNKILING,BOGHAL,NDIAMALATHIEL,"DIOPCOUNDA (NDJIRMEW)",31,46,234,239,473
SEDHIOU,BOUNKILING,BOGHAL,NDIAMALATHIEL,KANDEMBA,19,19,114,79,193
SEDHIOU,BOUNKILING,BOGHAL,NDIAMALATHIEL,KANICOUNDA,50,73,516,405,921
SEDHIOU,BOUNKILING,BOGHAL,NDIAMALATHIEL,KOBOEL,82,122,566,656,1222
SEDHIOU,BOUNKILING,BOGHAL,NDIAMALATHIEL,"MEDINA FRANCE (MADINA ALPHA)",62,77,410,456,866
SEDHIOU,BOUNKILING,BOGHAL,NDIAMALATHIEL,"MISSIRA KABADA (DIALLOCOUNDA)",56,79,395,397,792
SEDHIOU,BOUNKILING,BOGHAL,NDIAMALATHIEL,NDIAMALATHIEL,135,215,1371,1391,2762
SEDHIOU,BOUNKILING,BOGHAL,NDIAMALATHIEL,"NGADIARY BA",46,55,248,201,449
SEDHIOU,BOUNKILING,BOGHAL,NDIAMALATHIEL,"SARE BACARY",24,32,150,135,285
SEDHIOU,BOUNKILING,BOGHAL,NDIAMALATHIEL,"SARE BIRAME",23,38,204,246,450
SEDHIOU,BOUNKILING,BOGHAL,NDIAMALATHIEL,"H1 SARE HAMADI",6,6,26,17,43
SEDHIOU,BOUNKILING,BOGHAL,NDIAMALATHIEL,"SARE BITEYE",68,88,469,485,954
SEDHIOU,BOUNKILING,BOGHAL,NDIAMALATHIEL,"SARE BOUBA",4,5,35,36,71
SEDHIOU,BOUNKILING,BOGHAL,NDIAMALATHIEL,"SARE SEYNI DIALLO",35,46,322,306,628
SEDHIOU,BOUNKILING,BOGHAL,NDIAMALATHIEL,TEMENTO,7,7,48,46,94
SEDHIOU,BOUNKILING,BOGHAL,NDIAMALATHIEL,"TOUBA FALL",38,46,266,231,497
SEDHIOU,BOUNKILING,BOGHAL,NDIAMALATHIEL,"VELINGARA (SARE YAYA III)",44,64,375,359,734
SEDHIOU,BOUNKILING,BOGHAL,NDIAMALATHIEL,"SARE KEBA",15,18,93,85,178
SEDHIOU,BOUNKILING,BOGHAL,NDIAMALATHIEL,"MADINA MOUNAWARA",7,7,21,14,35
SEDHIOU,BOUNKILING,BOGHAL,NDIAMALATHIEL,"BOUDOUCK SEWARE",13,13,99,78,177
SEDHIOU,BOUNKILING,BOGHAL,NDIAMALATHIEL,"BOUDOUCK (BOUDOUCK DIEMBERING)",5,5,21,22,43
SEDHIOU,BOUNKILING,BOGHAL,NDIAMALATHIEL,"BOUDOUCK DIAMAGUENE",20,21,137,121,258
SEDHIOU,BOUNKILING,BOGHAL,NDIAMACOUTA,NDIAMACOUTA,556,912,5632,5911,11543
SEDHIOU,BOUNKILING,BONA,BONA,BANOUNGOUNE,9,9,56,56,112
SEDHIOU,BOUNKILING,BONA,BONA,BONA,149,203,997,956,1953
SEDHIOU,BOUNKILING,BONA,BONA,BOUDIOGOUNE,5,10,41,33,74
SEDHIOU,BOUNKILING,BONA,BONA,"BOUGHARY DOUMA",63,76,350,343,693
SEDHIOU,BOUNKILING,BONA,BONA,"H1 NIMZATT",13,15,86,100,186
SEDHIOU,BOUNKILING,BONA,BONA,"BOUGHARY SANTO",2,3,24,20,44
SEDHIOU,BOUNKILING,BONA,BONA,BOUROSSO,7,8,55,50,105
SEDHIOU,BOUNKILING,BONA,BONA,BRIOU,41,53,273,242,515
SEDHIOU,BOUNKILING,BONA,BONA,DIALANKINE,11,12,33,34,67
SEDHIOU,BOUNKILING,BONA,BONA,DJIBAGHAR,37,45,195,182,377
SEDHIOU,BOUNKILING,BONA,BONA,"DJINIPER KILINKO",22,34,103,116,219
SEDHIOU,BOUNKILING,BONA,BONA,"DJIRAGONE DIAFAR",10,28,118,96,214
SEDHIOU,BOUNKILING,BONA,BONA,KAMANGOUBA,18,25,184,116,300
SEDHIOU,BOUNKILING,BONA,BONA,KAMBILA,20,25,136,138,274
SEDHIOU,BOUNKILING,BONA,BONA,"H1 DJIRAGONE III",3,5,17,20,37
SEDHIOU,BOUNKILING,BONA,BONA,"KANDION NIOSSON",7,7,43,24,67
SEDHIOU,BOUNKILING,BONA,BONA,KANGODY,7,12,73,59,132
SEDHIOU,BOUNKILING,BONA,BONA,KANTINKO,15,20,126,107,233
SEDHIOU,BOUNKILING,BONA,BONA,KAPOUNDOUNE,22,30,155,141,296
SEDHIOU,BOUNKILING,BONA,BONA,KARIATE,30,48,265,190,455
SEDHIOU,BOUNKILING,BONA,BONA,"MADINA FODE KABA",2,2,10,9,19
SEDHIOU,BOUNKILING,BONA,BONA,MAMBIGNE,25,38,172,149,321
SEDHIOU,BOUNKILING,BONA,BONA,NIAHOUMP,40,67,322,302,624
SEDHIOU,BOUNKILING,BONA,BONA,"H1 DJIRAGONE II",13,15,68,64,132
SEDHIOU,BOUNKILING,BONA,BONA,"SOUMBOUNDOU FOGNY",58,84,708,723,1431
SEDHIOU,BOUNKILING,BONA,DIACOUNDA,"ALLOUTE DIOLA",11,17,113,110,223
SEDHIOU,BOUNKILING,BONA,DIACOUNDA,"ALLOUTE MANDINGUE",37,48,430,398,828
SEDHIOU,BOUNKILING,BONA,DIACOUNDA,BAFATA,21,26,214,235,449
SEDHIOU,BOUNKILING,BONA,DIACOUNDA,BALALA,4,10,60,70,130
SEDHIOU,BOUNKILING,BONA,DIACOUNDA,BAYANKA,3,3,17,15,32
SEDHIOU,BOUNKILING,BONA,DIACOUNDA,"BISSARY DIOUB",21,31,169,158,327
SEDHIOU,BOUNKILING,BONA,DIACOUNDA,COUMBAGHOR,13,31,198,178,376
SEDHIOU,BOUNKILING,BONA,DIACOUNDA,DIACOUNDA,148,194,1046,912,1958
SEDHIOU,BOUNKILING,BONA,DIACOUNDA,DIAMAMBOLI,11,11,54,62,116
SEDHIOU,BOUNKILING,BONA,DIACOUNDA,"DIAMBELE POUNE",7,9,36,36,72
SEDHIOU,BOUNKILING,BONA,DIACOUNDA,DIASSIFAR,4,6,42,31,73
SEDHIOU,BOUNKILING,BONA,DIACOUNDA,DIEDIELY,5,6,49,40,89
SEDHIOU,BOUNKILING,BONA,DIACOUNDA,DIENDIEME,49,69,361,379,740
SEDHIOU,BOUNKILING,BONA,DIACOUNDA,KABEUMB,20,32,214,210,424
SEDHIOU,BOUNKILING,BONA,DIACOUNDA,KAMBOUNDA,9,10,59,51,110
SEDHIOU,BOUNKILING,BONA,DIACOUNDA,KAMOGHONE,19,30,178,165,343
SEDHIOU,BOUNKILING,BONA,DIACOUNDA,"H1 ANTENNE",14,15,97,79,176
SEDHIOU,BOUNKILING,BONA,DIACOUNDA,KANKOULERO,1,1,5,3,8
SEDHIOU,BOUNKILING,BONA,DIACOUNDA,"H1 ANSOU GOUDIABY",22,23,101,99,200
SEDHIOU,BOUNKILING,BONA,DIACOUNDA,"H2 MAMADOU MANGA",8,8,61,63,124
SEDHIOU,BOUNKILING,BONA,DIACOUNDA,MAFONGO,17,26,115,111,226
SEDHIOU,BOUNKILING,BONA,DIACOUNDA,NGHOGNAME,9,9,38,28,66
SEDHIOU,BOUNKILING,BONA,DIACOUNDA,NIOROKI,26,38,280,204,484
SEDHIOU,BOUNKILING,BONA,DIACOUNDA,SALABENO,11,11,108,80,188
SEDHIOU,BOUNKILING,BONA,DIACOUNDA,SITA,4,5,20,27,47
SEDHIOU,BOUNKILING,BONA,DIACOUNDA,SOUCOUTA,1,2,9,11,20
SEDHIOU,BOUNKILING,BONA,DIACOUNDA,"YACKO OUOLOF",19,27,146,181,327
SEDHIOU,BOUNKILING,BONA,DIACOUNDA,"YACKO PEULH",11,25,159,143,302
SEDHIOU,BOUNKILING,BONA,INOR,BADIMBOUR,14,19,96,85,181
SEDHIOU,BOUNKILING,BONA,INOR,BARANDAMA,16,18,111,87,198
SEDHIOU,BOUNKILING,BONA,INOR,"H1 KEUR AMADOU DIAO",3,3,27,28,55
SEDHIOU,BOUNKILING,BONA,INOR,BASSADA,11,13,122,105,227
SEDHIOU,BOUNKILING,BONA,INOR,BAYA,22,23,100,100,200
SEDHIOU,BOUNKILING,BONA,INOR,"BISSARI NIOSSON",13,21,140,120,260
SEDHIOU,BOUNKILING,BONA,INOR,"BISSARY KANSOYE",10,10,49,50,99
SEDHIOU,BOUNKILING,BONA,INOR,"DIAMWELY DOULO",5,10,30,27,57
SEDHIOU,BOUNKILING,BONA,INOR,"DIAMWELY SAMBA BA",16,16,71,65,136
SEDHIOU,BOUNKILING,BONA,INOR,"DIOUROUR I",21,26,143,170,313
SEDHIOU,BOUNKILING,BONA,INOR,"DIOUROUR II",5,5,37,28,65
SEDHIOU,BOUNKILING,BONA,INOR,"INOR BAYNOUCK",16,22,124,162,286
SEDHIOU,BOUNKILING,BONA,INOR,"INOR DIOLA",32,56,311,332,643
SEDHIOU,BOUNKILING,BONA,INOR,"INOR MANDINGUE",78,101,548,636,1184
SEDHIOU,BOUNKILING,BONA,INOR,KADIALELE,6,11,47,32,79
SEDHIOU,BOUNKILING,BONA,INOR,"H1 DIAOCOUNDA",7,10,40,39,79
SEDHIOU,BOUNKILING,BONA,INOR,KAMPILA,10,12,84,61,145
SEDHIOU,BOUNKILING,BONA,INOR,KANDIALON,114,138,1589,1049,2638
SEDHIOU,BOUNKILING,BONA,INOR,"MADINA GALLO SOW",6,16,76,75,151
SEDHIOU,BOUNKILING,BONA,INOR,"MADINA NDAWENE",14,15,96,105,201
SEDHIOU,BOUNKILING,BONA,INOR,"MADINA SOUCOUTOTO",6,8,48,51,99
SEDHIOU,BOUNKILING,BONA,INOR,"MANIORA DIOLA",5,9,51,40,91
SEDHIOU,BOUNKILING,BONA,INOR,"MANIORA II",27,28,125,123,248
SEDHIOU,BOUNKILING,BONA,INOR,"MANIORA MANDINGUE",9,12,88,68,156
SEDHIOU,BOUNKILING,BONA,INOR,MAYOR,55,74,493,458,951
SEDHIOU,BOUNKILING,BONA,INOR,"MEDINA LAMINE SALL",22,24,175,172,347
SEDHIOU,BOUNKILING,BONA,INOR,"H1 MISSIRAH SY",27,27,109,106,215
SEDHIOU,BOUNKILING,BONA,INOR,"MEDINA LOUMENE",10,11,63,83,146
SEDHIOU,BOUNKILING,BONA,INOR,MOUSDALIFA,11,11,41,44,85
SEDHIOU,BOUNKILING,BONA,INOR,NDONGANE,24,30,171,190,361
SEDHIOU,BOUNKILING,BONA,INOR,"H1 SARE MOUSSA BA",3,3,11,5,16
SEDHIOU,BOUNKILING,BONA,INOR,NIAHOUMP,15,19,79,83,162
SEDHIOU,BOUNKILING,BONA,INOR,"SARE MADA BA (KABOEL)",5,9,27,29,56
SEDHIOU,BOUNKILING,BONA,INOR,SEDECK,5,7,28,30,58
SEDHIOU,BOUNKILING,BONA,INOR,SIBIDIAN,8,10,41,47,88
SEDHIOU,BOUNKILING,BONA,INOR,TASLIMA,62,65,751,462,1213
SEDHIOU,BOUNKILING,BONA,INOR,"H1 VELINGARA II",13,13,82,54,136
SEDHIOU,BOUNKILING,BONA,INOR,TOBOR,23,29,177,206,383
SEDHIOU,BOUNKILING,BONA,INOR,"H1 TOBOR MANJACQUE",4,4,19,20,39
SEDHIOU,BOUNKILING,BONA,INOR,"VELINGARA (FAMARA MANE)",11,16,109,99,208
SEDHIOU,BOUNKILING,BONA,"KANDION MANGANA","DAR SALAM",7,13,60,63,123
SEDHIOU,BOUNKILING,BONA,"KANDION MANGANA","FARABA PEULH",6,17,58,62,120
SEDHIOU,BOUNKILING,BONA,"KANDION MANGANA",FARANDING,4,4,38,25,63
SEDHIOU,BOUNKILING,BONA,"KANDION MANGANA",GOMBOL,4,7,78,53,131
SEDHIOU,BOUNKILING,BONA,"KANDION MANGANA",KAMBOUSSEMA,20,29,165,137,302
SEDHIOU,BOUNKILING,BONA,"KANDION MANGANA",KAMINDIA,10,13,66,56,122
SEDHIOU,BOUNKILING,BONA,"KANDION MANGANA","KANDION MANGANA",17,28,140,131,271
SEDHIOU,BOUNKILING,BONA,"KANDION MANGANA","H1 DANSOCOUNDA",1,3,15,17,32
SEDHIOU,BOUNKILING,BONA,"KANDION MANGANA","H2 KITA KANDION",17,19,87,78,165
SEDHIOU,BOUNKILING,BONA,"KANDION MANGANA","H3 SAMPA MANGA",3,3,23,14,37
SEDHIOU,BOUNKILING,BONA,"KANDION MANGANA",KANSAMANDIANG,4,7,62,51,113
SEDHIOU,BOUNKILING,BONA,"KANDION MANGANA",SANCANDY,17,26,190,147,337
SEDHIOU,BOUNKILING,BONA,"KANDION MANGANA","H1 SARE TENING",2,4,15,14,29
SEDHIOU,BOUNKILING,BONA,"KANDION MANGANA",SANECOUNDA,1,3,11,8,19
SEDHIOU,BOUNKILING,BONA,"KANDION MANGANA",SINDIALON,9,21,136,117,253
SEDHIOU,BOUNKILING,BONA,"KANDION MANGANA","H1 KAMPASSA",4,5,33,34,67
SEDHIOU,BOUNKILING,BONA,"KANDION MANGANA",SOUCOUTOTO,3,7,49,57,106
SEDHIOU,BOUNKILING,BONA,"KANDION MANGANA",TAMBACOUNDA,6,7,57,34,91
SEDHIOU,BOUNKILING,DIAROUME,DIAROUME,"AFIA NDIAMA PEULH",17,23,240,201,441
SEDHIOU,BOUNKILING,DIAROUME,DIAROUME,ANDIOUME,11,11,56,49,105
SEDHIOU,BOUNKILING,DIAROUME,DIAROUME,"H1 LINKOTO",1,1,7,3,10
SEDHIOU,BOUNKILING,DIAROUME,DIAROUME,"BAFABANTANG MANDINGUE",7,8,60,54,114
SEDHIOU,BOUNKILING,DIAROUME,DIAROUME,BAGADADJI,56,77,847,730,1577
SEDHIOU,BOUNKILING,DIAROUME,DIAROUME,"BANI SONCODOU",6,10,84,102,186
SEDHIOU,BOUNKILING,DIAROUME,DIAROUME,BANTANTO,35,45,390,321,711
SEDHIOU,BOUNKILING,DIAROUME,DIAROUME,"BISSARI LANG",30,32,180,161,341
SEDHIOU,BOUNKILING,DIAROUME,DIAROUME,"DAROU SALAM BAITY",20,21,195,123,318
SEDHIOU,BOUNKILING,DIAROUME,DIAROUME,DIAROUME,163,195,972,969,1941
SEDHIOU,BOUNKILING,DIAROUME,DIAROUME,DJINDIANCOUNDA,13,19,158,146,304
SEDHIOU,BOUNKILING,DIAROUME,DIAROUME,"ESSOUK DIEME",2,2,8,5,13
SEDHIOU,BOUNKILING,DIAROUME,DIAROUME,HAMDALAYE,14,16,129,109,238
SEDHIOU,BOUNKILING,DIAROUME,DIAROUME,KANDIADIOU,71,102,945,898,1843
SEDHIOU,BOUNKILING,DIAROUME,DIAROUME,KANDIOUNKOU,83,109,827,920,1747
SEDHIOU,BOUNKILING,DIAROUME,DIAROUME,"KARARA BALANTE",5,5,39,32,71
SEDHIOU,BOUNKILING,DIAROUME,DIAROUME,"KARARA MANJAQUE",1,1,6,4,10
SEDHIOU,BOUNKILING,DIAROUME,DIAROUME,"KATABA SOUKOTO",15,18,153,127,280
SEDHIOU,BOUNKILING,DIAROUME,DIAROUME,KEGNEROBA,34,34,216,158,374
SEDHIOU,BOUNKILING,DIAROUME,DIAROUME,"KEUR SOULEYE",20,20,112,57,169
SEDHIOU,BOUNKILING,DIAROUME,DIAROUME,KIMBOUTO,20,26,269,268,537
SEDHIOU,BOUNKILING,DIAROUME,DIAROUME,KOUSSAOR,32,38,133,108,241
SEDHIOU,BOUNKILING,DIAROUME,DIAROUME,LANOUAR,11,11,67,46,113
SEDHIOU,BOUNKILING,DIAROUME,DIAROUME,MANCONTONG,38,46,299,301,600
SEDHIOU,BOUNKILING,DIAROUME,DIAROUME,"MANDING TRAORE",15,20,130,131,261
SEDHIOU,BOUNKILING,DIAROUME,DIAROUME,"MEDINA BAMBALY",16,16,202,141,343
SEDHIOU,BOUNKILING,DIAROUME,DIAROUME,"MILARD (TOUBA MANJAQUE)",5,5,28,27,55
SEDHIOU,BOUNKILING,DIAROUME,DIAROUME,"NAYLOU MARAM",56,65,337,344,681
SEDHIOU,BOUNKILING,DIAROUME,DIAROUME,NDIAGNENE,18,18,98,98,196
SEDHIOU,BOUNKILING,DIAROUME,DIAROUME,NDIAMA,150,232,1610,1408,3018
SEDHIOU,BOUNKILING,DIAROUME,DIAROUME,"H1 NDIAMA (UMULKURA)",1,1,445,18,463
SEDHIOU,BOUNKILING,DIAROUME,DIAROUME,"NEMA DIASSOR",17,20,138,134,272
SEDHIOU,BOUNKILING,DIAROUME,DIAROUME,NIADOUCOUNDA,6,6,46,40,86
SEDHIOU,BOUNKILING,DIAROUME,DIAROUME,"NIAKHAR SENE SENE",14,19,127,109,236
SEDHIOU,BOUNKILING,DIAROUME,DIAROUME,NIANDANKY,41,46,767,653,1420
SEDHIOU,BOUNKILING,DIAROUME,DIAROUME,"PASSY DIAMBATY",25,31,196,189,385
SEDHIOU,BOUNKILING,DIAROUME,DIAROUME,"SARE MOUSSA",5,5,24,20,44
SEDHIOU,BOUNKILING,DIAROUME,DIAROUME,SOUAKY,49,63,607,606,1213
SEDHIOU,BOUNKILING,DIAROUME,DIAROUME,"H1 SITANOUNKOU",2,2,13,8,21
SEDHIOU,BOUNKILING,DIAROUME,DIAROUME,"TAIBA DIASSOR",30,32,260,259,519
SEDHIOU,BOUNKILING,DIAROUME,DIAROUME,TAMBANA,24,32,215,203,418
SEDHIOU,BOUNKILING,DIAROUME,DIAROUME,"TOUBA DIASSOR",33,36,275,298,573
SEDHIOU,BOUNKILING,DIAROUME,DIAROUME,"H1 MEDINA ALADJI SAMBA LY",9,11,67,60,127
SEDHIOU,BOUNKILING,DIAROUME,DIAROUME,"TOUBA MOURIDE II",10,10,63,50,113
SEDHIOU,BOUNKILING,DIAROUME,DIAROUME,"MEDIMA NANDJIGUI",37,41,299,251,550
SEDHIOU,BOUNKILING,DIAROUME,DIAROUME,"DIAROU SALIM",4,4,79,54,133
SEDHIOU,BOUNKILING,DIAROUME,DIAROUME,"SINTHIANG HAMADY SOW",2,4,19,20,39
SEDHIOU,BOUNKILING,DIAROUME,DIAROUME,"KATABA SOUKOTOTO",6,8,55,57,112
SEDHIOU,BOUNKILING,DIAROUME,DIAROUME,"TOUBA NDIAMBOUR",18,18,112,44,156
SEDHIOU,BOUNKILING,DIAROUME,DIAMBATI,"BADION FALY",12,21,142,143,285
SEDHIOU,BOUNKILING,DIAROUME,DIAMBATI,"BADION LYSSE",12,14,77,79,156
SEDHIOU,BOUNKILING,DIAROUME,DIAMBATI,"BADION SIBOTO (BADIONGADA)",7,9,58,70,128
SEDHIOU,BOUNKILING,DIAROUME,DIAMBATI,BANANA,23,38,338,342,680
SEDHIOU,BOUNKILING,DIAROUME,DIAMBATI,"BANTANGNIMA (SARE SAYAND)",3,3,25,23,48
SEDHIOU,BOUNKILING,DIAROUME,DIAMBATI,BAYAMBA,30,56,443,498,941
SEDHIOU,BOUNKILING,DIAROUME,DIAMBATI,"H1 TOUBA SALOUM",6,6,38,31,69
SEDHIOU,BOUNKILING,DIAROUME,DIAMBATI,"CENTOUR EL HADJI",7,8,61,39,100
SEDHIOU,BOUNKILING,DIAROUME,DIAMBATI,"DAROU MINAME",11,11,98,80,178
SEDHIOU,BOUNKILING,DIAROUME,DIAMBATI,"DAROU SALAM CISSE",97,110,715,586,1301
SEDHIOU,BOUNKILING,DIAROUME,DIAMBATI,"DIAKA FODE (SARE FODE)",13,16,128,116,244
SEDHIOU,BOUNKILING,DIAROUME,DIAMBATI,"DIAKA SOULEYMANE",5,7,67,49,116
SEDHIOU,BOUNKILING,DIAROUME,DIAMBATI,DIALABA,12,25,107,104,211
SEDHIOU,BOUNKILING,DIAROUME,DIAMBATI,DIALAMBERE,11,14,103,79,182
SEDHIOU,BOUNKILING,DIAROUME,DIAMBATI,DIAMBATI,51,80,603,664,1267
SEDHIOU,BOUNKILING,DIAROUME,DIAMBATI,"H1 DINGUIRAYE",8,8,63,60,123
SEDHIOU,BOUNKILING,DIAROUME,DIAMBATI,"H3 MEDINA NDIOBENE",17,19,81,85,166
SEDHIOU,BOUNKILING,DIAROUME,DIAMBATI,DIAMWELI,10,10,105,98,203
SEDHIOU,BOUNKILING,DIAROUME,DIAMBATI,"DIANNAH SONCODOU",41,50,489,553,1042
SEDHIOU,BOUNKILING,DIAROUME,DIAMBATI,"H2 TANEMA",3,3,31,13,44
SEDHIOU,BOUNKILING,DIAROUME,DIAMBATI,HAMDALAYE,3,4,32,26,58
SEDHIOU,BOUNKILING,DIAROUME,DIAMBATI,"H1 PROKHANE",7,8,61,54,115
SEDHIOU,BOUNKILING,DIAROUME,DIAMBATI,KOUKOUYE,8,8,65,50,115
SEDHIOU,BOUNKILING,DIAROUME,DIAMBATI,MANCONODING,14,17,147,158,305
SEDHIOU,BOUNKILING,DIAROUME,DIAMBATI,"H1 DIADIALY",7,7,39,38,77
SEDHIOU,BOUNKILING,DIAROUME,DIAMBATI,MANOTO,13,15,84,44,128
SEDHIOU,BOUNKILING,DIAROUME,DIAMBATI,"MEDINA ALI MBALLO",1,2,8,10,18
SEDHIOU,BOUNKILING,DIAROUME,DIAMBATI,"MEDINA ALPHA CISSE",11,13,89,104,193
SEDHIOU,BOUNKILING,DIAROUME,DIAMBATI,"MEDINA MBAYAMBA",6,6,29,39,68
SEDHIOU,BOUNKILING,DIAROUME,DIAMBATI,"MEDINA SEYDOU NOUROU TALL (KERDENG)",14,14,77,71,148
SEDHIOU,BOUNKILING,DIAROUME,DIAMBATI,"MISSIRAH SONCODOU",34,46,440,516,956
SEDHIOU,BOUNKILING,DIAROUME,DIAMBATI,"SARE ALETH",1,2,12,16,28
SEDHIOU,BOUNKILING,DIAROUME,DIAMBATI,"SARE ALI DIAO MBALLO",2,5,19,19,38
SEDHIOU,BOUNKILING,DIAROUME,DIAMBATI,"SARE AMADOU",4,12,56,46,102
SEDHIOU,BOUNKILING,DIAROUME,DIAMBATI,"SARE BACARY",4,5,33,34,67
SEDHIOU,BOUNKILING,DIAROUME,DIAMBATI,"SARE BARADJI",9,9,50,41,91
SEDHIOU,BOUNKILING,DIAROUME,DIAMBATI,"SARE BIDJI",8,10,53,58,111
SEDHIOU,BOUNKILING,DIAROUME,DIAMBATI,"SARE BODIO",2,3,15,18,33
SEDHIOU,BOUNKILING,DIAROUME,DIAMBATI,"SARE DABO (SINTHIOU DIEME)",1,1,9,6,15
SEDHIOU,BOUNKILING,DIAROUME,DIAMBATI,"SARE DEMBA SOW (SINTHIOU DEMBA COUMBA)",4,4,27,11,38
SEDHIOU,BOUNKILING,DIAROUME,DIAMBATI,"SARE DIASSY",4,4,40,36,76
SEDHIOU,BOUNKILING,DIAROUME,DIAMBATI,"H1 DAROU MINAME II",3,4,24,19,43
SEDHIOU,BOUNKILING,DIAROUME,DIAMBATI,"SARE DOGA",13,16,78,51,129
SEDHIOU,BOUNKILING,DIAROUME,DIAMBATI,"SARE GAGNA",4,4,21,29,50
SEDHIOU,BOUNKILING,DIAROUME,DIAMBATI,"SARE GUIDOM (BAOUDIALI)",6,13,64,62,126
SEDHIOU,BOUNKILING,DIAROUME,DIAMBATI,"SARE ILA DJIBAKENE",2,4,27,15,42
SEDHIOU,BOUNKILING,DIAROUME,DIAMBATI,"SARE ILO",5,6,29,28,57
SEDHIOU,BOUNKILING,DIAROUME,DIAMBATI,"SARE LAKOU",6,6,21,15,36
SEDHIOU,BOUNKILING,DIAROUME,DIAMBATI,"SARE LAMINE DIALLO",8,15,44,49,93
SEDHIOU,BOUNKILING,DIAROUME,DIAMBATI,"H1 MEDINA TALLENE",15,20,123,136,259
SEDHIOU,BOUNKILING,DIAROUME,DIAMBATI,"SARE MANFOU (SARE ILA BARRY)",34,36,171,159,330
SEDHIOU,BOUNKILING,DIAROUME,DIAMBATI,"SARE MANGASSA",4,4,25,23,48
SEDHIOU,BOUNKILING,DIAROUME,DIAMBATI,"SARE NGADIA",2,2,18,16,34
SEDHIOU,BOUNKILING,DIAROUME,DIAMBATI,"SARE PATHE CISSE",3,8,50,32,82
SEDHIOU,BOUNKILING,DIAROUME,DIAMBATI,"SARE SAMBA DIAME (SINTHIANG SAMBA DIAME)",8,10,57,55,112
SEDHIOU,BOUNKILING,DIAROUME,DIAMBATI,"H1 DAROU SALAM",5,6,13,23,36
SEDHIOU,BOUNKILING,DIAROUME,DIAMBATI,"H2 SARE LAMINE FALL (FALLENE)",2,2,9,7,16
SEDHIOU,BOUNKILING,DIAROUME,DIAMBATI,"SARE SAMBA SOW",1,2,10,11,21
SEDHIOU,BOUNKILING,DIAROUME,DIAMBATI,"SARE SAMBELE",13,15,89,72,161
SEDHIOU,BOUNKILING,DIAROUME,DIAMBATI,"SARE SARA SEYDI (TEMENTO SINTHIOU SARA)",3,3,15,22,37
SEDHIOU,BOUNKILING,DIAROUME,DIAMBATI,"SARE SELBA",6,8,39,38,77
SEDHIOU,BOUNKILING,DIAROUME,DIAMBATI,"H1 SARE BATHIE DIALLO (SARE SAMBA DIALLO)",2,2,11,8,19
SEDHIOU,BOUNKILING,DIAROUME,DIAMBATI,"SARE SOUNKAROU",3,4,15,15,30
SEDHIOU,BOUNKILING,DIAROUME,DIAMBATI,"SIMPITORY (SINTHIOU HAMADY GINDY)",3,6,26,20,46
SEDHIOU,BOUNKILING,DIAROUME,DIAMBATI,"SINTHIANG BOYE DIALLO",3,8,29,27,56
SEDHIOU,BOUNKILING,DIAROUME,DIAMBATI,"SINTHIANG KADIALY",1,1,10,4,14
SEDHIOU,BOUNKILING,DIAROUME,DIAMBATI,"SINTHIANG OUSMANE",3,3,20,22,42
SEDHIOU,BOUNKILING,DIAROUME,DIAMBATI,"SINTHIANG SAMBAROU",5,6,36,41,77
SEDHIOU,BOUNKILING,DIAROUME,DIAMBATI,SYLLACOUNDA,20,28,202,168,370
SEDHIOU,BOUNKILING,DIAROUME,DIAMBATI,"TABADIANG (SARE BALLA)",14,17,110,126,236
SEDHIOU,BOUNKILING,DIAROUME,DIAMBATI,"TOUBA BAYAMBA",23,25,189,214,403
SEDHIOU,BOUNKILING,DIAROUME,DIAMBATI,"TOUBA FOULBE (OURA)",8,8,50,44,94
SEDHIOU,BOUNKILING,DIAROUME,DIAMBATI,"TOUBA MORICOUNDA",21,21,158,205,363
SEDHIOU,BOUNKILING,DIAROUME,DIAMBATI,"TOUBA NDAWENE",41,47,306,269,575
SEDHIOU,BOUNKILING,DIAROUME,DIAMBATI,"BADINDING KALIDOU",3,3,39,11,50
SEDHIOU,BOUNKILING,DIAROUME,DIAMBATI,"H1 NEMA SADIO CISSE",2,2,6,16,22
SEDHIOU,BOUNKILING,DIAROUME,DIAMBATI,"SARE SAWAYE (SINTHIOU SIRADIO )",4,4,22,17,39
SEDHIOU,BOUNKILING,DIAROUME,DIAMBATI,"SINTHIANG CHERIFOU",1,1,7,7,14
SEDHIOU,BOUNKILING,DIAROUME,DIAMBATI,"SINTHIOU OUSMANE GUEYE",1,1,8,9,17
SEDHIOU,BOUNKILING,DIAROUME,FAOUNE,BAMBARACOUNDA,14,15,104,86,190
SEDHIOU,BOUNKILING,DIAROUME,FAOUNE,BOUSSINKI,18,22,165,145,310
SEDHIOU,BOUNKILING,DIAROUME,FAOUNE,BOUSSOURA,58,67,344,299,643
SEDHIOU,BOUNKILING,DIAROUME,FAOUNE,"DAROU DINE",18,18,127,83,210
SEDHIOU,BOUNKILING,DIAROUME,FAOUNE,DIAMAGUENE,7,7,39,48,87
SEDHIOU,BOUNKILING,DIAROUME,FAOUNE,DIOKOUL,90,174,1045,998,2043
SEDHIOU,BOUNKILING,DIAROUME,FAOUNE,FAOUNE,145,161,863,777,1640
SEDHIOU,BOUNKILING,DIAROUME,FAOUNE,"FASS NDIAYENE",61,77,655,602,1257
SEDHIOU,BOUNKILING,DIAROUME,FAOUNE,"KEUR SETTE",22,26,233,214,447
SEDHIOU,BOUNKILING,DIAROUME,FAOUNE,"MADINA BOCAR SY (SARE DEMBEL)",65,91,556,561,1117
SEDHIOU,BOUNKILING,DIAROUME,FAOUNE,"H1 BOUSTANE",3,3,23,18,41
SEDHIOU,BOUNKILING,DIAROUME,FAOUNE,"MADINA OUMAR TOURE (SINTHIOU TOURE)",29,30,219,201,420
SEDHIOU,BOUNKILING,DIAROUME,FAOUNE,"MADINA TORODO (MEDINA DEMBA GANO)",88,103,559,552,1111
SEDHIOU,BOUNKILING,DIAROUME,FAOUNE,"H1 TAIBATOU",29,29,446,165,611
SEDHIOU,BOUNKILING,DIAROUME,FAOUNE,"MEDINA DIAMAL",17,19,166,176,342
SEDHIOU,BOUNKILING,DIAROUME,FAOUNE,"MEDINA TAWFEKH",8,12,95,82,177
SEDHIOU,BOUNKILING,DIAROUME,FAOUNE,"MISSIRAH BOUBACAR DIENG",56,59,341,323,664
SEDHIOU,BOUNKILING,DIAROUME,FAOUNE,NGUEYENE,34,50,349,274,623
SEDHIOU,BOUNKILING,DIAROUME,FAOUNE,"NGUEYENE (SARE DEMBA  GUEYE)",9,9,75,65,140
SEDHIOU,BOUNKILING,DIAROUME,FAOUNE,"SARE DEMBA THIOUNE (SINTHIOU BANEBA)",43,57,298,320,618
SEDHIOU,BOUNKILING,DIAROUME,FAOUNE,"SARE LAMINE BA",42,51,251,235,486
SEDHIOU,BOUNKILING,DIAROUME,FAOUNE,"SARE MOUTAR",20,23,159,147,306
SEDHIOU,BOUNKILING,DIAROUME,FAOUNE,"SARE PATHE DIALLO",61,71,454,361,815
SEDHIOU,BOUNKILING,DIAROUME,FAOUNE,"SINTHIOU ALIMOU BARRY",59,64,329,302,631
SEDHIOU,BOUNKILING,DIAROUME,FAOUNE,"SINTHIOU OUMAR DIAO",9,11,79,78,157
SEDHIOU,BOUNKILING,DIAROUME,FAOUNE,SOUMACOUNDA,8,8,44,37,81
SEDHIOU,BOUNKILING,DIAROUME,FAOUNE,"TOUBA M’BACKE",71,71,321,303,624
SEDHIOU,BOUNKILING,DIAROUME,FAOUNE,"TOUBA MOURIDE",136,153,977,926,1903
SEDHIOU,BOUNKILING,DIAROUME,FAOUNE,"VELINGARA (SARE ALPHA)",55,66,336,407,743
SEDHIOU,BOUNKILING,DIAROUME,FAOUNE,"H1 SARE MOUSSA SY",16,17,83,74,157
SEDHIOU,BOUNKILING,DIAROUME,"MADINA WANDIFA","CITE MILLIONNAIRE",128,150,749,734,1483
SEDHIOU,BOUNKILING,DIAROUME,"MADINA WANDIFA","DAROU SALAM",154,181,852,845,1697
SEDHIOU,BOUNKILING,DIAROUME,"MADINA WANDIFA",DJIROF,171,210,1384,1286,2670
SEDHIOU,BOUNKILING,DIAROUME,"MADINA WANDIFA",ISLAM,281,327,1495,1522,3017
SEDHIOU,BOUNKILING,DIAROUME,"MADINA WANDIFA",NEMA,144,162,809,831,1640
SEDHIOU,BOUNKILING,DIAROUME,"MADINA WANDIFA","SANKANLANG COUNDA",133,175,1177,1173,2350
SEDHIOU,BOUNKILING,DIAROUME,"MADINA WANDIFA",TOUBA,114,159,1341,983,2324
SEDHIOU,BOUNKILING,DIAROUME,"MADINA WANDIFA","TOUBA EL HADJI I",160,182,838,836,1674
SEDHIOU,BOUNKILING,DIAROUME,"MADINA WANDIFA","TOUBA EL HADJI II",157,172,894,782,1676
SEDHIOU,GOUDOMP,GOUDOMP,GOUDOMP,"DIOLACOUNDA I",202,368,1941,1737,3678
SEDHIOU,GOUDOMP,GOUDOMP,GOUDOMP,"DIOLACOUNDA II",256,355,1825,1776,3601
SEDHIOU,GOUDOMP,GOUDOMP,GOUDOMP,HAMDALAYE,336,481,2576,2533,5109
SEDHIOU,GOUDOMP,GOUDOMP,GOUDOMP,SANSANCONO,206,378,1795,1810,3605
SEDHIOU,GOUDOMP,DJIBANAR,DJIBANAR,"BACONDING (DIATTACOUNDA II)",93,116,632,517,1149
SEDHIOU,GOUDOMP,DJIBANAR,DJIBANAR,"BAFATA BRAME (Pop Déplacée)",1,1,3,3,6
SEDHIOU,GOUDOMP,DJIBANAR,DJIBANAR,"BAFATA I (BALANTE)",96,119,543,513,1056
SEDHIOU,GOUDOMP,DJIBANAR,DJIBANAR,"H1 ADEANADING",24,24,50,55,105
SEDHIOU,GOUDOMP,DJIBANAR,DJIBANAR,"H2 SALAMOULHIYA",4,4,85,42,127
SEDHIOU,GOUDOMP,DJIBANAR,DJIBANAR,"BINDABA MANDINGUE (Pop Déplacée)",1,1,3,1,4
SEDHIOU,GOUDOMP,DJIBANAR,DJIBANAR,"BINDABA MANKAGNE (Pop Déplacée)",4,4,6,0,6
SEDHIOU,GOUDOMP,DJIBANAR,DJIBANAR,BIRKAMA,242,334,1656,1618,3274
SEDHIOU,GOUDOMP,DJIBANAR,DJIBANAR,DJIBANAR,318,398,2648,2508,5156
SEDHIOU,GOUDOMP,DJIBANAR,DJIBANAR,KLONIA,17,20,80,85,165
SEDHIOU,GOUDOMP,DJIBANAR,DJIBANAR,KOUNAYAN,82,107,590,527,1117
SEDHIOU,GOUDOMP,DJIBANAR,KAOUR,"KANEMA MANCAGNE",23,27,74,67,141
SEDHIOU,GOUDOMP,DJIBANAR,KAOUR,"KANEMA MANJACQUE",6,9,27,33,60
SEDHIOU,GOUDOMP,DJIBANAR,KAOUR,KAOUR,89,117,807,762,1569
SEDHIOU,GOUDOMP,DJIBANAR,KAOUR,"KAOUR MANJACQUE",9,10,18,25,43
SEDHIOU,GOUDOMP,DJIBANAR,KAOUR,"MANECOUNDA II",46,51,301,258,559
SEDHIOU,GOUDOMP,DJIBANAR,KAOUR,MANGACOUNDA,130,162,884,849,1733
SEDHIOU,GOUDOMP,DJIBANAR,KAOUR,"PONTO DOSSE DIOLA",45,47,289,271,560
SEDHIOU,GOUDOMP,DJIBANAR,KAOUR,"PONTO DOSSE MANCAGNE",24,27,119,131,250
SEDHIOU,GOUDOMP,DJIBANAR,KAOUR,"SINGHER BAYNOUCK",28,53,282,253,535
SEDHIOU,GOUDOMP,DJIBANAR,KAOUR,"SINGHER DIOLA",13,18,36,9,45
SEDHIOU,GOUDOMP,DJIBANAR,KAOUR,"SINGHER ESCALE",14,28,116,90,206
SEDHIOU,GOUDOMP,DJIBANAR,"MANGAROUNGOU SANTO",ADIOUTI,23,30,236,205,441
SEDHIOU,GOUDOMP,DJIBANAR,"MANGAROUNGOU SANTO",BEYLAN,39,53,412,360,772
SEDHIOU,GOUDOMP,DJIBANAR,"MANGAROUNGOU SANTO",BINAKO,72,85,870,806,1676
SEDHIOU,GOUDOMP,DJIBANAR,"MANGAROUNGOU SANTO",BISSAKAL,25,36,265,308,573
SEDHIOU,GOUDOMP,DJIBANAR,"MANGAROUNGOU SANTO","DJIDADJI BALANTE",18,33,310,290,600
SEDHIOU,GOUDOMP,DJIBANAR,"MANGAROUNGOU SANTO","DJIDADJI MANDINGUE",36,42,298,299,597
SEDHIOU,GOUDOMP,DJIBANAR,"MANGAROUNGOU SANTO","KARANTABA SOUCOUTOTO",39,59,480,456,936
SEDHIOU,GOUDOMP,DJIBANAR,"MANGAROUNGOU SANTO",KELEDIA,4,5,44,38,82
SEDHIOU,GOUDOMP,DJIBANAR,"MANGAROUNGOU SANTO",KIGNINE,32,43,363,343,706
SEDHIOU,GOUDOMP,DJIBANAR,"MANGAROUNGOU SANTO","H1 SANTASSOU",7,11,77,87,164
SEDHIOU,GOUDOMP,DJIBANAR,"MANGAROUNGOU SANTO",KOSSY,18,25,179,153,332
SEDHIOU,GOUDOMP,DJIBANAR,"MANGAROUNGOU SANTO","KOUGNARA DOUMA",67,91,512,537,1049
SEDHIOU,GOUDOMP,DJIBANAR,"MANGAROUNGOU SANTO","KOUGNARA SANTO II",57,94,464,354,818
SEDHIOU,GOUDOMP,DJIBANAR,"MANGAROUNGOU SANTO","MANGAROUNGOU DOUMA",43,77,329,289,618
SEDHIOU,GOUDOMP,DJIBANAR,"MANGAROUNGOU SANTO","MANGAROUNGOU SANTO",69,108,378,362,740
SEDHIOU,GOUDOMP,DJIBANAR,"MANGAROUNGOU SANTO",MARAKISSA,8,21,107,109,216
SEDHIOU,GOUDOMP,DJIBANAR,"MANGAROUNGOU SANTO","MISSIRAH MANGAROUNGOU",21,38,137,165,302
SEDHIOU,GOUDOMP,DJIBANAR,"MANGAROUNGOU SANTO","SAMBELCOUNDA (DJIBONG)",35,45,409,383,792
SEDHIOU,GOUDOMP,DJIBANAR,"MANGAROUNGOU SANTO",SEGAFOULA,31,72,388,334,722
SEDHIOU,GOUDOMP,DJIBANAR,"MANGAROUNGOU SANTO",SEKOUNAYAN,14,26,167,185,352
SEDHIOU,GOUDOMP,DJIBANAR,"MANGAROUNGOU SANTO",SINAFA,9,22,132,115,247
SEDHIOU,GOUDOMP,DJIBANAR,"MANGAROUNGOU SANTO","SOUMACOUNDA MANCAGNE",17,22,103,145,248
SEDHIOU,GOUDOMP,DJIBANAR,"MANGAROUNGOU SANTO","SOUMACOUNDA MANDING",54,67,369,337,706
SEDHIOU,GOUDOMP,DJIBANAR,"SIMBANDI BALANTE",ANICE,21,24,123,118,241
SEDHIOU,GOUDOMP,DJIBANAR,"SIMBANDI BALANTE",ATHIOUFA,61,66,505,478,983
SEDHIOU,GOUDOMP,DJIBANAR,"SIMBANDI BALANTE",BANI,30,38,392,269,661
SEDHIOU,GOUDOMP,DJIBANAR,"SIMBANDI BALANTE",BONDALI,39,67,415,368,783
SEDHIOU,GOUDOMP,DJIBANAR,"SIMBANDI BALANTE",BOUKAOUR,24,42,230,257,487
SEDHIOU,GOUDOMP,DJIBANAR,"SIMBANDI BALANTE",BOUTOGHOL,12,21,73,68,141
SEDHIOU,GOUDOMP,DJIBANAR,"SIMBANDI BALANTE",DARSALAM,16,18,226,163,389
SEDHIOU,GOUDOMP,DJIBANAR,"SIMBANDI BALANTE",DJIMASSAR,21,32,172,183,355
SEDHIOU,GOUDOMP,DJIBANAR,"SIMBANDI BALANTE",DJIMBANA,50,72,571,634,1205
SEDHIOU,GOUDOMP,DJIBANAR,"SIMBANDI BALANTE","H1 SOUCOUTOTO",41,43,326,331,657
SEDHIOU,GOUDOMP,DJIBANAR,"SIMBANDI BALANTE",FARARA,36,41,330,266,596
SEDHIOU,GOUDOMP,DJIBANAR,"SIMBANDI BALANTE","HAMDALAYE BALANTE",77,81,594,558,1152
SEDHIOU,GOUDOMP,DJIBANAR,"SIMBANDI BALANTE","HAMDALAYE MANJAQUE",5,10,63,61,124
SEDHIOU,GOUDOMP,DJIBANAR,"SIMBANDI BALANTE","KOLANE BALANTE",74,80,427,467,894
SEDHIOU,GOUDOMP,DJIBANAR,"SIMBANDI BALANTE","H1 KRISSIM",20,25,110,133,243
SEDHIOU,GOUDOMP,DJIBANAR,"SIMBANDI BALANTE","KOLANE MANJAQUE",33,40,240,226,466
SEDHIOU,GOUDOMP,DJIBANAR,"SIMBANDI BALANTE","MADINA PEULH",38,41,199,224,423
SEDHIOU,GOUDOMP,DJIBANAR,"SIMBANDI BALANTE","MANDINA BALANTE",75,84,473,442,915
SEDHIOU,GOUDOMP,DJIBANAR,"SIMBANDI BALANTE","MANDINA MANJAQUE",20,25,133,160,293
SEDHIOU,GOUDOMP,DJIBANAR,"SIMBANDI BALANTE","MANECOUNDA I",69,85,375,418,793
SEDHIOU,GOUDOMP,DJIBANAR,"SIMBANDI BALANTE","MISSIRAH SAFANE (ASSOUMOUN)",51,85,593,533,1126
SEDHIOU,GOUDOMP,DJIBANAR,"SIMBANDI BALANTE","NIAFOR DOUMA",72,87,391,409,800
SEDHIOU,GOUDOMP,DJIBANAR,"SIMBANDI BALANTE","NIAFOR SANTO",47,63,256,233,489
SEDHIOU,GOUDOMP,DJIBANAR,"SIMBANDI BALANTE",PARIS,5,8,39,46,85
SEDHIOU,GOUDOMP,DJIBANAR,"SIMBANDI BALANTE","PIRIKI (BAKOUNDIOUG)",7,13,34,42,76
SEDHIOU,GOUDOMP,DJIBANAR,"SIMBANDI BALANTE",SAFANE,65,84,534,441,975
SEDHIOU,GOUDOMP,DJIBANAR,"SIMBANDI BALANTE",SANGHATE,9,10,44,39,83
SEDHIOU,GOUDOMP,DJIBANAR,"SIMBANDI BALANTE",SEDHIOUNDING,15,18,102,121,223
SEDHIOU,GOUDOMP,DJIBANAR,"SIMBANDI BALANTE",SEMENE,11,20,66,66,132
SEDHIOU,GOUDOMP,DJIBANAR,"SIMBANDI BALANTE",SIBANA,19,22,101,101,202
SEDHIOU,GOUDOMP,DJIBANAR,"SIMBANDI BALANTE","SIMBANDI BALANTE",315,398,1998,2064,4062
SEDHIOU,GOUDOMP,DJIBANAR,"SIMBANDI BALANTE","SINCAP TILIDJI",7,11,37,46,83
SEDHIOU,GOUDOMP,DJIBANAR,"SIMBANDI BALANTE",SONAKO,13,15,49,43,92
SEDHIOU,GOUDOMP,DJIBANAR,"SIMBANDI BALANTE","H1 AMANSAL (CENTRE)",2,8,27,29,56
SEDHIOU,GOUDOMP,DJIBANAR,"SIMBANDI BALANTE","TEMENTO MANCAGNE",34,39,103,110,213
SEDHIOU,GOUDOMP,DJIBANAR,"SIMBANDI BALANTE","TEMENTO MANDINGUE",33,35,237,224,461
SEDHIOU,GOUDOMP,DJIBANAR,"SIMBANDI BALANTE","TERIMBASSE BALANTE",12,15,41,48,89
SEDHIOU,GOUDOMP,DJIBANAR,"SIMBANDI BALANTE","TERIMBASSE MANCAGNE",34,51,234,238,472
SEDHIOU,GOUDOMP,DJIBANAR,"SIMBANDI BALANTE",THIANNOULE,23,28,75,63,138
SEDHIOU,GOUDOMP,DJIBANAR,"SIMBANDI BALANTE",THIAR,93,118,752,693,1445
SEDHIOU,GOUDOMP,DJIBANAR,"SIMBANDI BALANTE",THIEBA,12,17,75,59,134
SEDHIOU,GOUDOMP,DJIBANAR,"YARANG BALANTE","ADJING BALANTE",9,11,69,71,140
SEDHIOU,GOUDOMP,DJIBANAR,"YARANG BALANTE",BAGNIMA,8,14,55,72,127
SEDHIOU,GOUDOMP,DJIBANAR,"YARANG BALANTE","BAGUI BALANTE",8,15,66,54,120
SEDHIOU,GOUDOMP,DJIBANAR,"YARANG BALANTE","BAMBATO BALANTE",17,26,106,109,215
SEDHIOU,GOUDOMP,DJIBANAR,"YARANG BALANTE","BAMBATO MANDINGUE",16,18,172,179,351
SEDHIOU,GOUDOMP,DJIBANAR,"YARANG BALANTE","BILASSAR BALANTE",7,21,97,102,199
SEDHIOU,GOUDOMP,DJIBANAR,"YARANG BALANTE","BILASSAR MANCAGNE",1,5,19,15,34
SEDHIOU,GOUDOMP,DJIBANAR,"YARANG BALANTE","BILASSAR MANDINGUE",31,39,343,320,663
SEDHIOU,GOUDOMP,DJIBANAR,"YARANG BALANTE",BINACKO,7,9,33,34,67
SEDHIOU,GOUDOMP,DJIBANAR,"YARANG BALANTE","BOUCAMBRA BALANTE",13,23,112,112,224
SEDHIOU,GOUDOMP,DJIBANAR,"YARANG BALANTE","BOUCAMBRA MANCAGNE",24,27,235,199,434
SEDHIOU,GOUDOMP,DJIBANAR,"YARANG BALANTE",BRIMINE,6,8,36,30,66
SEDHIOU,GOUDOMP,DJIBANAR,"YARANG BALANTE",DIABICOUNDA,13,17,107,82,189
SEDHIOU,GOUDOMP,DJIBANAR,"YARANG BALANTE","FARANDJANTO MANDINGUE",23,31,204,226,430
SEDHIOU,GOUDOMP,DJIBANAR,"YARANG BALANTE",FASSADA,40,46,255,272,527
SEDHIOU,GOUDOMP,DJIBANAR,"YARANG BALANTE","H1 BINACONDING",11,15,139,133,272
SEDHIOU,GOUDOMP,DJIBANAR,"YARANG BALANTE",FASSANE,31,38,329,297,626
SEDHIOU,GOUDOMP,DJIBANAR,"YARANG BALANTE",KANDIOULIANE,7,8,31,22,53
SEDHIOU,GOUDOMP,DJIBANAR,"YARANG BALANTE",KANICO,11,28,119,128,247
SEDHIOU,GOUDOMP,DJIBANAR,"YARANG BALANTE","KINGHATE BALANTE",7,8,48,36,84
SEDHIOU,GOUDOMP,DJIBANAR,"YARANG BALANTE","KOUGNE BALANTE",13,23,94,122,216
SEDHIOU,GOUDOMP,DJIBANAR,"YARANG BALANTE","KOUGNE MANDINGUE",47,53,388,431,819
SEDHIOU,GOUDOMP,DJIBANAR,"YARANG BALANTE","KOUGNE MANJACQUE",4,5,41,37,78
SEDHIOU,GOUDOMP,DJIBANAR,"YARANG BALANTE",KOUSSI,10,20,66,77,143
SEDHIOU,GOUDOMP,DJIBANAR,"YARANG BALANTE",LIMANA,34,58,585,564,1149
SEDHIOU,GOUDOMP,DJIBANAR,"YARANG BALANTE","MADINA BALANTE",13,17,65,78,143
SEDHIOU,GOUDOMP,DJIBANAR,"YARANG BALANTE",MARSAILLE,11,17,74,67,141
SEDHIOU,GOUDOMP,DJIBANAR,"YARANG BALANTE",NIACOUNDA,15,26,197,144,341
SEDHIOU,GOUDOMP,DJIBANAR,"YARANG BALANTE","SANOU SENEGAL",18,43,163,190,353
SEDHIOU,GOUDOMP,DJIBANAR,"YARANG BALANTE",SATHIOUM,76,105,737,590,1327
SEDHIOU,GOUDOMP,DJIBANAR,"YARANG BALANTE","SIDIFE BALANTE",15,27,148,135,283
SEDHIOU,GOUDOMP,DJIBANAR,"YARANG BALANTE","SIDIFE MANJAQUE",2,5,21,37,58
SEDHIOU,GOUDOMP,DJIBANAR,"YARANG BALANTE",SINA,42,60,622,544,1166
SEDHIOU,GOUDOMP,DJIBANAR,"YARANG BALANTE","SINCAP TILIBO",9,16,64,60,124
SEDHIOU,GOUDOMP,DJIBANAR,"YARANG BALANTE","SINDIMA BALANTE",47,61,436,406,842
SEDHIOU,GOUDOMP,DJIBANAR,"YARANG BALANTE","SINDIMA MANDINGUE",18,42,139,220,359
SEDHIOU,GOUDOMP,DJIBANAR,"YARANG BALANTE",SOUMBOUR,6,8,37,35,72
SEDHIOU,GOUDOMP,DJIBANAR,"YARANG BALANTE",THIANAFF,16,25,107,101,208
SEDHIOU,GOUDOMP,DJIBANAR,"YARANG BALANTE","TOUBACOUTA MANDINGUE",16,21,123,137,260
SEDHIOU,GOUDOMP,DJIBANAR,"YARANG BALANTE","YARANG BALANTE",155,197,837,794,1631
SEDHIOU,GOUDOMP,DJIBANAR,"YARANG BALANTE","YARANG MANDINGUE",81,85,557,542,1099
SEDHIOU,GOUDOMP,DJIBANAR,DIATTACOUNDA,HLM,80,119,460,422,882
SEDHIOU,GOUDOMP,DJIBANAR,DIATTACOUNDA,KOUGNE,215,261,1103,1015,2118
SEDHIOU,GOUDOMP,DJIBANAR,DIATTACOUNDA,MEDINE,71,83,407,404,811
SEDHIOU,GOUDOMP,DJIBANAR,DIATTACOUNDA,SINCAP,31,40,140,155,295
SEDHIOU,GOUDOMP,DJIBANAR,DIATTACOUNDA,TESSITO,61,78,402,441,843
SEDHIOU,GOUDOMP,DJIBANAR,SAMINE,BAFOULABEING,59,83,527,551,1078
SEDHIOU,GOUDOMP,DJIBANAR,SAMINE,"CITE BALANTE",45,56,240,220,460
SEDHIOU,GOUDOMP,DJIBANAR,SAMINE,DOUMASSOU,29,53,255,281,536
SEDHIOU,GOUDOMP,DJIBANAR,SAMINE,"MEDINA BOULY",99,117,832,723,1555
SEDHIOU,GOUDOMP,DJIBANAR,SAMINE,"SAMINE SANTO",79,93,428,443,871
SEDHIOU,GOUDOMP,DJIBANAR,SAMINE,SANTASSOU,123,183,1134,898,2032
SEDHIOU,GOUDOMP,KARANTABA,KARANTABA,BAMBADION,50,69,684,662,1346
SEDHIOU,GOUDOMP,KARANTABA,KARANTABA,DIARING,165,207,2564,2432,4996
SEDHIOU,GOUDOMP,KARANTABA,KARANTABA,"DJIDINKY MANDINGUE",40,49,430,451,881
SEDHIOU,GOUDOMP,KARANTABA,KARANTABA,"DJIDINKY TINTY",15,24,157,148,305
SEDHIOU,GOUDOMP,KARANTABA,KARANTABA,KARANTABA,305,415,3377,3216,6593
SEDHIOU,GOUDOMP,KARANTABA,KARANTABA,"H1 MANECOUNDA",8,10,78,69,147
SEDHIOU,GOUDOMP,KARANTABA,KARANTABA,KERERE,11,16,108,120,228
SEDHIOU,GOUDOMP,KARANTABA,KARANTABA,KOUBONI,42,49,489,501,990
SEDHIOU,GOUDOMP,KARANTABA,KARANTABA,MANCONONDING,26,32,227,273,500
SEDHIOU,GOUDOMP,KARANTABA,KARANTABA,SAMBOUNG,10,24,135,134,269
SEDHIOU,GOUDOMP,KARANTABA,KARANTABA,"H1 TOUBA SAMBOUNG",12,12,92,101,193
SEDHIOU,GOUDOMP,KARANTABA,KARANTABA,SANDINIERY,160,201,1153,1174,2327
SEDHIOU,GOUDOMP,KARANTABA,KARANTABA,"SINTHIANG DAKAR",6,11,64,76,140
SEDHIOU,GOUDOMP,KARANTABA,KOLIBANTANG,BANTANDIANG,64,107,887,894,1781
SEDHIOU,GOUDOMP,KARANTABA,KOLIBANTANG,"H1 SINTHIANG DARA",1,1,10,15,25
SEDHIOU,GOUDOMP,KARANTABA,KOLIBANTANG,BONCONDING,10,11,104,86,190
SEDHIOU,GOUDOMP,KARANTABA,KOLIBANTANG,BOURBATO,9,14,105,109,214
SEDHIOU,GOUDOMP,KARANTABA,KOLIBANTANG,"DAROU SALAM KEDDA",11,12,106,94,200
SEDHIOU,GOUDOMP,KARANTABA,KOLIBANTANG,KATABINA,27,46,361,389,750
SEDHIOU,GOUDOMP,KARANTABA,KOLIBANTANG,KERACOUNDA,52,80,677,665,1342
SEDHIOU,GOUDOMP,KARANTABA,KOLIBANTANG,"KOKOUM PEULH",20,39,364,238,602
SEDHIOU,GOUDOMP,KARANTABA,KOLIBANTANG,KOLIBANTANG,41,64,403,399,802
SEDHIOU,GOUDOMP,KARANTABA,KOLIBANTANG,KOUROUNKOUROUNTO,6,10,91,69,160
SEDHIOU,GOUDOMP,KARANTABA,KOLIBANTANG,"H1 BAGADAJI",4,4,23,17,40
SEDHIOU,GOUDOMP,KARANTABA,KOLIBANTANG,MAKA,41,86,520,570,1090
SEDHIOU,GOUDOMP,KARANTABA,KOLIBANTANG,"MEDINA DEMBA SOW",12,23,186,144,330
SEDHIOU,GOUDOMP,KARANTABA,KOLIBANTANG,"H1 SEYDICOUNDA (MAKA SOUCOUTOTO)",4,5,53,51,104
SEDHIOU,GOUDOMP,KARANTABA,KOLIBANTANG,"H2 BANTANCOUNTO",2,2,10,16,26
SEDHIOU,GOUDOMP,KARANTABA,KOLIBANTANG,"MISSIRAH BOURBON",10,14,144,117,261
SEDHIOU,GOUDOMP,KARANTABA,KOLIBANTANG,"MISSIRA SAMBAOUROU",15,18,148,145,293
SEDHIOU,GOUDOMP,KARANTABA,KOLIBANTANG,MOBAYA,27,38,357,350,707
SEDHIOU,GOUDOMP,KARANTABA,KOLIBANTANG,MOYAFARA,40,70,572,560,1132
SEDHIOU,GOUDOMP,KARANTABA,KOLIBANTANG,SAKHO,13,24,174,170,344
SEDHIOU,GOUDOMP,KARANTABA,KOLIBANTANG,"SARE BELLA",5,8,53,45,98
SEDHIOU,GOUDOMP,KARANTABA,KOLIBANTANG,"SARE DICORY",6,9,77,79,156
SEDHIOU,GOUDOMP,KARANTABA,KOLIBANTANG,"SARE HALAL",16,26,157,159,316
SEDHIOU,GOUDOMP,KARANTABA,KOLIBANTANG,"H1 SARE SAMBA SIRA",6,7,41,51,92
SEDHIOU,GOUDOMP,KARANTABA,KOLIBANTANG,"SARE SADIO",9,16,111,102,213
SEDHIOU,GOUDOMP,KARANTABA,KOLIBANTANG,"SARE THIEVAL",5,11,63,44,107
SEDHIOU,GOUDOMP,KARANTABA,KOLIBANTANG,SOBALY,14,32,282,201,483
SEDHIOU,GOUDOMP,KARANTABA,KOLIBANTANG,"TEMENTO LAO",14,18,135,129,264
SEDHIOU,GOUDOMP,KARANTABA,KOLIBANTANG,VELINGARA,12,19,153,164,317
SEDHIOU,GOUDOMP,KARANTABA,KOLIBANTANG,WASSADOU,6,9,76,65,141
SEDHIOU,GOUDOMP,KARANTABA,KOLIBANTANG,YIRICOUMBATO,14,20,147,143,290
SEDHIOU,GOUDOMP,"SIMBANDI BRASSOU",NIAGHA,"BAMARY (BAMAR)",19,21,180,170,350
SEDHIOU,GOUDOMP,"SIMBANDI BRASSOU",NIAGHA,"BAMBADALA BA I",39,50,467,412,879
SEDHIOU,GOUDOMP,"SIMBANDI BRASSOU",NIAGHA,"H1 SINTHIANG MBAMBADALLA",4,4,29,40,69
SEDHIOU,GOUDOMP,"SIMBANDI BRASSOU",NIAGHA,BAMBADALANDING,25,30,229,236,465
SEDHIOU,GOUDOMP,"SIMBANDI BRASSOU",NIAGHA,BANTANGHEL,15,24,140,156,296
SEDHIOU,GOUDOMP,"SIMBANDI BRASSOU",NIAGHA,"DIALABA PEULH",31,43,290,318,608
SEDHIOU,GOUDOMP,"SIMBANDI BRASSOU",NIAGHA,DYABOUGOU,9,9,50,55,105
SEDHIOU,GOUDOMP,"SIMBANDI BRASSOU",NIAGHA,FANKA,14,17,144,163,307
SEDHIOU,GOUDOMP,"SIMBANDI BRASSOU",NIAGHA,HINAKO,23,28,195,183,378
SEDHIOU,GOUDOMP,"SIMBANDI BRASSOU",NIAGHA,KAHAL,7,12,81,93,174
SEDHIOU,GOUDOMP,"SIMBANDI BRASSOU",NIAGHA,KAOLACK,13,17,153,148,301
SEDHIOU,GOUDOMP,"SIMBANDI BRASSOU",NIAGHA,KITIM,62,76,364,401,765
SEDHIOU,GOUDOMP,"SIMBANDI BRASSOU",NIAGHA,KOUDALLA,18,23,191,200,391
SEDHIOU,GOUDOMP,"SIMBANDI BRASSOU",NIAGHA,KOUGNADJI,5,9,93,100,193
SEDHIOU,GOUDOMP,"SIMBANDI BRASSOU",NIAGHA,"MADINA TENING BALDE",16,22,166,177,343
SEDHIOU,GOUDOMP,"SIMBANDI BRASSOU",NIAGHA,MALIFARA,17,22,164,196,360
SEDHIOU,GOUDOMP,"SIMBANDI BRASSOU",NIAGHA,MAMBOUNKOU,26,34,237,229,466
SEDHIOU,GOUDOMP,"SIMBANDI BRASSOU",NIAGHA,"MEDINA SAMBAROU SEYDI",14,18,170,149,319
SEDHIOU,GOUDOMP,"SIMBANDI BRASSOU",NIAGHA,"SARE LAO",4,23,113,116,229
SEDHIOU,GOUDOMP,"SIMBANDI BRASSOU",NIAGHA,NIAGHA,62,84,418,453,871
SEDHIOU,GOUDOMP,"SIMBANDI BRASSOU",NIAGHA,"SARE MAMADY MANE",3,5,34,25,59
SEDHIOU,GOUDOMP,"SIMBANDI BRASSOU",NIAGHA,"SANTANDIANG PATHE",37,46,332,352,684
SEDHIOU,GOUDOMP,"SIMBANDI BRASSOU",NIAGHA,"SARE BOUKO SALIA",13,18,135,140,275
SEDHIOU,GOUDOMP,"SIMBANDI BRASSOU",NIAGHA,"SARE DEMBA DIAO",5,6,66,46,112
SEDHIOU,GOUDOMP,"SIMBANDI BRASSOU",NIAGHA,"SARE DEMBANE",16,20,177,147,324
SEDHIOU,GOUDOMP,"SIMBANDI BRASSOU",NIAGHA,"SARE DIAO GOULO",9,13,114,115,229
SEDHIOU,GOUDOMP,"SIMBANDI BRASSOU",NIAGHA,"SARE MADY",18,20,94,107,201
SEDHIOU,GOUDOMP,"SIMBANDI BRASSOU",NIAGHA,"SARE META",11,15,114,95,209
SEDHIOU,GOUDOMP,"SIMBANDI BRASSOU",NIAGHA,"SARE NIAKO",12,17,136,141,277
SEDHIOU,GOUDOMP,"SIMBANDI BRASSOU",NIAGHA,"SARE SAMBA COUTA",6,7,97,68,165
SEDHIOU,GOUDOMP,"SIMBANDI BRASSOU",NIAGHA,"SARE SINDI",8,13,93,95,188
SEDHIOU,GOUDOMP,"SIMBANDI BRASSOU",NIAGHA,"SARE TENING",63,80,578,514,1092
SEDHIOU,GOUDOMP,"SIMBANDI BRASSOU",NIAGHA,SIBIDIANTO,32,49,337,325,662
SEDHIOU,GOUDOMP,"SIMBANDI BRASSOU",NIAGHA,SINSINKO,19,28,138,142,280
SEDHIOU,GOUDOMP,"SIMBANDI BRASSOU",NIAGHA,"H2 SINTHIANG SANKOUNG",9,10,49,47,96
SEDHIOU,GOUDOMP,"SIMBANDI BRASSOU",NIAGHA,"SINTHIANG ALIOU BALDE",2,2,24,23,47
SEDHIOU,GOUDOMP,"SIMBANDI BRASSOU",NIAGHA,"SINTHIANG ALIOU DIAMANKA",4,4,23,25,48
SEDHIOU,GOUDOMP,"SIMBANDI BRASSOU",NIAGHA,"SINTHIANG DEMBA BALDE",7,8,77,86,163
SEDHIOU,GOUDOMP,"SIMBANDI BRASSOU",NIAGHA,"SINTHIANG MALI KANDE",20,24,129,158,287
SEDHIOU,GOUDOMP,"SIMBANDI BRASSOU",NIAGHA,"SINTHIANG SAMBAROU",13,15,101,102,203
SEDHIOU,GOUDOMP,"SIMBANDI BRASSOU",NIAGHA,"SINTHIANG SARA BOYDO",3,3,19,10,29
SEDHIOU,GOUDOMP,"SIMBANDI BRASSOU",NIAGHA,"SINTHIOU DIAE",12,16,114,114,228
SEDHIOU,GOUDOMP,"SIMBANDI BRASSOU",NIAGHA,SOULABALY,7,10,119,104,223
SEDHIOU,GOUDOMP,"SIMBANDI BRASSOU",NIAGHA,"WINSANKO NIAKO",9,20,141,132,273
SEDHIOU,GOUDOMP,"SIMBANDI BRASSOU",NIAGHA,"WINSANKO YORO",10,17,135,155,290
SEDHIOU,GOUDOMP,"SIMBANDI BRASSOU",NIAGHA,"MEDINA SARE DIAO",6,8,40,44,84
SEDHIOU,GOUDOMP,"SIMBANDI BRASSOU",NIAGHA,"SARE KOUNDIANG",4,7,30,37,67
SEDHIOU,GOUDOMP,"SIMBANDI BRASSOU",NIAGHA,"SANTANDIANG YOBA",3,7,35,31,66
SEDHIOU,GOUDOMP,"SIMBANDI BRASSOU","SIMBANDI BRASSOU","BADOBAR DOUMA",37,45,289,303,592
SEDHIOU,GOUDOMP,"SIMBANDI BRASSOU","SIMBANDI BRASSOU","BADOBAR SANTO",9,10,63,80,143
SEDHIOU,GOUDOMP,"SIMBANDI BRASSOU","SIMBANDI BRASSOU",BANTANCOUNTOU,5,7,34,34,68
SEDHIOU,GOUDOMP,"SIMBANDI BRASSOU","SIMBANDI BRASSOU","BISSASSOU DOUMA",56,69,602,442,1044
SEDHIOU,GOUDOMP,"SIMBANDI BRASSOU","SIMBANDI BRASSOU","BISSASSOU SANTO",49,90,597,580,1177
SEDHIOU,GOUDOMP,"SIMBANDI BRASSOU","SIMBANDI BRASSOU",BOUCARCOUNDA,47,67,448,489,937
SEDHIOU,GOUDOMP,"SIMBANDI BRASSOU","SIMBANDI BRASSOU",DAFIYA,13,14,129,103,232
SEDHIOU,GOUDOMP,"SIMBANDI BRASSOU","SIMBANDI BRASSOU","DARSALAM MANDING",28,38,332,323,655
SEDHIOU,GOUDOMP,"SIMBANDI BRASSOU","SIMBANDI BRASSOU",KAROUMBOU,115,126,726,711,1437
SEDHIOU,GOUDOMP,"SIMBANDI BRASSOU","SIMBANDI BRASSOU","H1 MATAR",8,9,70,72,142
SEDHIOU,GOUDOMP,"SIMBANDI BRASSOU","SIMBANDI BRASSOU",KEGNIMACOUNDA,7,11,69,77,146
SEDHIOU,GOUDOMP,"SIMBANDI BRASSOU","SIMBANDI BRASSOU",MANCOLICOUNDA,100,118,747,754,1501
SEDHIOU,GOUDOMP,"SIMBANDI BRASSOU","SIMBANDI BRASSOU",SAMBOUCOUNDA,44,53,401,358,759
SEDHIOU,GOUDOMP,"SIMBANDI BRASSOU","SIMBANDI BRASSOU","SIMBANDI BRASSOU BALANTE",240,365,2396,2251,4647
SEDHIOU,GOUDOMP,"SIMBANDI BRASSOU","SIMBANDI BRASSOU","H1 DAROU TASNIMA",4,4,14,3,17
SEDHIOU,GOUDOMP,"SIMBANDI BRASSOU","SIMBANDI BRASSOU","SIMBANDI BRASSOU MANJAQUE",57,99,484,501,985
SEDHIOU,GOUDOMP,"SIMBANDI BRASSOU","SIMBANDI BRASSOU",TABANDITO,6,7,57,44,101
SEDHIOU,GOUDOMP,"SIMBANDI BRASSOU","SIMBANDI BRASSOU","TANKANTO PEULH",12,14,110,113,223
SEDHIOU,GOUDOMP,"SIMBANDI BRASSOU","SIMBANDI BRASSOU","WALICOUNDA DOUMA",25,38,227,271,498
SEDHIOU,GOUDOMP,"SIMBANDI BRASSOU","SIMBANDI BRASSOU","WALICOUNDA SANTO",36,58,329,300,629
SEDHIOU,GOUDOMP,"SIMBANDI BRASSOU","SIMBANDI BRASSOU","WALICOUNDA SOUCOUTOTO",19,25,209,160,369
SEDHIOU,GOUDOMP,"SIMBANDI BRASSOU",BAGHERE,BAGHERE,89,110,653,707,1360
SEDHIOU,GOUDOMP,"SIMBANDI BRASSOU",BAGHERE,BAKIDIOTO,68,72,445,390,835
SEDHIOU,GOUDOMP,"SIMBANDI BRASSOU",BAGHERE,DIAMAYE,24,31,369,301,670
SEDHIOU,GOUDOMP,"SIMBANDI BRASSOU",BAGHERE,DIARIFA,15,36,244,231,475
SEDHIOU,GOUDOMP,"SIMBANDI BRASSOU",BAGHERE,DIOURDIOURDE,18,19,122,155,277
SEDHIOU,GOUDOMP,"SIMBANDI BRASSOU",BAGHERE,"H1 DIOURDIOURDE MANJACQUE",5,5,65,46,111
SEDHIOU,GOUDOMP,"SIMBANDI BRASSOU",BAGHERE,FADIOUGHAR,35,41,299,279,578
SEDHIOU,GOUDOMP,"SIMBANDI BRASSOU",BAGHERE,"H1 FADIOUNGHAR SANTO",9,9,55,70,125
SEDHIOU,GOUDOMP,"SIMBANDI BRASSOU",BAGHERE,FRANCOUNDA,24,36,296,324,620
SEDHIOU,GOUDOMP,"SIMBANDI BRASSOU",BAGHERE,KAFOULOU,40,46,360,403,763
SEDHIOU,GOUDOMP,"SIMBANDI BRASSOU",BAGHERE,"H1 SINTHIANG BOYE",2,4,23,22,45
SEDHIOU,GOUDOMP,"SIMBANDI BRASSOU",BAGHERE,"KANDIENOU SOUCOTOTO",33,43,391,403,794
SEDHIOU,GOUDOMP,"SIMBANDI BRASSOU",BAGHERE,"KANDIENOU SOUCOUTOTO",27,42,377,367,744
SEDHIOU,GOUDOMP,"SIMBANDI BRASSOU",BAGHERE,KANEVALY,22,37,237,224,461
SEDHIOU,GOUDOMP,"SIMBANDI BRASSOU",BAGHERE,"LAMIN (LAMEL)",33,59,431,412,843
SEDHIOU,GOUDOMP,"SIMBANDI BRASSOU",BAGHERE,"MEDINA IBRAHIMA DIALLO",10,13,73,94,167
SEDHIOU,GOUDOMP,"SIMBANDI BRASSOU",BAGHERE,"SAMODJI DINSE",7,11,66,72,138
SEDHIOU,GOUDOMP,"SIMBANDI BRASSOU",BAGHERE,"SAMODJI MANSA",9,28,174,175,349
SEDHIOU,GOUDOMP,"SIMBANDI BRASSOU",BAGHERE,SANSANCOUTOTO,93,110,780,773,1553
SEDHIOU,GOUDOMP,"SIMBANDI BRASSOU",BAGHERE,"SARE PATHE",8,13,92,77,169
SEDHIOU,GOUDOMP,"SIMBANDI BRASSOU",BAGHERE,"SARE SAMBEL",19,32,240,277,517
SEDHIOU,GOUDOMP,"SIMBANDI BRASSOU",BAGHERE,"SINTHIANG NDIOBO",22,25,171,188,359
SEDHIOU,GOUDOMP,"SIMBANDI BRASSOU",BAGHERE,"SINTHIOU BOCAR DEMBA",9,12,102,108,210
SEDHIOU,GOUDOMP,"SIMBANDI BRASSOU",BAGHERE,SOLIKO,26,32,192,191,383
SEDHIOU,GOUDOMP,"SIMBANDI BRASSOU",BAGHERE,SOTOTO,19,29,208,206,414
SEDHIOU,GOUDOMP,"SIMBANDI BRASSOU",BAGHERE,"H1 SINTHIANG SAMBA SEYDI",1,1,10,12,22
SEDHIOU,GOUDOMP,"SIMBANDI BRASSOU",BAGHERE,TALICOURTO,21,32,211,224,435
SEDHIOU,GOUDOMP,"SIMBANDI BRASSOU",BAGHERE,"H1 SINTHIANG YORO",6,8,41,34,75
SEDHIOU,GOUDOMP,"SIMBANDI BRASSOU",DIOUBOUDOU,"BAMBALY BRASSOU",36,50,296,366,662
SEDHIOU,GOUDOMP,"SIMBANDI BRASSOU",DIOUBOUDOU,BISSARY,24,37,258,257,515
SEDHIOU,GOUDOMP,"SIMBANDI BRASSOU",DIOUBOUDOU,BORAYA,30,36,286,319,605
SEDHIOU,GOUDOMP,"SIMBANDI BRASSOU",DIOUBOUDOU,DIOUDOUBOU,29,39,274,287,561
SEDHIOU,GOUDOMP,"SIMBANDI BRASSOU",DIOUBOUDOU,"H1 MANTOURIYA",4,4,36,34,70
SEDHIOU,GOUDOMP,"SIMBANDI BRASSOU",DIOUBOUDOU,"H2 CHERIFOYA",5,6,30,45,75
SEDHIOU,GOUDOMP,"SIMBANDI BRASSOU",DIOUBOUDOU,KINDOMBALICOUNDA,17,25,248,268,516
SEDHIOU,GOUDOMP,"SIMBANDI BRASSOU",DIOUBOUDOU,MALANDIANCOUNDA,41,47,497,506,1003
SEDHIOU,GOUDOMP,"SIMBANDI BRASSOU",DIOUBOUDOU,MANECOUNDA,38,60,499,461,960
SEDHIOU,GOUDOMP,"SIMBANDI BRASSOU",DIOUBOUDOU,SANOUFILY,39,64,492,404,896
SEDHIOU,GOUDOMP,"SIMBANDI BRASSOU",DIOUBOUDOU,"SANTHIABA MANJAQUE",7,8,92,85,177
SEDHIOU,GOUDOMP,"SIMBANDI BRASSOU",DIOUBOUDOU,"TABADIANG KABACOTO",17,23,186,162,348
SEDHIOU,GOUDOMP,"SIMBANDI BRASSOU",DIOUBOUDOU,"TABANDIANG SANTASSOU",13,13,91,92,183
SEDHIOU,GOUDOMP,"SIMBANDI BRASSOU",DIOUBOUDOU,"H1 LIBRASSY",4,4,32,31,63
SEDHIOU,GOUDOMP,"SIMBANDI BRASSOU",DIOUBOUDOU,"H2 TOUBA MEDINA FALL",2,2,10,0,10
SEDHIOU,GOUDOMP,"SIMBANDI BRASSOU",DIOUBOUDOU,TOGNATABA,13,15,153,162,315
SEDHIOU,GOUDOMP,"SIMBANDI BRASSOU",TANAFF,BADING,18,29,305,288,593
SEDHIOU,GOUDOMP,"SIMBANDI BRASSOU",TANAFF,"ESCALE-DOUANE MANCAGNE",59,95,691,512,1203
SEDHIOU,GOUDOMP,"SIMBANDI BRASSOU",TANAFF,MANSACOUNDA,85,97,486,514,1000
SEDHIOU,GOUDOMP,"SIMBANDI BRASSOU",TANAFF,MORICOUNDA,141,203,955,883,1838
SEDHIOU,GOUDOMP,"SIMBANDI BRASSOU",TANAFF,NEMA,172,219,1042,1007,2049
THIES,TIVAOUANE,NIAKHENE,NGANDIOUF,NDIGAL,42,45,102,84,186